,Order_ID,Product_ID,Product_Name,Warehouse_Location,Stock_Availability,Order_Quantity,Timestamp,Reorder_Level
0,ORD_001,18568,Baby Bucket Baby Girls Cotton Panties (Pack of 1) (New 10LC 6PC PK 7891_White -18WH-L/42_6 Months-12 Months),Warehouse C,391,358,2025-02-28 10:25:00,33
1,ORD_002,18715,Mee Mee Fresh Feel Baby Powder (Pk of 2),Warehouse C,158,131,2025-02-28 08:56:00,27
2,ORD_003,10241,Bold N Elegant Stripe Print Happy Face Half Sleeve Kid's T-Shirt with Denim Dungaree Bibshorts for Baby Boy & Girl,Warehouse B,501,470,2025-02-28 13:40:00,31
3,ORD_004,20225,"Neska Moda Unisex Baby Booties For 6 To 12 Months (Pink,White)",Warehouse C,395,378,2025-02-28 02:00:00,17
4,ORD_005,20226,"VT VIRTUE TRADERS Panda Design Cartoon All Season Winter Cap for Babies/Kids/Children,2-6 Years",Warehouse C,144,114,2025-02-28 11:27:00,30
5,ORD_006,8660,"StickMe 'Alphabets for Kids Learning Education Nursery Pre School Kinder Garden Baby Wall Sticker' -SM656 (Multi Colour, V...",Warehouse A,492,484,2025-02-28 23:32:00,8
6,ORD_007,21600,"PLUSPOINT Building Block Toys ,Construction Kit, STEM Learning Building Bricks Set, Birthday Gifts for Kids Children Girls...",Warehouse C,109,86,2025-02-28 16:35:00,23
7,ORD_008,21990,SMARNN Nazariya for Baby boy Girl (0-9 Months) (Pack of 12),Warehouse A,496,469,2025-02-28 12:13:00,27
8,ORD_009,8652,ANAB GI 6 Pack Squishies Mochi Squishy Toys Glow in The Dark Party Favors for Kids - Mini Kawaii Squishies Mochi Animals S...,Warehouse B,234,215,2025-02-28 17:55:00,19
9,ORD_010,21614,3BROS Unisex Cotton Blend Regular Fit Summer Half Sleeve Tshirt & Shorts Clothing Set for Baby Boy/Girl,Warehouse C,339,324,2025-02-28 17:41:00,15
10,ORD_011,21624,"Huggies Complete Comfort Wonder Pants, Extra Small (0-5kg) Size Baby Diaper Pants, (24 count) with 5 in 1 Comfort",Warehouse C,356,309,2025-02-28 17:16:00,47
11,ORD_012,8639,Ooka Baby Bath Towel 385 GSM Pure Cotton with Hood - White with Peach Trim,Warehouse B,291,280,2025-02-28 06:32:00,11
12,ORD_013,21636,"Luv Lap Jungle Time Double Sided Water Proof Baby Play Mat, Reversible Play mats for Kids, Baby Carpet, for Crawling Baby,...",Warehouse C,357,315,2025-02-28 00:40:00,42
13,ORD_014,21641,"Nany Kids Natural Baby Lotion For All Skin Types, Enriched with Aloe Vera, Almond Oil & Olive Oil with No Parabens, Combo ...",Warehouse C,428,382,2025-02-28 05:41:00,46
14,ORD_015,18710,"Mee Mee Soft Cotton New Born Baby Gift Set for Baby Boys, Baby Girls | Baby Clothes Gift Set (5 Pieces, Blue)",Warehouse C,494,446,2025-02-28 05:03:00,48
15,ORD_016,10257,Mothercare Baby-Boys Baby and Toddler Sleepers,Warehouse B,174,167,2025-02-28 02:49:00,7
16,ORD_017,10216,"Baybee 3 in 1 Smart Clean Portable Anti Slip Bath tub for Baby, Baby Bath Tub for Toddlers/Infants Kids for 0-3 Years (Pin...",Warehouse C,333,315,2025-02-28 10:15:00,18
17,ORD_018,10204,Mitushi Products Boy's Swim Shorts MONKEY (18-24 Months),Warehouse A,87,72,2025-02-28 08:58:00,15
18,ORD_019,18784,TOTS BABY MOMENTS,Warehouse A,411,399,2025-02-28 18:50:00,12
19,ORD_020,10215,Mom's Darling Baby caps for New Born 0-12 Months (Pack of 3) | Cotton Baby Cap Set for New Born Baby boy & Girls| New Born...,Warehouse A,124,98,2025-02-28 12:07:00,26
20,ORD_021,18747,THE LITTLE LOOKERS Soft Baby Bath Towel I 100% Cotton Washcloth for New Born Baby/Infants/Toddlers Available in Cute Colou...,Warehouse A,478,432,2025-02-28 03:27:00,46
21,ORD_022,18739,Stoics-Lace-up Casual Shoes for Boys & Girls,Warehouse B,381,366,2025-02-28 06:43:00,15
22,ORD_023,18667,NEW.TONE Baby Infant Cotton Front Open Full Sleeve Vest Tshirt Jhabla Top Suitable for Girls & Boys (Kids Combo Pack of 6),Warehouse C,516,483,2025-02-28 06:27:00,33
23,ORD_024,10278,Global Home® Baby Hooded Blanket Animal Face II Baby Hooded Bath Towel Soft Infant Toddler Hooded Towel 34X34 Inch - Dk Pink,Warehouse A,150,131,2025-02-28 15:52:00,19
24,ORD_025,18683,Jack's Star Cotton Lower Track Pants for Kids - Pajama Pant for Boys and Girls with Bottom Ribs - Pack of 3 (Multicolored),Warehouse C,208,181,2025-02-28 10:08:00,27
25,ORD_026,18684,Max Girls Printed Round Neck T-Shirt,Warehouse C,297,284,2025-02-28 15:45:00,13
26,ORD_027,18695,LBV 925 Sterling Silver Semi Precious Fluorite Birth Stone With Traditional Black Thread Nazariya Bracelet For Boys and Gi...,Warehouse A,206,168,2025-02-28 02:15:00,38
27,ORD_028,18704,Hopscotch Boys and Girls Fabric Graphic Print Slip Ons in Royal Blue Color,Warehouse C,411,403,2025-02-28 08:06:00,8
28,ORD_029,21595,Weleda Baby Calendula Lotion - 6.8 Oz,Warehouse A,306,260,2025-02-28 00:45:00,46
29,ORD_030,21743,Kids Choice Soft Sole Sandal Boy's and Girl's Canvas with Anti-Slip Sole (3-12 Months),Warehouse B,481,469,2025-02-28 06:25:00,12
30,ORD_031,8581,LIZAYRA Boy's and Girl's Summer Stylish White & Black Multicolour Top And Multicolour Shorts Casual Clothing Sets,Warehouse C,298,258,2025-02-28 16:59:00,40
31,ORD_032,21755,Chicco Apple Banana Flavored Toothpaste (50 Ml) with Strawberry Flavored Toothpaste (50 Ml) Combo,Warehouse C,86,45,2025-02-28 01:58:00,41
32,ORD_033,8576,NAPPY CREAM 4IN1 NAT SENS 100ML INTL,Warehouse C,222,186,2025-02-28 13:34:00,36
33,ORD_034,8572,Hopscotch Boys Cotton and Polyester Suspender Style Bow Applique Romper in Gray Color,Warehouse B,151,139,2025-02-28 21:35:00,12
34,ORD_035,21769,WorldCare® 3mm Neoprene Snorkeling Shoes Diving Socks Water Beach Boots M Pink (54024718JEL),Warehouse B,309,264,2025-02-28 04:35:00,45
35,ORD_036,21749,Little Peaches Newborn Baby Front Open Long Sleeve 100% Cotton Unisex Sleep Suit/Romper,Warehouse C,119,113,2025-02-28 07:27:00,6
36,ORD_037,8630,Honey Boo Baby Nail Clipper Safety Cutter Toddler Infant Scissor Manicure Pedicure Care Kit (Set 4) (Blue Bear),Warehouse B,73,51,2025-02-28 04:05:00,22
37,ORD_038,8593,"Cotson Woolen Cap for Baby Winter Warm Hat Ear Flap Knit Cap Beanie for Baby Boys Girls, 2-4 Year Age",Warehouse C,42,27,2025-02-28 10:12:00,15
38,ORD_039,21661,Gugzy Cute Panda Soap Box Holder with Cover Bathroom Storage Shelves Racks Floor Type Kitchen Sponge Drain Holder Supplies...,Warehouse B,60,23,2025-02-28 13:54:00,37
39,ORD_040,21662,Mylo Care Gentle Baby Laundry Detergent 1Ltr,Warehouse C,269,241,2025-02-28 00:37:00,28
40,ORD_041,21663,Gas + Colic Heating Pad for Natural Belly Relief by Frida Baby | Gentle Heat to Relax + Soothe Bellies | Instant Tummy War...,Warehouse B,411,402,2025-02-28 21:40:00,9
41,ORD_042,21669,"SOCKS BLACK-""PREMIUM""(ODOUR FREE, COMBED ORGANIC COTTON) For Kids 12-14 yrs",Warehouse C,124,83,2025-02-28 02:28:00,41
42,ORD_043,21721,"Mylo Essentials Cloth diapers for babies with 2 Free Insert, Oeko Tex Certified for 3Months to 3Years, Pack of 2 (Blue & Red)",Warehouse C,485,447,2025-02-28 23:56:00,38
43,ORD_044,21735,7 Hills Riding Club Baby Boys & Baby Girls Full Sleeves Cotton Dungaree (Pink,Warehouse C,455,420,2025-02-28 01:16:00,35
44,ORD_045,8664,Storio Baby Toys Rattles and Teethers Set for New Born Babies Toddler Infants & Children 5 Pcs - Non Toxic,Warehouse B,341,296,2025-02-28 13:46:00,45
45,ORD_046,8587,WorldCare® Neoprene Scuba Diving Socks Water Sport Beach Snorkeling Quick Dry Shoes L (66020338JEL),Warehouse B,219,170,2025-02-28 12:42:00,49
46,ORD_047,21542,"Grandpitstop - 4-Sided Grip, Anti Shake & Stable Cradle Clamp with 360° Rotation Motorcycle/Bike/Scooter/Cycle Without Cha...",Warehouse A,378,340,2025-02-28 22:57:00,38
47,ORD_048,21563,"Mizzle Natural Bamboo Soft Organic Baby Washcloths, Large, 10 x10-inch (Baby Pink and Blue)- Pack of 6",Warehouse B,436,419,2025-02-28 10:58:00,17
48,ORD_049,21594,BUMZEE Baby-Boys Vest,Warehouse A,75,62,2025-02-28 23:57:00,13
49,ORD_050,8678,Mee Mee Portable Baby Bottle Warmer with Mee Mee Portable Baby Bottle Warmer with Quick USB Charging | 10 Mins to Warm Bab...,Warehouse A,93,85,2025-02-28 01:06:00,8
50,ORD_051,8675,Shrungarika Silver Ghungroo Heart Charms Kada/Bracelet For Baby Girls & Baby Boys Alloy Anklet,Warehouse C,73,48,2025-02-28 17:01:00,25
51,ORD_052,21582,Jo's 1 PC (BABY Dinosaur) Shoe Charms Decoration for Shoes Bracelets - shoe charms make your shoes more interesting fun an...,Warehouse C,389,378,2025-02-28 09:34:00,11
52,ORD_053,8672,"Mamaearth Gentle Cleansing Natural Baby Shampoo, 400ml (White)",Warehouse C,451,422,2025-02-28 01:18:00,29
53,ORD_054,21592,Nino Bambino 100% Organic Cotton Yellow Colour Panda Printed Short Sleeves Round Neck Snap Closure Half Romper/Bodysuit/On...,Warehouse B,314,272,2025-02-28 09:09:00,42
54,ORD_055,21570,"MANMANI Fashion Baby Boys Cotton Blazer Style Shirt and Pant Set for Newborn, Infants, Toddlers and Child For Party, Event...",Warehouse B,215,208,2025-02-28 15:08:00,7
55,ORD_056,8696,Military Athletics Canvas Shoes,Warehouse A,180,163,2025-02-28 08:01:00,17
56,ORD_057,21650,"EMPOISON Kids Warm Winter Beanie Hat & Scarf Set for Boys Girls. Stylish Knit Skull Cap with Fleece Lining, Cold Snow Knit...",Warehouse B,459,417,2025-02-28 09:08:00,42
57,ORD_058,8589,Lillypupp New Born Baby Shoes-Booties-Socks-Size 3-12 Months for Boy Girl- with Lays and Grip for Infants.,Warehouse B,39,13,2025-02-28 14:45:00,26
58,ORD_059,18766,"Luv Lap Bubbles Kids Manual Toothbrush with Soft Bristles, BPA Free, Suction Cup, 33 tuft bristles,Multicolor Boys & Girls...",Warehouse A,367,328,2025-02-28 16:18:00,39
59,ORD_060,18765,"Mamaearth Daily Moisturizing Natural Baby Lotion (400 Ml) And Mamaearth Natural Toothpaste, Orange Flavour, Sls Free, With...",Warehouse B,480,475,2025-02-28 23:35:00,5
60,ORD_061,19033,Himalaya Baby Care Combo Powder 400ml and Baby Lotion 400ml,Warehouse B,350,324,2025-02-28 14:15:00,26
61,ORD_062,19034,JHB Baby Bracelet Crystal Nazariya Bangle/Bracelet For Kids For Baby Girl's or Baby Boy's,Warehouse A,343,322,2025-02-28 17:59:00,21
62,ORD_063,19037,"Sebamed Baby Cream, Extra Soft, 200Ml&Sebamed Baby Wash Extra Soft, 200Ml",Warehouse A,359,326,2025-02-28 14:03:00,33
63,ORD_064,19039,"Himalaya Gentle Baby Soap (4N*75g) & Himalaya Herbals Natural Glow Kesar Face Cream, 25gm",Warehouse A,75,28,2025-02-28 13:08:00,47
64,ORD_065,19046,Majestique Luxury Portable Baby Care Kit - 11 Piece Nursery Healthcare & Grooming Set for New Born Babies Grooming Set & T...,Warehouse A,129,80,2025-02-28 16:01:00,49
65,ORD_066,10060,Fancy Walas Presents New Born Baby Winter Wear Keep Warm Baby Clothes 5Pcs Sets Cotton Baby Boys Girls Unisex Baby Fleece/...,Warehouse C,292,248,2025-02-28 08:21:00,44
66,ORD_067,10056,Himalaya Baby Lotion (200ml),Warehouse A,160,151,2025-02-28 11:21:00,9
67,ORD_068,19058,Kidbee Infant's Baby Terry Hosiery Soft Cotton Newborn Napkin/Handkerchief/WashCloth/FaceTowels Reusable Extra Soft Multic...,Warehouse C,238,226,2025-02-28 05:49:00,12
68,ORD_069,19032,Kalkent Cotton Made Mitten Set for Newborn Baby Mittens and Socks Combo Set with Easygirp Soft Elastic for Baby Boys and B...,Warehouse B,254,230,2025-02-28 10:17:00,24
69,ORD_070,18931,"Colgate Kids Toothpaste with 0% Artificial Preservatives, Colours, Sweeteners for Whitening (6-9 Years, Natural Strawberry...",Warehouse B,230,204,2025-02-28 22:49:00,26
70,ORD_071,19004,Karthi’s Star New Born Baby Soft Clothes 100% Baby Cotton Hooded Towel | Comfort Baby Wraps for New Born for 0 to 2 Years...,Warehouse B,219,205,2025-02-28 00:52:00,14
71,ORD_072,18940,"Nivihsa : Handmade Crochet Baby girl Booties with headband Gift, Ideal for 3-6 Month (Insole lenght 10cm) - 100% Cotton Ya...",Warehouse B,211,166,2025-02-28 15:43:00,45
72,ORD_073,18951,Piku Store Full Sleeves T-Shirts & Lower Set,Warehouse C,355,347,2025-02-28 05:42:00,8
73,ORD_074,10110,BUMZEE Pink Girls Full Sleeves Sweatshirt And Jogger Set,Warehouse B,511,483,2025-02-28 09:11:00,28
74,ORD_075,18958,"SOFTSWISS Baby Bath Sponge, In Fruits Design, UlraSoft, Specially for New Born Babies and Children (PEACH_2), Pack of 2 Pc",Warehouse C,158,146,2025-02-28 11:17:00,12
75,ORD_076,18975,AloeMaa Daily Moisturising Natural Baby Lotion for All Skin Types with 99.5% Purified Aloe extracts and Jojoba Oil and Mur...,Warehouse C,341,328,2025-02-28 22:38:00,13
76,ORD_077,19013,OYO BABY® New Born Combo Daily Moisturizing Natural Baby Lotion and Natural Dusting Baby Powder for New Born Babies 200gm ...,Warehouse A,416,371,2025-02-28 08:23:00,45
77,ORD_078,19026,Sebamed Baby Cleansing Bar (Pack of 4) (4 x 25 g),Warehouse C,101,88,2025-02-28 09:12:00,13
78,ORD_079,19025,"BABBY NEST Baby ON Board Combo(Bump ON Board,Baby Moon)",Warehouse C,86,81,2025-02-28 17:57:00,5
79,ORD_080,10189,Jimmy Jammy Unisex Baby Boy & Girl Dress Soft Hosiery Cotton Blend T-shirt and Shorts Pack 6 T-shirt + 6 Shorts Multi colo...,Warehouse A,391,374,2025-02-28 01:09:00,17
80,ORD_081,18813,ABV Boys & Girls Slip on Sneakers,Warehouse A,126,98,2025-02-28 01:04:00,28
81,ORD_082,10154,SOUTH SAILOR Infant Baby’s 100% Cotton Sleeveless Side tie Jablas (Unisex) Pack of 5,Warehouse C,43,37,2025-02-28 01:32:00,6
82,ORD_083,18822,1stbabystore New Born Baby Sleeveless Vest Unisex Kids Cotton Baniyan Pack of 6,Warehouse C,299,252,2025-02-28 21:30:00,47
83,ORD_084,18825,"Mee Mee Premium Baby Feeding Bottle (250 ml, Spoon Light Pink) (MM-FP 6A_Pink)",Warehouse A,373,356,2025-02-28 05:07:00,17
84,ORD_085,18833,Bumchums Baby Boy's Cotton Clothing Set (Assorted) (Color & Print May Vary),Warehouse C,281,233,2025-02-28 12:29:00,48
85,ORD_086,18838,Sahiba Gems Exclusive Silver Baby Trishul Damru Hand Kada Red And Blue Color Design With Silver Ghungroo (Chandi Kada) Pac...,Warehouse B,514,472,2025-02-28 16:04:00,42
86,ORD_087,18841,QYOOTY Denim Blue Jeans Handbag Shoulder Purse For Office,Warehouse C,195,150,2025-02-28 09:47:00,45
87,ORD_088,10160,"NeskaModa Unisex Baby Booties For 6 To 12 Months (Red,White)",Warehouse B,263,246,2025-02-28 08:39:00,17
88,ORD_089,10159,"Neska Moda 12 To 18 Months Baby Boys & Baby Girls Pack Of 3 Pair Cotton Rabbit & Butterfly Booties (Black,Blue,Rani Pink)...",Warehouse A,129,89,2025-02-28 14:02:00,40
89,ORD_090,18824,Bumtum Baby Gift Box | Combo Pack of 4 | Tear-Free Massage Oil - Shampoo - Body Wash - Lotion Inside,Warehouse B,408,390,2025-02-28 07:19:00,18
90,ORD_091,10194,"Dr. Brown's Natural Flow Standard Neck Feeding Bottle (Pack of 2, White)",Warehouse C,306,257,2025-02-28 00:10:00,49
91,ORD_092,18930,BeyBee Quick Dry Waterproof Protector Dry Sheet - X-Large (Beige),Warehouse C,136,107,2025-02-28 18:32:00,29
92,ORD_093,19014,"Neska Moda 6 To 12 Months Baby Girls Cotton Butterfly Booties (Yellow,Rani) -SK139andBT7",Warehouse A,117,77,2025-02-28 18:54:00,40
93,ORD_094,10084,"Neska Moda 6 To 12 Months Baby Girls Pack Of 2 Pair Cotton Butterfly Frill Booties (Rani Pink,Maroon) -BT3andBT84",Warehouse C,467,451,2025-02-28 00:08:00,16
94,ORD_095,19017,Baby Bucket Soft Cotton Baby Girl's & Boy's Panties Set of 6 (2-3 Years)-Dark-Coloured -10DC-2,Warehouse C,400,362,2025-02-28 01:48:00,38
95,ORD_096,10075,"Qishare Baby Birthday Crown Headband, 2Pcs Elastic Tiaras Mini Birthday Crown for Baby Girl or Pet, Photo Prop Hair Clips ...",Warehouse B,204,189,2025-02-28 19:58:00,15
96,ORD_097,10102,OYO BABY New Born Combo Baby Shampoo for Newborn Babies and Kachi Ghani Pure Mustard Oil for baby massage 200ml each,Warehouse B,460,421,2025-02-28 17:42:00,39
97,ORD_098,18764,Pigeon Natural Botanical Baby Milky Lotion 500ml,Warehouse B,492,453,2025-02-28 09:41:00,39
98,ORD_099,18586,"FARETO Baby Boy's Cotton Mittens & Socks (Multicolour, 0-6 Months) - Set of 12",Warehouse C,264,250,2025-02-28 21:44:00,14
99,ORD_100,10386,Pack of 500PCS T Shape Needles Flat Head Pins for Beading Crafts Jewelry Necklace Earrings Bracelet Making 32mm,Warehouse B,422,383,2025-02-28 12:54:00,39
100,ORD_101,18515,"Ci Baby® Rich Moisture with Coconut Oil & Vitamin E Enriched with Nature's Best Herbs,| Enhances Bone Mineralization Massa...",Warehouse B,283,262,2025-02-28 21:16:00,21
101,ORD_102,18520,"Chicco Baby Moments Gentle Body Wash And Shampoo with Natural ingredients, No tears, Soap free, Head to toe bath, Dermatol...",Warehouse B,312,283,2025-02-28 05:45:00,29
102,ORD_103,10360,Gilli Shopee Baby Nose Cleaner Blister Pack/Aspirator Vacum Sucker Nose Mucus Snot Cleaner Pump (Pink),Warehouse C,69,49,2025-02-28 08:42:00,20
103,ORD_104,10358,"BabyGo Cushioned Potty Seat, Toilet Seat with Handle for Kids (Blue)",Warehouse C,214,189,2025-02-28 10:45:00,25
104,ORD_105,10316,Hopscotch Girls PU and Fiber Applique Bow and Polka Dots Printed LED Sneaker in White Color,Warehouse C,73,38,2025-02-28 10:40:00,35
105,ORD_106,18552,"Brzone Bath Toy Wind up Backstroke Swimming Penguins for Kids ,Up to 2 Years Kids Multi Color (Pack of 1)",Warehouse A,472,427,2025-02-28 02:24:00,45
106,ORD_107,18557,925 Pure Silver (Chandi) Nazariya Baby Boy and Baby Girls Bangle/Bracelet For Kids | Hulasi - One Pair,Warehouse A,68,23,2025-02-28 04:55:00,45
107,ORD_108,18561,DearJoy Baby Safety Helmet also used as Baby Head Protector + Kneepads (Orange Helmet & Pink Kneepads),Warehouse C,204,159,2025-02-28 23:35:00,45
108,ORD_109,18548,Lillypupp New Born Baby Shoes for Boy Booties Sandals for Ethnic wear. for pre-Walker and Firstwalker. (9-15 Months),Warehouse B,275,231,2025-02-28 06:36:00,44
109,ORD_110,18652,DZT1968 Baby Toddler Girl Bowknot Headband Super Stretch Hairband Headwear Newborn Hair Accessories,Warehouse C,103,78,2025-02-28 03:11:00,25
110,ORD_111,18755,"AHC Soft Colorful Cotton Baby Anti Skid Boys Girls Socks for 0-12 Months (Mix Colour, 2 Pair)",Warehouse A,279,259,2025-02-28 16:20:00,20
111,ORD_112,18759,Munchkin White Hot Safety Bath Ducky (Yellow),Warehouse B,244,237,2025-02-28 22:49:00,7
112,ORD_113,18600,"Mee Mee Premium Baby Glass Feeding Bottle (50 ml, Blue)",Warehouse C,107,70,2025-02-28 23:28:00,37
113,ORD_114,18651,Boss Baby Boy Birthday Decoration - Theme Cutouts (10 Pieces) for Party Decoration,Warehouse A,119,91,2025-02-28 05:45:00,28
114,ORD_115,10093,"zee Ad Vitamin Baby Massage Oil with Vitamin A, D, E & OLIVE Oil 100ml (2)",Warehouse C,76,66,2025-02-28 16:57:00,10
115,ORD_116,10092,FAYBY Baby Boy Girls Anti-Skid Socks Shoe for Toddler | Soft Rubber Breathable Sole Booties Kids | Cute Stylish Non Slip F...,Warehouse B,54,10,2025-02-28 23:30:00,44
116,ORD_117,10196,US Polo Association Boys Red and Blue Button-Down Collar Check Shirt,Warehouse B,36,27,2025-02-28 16:30:00,9
117,ORD_118,18793,HighEnd Just Born 100% Cotton Newborn Baby Clothes/Jhablas/Vests and langot Nappy/Newborn Essentials Reusable Combo Offer...,Warehouse C,268,242,2025-02-28 04:21:00,26
118,ORD_119,18792,Curatio Atogla Baby Cream 100ml Pack of 4,Warehouse C,89,67,2025-02-28 10:28:00,22
119,ORD_120,18605,Hopscotch Baby Girls Polyester and Viscose Short Puff Sleeves All Over Printed Party Dresses in White Color,Warehouse B,517,493,2025-02-28 04:35:00,24
120,ORD_121,18610,Jimmy Jammy Baby Boy & Girl Dress Soft Hosiery Cotton Blend T-shirt and Shorts Pack 4 T-shirt + 4 Shorts Multi colored,Warehouse C,306,292,2025-02-28 07:52:00,14
121,ORD_122,18619,"Riyo Baby Care Massage Oil With 9 Oils - Olive Oil, Sweet Almond Oil, Jojoba Seed Oil, Manuka Oil & Vitamin E for Healthy ...",Warehouse B,206,196,2025-02-28 00:32:00,10
122,ORD_123,18620,GURU KRIPA BABY PRODUCTS Newborn Frock Kids Soft Hosiery Jhabla Cotton Girl Front Open Knee Full Sleeves Infant Button rou...,Warehouse B,24,10,2025-02-28 11:35:00,14
123,ORD_124,18624,DearJoy Baby Bedding Set / Baby Bedding Mattress Set with Mosquito Net / Baby Bed Set and Baby Play Gym with Mosquito Net...,Warehouse C,462,413,2025-02-28 23:25:00,49
124,ORD_125,10299,FB Collection Girl's Knee Length Net Frock Dress | Beautiful Comfortable Dress for Girls (M003),Warehouse B,338,324,2025-02-28 12:10:00,14
125,ORD_126,18602,CLAP Baby Girls 3 Pack Cotton Tagless Camisole Aline Midi Dress Multicolor,Warehouse A,521,483,2025-02-28 17:47:00,38
126,ORD_127,18627,LMN CHILD CARE New Born Baby Girls/Boy Booties Multicolor,Warehouse A,114,73,2025-02-28 03:10:00,41
127,ORD_128,10297,"Cetaphil Baby Daily Moisturizing Lotion 400ml with Organic Calendula for Face & Body, Moisturizer for Kids",Warehouse B,111,95,2025-02-28 07:41:00,16
128,ORD_129,18635,Sneaker King Royal Care Instant Freshness Footwear Deodoriser 150ml,Warehouse B,269,224,2025-02-28 10:57:00,45
129,ORD_130,18636,Mothercare Baby Girls' Bodysuit,Warehouse C,398,355,2025-02-28 13:18:00,43
130,ORD_131,10292,LuvLap CAPS Booties Mittens Set Helicopter Bear FACE Print PO2,Warehouse B,490,479,2025-02-28 11:17:00,11
131,ORD_132,18647,Sanvi Towel/Bath Towel / 100% Cotton Washcloth for New Born Baby/Kids/Toddlers (0-12 Months) Small (46 cm * 84 cm) (Colour...,Warehouse A,126,84,2025-02-28 10:19:00,42
132,ORD_133,18650,"FunBlast Baby Toothbrush– Cute Microfiber Soft Tooth Brush, Extra Soft Bristles Toothbrush for 2+ Years Children, Rounded ...",Warehouse B,331,286,2025-02-28 17:04:00,45
133,ORD_134,18632,"GURU KRIPA BABY PRODUCTS Baby's Cotton Super Soft , High Absorbency Wash Towel Cloth Napkins Hankies (9""x8"" , Multicolor)",Warehouse B,364,354,2025-02-28 21:45:00,10
134,ORD_135,21684,THE LITTLE LOOKERS 8-Piece Hosiery Soft Cotton Newborn Face Towels/Napkins for New Born Babies / Infants (Pack of 2),Warehouse C,221,177,2025-02-28 01:57:00,44
135,ORD_136,21687,FabChoice-Kids Boy's& Girls Faux Leather Socks/Room Socks Slippers Home Soft-soled Shoes Boots Booties fit for 3-4 Year Ki...,Warehouse A,37,31,2025-02-28 10:44:00,6
136,ORD_137,22377,Happy Night Strawberry Mosquito Vapourizer - Oil based Mosquito Repellent Refill| 45 ML Mosquito Refill - Mosquito Liquid ...,Warehouse B,87,69,2025-02-28 19:23:00,18
137,ORD_138,22379,KNITCO Unisex Boys Girls Acrylic Woollen Sweater Vest in Multicolour Regular fit,Warehouse B,232,226,2025-02-28 16:19:00,6
138,ORD_139,22347,Giffee Baby Towels / New Born / Kids / Hooded / Soft Cotton / Infants (Green || Orange),Warehouse A,149,130,2025-02-28 22:22:00,19
139,ORD_140,22382,Mee Mee Mild Baby Shampoo (with Fruit Extracts - 500 ml) & Mee Mee Anti-Bacterial Baby Liquid Cleanser (500 ml - Refill Pack),Warehouse B,272,247,2025-02-28 22:38:00,25
140,ORD_141,22392,SRCREATIONS Baby Girl's&Boys's Polycotton Printed Sleeveless T-Shirt and Shorts Set 0-6 Months (Pack of 5),Warehouse B,139,114,2025-02-28 00:08:00,25
141,ORD_142,22396,"Trendy Dukaan™ - New Born Baby Gift Set for 0-12 Month Baby (Clothes, Bag, Wardrobe, Blanket, Plastic Sheets, Toys) - Baby...",Warehouse A,112,64,2025-02-28 17:42:00,48
142,ORD_143,22397,"Pampers All round Protection Pants, Medium size baby Diapers, (7-12kg) 200 Count Lotion with Aloe Vera",Warehouse A,319,310,2025-02-28 16:12:00,9
143,ORD_144,22401,"Huggies Complete Comfort Wonder Pants,Large (L) Size Baby Diaper Pants,(64 count) (9-14Kg) with 5 in 1 Comfort",Warehouse B,310,286,2025-02-28 04:23:00,24
144,ORD_145,8199,"V.B.K® Baby Boys and Baby Girls Clothing Set With Jabla, Nappies, Hand Mittens, Leg Booties, Cap and Green Leave Shape Chh...",Warehouse A,382,345,2025-02-28 16:57:00,37
145,ORD_146,22385,little PANDA Baby Boys & Baby Girls Tiger Dungaree & T-Shirt Clothing Set,Warehouse C,73,53,2025-02-28 11:43:00,20
146,ORD_147,22342,"LuvLap Joy Baby Sonic Electric Toothbrush,Includes 2 Sensitive Brush Heads, Tongue & Gum Cleaner, Hippo shaped bristle pro...",Warehouse C,286,244,2025-02-28 06:05:00,42
147,ORD_148,22333,"Baby Dove Rich Moisture Bathing Bar, 75g",Warehouse A,333,293,2025-02-28 13:07:00,40
148,ORD_149,22265,KATS CHEESE Kids Baby Boy and Girls Chu-Chu Sound Musical Walking Sandal,Warehouse C,109,86,2025-02-28 04:50:00,23
149,ORD_150,22270,Bold N Elegant Cool Cute Mate Apple Print T-shirt with Silver Foil Polka Print Sleeve & Denim Shorts Set for Infant Toddle...,Warehouse B,121,97,2025-02-28 08:42:00,24
150,ORD_151,22272,Honey Boo Baby Nail Clipper Safety Cutter Toddler Infant Scissor Manicure Pedicure Care Kit (Set 4) (Sky Blue),Warehouse B,116,90,2025-02-28 07:21:00,26
151,ORD_152,22282,"Pigeon Baby Moisturizing Body Lotion, for New Born, Combination Skin Types, Paraben Free, Enriched with Oat Lipid and Almo...",Warehouse C,18,10,2025-02-28 18:34:00,8
152,ORD_153,22365,"Safe-O-Kid Baby Safety Finger Brush/Grooming Kit with Box, Blue- Combo",Warehouse A,271,230,2025-02-28 20:15:00,41
153,ORD_154,8226,toyific Full Sleeve Soft Cotton Romper/Bodysuit/Onesies for Baby Boy & Baby Girl | New Born Unisex Baby Sleepsuit,Warehouse C,352,318,2025-02-28 04:03:00,34
154,ORD_155,8231,"LuvLap Soft 100% Cotton Hooded Wrapper Cum Warm, Blanket, for New Born Baby to 3 Year Old, 75cmx75cm, Bus Print (Sky Blue)",Warehouse A,396,387,2025-02-28 00:09:00,9
155,ORD_156,22348,Aringel Afterbite Herbal Spray (8Ml Each) Set of 3 Fast Relief from Insect Bites & Stings,Warehouse A,471,426,2025-02-28 11:47:00,45
156,ORD_157,22066,TIDDLY TOTS TIDDLY TOTS Kids Cotton Sleeveless T Shirt and Trouser for Summer Combo Set Dress- (Pack of 6)(1 to 2 Years),Warehouse C,159,134,2025-02-28 11:32:00,25
157,ORD_158,8398,Max Boys Printed Full Sleeves T-Shirt - Set of 3,Warehouse C,277,266,2025-02-28 17:23:00,11
158,ORD_159,8396,MINI KLUB Baby-Girl's Cotton Regular Mini Dress,Warehouse C,117,85,2025-02-28 20:48:00,32
159,ORD_160,22081,"INSTABUYZ Unisex Baby Sandal for Boys & Girls, Infant Sandal for Newborn (6-9 Months) Blue",Warehouse B,47,11,2025-02-28 11:38:00,36
160,ORD_161,22084,"Mee Mee Premium Glass Feeding Bottle with Eazy-Flow Technology, Anti-Colic Valve,Anti Slip,BPA-Free Baby Feeding Bottle fo...",Warehouse B,333,318,2025-02-28 19:06:00,15
161,ORD_162,8364,"Cetaphil Baby Daily Lotion, 400ml and Cetaphil Baby Gentle Wash and Shampoo, 230ml (Pack of 2)",Warehouse C,309,303,2025-02-28 17:57:00,6
162,ORD_163,22086,House Of Sensation Baby Bather/Baby Bath Seat/Baby Bath Tub/Kids Bather,Warehouse B,421,406,2025-02-28 06:01:00,15
163,ORD_164,22091,Max Girls Graphic Printed T-Shirt - Set of 2,Warehouse B,198,191,2025-02-28 17:21:00,7
164,ORD_165,8372,VWorld Baby Loving Amazing Duck Family Bathing Rubber Toys for Baby 4 Set Yellow Rubber Squeaky Lovely Floating Water Pool...,Warehouse B,260,224,2025-02-28 01:31:00,36
165,ORD_166,22113,Stokke® Flexi Bath - Transperant Blue,Warehouse C,383,354,2025-02-28 21:02:00,29
166,ORD_167,8369,Shyamcollections Baby Boy and Baby Girl T- Shirt and Shorts Set Dress Soft Cotton Hosiery Half Sleeve Multicolour - Pack o...,Warehouse C,520,497,2025-02-28 14:14:00,23
167,ORD_168,8366,"Bigbought New Born Baby Care Jabla (10 Pcs), Nappy (8 Pcs), Hand Mittens (4 Pair), Leg Booties (4 Pair) And Cap (4 Pcs), P...",Warehouse A,350,305,2025-02-28 22:28:00,45
168,ORD_169,22063,"Giggles - Linking Seals , Multicolour Activity Toy , Stack,Link and Bath Toy , 6 Months & Above , Infant and Preschool Toys",Warehouse B,222,194,2025-02-28 23:09:00,28
169,ORD_170,22261,THE PEPPY TEND I'm Cute You Should See My Maasi Baby Unisex Onesie-Romper Half Sleeves Regular Fit,Warehouse B,337,292,2025-02-28 07:06:00,45
170,ORD_171,22289,"Neska Moda 12 To 18 Months Baby Girls Cotton Butterfly Booties (Mint,Yellow) -BT1148andBT1153",Warehouse A,144,110,2025-02-28 01:47:00,34
171,ORD_172,8260,"DISNEY BY Jagannath Gangaram Pednekar Since 1965 18KT Yellow Gold, PENDENT BABY BRACELET FOR GIRS",Warehouse A,114,105,2025-02-28 21:26:00,9
172,ORD_173,8286,KNITROOT Twins Baby Boys Bodysuit for Infant Half Sleeve Envelope Neck We areTwins,Warehouse C,282,277,2025-02-28 19:28:00,5
173,ORD_174,21905,"Sunbaby""First Bath"" Net Deluxe Bather w/Padded Cushion for Baby, Safety Anti Slip Rubber-for Newborn/Infants,Portable Fold...",Warehouse B,487,482,2025-02-28 10:25:00,5
174,ORD_175,21886,ARTIFICIAL TREE Exclusive German Silver Ghungroo Charm Nazariya Bracelet/Kada with Black & White Beads (Crystal) for Baby ...,Warehouse A,233,203,2025-02-28 02:09:00,30
175,ORD_176,21911,"Baby Nasal Irrigator, 4 Pcs 10ml/20ml Professional Nasal Syringe, Portable Infant Nose Cleaner Rinsing Device, Fast All Na...",Warehouse A,463,436,2025-02-28 04:28:00,27
176,ORD_177,21853,Vbaby Unisex-Baby's Walking Shoes,Warehouse A,57,38,2025-02-28 10:02:00,19
177,ORD_178,21796,Himalaya Baby Massage Oil (500ml) & Himalaya Gift Pack,Warehouse B,364,346,2025-02-28 05:24:00,18
178,ORD_179,21803,"VAGHBHATT Multi-Colour Nylon / Shimmer / Grosgrain Ribbon Lace Head Band For Girls, Hairbands, Ribbon Boutique, Elastic Bo...",Warehouse A,357,344,2025-02-28 18:12:00,13
179,ORD_180,8552,MAHAKAAL JEWELS® Gold Plated Brass Open Ended Free Size Kada Bracelet Adjustable Kids Bangle Nazariya Evil Eye Protector B...,Warehouse B,161,152,2025-02-28 22:33:00,9
180,ORD_181,8551,SNOWIE SOFT® Baby Mirror Toys Educational Toys for Babies Infant Car Seat Toy Tummy Time Toys for Infant Toddler Baby Car ...,Warehouse A,181,161,2025-02-28 07:05:00,20
181,ORD_182,8530,Mee Mee Gentle Baby Body wash / Bubble Bath (With Cherry Extracts- 500 ml) & Mee Mee Baby Lotion With Fruit Extracts- 200 ...,Warehouse B,188,168,2025-02-28 09:12:00,20
182,ORD_183,21831,"Amul School Pack Butter Pasteurised, 100 g",Warehouse C,285,260,2025-02-28 20:39:00,25
183,ORD_184,21832,Bouncy Toonz Holi Romper Newborn Baby Boy Girl Kids Cotton Dress 0-3 Months Onesies Decoration White Color Infant Bodysuit...,Warehouse C,413,374,2025-02-28 13:24:00,39
184,ORD_185,21834,GiftsBouquet Baby Diaper Cake Gift Set for Baby Girl (Small Size),Warehouse A,93,75,2025-02-28 11:02:00,18
185,ORD_186,21839,"SebaMed Baby Lip Balm, 4.8g, White",Warehouse A,184,141,2025-02-28 11:20:00,43
186,ORD_187,21844,"Nuby 10-Pack Little Squirts Fun Bath Toys, Assorted Characters",Warehouse B,501,492,2025-02-28 17:47:00,9
187,ORD_188,21845,Pampers Baby Gentle Wet Wipes with Aloe Vera 144 Wipes,Warehouse C,373,344,2025-02-28 05:07:00,29
188,ORD_189,21847,Adore Extra Rich Sweet Almond Baby Body Massage Oil - 100ml,Warehouse B,179,144,2025-02-28 00:53:00,35
189,ORD_190,8536,Mee Mee Mild Baby Liquid Laundry Detergent Bottle (500ml) And Mee Mee Anti-Bacterial Baby Liquid Cleanser Bottle (500ml),Warehouse B,444,432,2025-02-28 18:33:00,12
190,ORD_191,21903,Sathiyas Baby Girls' Knee Length Dress.,Warehouse A,224,181,2025-02-28 01:35:00,43
191,ORD_192,22298,Fresfoot Organic Cotton Socks For New Born Baby 0-18 Months - Multicolour,Warehouse B,188,180,2025-02-28 12:42:00,8
192,ORD_193,21901,YBN Peppa Pig Heavy Quality Games Theme Stainless Steel Baby Feed Spoon and Fork Set- Multi Color,Warehouse C,377,365,2025-02-28 13:45:00,12
193,ORD_194,8250,STHIRA® 1Pcs Refrigerator Lock Freezer Door Lock Cabinet Lock Strong Adhesive Lock Window Door Restrictor Cable for Baby T...,Warehouse C,174,161,2025-02-28 12:27:00,13
194,ORD_195,22304,"Bembika,Multi-Colour,,Nylon Headband For Girls, Hairbands for Kids infant Headband, (Set of 3)",Warehouse C,125,103,2025-02-28 11:14:00,22
195,ORD_196,8236,"First Trend Silicone Teether for Soothing Babies Gums (Multicolor,Pack of 1)",Warehouse B,261,234,2025-02-28 11:29:00,27
196,ORD_197,22295,"AH Decals Cartoon Animated Lion Elephant and 3D Butterflies Wall Sticker for Kids for Living Bed, Vinyl",Warehouse B,84,38,2025-02-28 23:10:00,46
197,ORD_198,8407,"Neska Moda 0 To 6 Months Baby Boys & Baby Girls Pack Of 2 Pair Cotton Rabbit & Butterfly Booties (Rani Pink,Yellow) -BT112...",Warehouse B,387,357,2025-02-28 10:01:00,30
198,ORD_199,8520,Soku Shopee kids unisex baby boy and girl newborn infant pink anti skid booties/socks (0-6 months)(Pair of 2),Warehouse C,133,118,2025-02-28 01:55:00,15
199,ORD_200,21869,Baba & Baby Unisex T-Shirt,Warehouse B,290,259,2025-02-28 19:42:00,31
200,ORD_201,8525,LC WAIKIKI Boys Knitted pant,Warehouse C,494,454,2025-02-28 02:24:00,40
201,ORD_202,21885,TechHark® Pack of 200pcs DIY Plastic Brick Set 4D Space Children Intelligence Plastic Pipe Blocks Building Toys Straws(100...,Warehouse C,307,294,2025-02-28 11:28:00,13
202,ORD_203,21888,MJ Ragav Bath Toy Fishing Game for Children Fishing Toy Game/ Magnetic Fishing Game with Fishing Rod and Fishes for Kids,Warehouse A,339,304,2025-02-28 09:24:00,35
203,ORD_204,8496,BORNSTAR BABY BOY'S & GIRL'S SOCKS PACK OF 3 MULTICOLOUR SIZE ( 12 TO 24 MONTHS ),Warehouse A,179,151,2025-02-28 06:06:00,28
204,ORD_205,21893,"ShopCash New Born Baby Cap and Mitten Set (Multicolour, 0-3 Months)",Warehouse A,256,229,2025-02-28 19:09:00,27
205,ORD_206,8488,"Neska Moda Unisex Set Of 3 Pair Booties for 6 to 12 Months (Black,Red,Pink)",Warehouse B,308,270,2025-02-28 12:33:00,38
206,ORD_207,22216,VRT Frog Face Cartoon Bathing Gloves Children Cartoon Bath Towel Baby Bath Gloves (Green),Warehouse C,39,22,2025-02-28 00:33:00,17
207,ORD_208,8287,"Milky Soft Body Wash for Babies with Oats, Milk and Calendula – 400 ml & Gentle Cleansing Shampoo for Babies (200 ml) & No...",Warehouse A,156,119,2025-02-28 00:11:00,37
208,ORD_209,8606,Lillypupp New Born Baby/Kid’s Girl Soft Hair Band Gift Set. Hair Accessories Combo Pack of 2 Toddlers’s Headband | 1 to15 ...,Warehouse A,100,82,2025-02-28 20:31:00,18
209,ORD_210,21287,Neobaby Unisex-Baby's Casual Shoes,Warehouse B,80,54,2025-02-28 06:40:00,26
210,ORD_211,8830,"Neska Moda 12 To 18 Months Baby Girls Cotton Butterfly Frill Booties (Maroon,Yellow) -BT1148andBT1169",Warehouse A,184,138,2025-02-28 16:03:00,46
211,ORD_212,21290,Spack Jerrow Cotton Printed Skirt top for Baby Girls,Warehouse C,94,80,2025-02-28 20:51:00,14
212,ORD_213,21329,Sahiba Gems Light Comfortable Traditional Plain Hollow Self Design Small Red Crystal Head Baby Kada/Bangles in Solid Silve...,Warehouse C,469,423,2025-02-28 08:17:00,46
213,ORD_214,21322,First Kick New Born Baby Gift Set Combo Pack for Baby Boys and Baby Girls Pack of 5 Pcs,Warehouse A,276,260,2025-02-28 10:39:00,16
214,ORD_215,21324,Lilsoft Baby Girls 3 Pack Set Wrap T-Shirt & Diaper Cover,Warehouse B,466,438,2025-02-28 16:52:00,28
215,ORD_216,8799,Kidbee Baby Kid's Cotton Pajama Track Pant with Rib Multicolor Print (Pack of 3 Pcs),Warehouse C,442,437,2025-02-28 08:38:00,5
216,ORD_217,8822,6 Pcs Baby Cleaning Finger Brush Finger-cot Gauze Cotton Cleaning Brushes Soft Gauze Clean Oral Hygiene Brush Finger Tooth...,Warehouse B,364,336,2025-02-28 18:32:00,28
217,ORD_218,21381,MA BABY Rompers Bodysuits Fr New Born Baby boy Pure Cotton Infant One Piece onesies Safe and Comfortable Clothes For Prema...,Warehouse C,527,481,2025-02-28 23:41:00,46
218,ORD_219,21388,Redburg Chu Chu Shoes & Sandals for Baby,Warehouse A,490,463,2025-02-28 10:28:00,27
219,ORD_220,21390,"Himalaya Baby Powder, 400g with Baby Shampoo, 200ml",Warehouse C,391,379,2025-02-28 23:15:00,12
220,ORD_221,21465,"Mee Mee Anti-Bacterial Baby Liquid Cleanser (1.5 L - Bottle) & Mild Baby Liquid Laundry Detergent, 500ml",Warehouse B,370,322,2025-02-28 03:39:00,48
221,ORD_222,8796,JABA'S® Chu chu Sound Duck Family Ducklings Bath Toys Baby Bathing Water Pool Tub Non-Toxic Toddler Rubber Squeaky Lovely ...,Warehouse A,252,240,2025-02-28 03:14:00,12
222,ORD_223,21354,MY NEWBORN Baby Bibs Apron for Baby boy and Baby Girl in Multicolor- Pack of 3 & MY NEWBORN Baby Towel Bathrobe Hooded Bla...,Warehouse A,290,246,2025-02-28 03:32:00,44
223,ORD_224,21470,"Neska Moda 12 To 18 Months Baby Boys & Baby Girls Pack Of 2 Pair Cotton Butterfly Frill Booties (Rani Pink,Baby Pink) -BT1...",Warehouse A,445,433,2025-02-28 13:17:00,12
224,ORD_225,21701,"Yellow Bee Pilot Beanie Cap for Boys, Brown, 6 Months to 4 Years",Warehouse C,101,56,2025-02-28 06:26:00,45
225,ORD_226,8605,UJEAVETTE New 3Mm Neoprene Diving Scuba Surfing Swimming Socks Water Sports Boots M,Warehouse C,484,466,2025-02-28 06:23:00,18
226,ORD_227,8598,"Munchkin Miracle Stainless Steel 360 Sippy Cup, Green, 10 Ounce",Warehouse C,508,465,2025-02-28 08:27:00,43
227,ORD_228,8698,Radhey Preet® 12pc Squeeze Set | Chu Chu Set | Bath Toy | 12 Different Type of Animals | Best for Kids Whose Ages Between ...,Warehouse B,268,255,2025-02-28 12:00:00,13
228,ORD_229,8701,"V.B.K® Baby Boys and Baby Girls Mittens (Hand Gloves), Pack Of 12 Pairs, Pure Hosiery Soft Fabric Material, 0 to 6 Months",Warehouse B,519,489,2025-02-28 20:55:00,30
229,ORD_230,8795,Philips Avent 1 Hole Newborn Flow Natural Teat (2 Pieces),Warehouse B,227,183,2025-02-28 16:42:00,44
230,ORD_231,8793,Vijkan Aarushi Baby Multi Colour Soft Cotton Water Resistance Round Bibs Pack of 3,Warehouse B,246,205,2025-02-28 22:44:00,41
231,ORD_232,21346,Aya Papaya Ouchie Monster Print Mosquito Repellent Patches 100% Natural 72 Patches,Warehouse A,410,402,2025-02-28 04:59:00,8
232,ORD_233,21348,Maate Baby Skincare Wellness Box | Collection of All Baby Skincare Needs | Baby Gift Set for New Born | Baby Kit,Warehouse A,43,17,2025-02-28 01:31:00,26
233,ORD_234,21365,"Cetaphil Baby Mild Bar for Face and Body-Pack of 2, 75g*2",Warehouse B,185,179,2025-02-28 23:29:00,6
234,ORD_235,8782,Mamaearth Milky Soft Natural Baby Face Cream for Babies 60mL & Dusting Powder with Organic Oatmeal & Arrowroot Powder 150g...,Warehouse A,152,119,2025-02-28 12:08:00,33
235,ORD_236,21371,Johnson's Baby Top To Toe Wash 500 Ml,Warehouse C,26,16,2025-02-28 17:38:00,10
236,ORD_237,8731,"Skip Hop Moby Friends Showerhead, Starfish Showerhead (235626)",Warehouse C,206,186,2025-02-28 13:37:00,20
237,ORD_238,8727,Bold N Elegant Kids Thick Warm Fur Fleece T-shirt Sweatshirt Joggers Pant Winter Clothing set for Baby Boy Girl,Warehouse B,470,456,2025-02-28 08:23:00,14
238,ORD_239,22239,"Pannie pink Slipper for Boys & Girls | Outdoor, Walking, All Day Casual Wear",Warehouse A,322,273,2025-02-28 04:58:00,49
239,ORD_240,8747,"Pigeon Peristaltic Nipple S,For 0+ Month Babies,BPS Free,BPA Free",Warehouse A,274,258,2025-02-28 14:35:00,16
240,ORD_241,21445,Kidbee Baby Girls Rich Cotton Soft Gripe Anti Slip/Anti Skid Kids Socks (MultiColor),Warehouse A,203,169,2025-02-28 03:49:00,34
241,ORD_242,8744,MINI BERRY AM Impex New Born Baby Gift Set in Yellow Color 10 PCs,Warehouse C,257,209,2025-02-28 21:10:00,48
242,ORD_243,8567,Baby Moo My Pet's House Chu-Chu Sound Breathable Anti-Skid Sandals - Blue (2Y-2.5Y),Warehouse B,260,245,2025-02-28 06:24:00,15
243,ORD_244,8835,eHomeKart Wave Plain Adjustable 3-in-1 Plastic Swing for Kids (Multicolour),Warehouse A,39,13,2025-02-28 06:12:00,26
244,ORD_245,21786,"The Moms Co. Natural Baby Massage Oil with 10 Oils- Sesame Oil, Avocado, Organic Almond, Organic Jojoba, Organic Chamomil...",Warehouse B,70,48,2025-02-28 13:04:00,22
245,ORD_246,21794,"Himalaya Baby Powder, 400 g",Warehouse C,358,319,2025-02-28 16:14:00,39
246,ORD_247,22142,AMAZARA Baby Proofing Corner Guards I Pre-Taped Corner Protectors I Child Safety Edge Guards I 10 Pieces Brown,Warehouse B,99,66,2025-02-28 05:14:00,33
247,ORD_248,22155,Amazon Brand - Solimo Cotton Buds - 200 Sticks (Pack of 2),Warehouse C,143,118,2025-02-28 05:36:00,25
248,ORD_249,22156,PUMA Infant Girls Future Rider Spring Lace Up Sneakers Shoes Casual - White,Warehouse A,87,58,2025-02-28 19:44:00,29
249,ORD_250,22173,Mee Mee Mild Baby Shampoo With Fruit Extracts | 100ml - Pack Of 1,Warehouse B,298,250,2025-02-28 02:50:00,48
250,ORD_251,8327,C-Knits Short Sleeves Flower Crochet Dress with Headband & Booties - Green,Warehouse B,136,109,2025-02-28 17:13:00,27
251,ORD_252,8326,"Adore Bottle Nipple and Straw Cleaning Kit, Multi Color Feeding Bottle Cleaner Brush (Cleaning Brush Kit) (Aventus)",Warehouse C,239,216,2025-02-28 06:36:00,23
252,ORD_253,8320,KNITROOT Chachu Bua Special Unisex Baby Romper Half Sleeve Envelope Neck Chachu Ki Jaan,Warehouse C,98,88,2025-02-28 17:31:00,10
253,ORD_254,22234,"Colgate Toothpaste for Kids (3-5 years), Natural Strawberry Flavour - 80 gr Tube,Cavity Protection,0% artificial preservat...",Warehouse A,212,206,2025-02-28 19:05:00,6
254,ORD_255,22236,SYGA Newborn Infant Baby Girls Soft Velvet Headbands Hairbands Hair Accessories Bow Headband Toddlers Kids 0-2 Years (Dark...,Warehouse C,409,384,2025-02-28 13:59:00,25
255,ORD_256,8748,Trendy Dukaan Baby Boy's & Baby Girl's Cotton Blend Socks,Warehouse A,293,246,2025-02-28 06:29:00,47
256,ORD_257,8721,"SAFERSKY (Set Of 4 Pcs) Baby Knee Pads for Crawling, Anti-Slip Padded Stretchable Elastic Cotton Soft Breathable Comfortab...",Warehouse B,125,108,2025-02-28 03:57:00,17
257,ORD_258,8750,SOFTSPUN Microfiber Baby Face & Bath Towel Set of 3 Pieces 40x40 40x60 Cms & 60x120 Cms 340 GSM Pink! Super Soft & Comfort...,Warehouse C,137,116,2025-02-28 06:59:00,21
258,ORD_259,21480,"GNASTAS Inflatable Cartoon Baby Bath tub for Baby Bath tub for 1 to 3 Years Bath tub for Kids Home and Travel More Fun, Si...",Warehouse B,498,480,2025-02-28 15:39:00,18
259,ORD_260,21463,MINI BERRY New Born Baby Multi-Color Long Sleeve Cotton Sleep Suit Romper for Boys and Girls Set of 3(Green),Warehouse B,49,38,2025-02-28 04:22:00,11
260,ORD_261,21485,VRION Squeezy Chu Chu Sound Ducks Duck Family with 1 Mother Duck and 3 Baby Duck Sound Toy Sound Bath Toy Bath Toy with So...,Warehouse A,225,179,2025-02-28 20:37:00,46
261,ORD_262,8713,MINI KLUB Boy's Regular Fit T-Shirt (22KBTS646-ON_White,Warehouse B,354,307,2025-02-28 16:28:00,47
262,ORD_263,8710,"Curatio Atogla Lotion (200 ml, Pack of 2)",Warehouse C,389,352,2025-02-28 19:47:00,37
263,ORD_264,8709,Amitasha Educational Tablet Toy for Kids,Warehouse C,97,89,2025-02-28 19:49:00,8
264,ORD_265,21517,United Colors of Benetton Boys' Shirt,Warehouse C,102,53,2025-02-28 00:04:00,49
265,ORD_266,21524,TEDDYY Baby Nappy Pads 20 Pads - Free Size,Warehouse C,451,414,2025-02-28 04:32:00,37
266,ORD_267,8714,Morisons Baby Dreams Classic Powder Puff - Blue & Pink (Pack of 2),Warehouse C,373,367,2025-02-28 06:29:00,6
267,ORD_268,21454,TOTOMO Unisex Babies Baseball Summer Hat Boys and Girls Rebbit for Kids Age 2-4 Years,Warehouse C,509,495,2025-02-28 09:51:00,14
268,ORD_269,8762,Himalaya Baby Powder (400g) & Himalaya Baby Lotion 700ml,Warehouse B,233,201,2025-02-28 03:57:00,32
269,ORD_270,21407,Mee Mee New Born Spacious Baby Bather Bath Chair |Foldable |3 Position Adjustable Chair |Washable Soft Mesh Large Seat,Warehouse C,210,205,2025-02-28 04:51:00,5
270,ORD_271,8755,Muslin Baby Washcloths 100% Cotton Face Towels 10 Pack Wash Cloths for Baby 12x12in Soft and Absorbent Baby Wipes by Yoofo...,Warehouse B,172,137,2025-02-28 01:55:00,35
271,ORD_272,21414,BKDT Marketing Yo Yo Ball Toy for Boys Girls Kids Ball Play Set Adjustable Wrist Band yoyo (Pack of 2),Warehouse B,105,93,2025-02-28 12:08:00,12
272,ORD_273,21418,PUMA Toddler Boys Smash V2 Suede Slip On Sneakers Shoes Casual - Green,Warehouse C,74,62,2025-02-28 04:04:00,12
273,ORD_274,18804,"DISNEY BY Jagannath Gangaram Pednekar Since 1965 18KT Yellow Gold, BABY BRACELET FOR GIRS",Warehouse B,181,169,2025-02-28 00:50:00,12
274,ORD_275,9434,GOOGO GAAGA Googogaaga Boy's Cotton Full Sleeves Sweatshirt with Pant set in Yellow Color Set For Baby Boys,Warehouse C,238,213,2025-02-28 21:44:00,25
275,ORD_276,20200,The Baby First Box Newborn Baby Essential Kit - 25 Items (Winter Kit for 0-3 Months)| Newborn Hamper Gift Set,Warehouse B,58,13,2025-02-28 05:30:00,45
276,ORD_277,20206,"Chicco Aspirator Nasal Pompetta, White",Warehouse B,75,48,2025-02-28 16:40:00,27
277,ORD_278,9439,"HS ENTERPRISE Cute Animal Bath Toys Non-Toxic, BPA Free Colorful Soft Natural Rubber Float Squeeze Sound Squeaky Bathing T...",Warehouse B,511,464,2025-02-28 07:44:00,47
278,ORD_279,20091,"Neska Moda 6 To 12 Months Baby Girls Cotton Butterfly Booties (Yellow,Black) -SK126andBT7",Warehouse B,433,420,2025-02-28 20:02:00,13
279,ORD_280,20098,Panchhi Store Corner Protector for Sharp Edges Clear Corner Guards High Resistant Adhesive Baby Proof Protector for Kids S...,Warehouse B,167,154,2025-02-28 19:51:00,13
280,ORD_281,9483,"The Purple Tree Woolen Fuzzy Cute Cat Paw Print Winter Socks For Women and Girls - 1 Pair, cozy socks for women, cute sock...",Warehouse C,383,344,2025-02-28 04:40:00,39
281,ORD_282,20107,Falkiya (pack Of 6) (0-2 Year) Baby Boy's and Girl's Cotton Anti Slip Grip Socks,Warehouse A,327,287,2025-02-28 13:26:00,40
282,ORD_283,9480,SMARTOTS Kids Casual Laces Shoes for Baby Boys Age 12 Months to 4 Years Rocky,Warehouse B,65,32,2025-02-28 07:49:00,33
283,ORD_284,20117,"Johnson's Baby Soap, 100g [Pack of 3]",Warehouse C,137,129,2025-02-28 21:35:00,8
284,ORD_285,20125,Mamaearth Daily Moisturizing Natural Baby Lotion (400 ml) & Original Orange Body Wash For Kids with Orange & Oat Protein –...,Warehouse A,292,255,2025-02-28 11:25:00,37
285,ORD_286,9478,"EcoSoft Plastic Sheet,PVC Sheet for Kids,Rubber Sheet for Babies,Bed Wetting Protector(36 x 40 Inches) (Rubber Sheet)",Warehouse B,238,195,2025-02-28 00:47:00,43
286,ORD_287,20134,GOLURK Bloomers Baby Girls & Baby Boys Soft Cotton Brief Panty Innerwear Drawer Comfortable & Regular Fit Bloomers for Kid...,Warehouse A,419,378,2025-02-28 08:35:00,41
287,ORD_288,19932,SYGA Baby Hat Autumn Winter Boys and Girls Warm hat Knitted Wool Cap Newborn Cotton Thread Cap,Warehouse C,221,192,2025-02-28 03:02:00,29
288,ORD_289,20008,Healofy Naturals Mosquito Repellent Patches for 0+ Month Babies Patches with 12 Hours Protection | 100% Safe & Waterproof...,Warehouse B,454,433,2025-02-28 23:04:00,21
289,ORD_290,19979,Hopscotch Girls PU Text Print LED Shoes in White Color,Warehouse A,407,394,2025-02-28 11:26:00,13
290,ORD_291,19994,Senyora Baby Lotion For Baby Skin Nourishing | Non – Irritating Tearless and Gentle on Skin 200Ml,Warehouse B,213,165,2025-02-28 15:09:00,48
291,ORD_292,20077,Mom's Love baby-girls Baby and Toddler Sleepers,Warehouse C,173,138,2025-02-28 18:03:00,35
292,ORD_293,20082,Adorable straberry designed For your cute princess hairabnd/Knitted with soft thread/Gives yor baby a princess look,Warehouse A,216,206,2025-02-28 16:09:00,10
293,ORD_294,20157,V.B.K® Baby Boys and Baby Girls Mittens and Booties Combo Pack With 12 Pair Hand Mittens (Gloves) and 12 Pair Of Leg Booti...,Warehouse B,525,479,2025-02-28 22:43:00,46
294,ORD_295,9456,OBLETTER Baby Printed Velvet Educational Alphabet Learning Soft Pillow Cushion Book Toys for Kids (Blue) (Pink Learning Cu...,Warehouse A,104,63,2025-02-28 10:53:00,41
295,ORD_296,20177,"Healofy Powder Storage Container with Feather Soft Acrylic Puff for New Born Baby, Infants (Pink)",Warehouse C,114,73,2025-02-28 05:57:00,41
296,ORD_297,9446,"HIYA Baby Boys/Girls Winter Wear Thermal Set With Full Sleeve T-shirts and Pyjama (Front Button Open), Multicolor Pack of 3",Warehouse B,308,266,2025-02-28 01:52:00,42
297,ORD_298,9442,"Neska Moda 12 To 18 Months Baby Boys & Baby Girls Pack Of 2 Pair Cotton Rabbit & Butterfly Booties (Maroon,Yellow) -BT1152...",Warehouse C,64,47,2025-02-28 23:23:00,17
298,ORD_299,20181,Printed Cotton Tshirt-Shorts for Baby (Boy/Girl from 1-2 Years) Pink,Warehouse C,272,238,2025-02-28 03:59:00,34
299,ORD_300,20183,Similac Follow-Up Formula Stage 2 - 400 g,Warehouse A,164,154,2025-02-28 07:13:00,10
300,ORD_301,20186,"BabyPro Lab Tested - Certified (Set of 5) Baby Proofing Combo of 2 Metres Edge Guard & 4 Corner Protectors, Thin & Sleek D...",Warehouse B,199,150,2025-02-28 16:51:00,49
301,ORD_302,19675,Baba & Baby Girls Cotton Printed Dark Color Bloomers,Warehouse C,223,212,2025-02-28 23:12:00,11
302,ORD_303,19692,Hopscotch Boys and Girls Fabric Checkered Slip Ons Shoes in Blue Color,Warehouse B,264,230,2025-02-28 19:18:00,34
303,ORD_304,19696,Donuts Baby Boy's Plain Regular fit T-Shirt (278104808_HS_Assorted 06M),Warehouse A,363,324,2025-02-28 20:37:00,39
304,ORD_305,9685,Coolz Kids Chu-Chu Sound Musical First Walking Sandals Baby-4 for Baby Boys and Baby Girls for 12-24 Months,Warehouse B,348,306,2025-02-28 23:37:00,42
305,ORD_306,19713,Mother Sparsh 99% Pure Water (Unscented) Baby Wipes I Natural Plant Made Fabric - Super Thick I 72 pcs/Pack - Pack of 10,Warehouse A,508,478,2025-02-28 15:42:00,30
306,ORD_307,9634,kids unisex boys and girls top and shorts set in multicolor pack of 6,Warehouse A,440,394,2025-02-28 10:11:00,46
307,ORD_308,19870,"MOM CARE Cotton Face Towel Soft Reusable Hankies Napkins with Designs for Newborn Baby Toddlers Adults - Pack of 12, Multi...",Warehouse B,95,64,2025-02-28 02:39:00,31
308,ORD_309,19874,NAPPERS by Mother Sparsh Free Size Cloth Diaper for Babies | Reusable | with 1200+ GSM Dry Feel Absorbent Soaker Pad | Pac...,Warehouse B,175,140,2025-02-28 06:32:00,35
309,ORD_310,19876,"Littloo 4 in 1 Baby Grooming Kit Unique Capsule Shaped Design Set Containing Scissor, Nail Clipper, Tweezers & Nail File f...",Warehouse B,255,213,2025-02-28 12:21:00,42
310,ORD_311,9602,Sebamed Baby Gentle Wash Extra Soft (400mL) and Sebamed Baby Shampoo (500mL) Ultra Mild Hydrating Cleanser for Delicate Ba...,Warehouse B,100,90,2025-02-28 00:48:00,10
311,ORD_312,19892,Hopscotch Boys Cotton Stripe Print T-Shirt And Overall Short Set in Beige Color,Warehouse A,134,101,2025-02-28 16:48:00,33
312,ORD_313,9593,"BeyBee Baby Bed Protector Waterproof Dry Sheet for New Born Babies (Large (140cm X 100cm), Yellow)",Warehouse C,234,193,2025-02-28 09:54:00,41
313,ORD_314,9701,Vrindam 925 Sterling Silver Nazariya Kada For baby Boys and Girls child Specially for 1 Year Baby to 2 Years kids | Tradit...,Warehouse A,171,142,2025-02-28 05:27:00,29
314,ORD_315,19662,Hopscotch Boys and Girls Cotton Animal Print Full-Sleeve Romper in White Color,Warehouse C,126,111,2025-02-28 14:22:00,15
315,ORD_316,9652,DAYZ Girls Slip on Walking Shoes,Warehouse B,67,21,2025-02-28 13:48:00,46
316,ORD_317,19770,Bold N Elegant Lace Up Formal Canvas Camo Shoes for Newborn Infant Toddler Baby Boys Girls,Warehouse C,476,441,2025-02-28 06:49:00,35
317,ORD_318,19771,Hopscotch Boys 95% Cotton and 5% Polyester Full Sleeves Animal Text Printed Top and Pyjama Set in Yellow Color,Warehouse B,177,159,2025-02-28 00:10:00,18
318,ORD_319,19773,MINI KLUB Baby Boy's Shorts,Warehouse B,482,450,2025-02-28 13:40:00,32
319,ORD_320,9657,Baby Moo Cute Puppy Checked Chu-Chu Sound Breathable Anti-Skid Sandals - Multicolour (18-24M),Warehouse A,36,22,2025-02-28 17:11:00,14
320,ORD_321,19781,Mini Berry Cotton New Born Baby Gift Sets-Purple-Pack of 13 Pcs,Warehouse A,285,272,2025-02-28 08:04:00,13
321,ORD_322,19784,Whitewhale Baby Hippy Thai Rayon Harem Aladdin Pirate Kids Bohemian Baggy Pants,Warehouse B,197,168,2025-02-28 13:44:00,29
322,ORD_323,9648,Bold N Elegant Sleeveless Cartoon Butterfly Polka Print Girls Tshirt Top Skirt Midi Dress for Infant Toddler Baby Girls,Warehouse A,143,104,2025-02-28 21:25:00,39
323,ORD_324,19793,"ChopWild Best Baby Gift Building Blocks,Creative Learning Educational Toy for Kids Puzzle Assembling Shape Building Unbrea...",Warehouse A,78,34,2025-02-28 22:44:00,44
324,ORD_325,19798,"Johnson's Baby - Soap, 100g Pack",Warehouse C,211,189,2025-02-28 00:39:00,22
325,ORD_326,19799,LAL TEL PHARMACY Baby Massage Oil | Massage Oil for Full Body | Massage Oil for Baby Boy & Girl | Baby Body Oil for New Bo...,Warehouse C,146,118,2025-02-28 16:15:00,28
326,ORD_327,9667,Unisex 100% Pure Cotton Baby Pyjami Lowers for Kids Toddlers (Pack of 6),Warehouse C,153,130,2025-02-28 07:21:00,23
327,ORD_328,19660,"Hood Rompers/Sleepsuits/Jumpsuit/Night Suits for Baby Boys & Girls, Infants, New Borns ( Yellow )",Warehouse A,290,284,2025-02-28 08:55:00,6
328,ORD_329,9543,R for Rabbit Large L Size Premium Feather Diaper for Baby 9 to 14 kgs (70 Pack Offer),Warehouse A,78,37,2025-02-28 16:19:00,41
329,ORD_330,10037,ANNACREATIONS Hair Bow Clips Set Hair Pins Toddlers Barrettes Hair Accessories for Baby Girls (Pack of 5) (STYLE 2),Warehouse A,472,427,2025-02-28 21:32:00,45
330,ORD_331,19110,Baby Moo Cute Puppy Checked Chu-Chu Sound Breathable Anti-Skid Sandals - Pink (18-24M),Warehouse A,200,163,2025-02-28 09:44:00,37
331,ORD_332,10032,MamyPoko Pants Extra Absorb XXL28,Warehouse A,122,110,2025-02-28 16:46:00,12
332,ORD_333,19117,Himalaya Herbals Gentle Baby Shampoo (400Ml)+ Powder (400G),Warehouse A,434,415,2025-02-28 05:42:00,19
333,ORD_334,19119,"Pigeon Cotton Balls For Baby PSH,Pure Cotton,Soft Cotton,Absorbent Cotton,100 pcs",Warehouse C,278,261,2025-02-28 08:12:00,17
334,ORD_335,10031,"Himalaya Baby Cream, 200ml, Herbals Lotion (400ml) and Gentle Bath (400ml) Combo",Warehouse A,187,144,2025-02-28 03:40:00,43
335,ORD_336,19123,Boy's Cotton Micky Mouse Printed Hoodie Sweatshirt with Pant,Warehouse C,173,161,2025-02-28 14:52:00,12
336,ORD_337,10029,Kiddery Maia | New Born Baby Cradle with Improved Mattress Design and Mosquito Net Protection | Palna for Comfortable Baby...,Warehouse A,197,166,2025-02-28 14:41:00,31
337,ORD_338,9892,Morisons Baby Dreams Classic Powder Puff - Blue & Purple (Pack of 2),Warehouse A,206,178,2025-02-28 22:41:00,28
338,ORD_339,19193,"Mistie Hub Baby Nail File Electric,Baby Nail Trimmer with 6 Grinding Heads Safe for Newborn Baby(Pink,Blue)",Warehouse A,400,375,2025-02-28 13:49:00,25
339,ORD_340,9942,LMN CHILD CARE Unisex Newborn Baby Booties | Baby First Walking Shoes | Baby Shoes | Baby Footwear (Multicolor),Warehouse C,439,432,2025-02-28 17:35:00,7
340,ORD_341,9940,"CHACKO Boy's and Girl's of School Winter Woolen Cap (Multicolour, 2-10 Years)",Warehouse A,144,104,2025-02-28 08:06:00,40
341,ORD_342,19265,"BeyBee Waterproof Rubber Sheet (Small (50cm X 70cm), Grey)",Warehouse A,303,277,2025-02-28 17:19:00,26
342,ORD_343,9932,"Himalaya Baby Shampoo (400 ml) and Cream, 200ml Combo",Warehouse A,48,33,2025-02-28 04:39:00,15
343,ORD_344,9919,SYGA Newborn Cotton Baby Cap Soft Bear Elephant Comfort Baby Toddler Print Infant Hat for 0-6 Months 15 X 13 CM,Warehouse A,324,304,2025-02-28 15:28:00,20
344,ORD_345,19310,Sahiba Gems Exclusive 925 Sterling Solid Silver Adjustable Nazariya Baby Bracelet/Kada/Bangle for Sweet Girl/Boys Baby,Warehouse C,424,409,2025-02-28 18:42:00,15
345,ORD_346,19127,"Galaxy MUAC Tape for Child, Deluxe Quality, PVC, Reusable (Pack of 10 Pcs.)",Warehouse C,251,215,2025-02-28 08:59:00,36
346,ORD_347,19093,SHOWRIN BABY TEAR FREE SHAMPOO 100ML,Warehouse B,354,310,2025-02-28 12:45:00,44
347,ORD_348,9911,Honey Boo Baby Nail Clipper Safety Cutter Toddler Infant Scissor Manicure Pedicure Care Kit (Set 4) (Off White),Warehouse B,31,14,2025-02-28 15:05:00,17
348,ORD_349,19145,"Gugzy Baby Headbands Baby Girl's Elastic Fabric Rabbit Ears Bow Knot, Baby Bow Headbands, Hair Accessories, Suitable for N...",Warehouse B,478,455,2025-02-28 08:34:00,23
349,ORD_350,19148,"Zest 4 Toyz Pack of 12 Fun Chu-Chu Toyz for Kids, Baby Squeeze Sound Bath Toy, Colorful Animal Shape Toy for Kids-Multicolor",Warehouse A,436,409,2025-02-28 12:47:00,27
350,ORD_351,19157,"Little's Baby Pants Diapers Medium (M), 7-12 kg, 128 Count with Wetness Indicator and 12 Hours Absorption",Warehouse C,313,274,2025-02-28 20:05:00,39
351,ORD_352,19163,M.S Dresses Baby Girls Casual Top Shorts and pant,Warehouse B,135,93,2025-02-28 19:21:00,42
352,ORD_353,10026,"Mee Mee Premium Baby Feeding Bottle (125 ml, Pink & Light Green)",Warehouse A,90,76,2025-02-28 06:09:00,14
353,ORD_354,10008,Funkey Battle Layer DB Launcher Suitable for All Spinning top Toys LR Launcher,Warehouse B,238,224,2025-02-28 14:00:00,14
354,ORD_355,10004,Baby Cry New Born Baby Super Soft Cotton Hand Gloves/Mitten with Elastic for Baby Boys and Girls (Pack of 3),Warehouse C,360,314,2025-02-28 10:40:00,46
355,ORD_356,9992,Neska Moda Unisex Sandal Booties For 6 To 12 Months (Pink) -BT675,Warehouse B,236,204,2025-02-28 13:11:00,32
356,ORD_357,19176,DULCI® Gold Tone Handmade Twisted Wires Flower Shape Ghungroo Bells Free Size Adjustable Kids Kada Anklet Nazaria Jeweller...,Warehouse C,431,400,2025-02-28 00:17:00,31
357,ORD_358,9990,Kuber Industries Kids Bath Towel|Soft Cotton & Sides Stitched Baby Towel|Microfibered Super Absorbent Princess Pattern Tow...,Warehouse C,70,56,2025-02-28 18:48:00,14
358,ORD_359,19185,toothless Marvel Avengers Kids Boys Blue Lycra Shoes,Warehouse B,354,338,2025-02-28 22:52:00,16
359,ORD_360,10007,Baby's Pride Cotton Girls Casual Frocks - Frock for Baby Girl,Warehouse A,93,50,2025-02-28 14:56:00,43
360,ORD_361,9978,HUMPU Summer Baby Girls Clothes Set 100% Cotton Kids Clothes Vest Tops and Shorts 2 PCS Set For Princess Kids,Warehouse C,325,300,2025-02-28 08:25:00,25
361,ORD_362,19129,Verbier Kids Cartoon Hair Antistatic Brush Massage Shower Comb (1-4 Year) 10 Grams,Warehouse B,311,274,2025-02-28 03:47:00,37
362,ORD_363,10039,Malli Spiritual : New Born Baby Care - Vengai Pottu/Karu Valayal/Paal Pasi/Erukkan Arainganan kodi (set of 4),Warehouse B,460,414,2025-02-28 22:27:00,46
363,ORD_364,19311,Smart Stick Pack 215+ Sticks Game Set for Age 3-8 Years Old Kids Learning Educational Toy Games Boy Girl Children Puzzle C...,Warehouse B,277,260,2025-02-28 01:23:00,17
364,ORD_365,19657,DECONDS Stylish and Comfortable Walking and Running Shoes for Kids in and Design,Warehouse A,161,128,2025-02-28 07:06:00,33
365,ORD_366,20030,S2S Robo Fish Toy | Water Activated Swimming Robotic Small Fish Toy (RED),Warehouse B,411,402,2025-02-28 04:46:00,9
366,ORD_367,20033,Generic U Shaped Kids Toothbrush for Kids 3-5 Years Children U Shape Toothbrush Baby Brush Teeth Cleaner Silicone Tooth Br...,Warehouse A,474,455,2025-02-28 13:37:00,19
367,ORD_368,20035,Funkey Battle top Starter B187 Savior Valtryek Ev. Sh-7 top Toys Set with SL Launcher,Warehouse A,178,172,2025-02-28 22:31:00,6
368,ORD_369,20042,"Neska Moda 12 To 18 Months Baby Boys & Baby Girls Pack Of 2 Pair Cotton Butterfly Booties (Maroon,Light Green) -BT1143andB...",Warehouse B,458,412,2025-02-28 13:53:00,46
369,ORD_370,20062,BRATS N BEAUTY Kid's Fleece Hat (RS/KWC14/BG/FS/0S_Black_Free Size),Warehouse C,234,229,2025-02-28 11:16:00,5
370,ORD_371,20068,ISHRIN Cotton Printed Full Length Pyjamas for Baby Boy Or Baby Girl Infant & Toddlers Pants for Sleep Wear with Multicolor...,Warehouse B,388,366,2025-02-28 00:53:00,22
371,ORD_372,9493,"Fareto Baby's Gift Pack Combo of 1 Mosquito Toddler Mattress Net Bed 32Lx18B Inches,1 Sleeping Bag & 4 Plastic Diaper Chan...",Warehouse B,318,302,2025-02-28 14:53:00,16
372,ORD_373,19953,Lillypupp New Born Baby/Kid’s Girl Soft Hair Band Gift Set. Hair Accessories Combo Pack of 2 Infant's and Toddler's Headba...,Warehouse C,58,48,2025-02-28 21:23:00,10
373,ORD_374,19955,Krystle Baby Winter Warm Hat Scarf Toddler Girls Boys Ear Flaps Hood Balaclava Kids Fleece Lining Knit Pompom Beanie Hat w...,Warehouse C,349,328,2025-02-28 12:53:00,21
374,ORD_375,19315,Mini Klub Baby Boy's Regular fit Romper Suit (97BBRO652-ON_MULTI09_3 6 Months),Warehouse C,299,253,2025-02-28 21:31:00,46
375,ORD_376,19649,Johnson's Baby Cream 100g (Pack of 2),Warehouse B,393,376,2025-02-28 02:07:00,17
376,ORD_377,19296,Motherly Nursing Breastfeeding Cover Scarf Cloth- Breast Feeding Shawl (Yellow Flower Print),Warehouse B,122,90,2025-02-28 11:26:00,32
377,ORD_378,9974,"Nivihsa : Handmade Baby girl Booties with headband Gift, Ideal for 3-6 Month (Insole lenght 10cm) - 100% Cotton Yarn - red",Warehouse B,42,20,2025-02-28 03:03:00,22
378,ORD_379,19254,"Pampers Active Baby Taped Diapers, Medium size diapers, (6-11kg) 90 count,taped style custom fit",Warehouse B,456,444,2025-02-28 09:22:00,12
379,ORD_380,9972,Hopscotch Baby Girls Cotton Sleeveless Solid Top with Skirt Set in Red Color for Ages 9-12 Months (MFN-3593564/Z),Warehouse B,52,29,2025-02-28 13:52:00,23
380,ORD_381,19202,CLUZE Winter Warm Socks for Kids Toddlers Boys Girls Thick Thermal Woolen Socks Terry Lined Cozy Ankle Socks for Children...,Warehouse B,415,379,2025-02-28 23:02:00,36
381,ORD_382,19205,"Woolen Winter Socks for Boys and Girls Playing and Walking Indoor (Unisex, 8-10 Years)",Warehouse B,53,37,2025-02-28 23:55:00,16
382,ORD_383,9968,Mom's Darling New Born Baby caps for New Born 0-6 Months - (Pack of 6) | Cotton Baby Cap Set for Baby boy & Girls| New Bor...,Warehouse B,298,259,2025-02-28 11:24:00,39
383,ORD_384,19212,ANTIL'S® Baby Carrier Bag/Adjustable Hands Free 4 in 1 Baby/Baby Safety Belt/Child Safety Strip/Baby Sling Carrier Bag/Bab...,Warehouse B,284,244,2025-02-28 11:40:00,40
384,ORD_385,9955,Sunshine Enterprises Mustang Ankle Length Frilled Socks (White) - Medium,Warehouse C,249,215,2025-02-28 03:17:00,34
385,ORD_386,19222,"GURU KRIPA BABY PRODUCTS Baby Nail Scissors with Stainless Steel Blades for 3m+ Babies,",Warehouse B,335,327,2025-02-28 18:49:00,8
386,ORD_387,19229,"Nizomi Beach Toys Set for Kids, Indian Made 7 Pcs Mold Castle Toys, Sandpit Bucket,Animal, Mould, Beach Shovel Spade Etc ...",Warehouse C,453,427,2025-02-28 06:43:00,26
387,ORD_388,9945,LILTOES Baby Safety Helmet Royal Blue,Warehouse B,503,489,2025-02-28 01:17:00,14
388,ORD_389,19214,TheYaYaCafe Bura na Mano Holi hai Matching Men's Women's Kid's Round Neck Holi Famliy T-Shirts_ (Sold Separately),Warehouse A,224,211,2025-02-28 21:10:00,13
389,ORD_390,19910,"MamyPoko Pants Extra Absorb S136,Unisex Baby, Pack of 136",Warehouse B,295,262,2025-02-28 16:11:00,33
390,ORD_391,18858,"BabyGo Organic Baby's BPA-Free Silicone Nipple Food Nibbler for Fruits ( Multicolor,)",Warehouse A,421,383,2025-02-28 23:34:00,38
391,ORD_392,17971,"SOFTSPUN Microfiber Baby Hand & Face Wipes 30x30 Cms, 3 Piece Towel Set, 340 GSM (Sky Blue) Super Soft & Silky for Hand, F...",Warehouse B,483,470,2025-02-28 01:17:00,13
392,ORD_393,18031,ANGAAKAR CLOTHINGS Printed Baby Vest For Kids Cotton Sleeveless Sando Baniyan infant Baby Innerwear Cloth For Boys & Girl...,Warehouse C,218,197,2025-02-28 17:43:00,21
393,ORD_394,17986,baby wish Half Birthday Baby Bodysuits Newborn Romper Half Sleeve Envelope Neck Cute Outfit It's My 1/2 Birthday,Warehouse A,150,122,2025-02-28 21:42:00,28
394,ORD_395,17994,Hopscotch Boys and Girls Recycled Polyester/Memory Foam Solid LED Sneakers in Yellow Color,Warehouse A,396,386,2025-02-28 08:39:00,10
395,ORD_396,17996,"Neska Moda 6 To 12 Months Baby Boys & Baby Girls Cotton Lace Shoes/Booties (Red,Blue) -SK138andSK135",Warehouse A,53,43,2025-02-28 20:09:00,10
396,ORD_397,10705,KidDough Furniture Safety Locks for Kids (10 White Locks),Warehouse B,271,226,2025-02-28 03:10:00,45
397,ORD_398,10704,"Runbugz Mosquito Repellent Patches for Babies, Cute Animal Patch (Green, 24 Patches)",Warehouse A,513,468,2025-02-28 01:26:00,45
398,ORD_399,10700,PediflorKidz Anticavity Fluoride Green Apple and Orange Flavor Toothpaste for children | 70g x 2 pack | Family combo pack...,Warehouse B,161,155,2025-02-28 13:23:00,6
399,ORD_400,18091,Cute Landings® New Born Baby Boys and Girls No Scratch Mittens Set/Glove/Mitten/Gloves/Infant/Toddler/Mitts Set/Winter Wea...,Warehouse A,153,147,2025-02-28 15:42:00,6
400,ORD_401,18098,"Himalaya Anti Hair Fall Shampoo with Bringaraja, 1000 ml and Himalaya Herbals Cocoa Butter Intensive Body Lotion, 400ml",Warehouse B,384,357,2025-02-28 08:28:00,27
401,ORD_402,18169,Small Wonder Powder Puff (Purple),Warehouse A,24,13,2025-02-28 02:16:00,11
402,ORD_403,18172,"THE LITTLE LOOKERS Swimming Bath Gown for Kids, Bath Gown for Baby Boys/Baby Girls | Swimming Gown for Kids (Bunny Blue, ...",Warehouse C,372,365,2025-02-28 12:20:00,7
403,ORD_404,18175,"Neska Moda 0 To 6 Months Baby Boys & Baby Girls Cotton Rabbit Booties (Orange,Red) -BT380andBT371",Warehouse B,409,402,2025-02-28 19:27:00,7
404,ORD_405,10608,"Neska Moda 6 To 12 Months Baby Boys & Baby Girls Cotton Rabbit Booties (Maroon,Rani) -SK129andBT82",Warehouse A,142,116,2025-02-28 00:02:00,26
405,ORD_406,18177,"Neska Moda 6 To 12 Months Baby Girls Cotton Butterfly Booties (Baby Pink,Rani) -SK129andBT4",Warehouse C,480,444,2025-02-28 22:53:00,36
406,ORD_407,17970,Trendy World Stylish & Comfortable Woolen Full Sleeve Sweater Sweatshirt for Kids and Baby Boys & Baby Girls(Pack of 1),Warehouse C,309,284,2025-02-28 07:37:00,25
407,ORD_408,18163,MumsLap Baby Boys & Baby Girls Ankle Length Cotton Blend Warm socks for winters (Set of 5 pairs) | Socks for newborn baby ...,Warehouse B,336,300,2025-02-28 10:22:00,36
408,ORD_409,17951,MINI KLUB Baby-Girls Sleep Suit,Warehouse A,212,163,2025-02-28 16:21:00,49
409,ORD_410,10585,Frowwy Organic Cotton Anti-Skid Socks (pack of 3),Warehouse B,468,462,2025-02-28 21:21:00,6
410,ORD_411,18209,Cuteably™ Cute Nail Cutter 1 Pcs (Multi Color),Warehouse A,160,118,2025-02-28 17:18:00,42
411,ORD_412,18044,Bumchums unisex-baby Clothing Set,Warehouse C,336,306,2025-02-28 18:09:00,30
412,ORD_413,10688,MINI KLUB Baby-Girls Bodysuit,Warehouse A,470,458,2025-02-28 10:08:00,12
413,ORD_414,10673,"Prime Deals Dancing Dog with Music, Flashing Lights - Sound & Light Toys for Small Babies | Best Gift for Toddlers",Warehouse A,320,309,2025-02-28 11:17:00,11
414,ORD_415,18038,Baby Beanies Baby Boy's & Girl's Cotton Front Open Vest Jhabla Perfect for Summer Wear Kids T-Shirt Baby Sando Innerwear B...,Warehouse C,30,13,2025-02-28 12:20:00,17
415,ORD_416,18060,"Huggies Wonder Pants Small (S) Size Baby Diaper Pants, 20 count, with Bubble Bed Technology for comfort",Warehouse C,252,206,2025-02-28 03:08:00,46
416,ORD_417,18069,"Neska Moda 6 To 12 Months Baby Boys & Baby Girls Cotton Rabbit Booties (Blue,Red) -SK172andSK132",Warehouse A,153,139,2025-02-28 14:05:00,14
417,ORD_418,10661,"GoldGiftIdeas Pure 999 Silver New Born Baby Coin for Gift, Silver Congratulation Coin for Baby Shower, Silver Gift Items, ...",Warehouse C,460,412,2025-02-28 08:58:00,48
418,ORD_419,18084,Max boys Jacket,Warehouse C,238,208,2025-02-28 23:52:00,30
419,ORD_420,18087,Kuchipoo Kids Baby's Dungaree Set,Warehouse B,71,32,2025-02-28 12:16:00,39
420,ORD_421,10654,"Philips Avent Natural Teat 4 Holes Fast Flow for 6months and above, Pack of 2",Warehouse B,437,415,2025-02-28 13:33:00,22
421,ORD_422,18068,Neska Moda 2 to 3 Years Pack of 1 Solid Kids Monkey Cap/Woolen Cap/Winter Cap (Blue)-KC407,Warehouse C,470,443,2025-02-28 14:00:00,27
422,ORD_423,10695,EIO New Born Baby Clothing Gift Set -13 Pieces (Orange),Warehouse A,120,107,2025-02-28 20:08:00,13
423,ORD_424,10698,Baby Beanies Kids Baby Boys and Girls Unisex Woolen Winter Warm Lower Track Pant Regular Fit Inside Fleece Legging Cotton ...,Warehouse B,403,388,2025-02-28 17:22:00,15
424,ORD_425,10468,"SAS IND Baby boy & Baby Girl Half Sleeves Dot Printed Cotton Dungaree Set with T-Shirt (0-2 Year, Pack of 1)",Warehouse C,205,183,2025-02-28 02:47:00,22
425,ORD_426,10620,SYGA 2 Pcs Mom & Baby Printed Flower Headband Womens & Kids Fashion Bowknot Head Band Hair Accessories (Green),Warehouse C,496,451,2025-02-28 09:24:00,45
426,ORD_427,10396,Lavitra Fashion headbands foam flower soft nylon hairbands for baby girls infants Toddlers - (Pack of one) (pink),Warehouse C,387,340,2025-02-28 05:01:00,47
427,ORD_428,18505,WorldCare® Neoprene Scuba Diving Socks Water Sport Beach Snorkeling Quick Dry Shoes S (66020336JEL),Warehouse C,449,422,2025-02-28 14:12:00,27
428,ORD_429,18875,"Nestlé NESTUM Baby Cereal - Rice (From 6 to 24 months) - Bag-in-Box Pack, 300g",Warehouse B,135,125,2025-02-28 17:04:00,10
429,ORD_430,18876,"Neska Moda 0 To 6 Months Baby Girls Cotton Butterfly Booties (Yellow,Blue) -BT385andBT1113",Warehouse C,102,93,2025-02-28 10:50:00,9
430,ORD_431,10139,"LuvLap Tiny Love Heat Sensitive Baby Feeding Spoons Set, Food Grade PP Kids & Baby Spoon with Soft Silicone Tip, Color cha...",Warehouse C,535,497,2025-02-28 03:59:00,38
431,ORD_432,18883,"KIDZHEART Multicolor Stylish Cute New Born Baby Infant Kids Accessories Winter Soft Woolen Monkey Cap (6-12 Months, New Ca...",Warehouse A,394,361,2025-02-28 10:50:00,33
432,ORD_433,10136,Himalaya Baby Massage Oil Improves Skin Tone 50 ML (Pack Of 5),Warehouse B,356,349,2025-02-28 21:49:00,7
433,ORD_434,18897,"Himalaya Gift Pack & Himalaya Total Care Baby Pants Diapers, Medium, 78 Count",Warehouse B,471,458,2025-02-28 13:56:00,13
434,ORD_435,18901,"HIBA Sunflower Dress for Baby Girl Yellow Crop Top, Skirt with Hairband",Warehouse A,298,292,2025-02-28 11:43:00,6
435,ORD_436,18872,SVS Baby Boy's and Girl's Cotton Sleeveless T Shirt and Shorts Set,Warehouse A,97,69,2025-02-28 21:43:00,28
436,ORD_437,10123,"Buddsbuddy BPA Free Popo Baby Powder Puff With Storage Powder Case, (Combo of 2) (Multicolor)",Warehouse A,512,464,2025-02-28 21:43:00,48
437,ORD_438,10121,"Little Angel Premier Pants Baby Diaper, Small (S) Size, 112 Count, Cottony Soft Material, Wetness Indicator, Breathable La...",Warehouse B,257,244,2025-02-28 15:22:00,13
438,ORD_439,18912,80+pcs Big size House Building Blocks For Kids Learning Educational Construction Activity Puzzle set Toys and games Toy Gi...,Warehouse B,344,312,2025-02-28 13:42:00,32
439,ORD_440,10118,Bumchums Unisex-Baby Cotton Clothing Set,Warehouse C,85,52,2025-02-28 20:11:00,33
440,ORD_441,18922,Clothe Funn New Born Knee Length Baby Girl Dress,Warehouse B,386,357,2025-02-28 05:39:00,29
441,ORD_442,18905,SYGA Electric Safe 5 in 1 Nail File Kit Grinder Clipper Trimmer Set for Newborn Toddler and Fingernails - Mint Green,Warehouse B,259,230,2025-02-28 08:07:00,29
442,ORD_443,10621,"Uber World Bibs Eva Waterproof (Large, Multicolor, 3 Piece)",Warehouse C,374,367,2025-02-28 15:11:00,7
443,ORD_444,10629,ESSA Baby Boys' & Baby Girls' Cotton Drawers (Pack of 10),Warehouse C,76,30,2025-02-28 14:30:00,46
444,ORD_445,18188,Bubblegummers Baby-Boys Printed Softy First Walking Shoes,Warehouse A,229,185,2025-02-28 23:19:00,44
445,ORD_446,10603,United Colors of Benetton Boys Grey Melange Stay in Jungle Tee,Warehouse B,368,335,2025-02-28 09:32:00,33
446,ORD_447,18199,Kidbee Boys and Girls Cotton Hosiery Track Pants Pajama Lowers (Set of 4),Warehouse C,163,150,2025-02-28 12:43:00,13
447,ORD_448,18201,Big Box Headband for Baby Girl Hair Bands Girls Headbands Hairband Accessories Stylish Soft Latest Turban Hair Bow Bands G...,Warehouse A,450,402,2025-02-28 10:16:00,48
448,ORD_449,18187,Sebamed baby bath essentials,Warehouse A,244,201,2025-02-28 11:39:00,43
449,ORD_450,10614,"Jordan Baby Toothbrush Step 3 for 6-9 Years very Soft and Gentle for gum, White",Warehouse A,308,295,2025-02-28 17:54:00,13
450,ORD_451,10647,Hopscotch Boys and Girls Soft Foam Checkered LED Slip Ons in Black Color,Warehouse A,390,363,2025-02-28 17:00:00,27
451,ORD_452,18118,KITTENS Girl's KTG695 Booties,Warehouse B,271,228,2025-02-28 22:53:00,43
452,ORD_453,18121,Toyzone Building Blocks | Building Blocks Game | Educational Toy | Smart Activity Fun & Learning Blocks | Colorful Blocks...,Warehouse C,49,20,2025-02-28 11:05:00,29
453,ORD_454,18126,"Naughty Kidz Warmer Baby Glass Feeding Bottle, New Born/Infants/Toddler Upto 3 Years, 250ml,Pack of 1",Warehouse C,27,14,2025-02-28 23:32:00,13
454,ORD_455,10637,Farlin Free Drop Powder Puff Pink Colour,Warehouse B,337,292,2025-02-28 12:39:00,45
455,ORD_456,10636,Jimmy Jammy 100% Pure Organic Cotton Bodysuits Jumpsuit Sleepsuit One size Romper for Baby Boy and Baby Girl | Pack of 2 R...,Warehouse B,148,129,2025-02-28 11:26:00,19
456,ORD_457,18134,"Shoe Crease Guards, Breathable Sneaker Shield White Black Long Life for Daily Use (S)",Warehouse B,443,417,2025-02-28 19:50:00,26
457,ORD_458,18389,Kidbee Baby Boy's & Girl's Kids Infants & Toddler Regular Fit Soft Track Pants Pajama Lowers (Set of 5),Warehouse C,368,329,2025-02-28 10:34:00,39
458,ORD_459,19915,MumsLap Baby Boys & Baby Girls Ankle Length Cotton Blend Socks (Set of 2 pairs) | Anti Slip | Booties Socks for a newborn ...,Warehouse B,222,209,2025-02-28 21:26:00,13
459,ORD_460,18318,Amitasha Silicone Bristles Toothbrush for Babies with Anti Choking Shield - Pack of 1,Warehouse B,498,458,2025-02-28 13:25:00,40
460,ORD_461,18323,"Jordan Kids Toothbrush with a travel cap Step 2 -3-5 Years Kids Tooth brush Soft Bristles, BPA Free (3-5Years Kid-Travel C...",Warehouse A,322,314,2025-02-28 15:11:00,8
461,ORD_462,10528,Nike Womens W Dunk Low Lx Running Shoe,Warehouse C,60,48,2025-02-28 12:02:00,12
462,ORD_463,18334,"KASSY POP CURATED JUST FOR YOU Cartoon Hooded Microfiber Fleece Baby Blankets Cum Bath Towels/Robes, 30 x 40 inches, 0-2 Y...",Warehouse A,382,360,2025-02-28 01:14:00,22
463,ORD_464,18305,Mothercare Baby-Boys VF413,Warehouse B,105,61,2025-02-28 19:17:00,44
464,ORD_465,10523,"Neska Moda 0 To 6 Months Baby Boys & Baby Girls Cotton Lace Shoes/Booties (Orange,Black) -BT1132andBT1136",Warehouse A,221,199,2025-02-28 13:51:00,22
465,ORD_466,10519,Oral-B Pro Health Base Soft Manual Toothbrush - 1 Piece pack,Warehouse B,416,367,2025-02-28 13:54:00,49
466,ORD_467,18341,"Neska Moda 6 To 12 Months Baby Girls Cotton Butterfly Frill Booties (Black,Red) -SK128andBT44",Warehouse A,457,450,2025-02-28 03:25:00,7
467,ORD_468,18343,GJ Baby Baby-Boy's Regular fit Trousers,Warehouse C,505,469,2025-02-28 18:45:00,36
468,ORD_469,18345,DHRUVS COLLECTION Exclusive 925 Sterling Silver Pair Of Baby Nazariya Silver Bracelets With A Combination Of Soft Brown An...,Warehouse A,304,283,2025-02-28 23:58:00,21
469,ORD_470,10510,AmBaby Pack of 12 Super Absorbent Full Padded New Born Baby Nappies Langot|Breathable Adjustable Washable Reusable Soft Ho...,Warehouse B,192,184,2025-02-28 07:54:00,8
470,ORD_471,10509,Neska Moda Unisex Baby Sandal Booties for 6 to 12 Months (Blue),Warehouse B,258,220,2025-02-28 02:14:00,38
471,ORD_472,18356,Density Collection Kid Baby Safe LED Flashlight Earpick Luminous Visible Ear Spoon Earwax Remover Curette Cleaning Earpick...,Warehouse C,310,300,2025-02-28 00:39:00,10
472,ORD_473,18296,"Prattle Foot Kids Running Led Shoes, Casual Led lace Up Shoes Light Weight Outdoor Sports Shoes for Boys & Girls",Warehouse C,357,314,2025-02-28 16:22:00,43
473,ORD_474,10542,Max Boys Printed Crew Neck T-Shirt,Warehouse B,495,479,2025-02-28 06:28:00,16
474,ORD_475,10575,"SebaMed Baby Rash Cream, 100ml & Baby Massage Oil, 150ml Combo",Warehouse A,68,26,2025-02-28 06:01:00,42
475,ORD_476,10051,"Johnson's Baby Oil With Vitamin E, Non-sticky For Easy Spread and Massage, 2X200ml",Warehouse B,358,338,2025-02-28 06:56:00,20
476,ORD_477,19862,Neska Moda Boy's & Girl's 5 Pair Striped Cotton Ankle Socks For 8 To 11 Years,Warehouse B,368,353,2025-02-28 21:48:00,15
477,ORD_478,19860,"PALAY® Bucket Hat for Kids,Cotton Kid Hat for 1-4 Year-Old Kids,Spider-Man Hat,Kid Summer Outdoor Hat,Bucket Hat for Girl ...",Warehouse A,413,384,2025-02-28 19:38:00,29
478,ORD_479,19919,Generic Baby Boys & Baby Girls Handmade Sweater,Warehouse B,197,190,2025-02-28 12:08:00,7
479,ORD_480,19920,"Himalaya Anti-Hair Fall Shampoo | Helps Reduce Hair Fall | For Women & Men | 1000ml & Himalaya Baby Powder, 700g",Warehouse C,458,429,2025-02-28 05:41:00,29
480,ORD_481,19924,Nabhya Stainless Steel Baby Spout Sipper Cup for Kids Age 3 Months to 18 Months 250 ML (Purple),Warehouse B,524,476,2025-02-28 22:43:00,48
481,ORD_482,19866,ASK - JS - LCD & CO -Pack of 6 -Babies boys and girls tops and bottoms - Unisex - sweater dress - socks for toddler girls...,Warehouse A,359,331,2025-02-28 04:05:00,28
482,ORD_483,19865,"Johnson's Baby Hair Oil with Avocado, 100ml",Warehouse A,195,153,2025-02-28 04:37:00,42
483,ORD_484,9632,Lillypupp New Born Baby Shoes 0-6 Months for Boy Girl | Foot Length 11Cm | Casual Footwear/Socks/Booties for Infant and To...,Warehouse C,214,182,2025-02-28 13:05:00,32
484,ORD_485,19816,Little Angels Full Sleeves Baby Sweater Set | Colour Unisex Colorblocked Pattern Button Closer Sweater for New Born Baby,Warehouse B,215,192,2025-02-28 04:22:00,23
485,ORD_486,9628,Mee Mee Baby Oil (with Fruit Extracts- 200 ml (Single Pack),Warehouse A,464,429,2025-02-28 02:46:00,35
486,ORD_487,19828,Fomti Women's Hosiery Cotton Nighty/Night Dress/Gown in Maternity Wear Printed Maxi,Warehouse A,394,359,2025-02-28 11:08:00,35
487,ORD_488,19830,"LuvLap Baby Silicone Manual Gum Massager, First Starter Toothbrush for Babies and Toddlers, Tri-Bristle Gum Toothbrush, 3...",Warehouse A,469,457,2025-02-28 22:45:00,12
488,ORD_489,19836,Honey Boo Infant's and Toddler's 4 in 1 Grooming Set with Baby Scissor; File and Tweezer Baby Nail-Care Kit (Attractive Ca...,Warehouse B,154,124,2025-02-28 20:52:00,30
489,ORD_490,19838,Nonibud Baby Waterproof Plastic Sheet Double Bed/Baby-Adult Waterproof Protection Sheet for Mattress (7.5 feet x 6.5 feet)...,Warehouse B,269,228,2025-02-28 07:39:00,41
490,ORD_491,9617,"FWQPRA® Anti Slip Big Plastic Bath Chair Seat Sling with Non Slip Strong Suction for Bathing with Water,Baby Shower,Bubble...",Warehouse B,95,73,2025-02-28 01:30:00,22
491,ORD_492,9611,"MINI KLUB baby-boys Regular Fit Track Set, Blue, 3 Months-6 Months",Warehouse B,208,175,2025-02-28 18:19:00,33
492,ORD_493,9608,Luster Black Red Frock Makara Sankranti (Age 3M to 5Y),Warehouse A,129,83,2025-02-28 11:46:00,46
493,ORD_494,18237,"Mamaearth Soothing Baby Massage Oil, with Sesame, Almond & Jojoba Oil - 200ml & Mamaearth Agent Apple Body Wash for Kids w...",Warehouse A,455,447,2025-02-28 00:08:00,8
494,ORD_495,18414,Aarushi Vijkan Born Baby Soft Cotton Multicolor Mix Mittens Set of 12 Pairs,Warehouse A,524,483,2025-02-28 14:29:00,41
495,ORD_496,10404,"HEGZI Feeding Pillow, Breast Feeding Pillows with Removable Cover, Vacuum Packed, Cotton Nursing Pillow and Positioner, Br...",Warehouse B,267,241,2025-02-28 00:34:00,26
496,ORD_497,10402,Jo's 9 PCS PEPPA PIG Shoe Charms Decoration for Croc Shoes Bracelets - shoe charms make your shoes more interesting fun an...,Warehouse C,135,104,2025-02-28 04:10:00,31
497,ORD_498,10401,Chicco Sweet Surprise Gift Set-Blue,Warehouse B,200,171,2025-02-28 08:08:00,29
498,ORD_499,18497,My Newborn Baby Boys and Baby Girls 3 in 1 Baby Blanket-Safety Bag-Sleeping Bag Pack of 2 Pcs&My Newborn Baby Mitten Cap a...,Warehouse C,440,413,2025-02-28 09:33:00,27
499,ORD_500,18484,"Johnson's Baby Powder Blossoms | With Sodium Citrate, Citric Acid | Pack of 1, 100g",Warehouse B,401,396,2025-02-28 17:47:00,5
500,ORD_501,18368,NEW.TONE New Born Baby Elastic Free Tying Mittens Gloves Combo Pack Of - 6 Pairs,Warehouse B,371,358,2025-02-28 23:23:00,13
501,ORD_502,18369,Littlenuts Unisex Comfortable & Regular Fit Cotton Printed Track Pants Lowers Pajama for baby Boys & Girls Joggers Bottom ...,Warehouse A,524,491,2025-02-28 00:56:00,33
502,ORD_503,10491,ANNACREATIONS Baby Girls Super Stretchy Cotton Soft multi-colored kids premium Soft knot headband hair bows Head Wrap For ...,Warehouse C,487,462,2025-02-28 03:20:00,25
503,ORD_504,18440,Chicco Baby Moments Gentle Body Wash and Shampoo (500ml),Warehouse A,411,374,2025-02-28 05:41:00,37
504,ORD_505,18403,MINI KLUB Baby-Boy's Regular Denim Pant,Warehouse A,313,273,2025-02-28 23:30:00,40
505,ORD_506,18404,"LuvLap Banana Time 210ml Anti Spill, Interchangeable Sipper / Sippy Cup with Soft Silicone Spout and Straw BPA Free, 6m+ (...",Warehouse A,483,457,2025-02-28 14:08:00,26
506,ORD_507,10403,Freshfoot Baby's Organic Cotton Ankle Socks For 0-12 Months- 6 Pairs,Warehouse B,383,338,2025-02-28 18:07:00,45
507,ORD_508,18445,BABY GO 100% Pure Cotton T-shirt and Shorts Set for Baby Boys,Warehouse C,455,441,2025-02-28 13:58:00,14
508,ORD_509,10558,"Piku Store Kids Hosiery Full Sleeves T-Shirts for Kids Royal Blue, Yellow, White & Orange - Pack of 4",Warehouse B,379,365,2025-02-28 12:15:00,14
509,ORD_510,18286,"Mother Sparsh Plant Powered Natural Baby Shampoo With Vanilla Oil, Vitamin E & Coconut Oil | Nourishes Baby's Scalp & Hair...",Warehouse B,531,490,2025-02-28 04:36:00,41
510,ORD_511,18259,Mini Klub Boys Purple T-Shirt Pack of 1,Warehouse A,186,155,2025-02-28 23:13:00,31
511,ORD_512,10552,"PediflorKidz Anticavity Fluoride Toothpaste for children | Green Apple, Bubble Gum, Orange and Melon Flavor Combo pack | V...",Warehouse A,276,269,2025-02-28 07:46:00,7
512,ORD_513,18275,JUNIOR JOE Baby Nail Clipper with Magnifier Glass (Grey),Warehouse C,484,475,2025-02-28 02:34:00,9
513,ORD_514,18277,Kitty Baby Sneakers White First Step Shoes-0-6 Months,Warehouse C,339,297,2025-02-28 09:52:00,42
514,ORD_515,18278,"Neska Moda 6 To 12 Months Baby Boys & Baby Girls Pack Of 2 Pair Cotton Butterfly Frill Booties (Light Green,Blue) -BT88and...",Warehouse B,283,237,2025-02-28 18:37:00,46
515,ORD_516,18366,Kidbee Newborn Unisex Baby Cotton Sleepsuits/Romper/Bodysuit/Onesies/Dungaree (Set of 3),Warehouse B,64,23,2025-02-28 18:44:00,41
516,ORD_517,10432,VBaby Soft Fur Organic Booties Antiskid Baby Shoes 15-18 Months,Warehouse A,153,127,2025-02-28 09:25:00,26
517,ORD_518,10424,Himalaya Gental Baby Wash With Goodness Of Chickpea And Fenugreek 400 Ml,Warehouse C,155,148,2025-02-28 11:20:00,7
518,ORD_519,10422,"Pampers Premium Care Pants, Medium size baby Diapers, (7-12kg) 108 Count Softest ever Pampers Pants, Medium Size, Pack of 108",Warehouse B,230,216,2025-02-28 03:03:00,14
519,ORD_520,10419,Himalaya Baby Massage Oil (100ml) - Pack of 2,Warehouse A,221,181,2025-02-28 11:00:00,40
520,ORD_521,18463,Zacharias Girl's Cotton Solid Bucket Hat (Pack of 1) (8-14 Years),Warehouse C,176,145,2025-02-28 14:55:00,31
521,ORD_522,18470,Maanit Bath Tub with Shampoo Mug Bubble Bather Set for Babies (Blue),Warehouse B,168,128,2025-02-28 05:25:00,40
522,ORD_523,8474,"CHILDCHIC 1 Set of Baby Goat Hair Brush and Comb, Natural Soft Bristles for Grooming Hair Care Products Newborns and Toddl...",Warehouse C,211,203,2025-02-28 08:28:00,8
523,ORD_524,19134,ayushicreationa Newborn Baby Girls Socks Lace Ruffle Frilly Ankle Princess Dress Sock for Infants Toddler Multicolor Pack ...,Warehouse A,176,160,2025-02-28 17:36:00,16
524,ORD_525,15660,"Neska Moda 6 To 12 Months Baby Girls Cotton Butterfly Booties (Baby Pink,Yellow) -SK141andSK175",Warehouse C,252,207,2025-02-28 20:52:00,45
525,ORD_526,15457,"Neska Moda 12 To 18 Months Baby Boys & Baby Girls Cotton Rabbit Booties (Mint,Rani) -BT1155andBT1178",Warehouse A,203,165,2025-02-28 22:18:00,38
526,ORD_527,12206,Hopscotch Unisex Cotton-blend Solid Fixed Lace Snow Boat in Black Color,Warehouse B,175,151,2025-02-28 03:46:00,24
527,ORD_528,15464,MOM CARE Newborn Gift Set Has All Born Baby Items for Both Newly Born Baby Boy or Girl for or Girls Unisex 11 pcs Set Pink,Warehouse B,542,497,2025-02-28 10:33:00,45
528,ORD_529,15401,Adore Baby Nasal Aspirator (Multi-Color),Warehouse A,196,176,2025-02-28 04:27:00,20
529,ORD_530,12162,Lula Reusable Muslin Square Napkins-(Pack of 6)-45cm X 45cm -Orange,Warehouse A,479,461,2025-02-28 15:48:00,18
530,ORD_531,15528,"Neska Moda 6 To 12 Months Baby Girls Cotton Butterfly Frill Booties (Mint,Yellow) -SK141andBT42",Warehouse B,91,70,2025-02-28 13:24:00,21
531,ORD_532,15627,Little Innocents® Big Size Fibre Filled Stuffed Animal Elephant Baby Pillow with Ball Soft Toy for Baby of Plush Hugging P...,Warehouse B,281,237,2025-02-28 09:41:00,44
532,ORD_533,15654,United Colors of Benetton Boy's Regular FIT,Warehouse A,152,104,2025-02-28 15:18:00,48
533,ORD_534,12082,"ROYAL HERITAGE 15 HERBS AYURVEDIC VETIVER ESSENTIAL OIL, ""OIL OF TRANQUILITY"" NOURISHING AYURVEDIC BABY MASSAGE OIL FOR AL...",Warehouse B,238,192,2025-02-28 14:30:00,46
534,ORD_535,15622,socho samjo Baby Girl's Fit & Flare Midi Dress,Warehouse C,85,38,2025-02-28 22:18:00,47
535,ORD_536,12081,"Inditradition Child Safety Form Cushion Strip (2 Meter) | Corner Edge Guard Bump Protector | Multipurpose Usage, 6.5 Feet,...",Warehouse B,359,328,2025-02-28 20:17:00,31
536,ORD_537,15682,Mynekids Pack of 3 Flower for Baby Boy & Girl Booties for 3 to 12 Months-RK1-Yellow-RK3-Red-RK4-Pink Multicolor,Warehouse C,108,77,2025-02-28 01:36:00,31
537,ORD_538,12066,Pokory Nail Cutters for Kids Pink Pack of 2|Suitable for Age 6 Months and Above|Useful for Nail Clipper Manicure Pedicure ...,Warehouse A,81,73,2025-02-28 23:03:00,8
538,ORD_539,12062,"Little's Baby Pants Diapers,Small (S),4-8 kg,42 Count, with Wetness Indicator & 12 Hours Absorption",Warehouse A,402,387,2025-02-28 04:30:00,15
539,ORD_540,15694,SELETA - 6 To 12 Month Set of 1 Pair Baby Boys & Baby Girls Cotton Printed Baby Booties | First Walking Baby Footwear |Inf...,Warehouse C,248,217,2025-02-28 09:56:00,31
540,ORD_541,12214,AV2 Women's Cotton Floral Maxi Maternity/Feeding Nighty,Warehouse B,224,211,2025-02-28 03:24:00,13
541,ORD_542,12217,"Pigeon Peristaltic Nipple Y Cut,For 6+ Month Babies,BPS Free,BPA Free",Warehouse C,192,175,2025-02-28 04:15:00,17
542,ORD_543,15499,Mee Mee Baby Powder (Fresh Feel - 500 g (Single Pack)) & Mee Mee Baby Oil with Fruit Extracts/Moisturising Baby Lotion wit...,Warehouse C,482,462,2025-02-28 00:29:00,20
543,ORD_544,15503,"Sebamed Baby Lotion, 400Ml And Sebamed Baby Wash Extra Soft, 200Ml",Warehouse B,467,459,2025-02-28 07:27:00,8
544,ORD_545,15506,NYRWANA DELIVERING SMILES IN INIDA Inflatable Bath Tubs for Kids BPA-Free Swimming Tub- Blue,Warehouse B,224,187,2025-02-28 08:44:00,37
545,ORD_546,15508,Baby Luv 3-9 Years Unisex Infant Toddler Baby Boys Girls Summer Sandal | Newborn Soft Breathable Shoes Butterfly Design,Warehouse C,368,362,2025-02-28 04:43:00,6
546,ORD_547,15511,Easybuy baby-girls Clothing Sets,Warehouse B,113,83,2025-02-28 13:58:00,30
547,ORD_548,15514,Zumrut Dual Tone Copepr Silver Finish Adjustable Kids Bangle Free Size Nazariya for Unisex Babies Kids Jewellery -Set of 2...,Warehouse B,235,213,2025-02-28 15:58:00,22
548,ORD_549,15515,Morisons* babydreams THE CHOICE OF SMART MUMS Baby Dreams Bottle & Accessories Cleaner 500ml,Warehouse C,458,417,2025-02-28 06:30:00,41
549,ORD_550,15519,Max Girls Printed Skorts,Warehouse A,470,426,2025-02-28 07:45:00,44
550,ORD_551,12178,Elk New Born baby boys & girls 100% Cotton jabla set(Pack of 5),Warehouse A,370,364,2025-02-28 10:33:00,6
551,ORD_552,15466,Nammababy Unisex-Child Loose Fit Track Pants,Warehouse A,117,83,2025-02-28 18:17:00,34
552,ORD_553,15409,"Zero Baby Front Open Half Sleeves Vest Tshirt Pack of 3, 100% Cotton Top Set for Boys and Girls",Warehouse C,186,179,2025-02-28 21:53:00,7
553,ORD_554,12227,TheYaYaCafe Yaya Cafe� Brother Kids Baby Romper Onesie with Little Brother,Warehouse A,152,139,2025-02-28 02:03:00,13
554,ORD_555,12222,Tweeny Mini Baby Girl Dress Set of Three Rayon Summer Dress-Bloomer Matching Headband for Infants New Born Baby Girls (Lig...,Warehouse B,497,478,2025-02-28 19:11:00,19
555,ORD_556,15208,"Amazinghind Crib Mosquito Net for Cot, Crib & Cot Bed with Zipper Opening for Easy Access to Your Baby. Ideal for Large Cr...",Warehouse C,360,329,2025-02-28 13:35:00,31
556,ORD_557,15170,ZEDAI Baby Vest White Baniyan Cotton Inner wear Vest for Baby Boy & Baby Girls Toddler Vest (Pack of 6),Warehouse C,409,374,2025-02-28 03:42:00,35
557,ORD_558,12330,YOUSTYLO - YOU ARE PRIORITY Baby Anti Slip Crew Socks with Grips for Toddlers Little Boys Girls Infants Kids Non Skid Sock...,Warehouse C,273,255,2025-02-28 08:29:00,18
558,ORD_559,15232,"Mee Mee Mild Baby Liquid Laundry Detergent Refill Pack, 1.2L & Caring Baby Wet Wipes, Aloe Vera, 72 Pieces (Pack of 5) Combo",Warehouse A,263,245,2025-02-28 16:50:00,18
559,ORD_560,15235,"Mothercare All We Know Baby Bubble Bath, 300ml",Warehouse C,497,448,2025-02-28 20:49:00,49
560,ORD_561,15246,"Skip Hop Playspot Geo (Ff), Grey/Cream, 1 Count (Pack of 1) (245411)",Warehouse B,357,332,2025-02-28 11:21:00,25
561,ORD_562,12333,Ziory 1 Pc Go Baby' Cartoon Bear Cap - Green Yellow (9 months-18 Months),Warehouse B,218,174,2025-02-28 00:41:00,44
562,ORD_563,15162,AJ DEZINES Kids Ethnic Wear Kurta Pyjama Waistcoat Set for Boys,Warehouse A,416,381,2025-02-28 11:07:00,35
563,ORD_564,15123,PEAHEN Baby Potty Training Seat (Pink),Warehouse A,173,161,2025-02-28 12:32:00,12
564,ORD_565,15124,SNOWIE SOFT ® Baby Safety Walking Harness; Child Toddler Anti-Lost Belt Harness Reins with Leash Kids Assistant Strap Ange...,Warehouse B,116,88,2025-02-28 23:49:00,28
565,ORD_566,12390,LENAM Baby Cotton Soft Pants/Diaper Fit/Pyjama/Leggings(Pack of 7),Warehouse B,503,462,2025-02-28 06:35:00,41
566,ORD_567,12386,Hopscotch Girls Cotton Sleeveless Applique Solid Party Dress in Red Color,Warehouse B,387,370,2025-02-28 23:14:00,17
567,ORD_568,15133,VParents Bitsy New Born Baby Gift Set (Pack of 8) (Red),Warehouse C,244,216,2025-02-28 17:35:00,28
568,ORD_569,15134,Bold N Elegant - Be Bold Inside & Elegant Outside Baby Girls' Bootie,Warehouse A,291,274,2025-02-28 15:16:00,17
569,ORD_570,12383,KATS NEXXT Kids Baby Boy and Girls Walking Sandal,Warehouse A,100,77,2025-02-28 14:00:00,23
570,ORD_571,15222,"Mamaearth Natural Repellent Mosquito Patches For Babies with 12 Hour Protection,White,Pack of 1",Warehouse A,145,127,2025-02-28 13:27:00,18
571,ORD_572,12147,Supples Baby Diaper Pants M Pack of 3 Super Jumbo Box (216 Piece),Warehouse A,108,79,2025-02-28 14:17:00,29
572,ORD_573,15192,VISMIINTREND Baby Clay Hand and Footprint Casting Kit with Frame for Newborn Boys and Girls (0-5 Year Old) | New Parents G...,Warehouse A,276,262,2025-02-28 04:25:00,14
573,ORD_574,15556,Medela Contact Nipple Shields M (2 pcs),Warehouse A,392,364,2025-02-28 09:18:00,28
574,ORD_575,12144,VGRASSP Musical Crawling Baby Toy for Babies Kids Infants - Dazzling Lights and Dynamic Sound - Colour as per Stock,Warehouse B,154,124,2025-02-28 16:01:00,30
575,ORD_576,15562,"DAKULO® Soft Cloth Swing New Born Baby Cradle/Ghodiyu/Khoyu Hammock in Cool Cotton with Net, Orange (with Steel Hangers)",Warehouse C,257,243,2025-02-28 21:15:00,14
576,ORD_577,15567,"ELOSH Baby Nail File Electric - [2019 Upgraded] Safe Baby Nail Trimmer, Electric Nail Clipper with Light.",Warehouse A,472,433,2025-02-28 10:21:00,39
577,ORD_578,12136,Ginoya brothers Baby Girl's Hair Clips transparent hair clips Cute Hair Accessories (3 pcs BOW HAIR CLIPS),Warehouse B,391,345,2025-02-28 04:47:00,46
578,ORD_579,15583,PEARSILK Unisex-Baby's Casual Shoe's,Warehouse B,410,401,2025-02-28 04:58:00,9
579,ORD_580,15586,Fynxther U Shaped Baby Toothbrush for Kids multi color,Warehouse B,380,368,2025-02-28 07:01:00,12
580,ORD_581,12127,Butterthief Unisex Soft Infant Bootie New Born Shoes 6-9 Months Feet Size 12cm (Pack of 2pair) Multi,Warehouse C,362,322,2025-02-28 07:40:00,40
581,ORD_582,12122,AZAD57 Spinning Top Z Achilles B-105 Starter Spinner with Handle Launcher,Warehouse A,296,273,2025-02-28 20:07:00,23
582,ORD_583,15599,Baby Moo My Pet's House Chu-Chu Sound Breathable Anti-Skid Sandals - Beige (2Y-2.5Y),Warehouse A,334,329,2025-02-28 14:15:00,5
583,ORD_584,15600,StarAndDaisy Portable 2-in-1 Table Talk High Chair Convertible High Chair Compact Light Weight Portable Highchair (Yellow),Warehouse C,98,53,2025-02-28 12:17:00,45
584,ORD_585,15604,"KNITROOT Half Birthday Unisex Baby Romper Whilte Color Half Sleeve"" Yay I Am 6 Month Old"" (6-9 Months, KSBR22-3)",Warehouse B,505,480,2025-02-28 22:19:00,25
585,ORD_586,12118,"Skip Hop Bath Tub - Moby Smart Sling 3-Stage Tub, PVC-Free, Phthalate-Free, Non Slip Bath Tub for New Born with Drain Plug...",Warehouse C,38,22,2025-02-28 22:41:00,16
586,ORD_587,15587,"LuvLap wipes for baby skinParaben Free, Fragrance Free, pH Balanced, Dermatologically Safe, Baby Wipes for Sensitive skin,...",Warehouse C,82,64,2025-02-28 23:40:00,18
587,ORD_588,12236,"Chicco Gentle Body Wash and Shampoo 500ml, Pack of 2 (1000ml Total)",Warehouse A,463,426,2025-02-28 19:14:00,37
588,ORD_589,12241,ARIEL Cotton Clothing Sets for Baby Boys & girls - Unisex Clothing sets Full Sleeve T-shirt & Pant,Warehouse B,197,167,2025-02-28 05:23:00,30
589,ORD_590,12187,Mothercare All We Know Baby Top To Toe Wash 300ml,Warehouse B,258,240,2025-02-28 00:47:00,18
590,ORD_591,15491,Wowper Fresh Baby Diaper Pants | Large Size Diapers | Diapers with Wetness Indicator | Upto 10 Hrs Absorption | 9-14 Kg | ...,Warehouse A,152,128,2025-02-28 22:37:00,24
591,ORD_592,14672,"CITTA Nourishing Baby Massage oil, Talc-Free Baby Powder & Moisturizing Baby Balm Pack of 3-200 ml, 200 gm, 200 gm | Free ...",Warehouse C,508,471,2025-02-28 23:41:00,37
592,ORD_593,12634,JUNIOR JOE Nail Trimmer with 6 Grinding Head Kit for Kids and New Born Baby (Pink),Warehouse C,39,18,2025-02-28 12:59:00,21
593,ORD_594,14680,Babies Cotton Soft Muthi for New Born Baby to 6 Months Old of Multicolour Pack of 5 Pairs of Unisex Hand Gloves for Babies...,Warehouse B,63,42,2025-02-28 13:37:00,21
594,ORD_595,14682,"Cute Collection- New Born Baby Boy's and Baby Girl's Hand Made Woollen Frocks with Pyjama , Cap and Booties (6-12 Months ,...",Warehouse A,110,78,2025-02-28 12:53:00,32
595,ORD_596,12661,"Glowick Comfortable & Soft Bootie Socks Shoes Prewalker for Boys/Girls/New Born Baby, Anti- Skid Rubber Sole Rib Sock Shoe...",Warehouse A,417,401,2025-02-28 13:32:00,16
596,ORD_597,14577,"Toddylon Baby Clothing Sets Full Sleeves Jhabla with Nappy & Caps (Multicolour, 0-6 Months)",Warehouse C,358,342,2025-02-28 16:42:00,16
597,ORD_598,14629,"Subhankara New Baby Nail File Electric,Baby Nail Trimmer with 6 Grinding Heads Safe for Newborn Baby",Warehouse B,119,98,2025-02-28 14:02:00,21
598,ORD_599,12678,ADRIEL Bringing Joy® New Born Baby Woolen Hood Romper for Winter,Warehouse B,334,290,2025-02-28 06:38:00,44
599,ORD_600,12640,"Luvlap Anti-Colic Natura Flo Teat/Nipple for Wide Neck Bottle, 4pcs, Fast Flow, 6m+",Warehouse C,483,474,2025-02-28 07:53:00,9
600,ORD_601,12641,Hopscotch Girls Solid Casual Dress with Headband Polyester in Red Color,Warehouse C,465,441,2025-02-28 21:49:00,24
601,ORD_602,14663,Sebamed Baby Body Lotion 50 ml|Ph 5.5|Camomile & Allantoin| Dermatalogically tested| Sensitive skin,Warehouse B,283,256,2025-02-28 22:45:00,27
602,ORD_603,14994,BabyChakra Moisturizing Creamy Bathing Bar Baby Soap | Oatmeal Extract & Almond Oil | pH Balanced 5.5 | No tears & Soap Fr...,Warehouse A,66,33,2025-02-28 14:48:00,33
603,ORD_604,12472,Aphrodite Magic Lattoo Spinning Top Toy with LED Flashing Colorful Lights Laser Toy Spinner Toy Stress Relief Gadgets Non ...,Warehouse A,105,62,2025-02-28 03:41:00,43
604,ORD_605,15001,SYGA 1 Piece Velvet Bow Shape Baby Head Band,Warehouse B,266,242,2025-02-28 22:38:00,24
605,ORD_606,15004,Silver Dangler with Mickey Mouse Cut-out,Warehouse C,290,269,2025-02-28 02:22:00,21
606,ORD_607,15007,Hopscotch Boys Cotton All-Over Print Slim-Fit T-Shirt - Pack of 3 in Multi Color,Warehouse B,288,279,2025-02-28 21:13:00,9
607,ORD_608,15018,Mother Sparsh Plant Powered Natural Hydrating Baby Wash With Avacado Oil & Coconut - 100 ml,Warehouse B,143,113,2025-02-28 12:53:00,30
608,ORD_609,15029,Aveeno Baby Daily Moisturising Lotion for Delicate Skin (227g),Warehouse A,89,58,2025-02-28 15:43:00,31
609,ORD_610,15041,StarAndDaisy Baby High Chair Booster Seat for Dining Table Height Adjustable Toddlers Chair Portable Foldable Highchair wi...,Warehouse B,88,51,2025-02-28 13:00:00,37
610,ORD_611,14825,"The Little Lookers� Super Soft Hooded Towel for Babies, Kids, Toddlers & Infants| Quick Dry Baby Towel/Wrap-On | 420 GSM M...",Warehouse C,359,325,2025-02-28 20:40:00,34
611,ORD_612,12656,"UNIBLISS Women's Cotton Maternity Dress, Pregnancy Dress, Easy Breast Feeding, Breast Feeding Dress Zippers for Nursing Pr...",Warehouse B,161,152,2025-02-28 01:54:00,9
612,ORD_613,14644,"VRITRAZ Kids Summer Fashion Straw Bucket Cap, Suitable for 3-12 Year Hat (White)",Warehouse B,272,236,2025-02-28 05:52:00,36
613,ORD_614,12647,Hopop Safety Nail Cutter for Infants and Kids with Skin Guard (Blue Check),Warehouse A,532,486,2025-02-28 02:38:00,46
614,ORD_615,12671,Fareto Baby Boy's & Baby Girl's Cut Sleeves | Touch Button | T-Shirts(Pack of 5),Warehouse A,424,400,2025-02-28 06:05:00,24
615,ORD_616,14617,DABUR Oil Lal Tail - 100 ml,Warehouse C,79,74,2025-02-28 20:14:00,5
616,ORD_617,15490,Zero Size Vest (Pack of 6) New Born Infant Baby Kids Inner Wear Baniyan Unisex Cotton Baby Sando Vest 100% Cotton Housiry...,Warehouse C,75,35,2025-02-28 22:42:00,40
617,ORD_618,12620,BabyGo Baby Bandana Bibs Apron with 2 Snap Buttons For Drooling Teething Feeding Super Absorbent 100% Organic Cotton For B...,Warehouse A,325,277,2025-02-28 09:28:00,48
618,ORD_619,14703,"Neska Moda 6 To 12 Months Baby Girls Cotton Butterfly Booties (Mint,Red) -SK172andBT83",Warehouse A,274,240,2025-02-28 02:28:00,34
619,ORD_620,14716,Neppe's World Born Baby Boy Multicolor Top And Bottom Set | 0 to 3 Month Baby Boy Cotton Dress | Pack Of 5,Warehouse A,471,432,2025-02-28 17:57:00,39
620,ORD_621,14719,"HUNK SHOPPERS See and Spell Learning Toys, Matching Letter Spelling Game Sight Words Games Educational Preschool Toys Lear...",Warehouse A,376,337,2025-02-28 21:43:00,39
621,ORD_622,14731,Hopscotch Unisex PVC Star Print Slip-Ons in Black Color,Warehouse A,299,252,2025-02-28 11:34:00,47
622,ORD_623,14742,Fancy Foam Sheet and Rubber Sheet Work tic tac pins Pair,Warehouse C,265,219,2025-02-28 16:26:00,46
623,ORD_624,14747,Fllik Kids Cotton Caps Summer Cap for Sun Protection for Kids Boys and Girls Kids Cotton Caps for 2 to 3 Years Kids Boys a...,Warehouse C,227,189,2025-02-28 12:04:00,38
624,ORD_625,12596,MOMISY New Born Gift Baby Girl Cute Head Band and Socks (1 Pair of Socks and 2 Head Bands) Suitable for 0-09 Month Baby (P...,Warehouse C,205,193,2025-02-28 03:09:00,12
625,ORD_626,14754,Soku Shopee kids baby boy girl teddy cartoon woolen winter warm booties/socks/shoes/prewalkers/newborn (0-12 months),Warehouse B,298,268,2025-02-28 02:14:00,30
626,ORD_627,14756,"Supples Baby Pants Diapers, Medium (7-12 kg), 72 Count",Warehouse A,134,109,2025-02-28 18:27:00,25
627,ORD_628,12695,"Firstly Traders 24 Pcs Bouncing Bouncy Balls Bulk Set, Assorted Colorful Neon Mixed Pattern Designs for Kids Playtime, Par...",Warehouse C,531,487,2025-02-28 19:22:00,44
628,ORD_629,15480,"Cucumber Baby Girls Printed Cotton Frock Pack of 3 (3-6 Months, Multicoloured-1) (3-6 Months, Multicoloured-1)",Warehouse C,254,238,2025-02-28 07:03:00,16
629,ORD_630,15485,"XIVUMN Baby Electric Nail Trimmer, Newborn Nail Polisher Manicure Set, Infants Nail File for Kids, Replaceable Grinding He...",Warehouse C,385,376,2025-02-28 19:12:00,9
630,ORD_631,15489,AVEENO Baby WASH & Shampoo - 236ML (8oz),Warehouse C,85,39,2025-02-28 21:04:00,46
631,ORD_632,14761,Ratna's Spinning Ball for Toddlers,Warehouse B,79,72,2025-02-28 00:39:00,7
632,ORD_633,12667,"Mamaearth nourishing wash for babies (100 ml, 0-5 Yrs)( Pack of 2)",Warehouse A,493,465,2025-02-28 06:29:00,28
633,ORD_634,14762,Lifezen Inostretch Stretch Mark Cream To Reduce Stretch Marks & Scars Paraben Free & Dermatologist Approved (60-Gm) Pack Of 1,Warehouse A,142,119,2025-02-28 05:49:00,23
634,ORD_635,12666,"Chicco Oral care Toothpaste (Mela-Applebanana), 50ml",Warehouse A,79,33,2025-02-28 03:17:00,46
635,ORD_636,14693,BRANDONN Ultrasoft Extra Large White Premium Supersoft Cute Cat Hooded Wrapper/Bathrobe(White Catty),Warehouse B,114,65,2025-02-28 19:52:00,49
636,ORD_637,12592,"Safety 1st Newborn Nasal Aspirator, White, One Size",Warehouse B,143,107,2025-02-28 12:15:00,36
637,ORD_638,14774,"KGr Splash evil eye nazaria black for new born baby to 4 year child(unisex child), Pack Of 1 Pair",Warehouse A,276,239,2025-02-28 06:14:00,37
638,ORD_639,14785,"Pigeon Baby Soap with Glycerine, For New Born, Enriched with Jojoba, Chamomile and Olive Oil, Paraben Free, 75 gm, Pack of 3",Warehouse B,34,16,2025-02-28 09:06:00,18
639,ORD_640,14788,4INFANTSONLY Baby Boy's & Baby Girl's Regular Fit Leggings Pajamas Baby Lower Pack of 6,Warehouse B,221,194,2025-02-28 04:05:00,27
640,ORD_641,14790,Lillypupp chu chu Sound Making Shoes for boy and Girl.,Warehouse C,190,160,2025-02-28 23:18:00,30
641,ORD_642,12572,BUMZEE Pink & Sea Green Half Sleeve Baby Girls T-Shirt & Pajama Set Pack Of 2 Age - 6-12 Months,Warehouse C,421,413,2025-02-28 15:28:00,8
642,ORD_643,14813,UJEAVETTE Soft Water Shoes Stretchy Aqua Socks Yoga Swim Shoe Dive Sock Pink L,Warehouse A,75,42,2025-02-28 16:12:00,33
643,ORD_644,14814,KUNKUN Foldable Mosquito Net for Single Bed ( Large Size 7x4x4 Feet ) :: Standard Quality (Black),Warehouse C,393,365,2025-02-28 13:38:00,28
644,ORD_645,14791,Baby Girl's Fit And Flare Knee Length Frock (kukuranijacketblue0-6_Blue_0-6 Months),Warehouse C,303,257,2025-02-28 07:09:00,46
645,ORD_646,13466,KRONADO Baby Boys and Baby Girls Cotton-Blend Printed Half Sleeve Night Suit Top and Shorts,Warehouse B,81,69,2025-02-28 21:00:00,12
646,ORD_647,13477,Gentle Baby Bath Himalaya Bath 100ml Each (Pack of 2),Warehouse C,80,40,2025-02-28 03:15:00,40
647,ORD_648,13481,"HASTHIP® Hair Bows Holder Wall Hanging Headband Hair Clips Organizer for Girls Room, Large Capacity Felt Storage Display f...",Warehouse C,225,212,2025-02-28 08:28:00,13
648,ORD_649,13501,FANY School Green Socks for Kids | Pack of 3 (2-12 years),Warehouse B,172,130,2025-02-28 23:45:00,42
649,ORD_650,13529,SYGA Binoax Multipurpose Level Laser Horizon Vertical Measure Tape Aligner Bubbles Ruler,Warehouse C,415,393,2025-02-28 14:26:00,22
650,ORD_651,13271,"Neska Moda 12 To 18 Months Baby Boys & Baby Girls Cotton Rabbit Booties (Blue,Yellow) -BT1157andBT1176",Warehouse B,48,38,2025-02-28 07:14:00,10
651,ORD_652,13491,"TinyLane - Curated for you! All in One Bamboo: Cotton Newborn Baby Gift Pack, Pack of 13 Pieces, 0-18 Months, Multi Color,...",Warehouse C,398,361,2025-02-28 14:26:00,37
652,ORD_653,13538,"Desi Rang Baby Hand and Footprint kit, Infant Foot and Handprint, Hand Foot Impression Print DIY, No Touch, Safe Non Toxic...",Warehouse A,329,301,2025-02-28 06:59:00,28
653,ORD_654,13443,"Goodknight Power Activ+, Mosquito Repellent - 60 Nights Jumbo Refill Pack",Warehouse C,127,89,2025-02-28 21:43:00,38
654,ORD_655,13330,KITTENS Boy's Ktb522red Boots,Warehouse A,238,200,2025-02-28 19:16:00,38
655,ORD_656,13376,DS FASHION Girls Cotton Solid With Side Striped Leggings,Warehouse A,301,291,2025-02-28 04:16:00,10
656,ORD_657,13377,Neska Moda Baby Boys & Girls Studd Baby Booties For 0 To 12 Months Infants,Warehouse B,325,292,2025-02-28 00:08:00,33
657,ORD_658,13393,"BeeBaby Teddy Teethers for 6 to 12 Months BPA Free. Cooling Water Filled Baby Teether, Soft Teething Toy for Babies with C...",Warehouse A,262,251,2025-02-28 08:41:00,11
658,ORD_659,13399,"Johnson's Baby No More Tears Baby Shampoo 200ml & Johnson's Baby Cream For Summer, 100g & Johnson's Baby Oil with Vitamin ...",Warehouse B,412,374,2025-02-28 12:33:00,38
659,ORD_660,13468,AkinosKIDS Fuchsia Pink Flower Newborn to Five years Baby Girl Headband(Kids Hair Accessories) AKHA1167FP,Warehouse C,478,458,2025-02-28 21:38:00,20
660,ORD_661,13354,Mothercare Girls Round Neck Printed and Dot Pattern Tee - Pack of 3,Warehouse C,387,361,2025-02-28 16:12:00,26
661,ORD_662,13464,"Neska Moda 0 To 6 Months Baby Boys & Baby Girls Cotton Lace Shoes/Booties (Orange,Mint) -BT1135andBT1136",Warehouse B,25,12,2025-02-28 20:34:00,13
662,ORD_663,13916,Cho-Cho Inflatable Bath Tubs Kids and Adults SPA Tub with Pump 5.5ft ( A180F; Blue White),Warehouse A,145,116,2025-02-28 14:17:00,29
663,ORD_664,13841,Max Boys Striped Sleeveless Crew Neck T-Shirt,Warehouse C,341,314,2025-02-28 00:43:00,27
664,ORD_665,13104,SVM CRAFT®13 Pieces MDF Wood Baby Milestone Cards Baby Monthly Milestone Sign Discs Boho Rainbow Single Sided Printed MDF ...,Warehouse B,348,299,2025-02-28 00:00:00,49
665,ORD_666,13854,"B 4 Baby - Vest for Kids & Baby, Cotton Sando Baniyan Innerwear for Boys & Girls",Warehouse A,368,327,2025-02-28 01:26:00,41
666,ORD_667,13875,| Baby Glow Soap-75gm (Pack of 3) | Of Arya Vaidya Sala Kottakkal,Warehouse C,157,142,2025-02-28 17:23:00,15
667,ORD_668,13915,Quasar Animals with Baby Tub Chu Chu Bathtub Bathing Squeeze Made in Safe Non-Toxic Silicone Rubber Rattle for Children To...,Warehouse A,64,51,2025-02-28 06:10:00,13
668,ORD_669,13876,Hopscotch Boys and Girls Synthetic/PU Graphic Print LED Slip Ons in Black Color,Warehouse C,521,485,2025-02-28 13:26:00,36
669,ORD_670,13889,BRATS N BEAUTY®-Baby Winter Hat Cute Cartoon Frog Plush Thick Hat and Scarf Set for Kids 9-10 Year Pink Color,Warehouse C,168,133,2025-02-28 17:17:00,35
670,ORD_671,13082,"VParents Honey Punch New Born Baby Gift Set (Red, Pack of 10)",Warehouse B,320,272,2025-02-28 20:22:00,48
671,ORD_672,13902,"Baby Dreams MBD Nail Clipper with Magnifier, Green",Warehouse A,244,233,2025-02-28 19:07:00,11
672,ORD_673,13905,AJ DEZINES® Boy's Regular Fit Double Breasted Suit,Warehouse B,452,414,2025-02-28 16:47:00,38
673,ORD_674,13906,UJEAVETTE 2Mm Neoprene Quick Dry Beach Shoes Scuba Diving Snorkeling Socks M Black,Warehouse C,228,192,2025-02-28 15:08:00,36
674,ORD_675,13907,Hopop Baby Medicine Spoon & Dropper (HP-2004B-WHITE),Warehouse C,421,414,2025-02-28 04:21:00,7
675,ORD_676,13877,MINITATU Boy's Full Sleeve Unisex Baby Sleepsuit Pack of 2 Regular and Toddler Sleepers,Warehouse B,467,456,2025-02-28 15:50:00,11
676,ORD_677,13410,FY LANE Baby Boys & Baby Girls Woolen Cap,Warehouse A,52,42,2025-02-28 00:44:00,10
677,ORD_678,13945,"100% Muslin Cotton 4 Layer Newborn Baby Blanket Upto 5 Years, Soft Dream Blanket, Muslin Baby Blankets for Girls & Boys, L...",Warehouse B,474,433,2025-02-28 13:14:00,41
678,ORD_679,13238,Mothercare Girls Round Neck Printed Tee with Headband,Warehouse C,22,12,2025-02-28 12:41:00,10
679,ORD_680,13239,"Figaro Baby Lotion with Goodness of Natural Olive oil enriched with vitamin E, Dermatologically tested, 100 ml",Warehouse C,372,336,2025-02-28 09:12:00,36
680,ORD_681,13567,Mothercare Striped Cotton Infant Girls T-Shirt (S21WC108-P),Warehouse A,205,168,2025-02-28 09:04:00,37
681,ORD_682,13569,MAHAKAAL JEWELS® Copper Ashtdhaatu Free Size Kada Bracelet Adjustable Kids Bangle Child Nazariya for Unisex Babies Kids Je...,Warehouse A,355,306,2025-02-28 10:06:00,49
682,ORD_683,13571,AHC Baby Boy Baby Girl Cotton Socks Full Length Plain Colors 3-5 years,Warehouse C,132,127,2025-02-28 07:43:00,5
683,ORD_684,13252,"Healofy Naturals Soothing Sleep Balm to Help Baby Sleep, 50gm | With Lavender Oil, Chamomile Oil & Sandalwood Oil",Warehouse B,132,92,2025-02-28 11:58:00,40
684,ORD_685,13581,ZoLi Buzz B Electric Nail Trimmer,Warehouse C,518,495,2025-02-28 07:48:00,23
685,ORD_686,13251,Fflirtygo One Month Birthday Special Baby Romper Full Sleeve with Booties/Onesies/Body Suit/Sleepsuit/Jumpsuit Full Rompers,Warehouse C,399,366,2025-02-28 06:28:00,33
686,ORD_687,13604,"Set of 8 Rubber Band For Baby Girls Gorgeous, Designer & Stylish Too; Very Famous among Kids",Warehouse C,269,245,2025-02-28 12:38:00,24
687,ORD_688,13607,New Vastra Lok Multi Color Woolen Socks 3 Pair for 2-3 Year for Boy's & Girl's,Warehouse A,169,123,2025-02-28 11:51:00,46
688,ORD_689,13608,"MY NEWBORN 3-in-1 Hooded Baby Towel Wrapper- Set of 2 (Unicorn Pink and Blue, 0 - 12 Months) | Multi-Purpose Wrap for Baby...",Warehouse C,261,244,2025-02-28 09:35:00,17
689,ORD_690,13243,GOCART WITH G LOGO Suitable for New Born Baby Safety Nail Scissor(Blue),Warehouse B,299,262,2025-02-28 19:54:00,37
690,ORD_691,13618,TEESCART baby boys and baby girls unisex 100% cotton First month Romper Bodysuits,Warehouse C,453,423,2025-02-28 23:18:00,30
691,ORD_692,13973,"Mamaearth Daily Moisturizing Lotion For Babies (200 Ml) And Mamaearth Natural Toothpaste, Orange Flavour, Sls Free, With 7...",Warehouse A,164,116,2025-02-28 14:24:00,48
692,ORD_693,13220,"Luv Lap Silicone Training Toothbrush with Soft bristles, Anti Choking Shield,manual brush for kids, Baby Oral Hygiene, Orange",Warehouse C,106,70,2025-02-28 02:28:00,36
693,ORD_694,13414,Mi Arcus Baby Pink Anti- Skid Rubber Sole Rib Sock Shoes for Kids Boys and Girls,Warehouse A,491,463,2025-02-28 18:35:00,28
694,ORD_695,13343,MINI KLUB Boys Aqua Dungaree Set,Warehouse C,109,97,2025-02-28 07:59:00,12
695,ORD_696,13427,Muma's Love Baby Fruit Feeder Pacifier (1 Pcs) with 1 PCS Silicone Baby Food Dispensing Spoon 90ML and 1 pcs Fruit Teether...,Warehouse B,510,477,2025-02-28 11:39:00,33
696,ORD_697,13429,BeeBaby Silicone Baby Finger Brush with Carry Case (Pink),Warehouse C,449,430,2025-02-28 07:22:00,19
697,ORD_698,13439,"Babique Unicorn Teddy Bear Plush Soft Toy Cute Kids Birthday Animal Baby Boys/Girls (25 cm, Pink )",Warehouse A,230,184,2025-02-28 20:43:00,46
698,ORD_699,13351,Baby Moo My Pet's House Chu-Chu Sound Breathable Anti-Skid Sandals - Pink (2Y-2.5Y),Warehouse A,150,124,2025-02-28 21:31:00,26
699,ORD_700,13539,Neska Moda Unisex Baby Booties (Green)-BT90,Warehouse A,46,31,2025-02-28 08:42:00,15
700,ORD_701,13551,"Kuchipoo Baby Girl Regular Fit Cotton T-Shirts (© Disney-TSHRT-349, Multi-Colored)",Warehouse A,108,86,2025-02-28 08:52:00,22
701,ORD_702,13554,"Sathiyas Baby Boy's Tank Top Jhablas (Multicolored, 0-6 Months, Pack of 5)",Warehouse C,428,408,2025-02-28 08:28:00,20
702,ORD_703,13631,"Chicco Fliptop Wipes (Pack of 3, 72 Count per Pack)",Warehouse B,531,489,2025-02-28 07:54:00,42
703,ORD_704,13635,Easybuy Baby-Girls T-Shirt,Warehouse C,371,356,2025-02-28 07:12:00,15
704,ORD_705,13638,"Lalisha Beautiful Frock Dress for Baby Girls, Frock with Soft Net, Midi/Knee Length Festive/Wedding Dress|Birthday Gift It...",Warehouse A,516,474,2025-02-28 17:27:00,42
705,ORD_706,13224,"Neska Moda 6 To 12 Months Baby Boys & Baby Girls Pack Of 2 Pair Cotton Butterfly Frill Booties (Black,Red) -BT6andSK135",Warehouse C,515,467,2025-02-28 15:18:00,48
706,ORD_707,13650,Infantbond Born Baby Mattress with Net & Sleeping Bag(0-6 Months) (Yellow)(Star),Warehouse A,75,26,2025-02-28 13:29:00,49
707,ORD_708,13668,Clothe Funn New Born Baby Girl Trendy Cotton Dress,Warehouse A,75,35,2025-02-28 07:00:00,40
708,ORD_709,13204,Mosquito Repellent | Unica Natural Mosquito Repellent Refill Liquid | Combo Pack of 10,Warehouse B,293,251,2025-02-28 09:50:00,42
709,ORD_710,12283,Baby Headband Hairbands Grosgrain Ribbon Boutique Elastic Bow Bowknot for Kids Girls Newborn Teens Infant Toddler Hair Ban...,Warehouse A,291,264,2025-02-28 03:02:00,27
710,ORD_711,15257,Chicco Brush and Comb and Nail Scissor Set (Blue),Warehouse B,150,114,2025-02-28 18:44:00,36
711,ORD_712,15269,BUMZEE Unisex T-Shirt,Warehouse C,120,108,2025-02-28 13:35:00,12
712,ORD_713,15273,DUCOSOFT BABY MLIK MOISTURIZING LOTION,Warehouse B,193,160,2025-02-28 02:11:00,33
713,ORD_714,15275,Hopscotch Baby Boys and Baby Girls Cotton All Over Print Full Sleeve Footie in Red Color,Warehouse A,30,19,2025-02-28 18:02:00,11
714,ORD_715,15277,Mothercare Baby Body Wash (300 ml),Warehouse B,98,64,2025-02-28 06:23:00,34
715,ORD_716,15291,"Baby Forest Mashak Kawach Baby Mosquito Repellant Spray, 100ML, pack of 1, Made with Lemongrass oil, Cedarwood, and Lavend...",Warehouse C,478,431,2025-02-28 11:07:00,47
716,ORD_717,12298,fizzytech Toys Talking Cactus Baby Toys for Kids Dancing Cactus Toys Can Sing Wriggle & Singing Recording Repeat What You ...,Warehouse A,493,444,2025-02-28 23:12:00,49
717,ORD_718,12291,Himalaya Pure Hands | Hand Sanitizer - 500 ml (Lemon) (Packaging may vary),Warehouse B,334,320,2025-02-28 05:23:00,14
718,ORD_719,15307,"Maxisoft Baby Powder |With Tulsi, Neem, Aloe vera, Shea Butter, Vitamin E, Avacado oil, Pine Bark , Olive Extract, Pomegra...",Warehouse A,112,86,2025-02-28 09:12:00,26
719,ORD_720,15311,Maxigo Real Bathtub with Detachable Shower Spray and Accessories for Kids Pretend Play Baby Doll Bath time Set (Multicolor),Warehouse A,299,262,2025-02-28 13:47:00,37
720,ORD_721,15115,HAPPU COLLECTION printed kids boots (pink) 2c,Warehouse A,93,58,2025-02-28 05:15:00,35
721,ORD_722,15704,"Pampers Premium Care Pants, Medium size baby Diapers, (M) 162 Count Softest ever Pampers Pants,",Warehouse A,423,375,2025-02-28 21:19:00,48
722,ORD_723,14567,Organic Cotton Muslin Pack of 2 Baby Bath Towel 120 cm X 120 cm_Tri Bear,Warehouse A,514,492,2025-02-28 05:33:00,22
723,ORD_724,14556,"Mom's Darling Baby Bed Protector Waterproof Plastic Sheets, Urine Matress Protector Sheets, Baby Diaper Changing Sheet(0-1...",Warehouse A,402,381,2025-02-28 05:13:00,21
724,ORD_725,13784,Lappu Baby Boys and Baby Girls Baby Bloomer | Baby Panties | Baby Brief | Cotton Bloomer for Babies| Baby Underwears - Pac...,Warehouse C,252,220,2025-02-28 02:47:00,32
725,ORD_726,13785,Mothercare Baby-Girls Leggings,Warehouse C,445,407,2025-02-28 21:30:00,38
726,ORD_727,15332,Hopscotch Girls Cotton Animal Print Casual Dress in Pink Color,Warehouse B,517,480,2025-02-28 01:24:00,37
727,ORD_728,15372,"Batman Toys Organizer (Set of 2 pcs - Big & Small), Storage Box for Kids",Warehouse A,166,141,2025-02-28 13:46:00,25
728,ORD_729,15158,Johnson's Baby Powder Blossoms 200g,Warehouse A,382,356,2025-02-28 21:55:00,26
729,ORD_730,15253,Mothercare baby-boys socks,Warehouse C,274,225,2025-02-28 06:02:00,49
730,ORD_731,15349,bosig® LED Flashlight Earpick with Tweezer and Spoons in Case Pack of 2 Earpick,Warehouse A,182,155,2025-02-28 06:01:00,27
731,ORD_732,15333,baby wish Ultra Absorbent and Hypoallergenic Cotton Hooded Bath Towel for Newborn Baby Boys and Baby Girls (Pink),Warehouse A,176,151,2025-02-28 02:36:00,25
732,ORD_733,12257,BUMZEE Girls Full Sleeves T-Shirt And Pajama Set Pack Of 2,Warehouse A,170,124,2025-02-28 13:24:00,46
733,ORD_734,15382,Fflirtygo Dad is My Super Hero Printed Romper Baby Wear 100% Hosiery Cotton Infants Onesies/Rompers Half Sleeves/Jumpsuit/...,Warehouse B,247,219,2025-02-28 00:54:00,28
734,ORD_735,15384,"Koochie-Koo Cotton Baby Socks for Boys, Kids Socks with Rubber Grip, Socks for Baby Boy, Anti Skid Socks for Boys, Anti Sl...",Warehouse C,226,202,2025-02-28 05:23:00,24
735,ORD_736,12247,"Luke and Lilly 1,2,3,4 Number Kids Wall Sticker(PVC Vinyl,60cm x110cm)",Warehouse A,116,84,2025-02-28 13:12:00,32
736,ORD_737,15390,"Kideezguild… Infant New-Born Girls Boys Winter Full Sleeve Thermal Romper Bodysuit Combo Set Pack 3 (GREY3, 0-3 Months)",Warehouse A,414,405,2025-02-28 00:25:00,9
737,ORD_738,13034,BABY4U Kids/Baby Girls/Boys Cotton Panty/Panties Multicolored Blommers Children Assorted Coloured Frozen Printed Hipster R...,Warehouse B,167,122,2025-02-28 01:26:00,45
738,ORD_739,13759,"Neska Moda 0 To 6 Months Baby Girls Cotton Butterfly Booties (Red,Orange) -BT386andBT380",Warehouse B,172,134,2025-02-28 01:34:00,38
739,ORD_740,13153,MINI KLUB Cotton Po2 Dress Girls | Pink/Lilac |,Warehouse C,447,401,2025-02-28 06:10:00,46
740,ORD_741,13152,Baby Nail Scissors Baby Nail Clippers Kids Hair Sissors Round Head Scissors Gift for Infant set of 2,Warehouse B,480,458,2025-02-28 17:55:00,22
741,ORD_742,13144,"MY NEWBORN Baby Towel (Panda White and Rabbit Pink, Set of 2) | 0 - 12 Months | Boy Girl Baby Wrap | Hooded Blanket | All ...",Warehouse C,279,238,2025-02-28 06:03:00,41
742,ORD_743,13747,TINYCRAWL Boogerbuster Baby Nasal Aspirator Nose Cleaner Mucus Sucker (0-5 Years) with Additional 20 Hygiene Filters with ...,Warehouse B,317,287,2025-02-28 17:39:00,30
743,ORD_744,13835,"Protinex Mama Nutritional Drink - (Chocolate Flavor, 400 Gms, Jar) with 28 Vital Nutrients to Support Healthy Birth Weigh...",Warehouse A,314,307,2025-02-28 22:48:00,7
744,ORD_745,13115,Baby Smart New Born Baby Baby's Premium Cotton Housiry Mittens Set/Hand Gloves/Muthi/to Keep Baby Hand Tender for Age 0 to...,Warehouse B,251,230,2025-02-28 19:45:00,21
745,ORD_746,13922,BUMZEE White & Red Half Sleeve Baby Boys T-Shirt & Pajama Set Pack Of 2 Age - 6-12 Months,Warehouse C,203,180,2025-02-28 08:11:00,23
746,ORD_747,13923,"Lotus Herbals Baby+ Little Bubbles Body Wash and Shampoo, 200ml",Warehouse B,22,10,2025-02-28 12:43:00,12
747,ORD_748,13927,"Kalp® Citronella oil -Pure,Therapeutic Grade,Natural Mosquito repellent (15 ml)",Warehouse C,156,145,2025-02-28 06:05:00,11
748,ORD_749,13928,RATAVA nflatable Cartoon for Baby Bath tub 1 to 3 Years Bath tub for Kids Home and Travel More Fun with Size 2 Feet 24 inc...,Warehouse A,458,429,2025-02-28 03:28:00,29
749,ORD_750,13059,Fitplus Pure Cotton Multi-Color Baby Boys/Baby Girls Dress-Pack of 10 and 5 Pieces,Warehouse A,108,101,2025-02-28 17:06:00,7
750,ORD_751,13918,Himalaya Refreshing Baby Wash 400 ml and Himalaya Baby Shampoo (400 ml),Warehouse C,63,42,2025-02-28 02:58:00,21
751,ORD_752,13936,"Baybee 5 in 1 Baby Bottle Warmer & Sterilizer | Electric Baby Food,Water & Milk Heater & Defrost with Manual Temperature A...",Warehouse A,452,433,2025-02-28 18:52:00,19
752,ORD_753,13951,Littly Ethnic Wear Kids Fancy Kurta Pajama Set For Baby Boys,Warehouse B,215,170,2025-02-28 23:57:00,45
753,ORD_754,13953,"Amazon Brand - Solimo Baby Water Resistant Dry Sheet, Medium, 100cm x 70cm, Navy Blue",Warehouse C,502,467,2025-02-28 07:54:00,35
754,ORD_755,13155,A.T.U.N. (ALL THINGS UBER NICE) Girl's Cotton A-Line Knee-Length Casual Dress (GDRS HED_Red-Black_11-12 Years),Warehouse A,273,239,2025-02-28 21:33:00,34
755,ORD_756,13791,6 To 12 Months/ 1 Year Baby Boys & Baby Girls Pack of 2 Pair Cotton Red Cartoon Face Booties (Red),Warehouse B,505,489,2025-02-28 12:50:00,16
756,ORD_757,13794,AmazingHind King Size Family mosquito net for bed. Mosquito net for bed king size. Mosquito net for double bed with 40 GSM...,Warehouse B,373,368,2025-02-28 23:07:00,5
757,ORD_758,13134,Fratelli Cussons Baby Laundry Detergent - Antibacterial/Antiviral Fabric wash(Pack of 2),Warehouse B,371,343,2025-02-28 19:10:00,28
758,ORD_759,13128,TM Collection Net Casual Solid Knee Length Frock Dress for Girls,Warehouse A,402,383,2025-02-28 02:38:00,19
759,ORD_760,13124,KETKAR Baby Boys & Baby Girls Winter Hand Gloves For Babies | Baby Winter Warm Hand Striped Gloves_Pack Of 12(Multicolour),Warehouse A,374,369,2025-02-28 02:56:00,5
760,ORD_761,13819,Casual Fashion Trending Printed Top And Skirt Dress For Girls | Casual Sleeveless Printed Top & Skirt for Girls | Sleevles...,Warehouse C,259,225,2025-02-28 00:55:00,34
761,ORD_762,13122,Himalaya Herbal Babycare Set of 7 Pack of 2,Warehouse A,151,140,2025-02-28 06:33:00,11
762,ORD_763,13118,"Chicco Teat Perfect 5 with Anti-Colic Effect, Nipple for Wide Neck Feeding Bottles, Medium Flow, for Babies 2m+ (Pack of 2)",Warehouse B,186,148,2025-02-28 11:19:00,38
763,ORD_764,13143,Himalaya Baby Care Combo Pack,Warehouse C,110,93,2025-02-28 08:12:00,17
764,ORD_765,13188,Baby Collection Baby Pure Cotton Printed Vest Inner wear Unisex Baniyan Undershirt Baby Combo ( Pack of 6 ),Warehouse A,515,483,2025-02-28 17:41:00,32
765,ORD_766,13716,A&D Diaper Rash Ointment & Skin Protectant - 1.5 Oz,Warehouse A,154,135,2025-02-28 09:33:00,19
766,ORD_767,13726,Hopscotch Girls EVA Floral Applique Infant Booties in Pink Color,Warehouse B,316,301,2025-02-28 00:59:00,15
767,ORD_768,13728,"SYGA High Chair for Baby Kids,Safety Toddler Feeding Booster Seat Dining Table Chair (with Cushion, Brown)",Warehouse C,323,310,2025-02-28 10:34:00,13
768,ORD_769,13182,"Huggies Complete Comfort Wonder Pants, Medium (M) Size Baby Diaper Pants, 50 count, with 5 in 1 Comfort",Warehouse B,344,317,2025-02-28 15:06:00,27
769,ORD_770,13732,istore Antiskid Shoe Socks for Baby Boys and Girls Antislip Soft Sole Socks Cum Shoes Bootie Footwear for Baby/Toddler and...,Warehouse B,237,228,2025-02-28 14:36:00,9
770,ORD_771,13774,Kidbee Baby Soft Cotton Track Pants Lowers Pajama for Kids Infants & Toddler - Lowers/Joggers for Boys and Girls,Warehouse A,118,99,2025-02-28 13:14:00,19
771,ORD_772,12478,FLITE Mens Fl-2002 Clog,Warehouse C,341,323,2025-02-28 18:23:00,18
772,ORD_773,14978,"OYO BABY Baby Diaper Pants XL Size (Extra Large), with Aloe Vera Lotion for rash protection, Pack of 36 Count, with upto 1...",Warehouse C,187,172,2025-02-28 21:56:00,15
773,ORD_774,14976,"Chicco Liquid Cleanser Bottle Wash for Cleaning Baby Bottles, 100% Food Grade & Natural Ingredients, kills 99.99% Germs, A...",Warehouse C,401,382,2025-02-28 16:14:00,19
774,ORD_775,9355,BONDWET U Shape Toothbrush Kids Cleaning Brush Smile Rubber Cups Soft Silicone Brush Head for Kids Children Whole Mouth Te...,Warehouse B,386,347,2025-02-28 10:23:00,39
775,ORD_776,20342,Mi Arcus Baby Unisex Cotton Ultrasoft Hooded Towel - Arcus,Warehouse C,64,18,2025-02-28 12:41:00,46
776,ORD_777,20321,"LuvLap Instadry Extra Absorbent Quick Dry Sheet for baby, Baby Bed Protector, Waterproof baby sheet, 0m+ - Extra Large, 14...",Warehouse A,154,115,2025-02-28 01:04:00,39
777,ORD_778,9352,"Lavitra fashion headbands sunflower soft nylon hairbands for baby girls , Kids infants Toddlers - Pack of one (Red)",Warehouse A,124,117,2025-02-28 23:46:00,7
778,ORD_779,20290,"Luv Lap Baby Laundry Liquid Detergent, Food Grade, Refill Pack 1000ml",Warehouse B,491,479,2025-02-28 23:57:00,12
779,ORD_780,20229,MOMISY 5 Pairs Baby Girl Boys Tube Socks Toddlers Infant Solid Color Ankle Socks Stretch Baby Socks,Warehouse B,373,325,2025-02-28 14:10:00,48
780,ORD_781,9415,"Healofy Naturals Moisturizing Nourishing Baby Face & Body Lotion, 200 ml | With Unique Blend of Natural Ingredients | Gent...",Warehouse C,30,13,2025-02-28 14:37:00,17
781,ORD_782,9404,"LuvLap Tongue Scraper, Special Food grade TPE rubber material, tender for children, Solid Translucent colour, 18M+, Assort...",Warehouse B,403,391,2025-02-28 02:26:00,12
782,ORD_783,20249,THE PEPPY TEND No Hair Don't Care Ganju Baby Unisex Onesie-Romper Half Sleeves Regular Fit,Warehouse B,187,169,2025-02-28 13:35:00,18
783,ORD_784,20253,Gini & Jony BOYS Blue DUNGREE,Warehouse C,38,18,2025-02-28 12:59:00,20
784,ORD_785,20288,Hopscotch Girls Cotton Floral Print Casual Dress in Yellow Color,Warehouse C,180,156,2025-02-28 05:52:00,24
785,ORD_786,20267,Webby Plastic Building Blocks Construction (Multicolour) - Set of 500 Pieces,Warehouse B,418,383,2025-02-28 04:56:00,35
786,ORD_787,9393,"Baby Flower Extra Soft Cotton Hosiery Bio Assorted Prints Wash Reusable Face N-ew Born Towels (White, 25 x 25 cm) Pack of 6",Warehouse C,67,58,2025-02-28 08:17:00,9
787,ORD_788,9388,Mothercare Baby-Boy's Regular Polo Shirt,Warehouse B,206,162,2025-02-28 18:20:00,44
788,ORD_789,9386,"Kids Comfort Colourful Winter Woollen Monkey Cap Pack of 2 (Red,Pink, 1-2 Years)",Warehouse A,434,405,2025-02-28 03:18:00,29
789,ORD_790,9381,Maglu Underwear Baby Boys & Baby Girls Unisex Cotton Inner Wear Bloomer Combo Pack of 6,Warehouse C,172,141,2025-02-28 16:15:00,31
790,ORD_791,20258,"Softsens Baby Powder |Enriched with Patchouli, Clove leaf & Olive|Paraben free 200g",Warehouse C,391,384,2025-02-28 19:35:00,7
791,ORD_792,20334,KM Jewels 925 Sterling Silver Evil Eye Black Bead Crystal Nazariya Bangle/Bracelet For Kids,Warehouse B,249,222,2025-02-28 02:50:00,27
792,ORD_793,9169,FLAX Kids Boy's & Girl's Bermuda Regular Printed Cotton Shorts (Pack of 10)(Multicolor),Warehouse C,442,420,2025-02-28 04:30:00,22
793,ORD_794,9168,1st Step Matte Collection BPA Free Polypropylene Hard Spout Sipper with Twin Handles for Easy Grip - Pink,Warehouse A,65,42,2025-02-28 06:21:00,23
794,ORD_795,9166,KNITROOT Unisex Baby Bodysuit For toddler White Color Mom Turned Upside Down Spells Wow,Warehouse B,62,39,2025-02-28 18:33:00,23
795,ORD_796,20471,"Mee Mee Fresh Feel Baby Powder, 500g & Fluoride-Free Toothpaste, Strawberry, 70g (Pack of 2) Combo",Warehouse A,314,308,2025-02-28 02:34:00,6
796,ORD_797,20464,"Neska Moda 6 To 12 Months Baby Boys & Baby Girls Pack Of 2 Pair Cotton Butterfly Booties (Maroon,Baby Pink) -BT17andBT4",Warehouse C,152,119,2025-02-28 11:19:00,33
797,ORD_798,20306,Mamaearth Gentle Cleansing Shampoo for Babies (200 ml) & Mamaearth Dusting Powder with Organic Oatmeal & Arrowroot Powder ...,Warehouse B,505,482,2025-02-28 00:04:00,23
798,ORD_799,20312,"LuvLap Baby Grooming Combo, 2 pcs Set (White,Grooming Kit & Comb/Brush Set)",Warehouse A,68,31,2025-02-28 19:18:00,37
799,ORD_800,9364,Chicco Baby Moments Soap 75 Grams Pack OF 4 + 1 Free,Warehouse B,128,121,2025-02-28 15:44:00,7
800,ORD_801,20319,Sathiyas 100% Soft Cotton Baby Hooded Towels - Pack of 2,Warehouse B,463,424,2025-02-28 04:31:00,39
801,ORD_802,20296,"Bubos Baby Nail File Electric Manicure Set - Safe Baby Nail Clippers & Trimmer with LED Light, Toes.",Warehouse A,118,97,2025-02-28 20:37:00,21
802,ORD_803,20320,Wowper Fresh Baby Diaper Pants | Medium Size Diapers | Diapers with Wetness Indicator | Upto 10 Hrs Absorption | 7-12 Kg |...,Warehouse B,492,459,2025-02-28 12:22:00,33
803,ORD_804,20324,"Neska Moda 12 To 18 Months Baby Boys & Baby Girls Pack Of 2 Pair Cotton Rabbit & Butterfly Booties (Maroon,Yellow) -BT1143...",Warehouse B,265,249,2025-02-28 01:51:00,16
804,ORD_805,9345,"Himalaya Baby Gift Pack Series,Pack of 1 Set,White & Himalaya Herbals Cocoa Butter Intensive Body Lotion, 400ml",Warehouse C,83,73,2025-02-28 16:28:00,10
805,ORD_806,20646,"GION Kids Boys/Girls Shoe Running, Walking, All Day Casual Wear Anti-Skid Rubber Sole Sock Shoes Cute Boots First Walkers/...",Warehouse A,442,404,2025-02-28 04:20:00,38
806,ORD_807,9330,Mee Mee Mild Baby Shampoo with Fruit Extracts-500ml (Pack of 2),Warehouse A,444,412,2025-02-28 07:19:00,32
807,ORD_808,20392,"Neska Moda 12 To 18 Months Baby Girls Pack Of 3 Pair Cotton Butterfly Frill Booties (Black,Maroon,Yellow) -BT1168andBT1169...",Warehouse A,500,477,2025-02-28 09:10:00,23
808,ORD_809,9329,"Mamypoko Extra Absorb Pants for Babies, Pack of 1, Size : XXL : 51 count (36+15)",Warehouse C,259,219,2025-02-28 22:29:00,40
809,ORD_810,20394,Hopscotch Unisex Cotton All-Over Print Full-Sleeve Romper in Navy Color,Warehouse C,124,108,2025-02-28 00:04:00,16
810,ORD_811,9321,Jimmy Jammy Baby Boy Dress Clothing Set Soft Hosiery Cotton T-Shirt and Shorts Set Pack of 8 (4 T-Shirt + 4 Shorts) Multi ...,Warehouse C,20,10,2025-02-28 08:07:00,10
811,ORD_812,20405,CUTE LANDINGS New Born Baby Soft Pure White Cotton Jhabla/Shirt/Tops (0-3 Months (with Sleeves)),Warehouse A,497,454,2025-02-28 09:38:00,43
812,ORD_813,20741,Sahiba Gems 925 Sterling Silver Nazariya Hand Bracelet With Black And Gold Color Beads For Babies ~ Fit Upto 2.50 Years Ba...,Warehouse A,235,199,2025-02-28 09:41:00,36
813,ORD_814,20745,"vaghbhatt Multi-Colour Nylon Lace Head Band For Girls, Hairbands, Ribbon Boutique, Elastic Bow Bowknot for Kids Girls Infa...",Warehouse A,467,459,2025-02-28 14:19:00,8
814,ORD_815,21070,"The White Willow Baby Crib Half Wedge Pillow Used Under Mattress For Acid reflux, Colic , Anti Vomiting Special High Incli...",Warehouse C,150,143,2025-02-28 10:51:00,7
815,ORD_816,21075,Appu Kids Baby Hosiery Soft Cotton Newborn Napkin Wash Cloth Face Towels (Multicolor) - Pack of 8 Pcs,Warehouse C,73,53,2025-02-28 22:00:00,20
816,ORD_817,21079,"Grapify Baby Cap,Mittens and Booty Set of 3",Warehouse B,346,312,2025-02-28 22:45:00,34
817,ORD_818,21080,"Baybee Baby Nail Clipper with Magnifier Zoom Lens, Safety Nail Cutter for New Born Babies Infant Toddler, Manicure Pedicur...",Warehouse C,30,18,2025-02-28 19:44:00,12
818,ORD_819,21082,"Chicco Baby Moments Caring Gift Pack Blue, Ideal Baby Gift Sets for Baby Shower, Newborn Gifting, New Parents, Birthdays, ...",Warehouse A,311,288,2025-02-28 07:10:00,23
819,ORD_820,21086,The Root and Craft Kids Birthday Photoshoot Dress Red(12 Month),Warehouse A,194,182,2025-02-28 01:40:00,12
820,ORD_821,21091,"MY NEWBORN Polyester Towel (1 Piece, Yellow)",Warehouse A,523,499,2025-02-28 01:45:00,24
821,ORD_822,21094,"Neska Moda 12 To 18 Months Baby Boys & Baby Girls Cotton Rabbit Booties (Baby Pink,Yellow) -BT1148andBT1174",Warehouse A,401,378,2025-02-28 06:55:00,23
822,ORD_823,20382,Krystle Baby Knit Hat Scarf Set Toddler Girls Boys Winter Pom Pom Beanie Cap with Neck Warmer (Yellow)-(0-3 Years),Warehouse C,210,185,2025-02-28 12:17:00,25
823,ORD_824,20377,AV2 Women's Cotton Starred Knee Length Maternity Nightdress,Warehouse A,263,248,2025-02-28 22:34:00,15
824,ORD_825,9315,Baby Finger Toothbrush for Training Teething - Infant & Toddler & Kids Tooth Brush Soft Babies Toothbrushes Oral Cleaning ...,Warehouse C,170,133,2025-02-28 16:17:00,37
825,ORD_826,20420,"PATPAT® Baby Bath Toys, Whale Spray Toy Whale Induction Spray Water Toys for Kids Sprinkler Toy with LED Light Up Toy Bath...",Warehouse A,447,434,2025-02-28 19:31:00,13
826,ORD_827,20423,Saumabhi Autumn and Winter Terry Cute Tube Toddler Shoes for Children,Warehouse B,135,110,2025-02-28 07:51:00,25
827,ORD_828,20424,Hopscotch Unisex Cotton Stripe Print Full-Sleeve Romper in Navy Color,Warehouse C,514,479,2025-02-28 19:42:00,35
828,ORD_829,9314,MINI KLUB baby-boys Clothing Set,Warehouse B,493,450,2025-02-28 22:06:00,43
829,ORD_830,9313,"Nestlé Nan EXCELLAPRO 2 Follow-Up Formula Powder - After 6 months, Up to 12 months, Stage 2, 400g Bag-In-Box Pack",Warehouse A,413,388,2025-02-28 06:16:00,25
830,ORD_831,9309,BUTUNU Baby Girls Kids Infant Cotton Dungaree Set with Round Neck Half Sleeves T-Shirt Top Pack of 2,Warehouse A,60,30,2025-02-28 23:42:00,30
831,ORD_832,20439,Adore Pop Kid's Toothbrush With Cover (Bee Orange),Warehouse B,270,222,2025-02-28 09:11:00,48
832,ORD_833,20440,OANGO 5 Ft Large Bath Pool Tubs for Adults | Outdoor & Indoor Large Bath Tub for Kids / Bathing Tub-Portable,Warehouse B,476,438,2025-02-28 21:39:00,38
833,ORD_834,9306,"Cotton Cloth Premium Baby Washable, Reusable, Absorbent, Extra Soft Face Towels/Washcloth Muslin Cotton Cloth for Sensitiv...",Warehouse A,121,99,2025-02-28 07:20:00,22
834,ORD_835,20447,EVILLIVE U Shaped Kids Toothbrush for Kids 3-5 Years Children U Shape Toothbrush Baby Brush Teeth Cleaner Silicone Tooth B...,Warehouse B,519,495,2025-02-28 23:17:00,24
835,ORD_836,9302,Himalaya Refreshing Baby Soap 125g Pack of 10,Warehouse C,100,76,2025-02-28 20:39:00,24
836,ORD_837,20366,"VGRASSP Kid's ABS Material Musical Army Style Toy Gun with Music, Lights and Laser Light (25 Inch)",Warehouse B,325,302,2025-02-28 15:21:00,23
837,ORD_838,9340,Amazon Brand - Jam & Honey Baby Boys Romper Suit,Warehouse B,349,316,2025-02-28 01:38:00,33
838,ORD_839,20369,"POLKA TOTS Two-Wheeler/Motorcycle Child Harness Safety Seat Belt with Adjustable Baby Carrier for Toddler Baby Kids (Cat, ...",Warehouse C,180,155,2025-02-28 11:01:00,25
839,ORD_840,20642,JACK N JILL Quick Drying High Absorbent Cartoon Animal Printed Baby & Kids Super-Soft Muslin Square Cotton Bath Towel Wash...,Warehouse A,209,163,2025-02-28 17:56:00,46
840,ORD_841,21103,"Neska Moda 6 To 12 Months Baby Boys & Girls Lion Face Velvet Sandal Booties (White,Red) -BT857",Warehouse B,219,196,2025-02-28 12:18:00,23
841,ORD_842,21949,KNITROOT Monthly Birthday Special Unisex Baby Romper Half Sleeve White Color eleventh months,Warehouse C,410,392,2025-02-28 20:42:00,18
842,ORD_843,21956,Happy365 Mosquito Net Single Bed - Cream -3x6.5 Feet-Polyster Net with Pure Cotton Border on Top and Bottom,Warehouse A,463,447,2025-02-28 02:41:00,16
843,ORD_844,8447,LMN CHILD CARE Unisex 0-6 Months Baby Boy/Girl Multi-Color (Assorted) Socks/Booties (Set of 2),Warehouse B,224,182,2025-02-28 13:27:00,42
844,ORD_845,8444,"Manan Shopee 360 Degrees Rotation Cleaner Long Straw Brush Straw Cleaning Brush Straw Sipper Cleeaning Brush for Babies, M...",Warehouse B,432,385,2025-02-28 14:02:00,47
845,ORD_846,8443,Mamaearth Daily Moisturizing Natural Baby Lotion (400 ml) & Brave Blueberry Body Wash For Kids with Blueberry Oat Protein ...,Warehouse A,130,121,2025-02-28 20:14:00,9
846,ORD_847,21789,Pokory H-141 Baby Hat Regular Usage Line Printed Soft Cotton Fancy Fashion Summer (1 Year to 4 Years) for Boy and Girl Kid...,Warehouse C,297,287,2025-02-28 14:27:00,10
847,ORD_848,17945,HAP Girls' Cotton Bloomers (Pack of 5),Warehouse B,363,317,2025-02-28 05:12:00,46
848,ORD_849,21280,NewMom Women Lycra Non Padded Non-Wired Maternity Bra,Warehouse B,502,493,2025-02-28 15:02:00,9
849,ORD_850,9235,Fllik Set of 4 Soft Mitten Gloves Winter Warm Baby Gloves for Baby Boys and Baby Girls 6-12 Months Baby Gloves M2,Warehouse B,253,211,2025-02-28 22:12:00,42
850,ORD_851,20571,HOPOP Medicine Dropper & Dispenser (Pink),Warehouse A,266,239,2025-02-28 11:33:00,27
851,ORD_852,20580,"DIAZ Unisex 100% Soft Cotton in Attractive Color Baby Pajama, Baby Pajamas, Baby Leggings, Baby Track Pants, Baby Sleepwea...",Warehouse C,42,15,2025-02-28 14:55:00,27
852,ORD_853,9244,Himalaya Baby Massage Oil 200 ml x Pack of 4,Warehouse A,348,340,2025-02-28 20:36:00,8
853,ORD_854,20585,Zero Baby Cotton T-Shirt Short Pant Set | Unisex Printed Clothing Pair | Multi - Color | Size New Born Baby - 3 Months | (...,Warehouse A,133,89,2025-02-28 15:13:00,44
854,ORD_855,21947,"Finches Pack Of 1 Infant Newborn, First Walking Shoe Unisex-Baby's Boy Girl Fashion Non Skid Comfortable All Seasons Soft ...",Warehouse A,82,68,2025-02-28 21:37:00,14
855,ORD_856,20592,"OSG Presents black nazariya chand suraj chakku and haay for baby girl baby boy, Silver Chand Suraj Chaku Haay Fine Finish ...",Warehouse C,188,165,2025-02-28 00:17:00,23
856,ORD_857,8455,CUSTOMARY 5 Layers Bamboo Charcoal Baby Diaper Insert Pad Reusable And Washable For Cloths Diaper Set (Pack of 8),Warehouse C,415,380,2025-02-28 12:19:00,35
857,ORD_858,8424,Kidbee Baby Kid's Cotton Pajama Track Pant with Rib Multicolor Print (Pack of 4 Pcs),Warehouse B,287,258,2025-02-28 01:03:00,29
858,ORD_859,8430,Nino Bambino 100% Organic Cotton Full Sleeve Round Neck Set of 3 T-Shirt for Baby Boy,Warehouse C,372,349,2025-02-28 05:43:00,23
859,ORD_860,22007,"MOM CARE Terry Face Towels for Newborn Baby ,wash Cloth for Babies, Extra Soft hankies, Reusable Napkins Embossed Terry Hi...",Warehouse B,203,170,2025-02-28 14:53:00,33
860,ORD_861,8417,DADDY - G® 100% Cotton Rompers/Sleepsuits/Jumpsuit/Night Suits for New-Born Baby Boys & Girls Pack of 3,Warehouse C,275,249,2025-02-28 21:38:00,26
861,ORD_862,22044,KRAAFTAR Handmade Newborn Baby Headband Baby Shower Photo Prop Hairband Dark Pink,Warehouse A,74,48,2025-02-28 01:15:00,26
862,ORD_863,22011,OYO BABY Baby Daily Moisturising Cream for Delicate Skin 50ml,Warehouse C,405,394,2025-02-28 18:47:00,11
863,ORD_864,21977,"Himalaya Baby Care Refreshing Baby Wash, 200ml ….Search for Ramiya",Warehouse B,116,75,2025-02-28 03:17:00,41
864,ORD_865,21975,"Basics21 Unisex-Baby's Bootie (3-12 months, Toe to heel length -12 cm)",Warehouse B,458,436,2025-02-28 15:16:00,22
865,ORD_866,8469,"Luv Lap Essential Slim Neck Glass Feeding Bottle, 125ml, 3m+/Babies Upto 3 Years, Made of Borosilicate Glass, BPA Free, Er...",Warehouse C,432,408,2025-02-28 15:11:00,24
866,ORD_867,21932,Johnson's Baby Oil (Triple Baby Protection) 500 ml with Ayur Product in Combo,Warehouse C,339,323,2025-02-28 18:21:00,16
867,ORD_868,8462,Knotty Ribbons Baby Girls Flower & Bow Headband Set,Warehouse B,422,392,2025-02-28 18:06:00,30
868,ORD_869,8460,Baby Boys and Girls Cotton Brief Panty Padded Underwear-Pack of 2 for Babies/Toddlers/Kids,Warehouse B,139,103,2025-02-28 13:51:00,36
869,ORD_870,21940,StickMe 'Kamdhenu Cow and Calf - Holy Cow - Hindu Religion - Sacred - God - Creative - Colorful Wall Sticker' -SM784 (Mult...,Warehouse C,411,384,2025-02-28 23:56:00,27
870,ORD_871,9217,VIVIN New Born Cotton Blended Regular Shorts (Multicolor) Assorted Pack of 12,Warehouse C,376,357,2025-02-28 01:56:00,19
871,ORD_872,20618,"GRNSHTS Baby Boy Funny First Birthday Clothes Infant Boy Bow Tie Romper Bodysuit Cake Smash Outfits (A Gray, 12-18 Months)",Warehouse B,435,411,2025-02-28 01:26:00,24
872,ORD_873,20693,"CalMyotis Corner Protector, Baby Proofing Table Corner Guards, Keep Child Safe, Protectors for Furniture Against Sharp Cor...",Warehouse A,58,26,2025-02-28 04:07:00,32
873,ORD_874,20694,"Baby Girl Hair Clips,Bows for Girls Doted Print Clip Assorted Hair Accessories for Girls Toddler Kids Teen",Warehouse C,149,102,2025-02-28 23:15:00,47
874,ORD_875,20695,SYGA 3 Layer Cute Bear Portable Baby Food Milk Powder Storage Box Bottle Container (Green),Warehouse C,59,17,2025-02-28 09:01:00,42
875,ORD_876,20696,Merqwadd 4-Pack Baby Girls Knee High Socks Infants Toddlers Bow Knit Socks Cotton Tube Ruffled Stockings,Warehouse C,82,54,2025-02-28 00:18:00,28
876,ORD_877,9149,"Brim Hugs and Cuddles Brim Hugs and Cuddles Premium High Cushion Baby Bedding Set Cum Sleeping Bag, Bed for New Born Baby",Warehouse C,91,68,2025-02-28 12:35:00,23
877,ORD_878,9157,"Baby Cry Baby Multi-Color Long Sleeve Cotton Sleep Suit Romper for Boys and Girls Set of 3 (Black, 3-6 Months)",Warehouse C,109,75,2025-02-28 11:58:00,34
878,ORD_879,9137,Baby Bucket Eco-Friendly Plastic Rounded Lobes Soft Bristle Baby Soft Hair Comb Set - Pack of 4 (Multicolor),Warehouse B,303,289,2025-02-28 12:37:00,14
879,ORD_880,20720,"Neska Moda 6 To 12 Months Baby Girls Cotton Butterfly Booties (Maroon,Baby Pink) -SK175andBT79",Warehouse B,101,69,2025-02-28 13:55:00,32
880,ORD_881,20732,"SNOWIE SOFT® 300 Grams Baby Formula Dispenser, Portable Milk Powder Dispenser Container with Carrying Handle and Scoop, Fo...",Warehouse A,448,417,2025-02-28 15:48:00,31
881,ORD_882,20716,Sebamed Extra Soft Baby Wash (50ml) & Baby Cleansing Bar - 100 g Combo,Warehouse C,360,321,2025-02-28 06:03:00,39
882,ORD_883,20616,Jordan Flare Toddlers,Warehouse C,242,221,2025-02-28 16:57:00,21
883,ORD_884,20626,WorldCare® 3mm Neoprene Diving Scuba Surfing Swimming Socks Snorkeling Boots XL(45-47) (66000588JEL),Warehouse A,242,229,2025-02-28 00:51:00,13
884,ORD_885,9195,Cherry Crumble California Baby Girls' A-Line Knee-Long Dress,Warehouse B,197,154,2025-02-28 04:01:00,43
885,ORD_886,20635,El Regalo 1 Pair Winter Socks for Girls Kids- Cute Plush Soft Warm Winter Flower Socks for Kids Girls Toddler (from 2 to 9...,Warehouse A,187,182,2025-02-28 20:40:00,5
886,ORD_887,9216,Boys Communion Armband White Satin with Embroidered Religious Cross (Boys),Warehouse C,403,358,2025-02-28 02:26:00,45
887,ORD_888,20603,Zumrut Gold Plated Traditional Kids Bangle Bracelet with Gold Ghungroo Nazariya for Unisex Babies New Born Baby Child Kids...,Warehouse C,314,289,2025-02-28 14:05:00,25
888,ORD_889,20605,"Neska Moda 12 To 18 Months Baby Girls Cotton Butterfly Frill Booties (Maroon,Yellow) -BT1157andBT1169",Warehouse B,402,397,2025-02-28 10:50:00,5
889,ORD_890,9223,Trends Collection Baby Medicine Dropper 5ml - Pink,Warehouse B,317,268,2025-02-28 03:17:00,49
890,ORD_891,20606,CLOTH KING Presents Kids Unisex Cotton Bloomer Baby Underwear Kids Panty Baby Innerwear Kids Bloomer with Inner Elastic (P...,Warehouse B,54,12,2025-02-28 07:44:00,42
891,ORD_892,20549,SYGA 5 Pairs Baby Girl Boys Non Slip Trainer Socks Toddlers Infant Socks Warm and Socks Cotton Stretch Crew Anti-Slip Baby...,Warehouse A,399,367,2025-02-28 22:19:00,32
892,ORD_893,20485,MA Baby Boys and Baby Girls Printed Cotton Baby Bodysuits Onesie one Piece Romper t Shirt for New Born Infant Toddlers Bab...,Warehouse A,62,15,2025-02-28 06:51:00,47
893,ORD_894,20491,"Neska Moda 12 To 18 Months Baby Boys & Baby Girls Pack Of 2 Pair Cotton Butterfly Frill Booties (Yellow,Orange) -BT1173and...",Warehouse A,115,102,2025-02-28 15:38:00,13
894,ORD_895,20514,LBV 925 Sterling Silver Semi Precious Emerald Birth Stone With Traditional black Thread Nazariya Bracelet For Boys and Gir...,Warehouse C,166,139,2025-02-28 06:32:00,27
895,ORD_896,9268,Max Girls Printed Round Neck A-Line Dress,Warehouse B,499,491,2025-02-28 22:44:00,8
896,ORD_897,20519,"Little Peaches Unisex Baby Burp Cloths Double Layered Organic Cotton - (Pack of 4, Heather Grey)",Warehouse A,369,321,2025-02-28 14:36:00,48
897,ORD_898,9267,"Pampers All round Protection Pants, Small size baby diapers (4-8kg) 56 Count, Anti Rash diapers, Lotion with Aloe Vera",Warehouse B,487,446,2025-02-28 06:15:00,41
898,ORD_899,9260,"Neska Moda 12 To 18 Months Baby Girls Cotton Butterfly Booties (Rani,Blue) -BT1151andBT1164",Warehouse A,356,343,2025-02-28 12:15:00,13
899,ORD_900,9258,Chicco No Tears Shampoo 500ml Combo Pack of 2 Baby Shampoo,Warehouse B,387,355,2025-02-28 03:39:00,32
900,ORD_901,9257,"CUSTOMARY Baby Boy's and Baby Girl's Sweater, Pyjama and Booties (0-6 Months) (6-12 Month, Black-White)",Warehouse B,452,413,2025-02-28 01:01:00,39
901,ORD_902,9254,"Mamaearth Rose Body Lotion with Rose Water and Milk For Deep Hydration - (400ml, All Skin Types)",Warehouse B,177,156,2025-02-28 17:21:00,21
902,ORD_903,9251,Hopscotch Unisex Cloth Checkered Boots in Multi Color,Warehouse A,497,487,2025-02-28 07:16:00,10
903,ORD_904,9266,GURU KRIPA BABY PRODUCTS Baby Pure Cotton Printed Innerwear Baniyan Infants Sando Unisex Undershirts for Baby Sleeveless R...,Warehouse A,421,393,2025-02-28 06:51:00,28
904,ORD_905,8940,Safety 1st Sleepy Baby Nail Clipper,Warehouse C,107,86,2025-02-28 16:08:00,21
905,ORD_906,21111,"Johnson's Baby Cream Combo (Baby Milk & Rice,Baby Cream,Cottontouch Baby Cream) 50g Each",Warehouse A,150,120,2025-02-28 22:47:00,30
906,ORD_907,12453,Koochie-Koo 6-Layered Cute Cartoon Duck Designed Light Weight Soft Cozy Muslin Blanket for All Seasons Reversible Baby Bla...,Warehouse B,25,19,2025-02-28 22:05:00,6
907,ORD_908,9063,"Lulamom Reusable Muslin Square Napkins, Pack of 6, Multicolor",Warehouse A,73,63,2025-02-28 00:27:00,10
908,ORD_909,9055,BUTUNU Polka Dot Printed Baby Kids Girls Infant Cotton Front Open Full Long Sleeves Short Frock Dress Combo Set Pack of 2,Warehouse A,428,403,2025-02-28 04:09:00,25
909,ORD_910,20875,Baybee Baby Nail Clipper with Magnifier Safety Nail Cutter Toddler Infant Scissor Manicure Pedicure Care Pack of 1 (Pack o...,Warehouse C,203,190,2025-02-28 23:34:00,13
910,ORD_911,9040,"Sunbaby Baby Bath Support seat for New born babies for bathing, Inclined baby bather cum bath sling (LITTLE PIRATES)",Warehouse C,146,101,2025-02-28 06:37:00,45
911,ORD_912,9034,"Ikea TSSP Cover for Baby Care mat, White 48x74 cm ,(18 7/8x29 1/8 "")",Warehouse C,326,280,2025-02-28 17:08:00,46
912,ORD_913,20888,Disney Boys Mickey Kids Boys Blue Lycra Shoes by Toothless Walking Shoes,Warehouse B,240,208,2025-02-28 04:28:00,32
913,ORD_914,9032,"Kidbee Babies and Kids Soft Cotton Hosiery Solid Color Baby Boys & Baby Girls Wear Regular Shorts (Multicolor (Pack of 5),...",Warehouse C,502,456,2025-02-28 08:06:00,46
914,ORD_915,20901,Store 2508 Combo Pack of Child Safety Strip Cushion and Corner Guards (Brown),Warehouse C,445,438,2025-02-28 22:30:00,7
915,ORD_916,17942,GOCART WITH G LOGO Baby Nail Clipper with Magnifier,Warehouse B,65,27,2025-02-28 02:48:00,38
916,ORD_917,10740,Desitin Diaper Rash Cream 136g (Blue),Warehouse C,363,323,2025-02-28 17:33:00,40
917,ORD_918,12517,"Safe-O-Kid- Pure Metal Baby Safety Gate (75-85 cm) +4 Electric Socket Covers +4 Sharp Corner Guards, Adjustable, 2 Way Aut...",Warehouse B,334,325,2025-02-28 06:16:00,9
918,ORD_919,20855,"Softsens Baby Nourishing Bar Soap with Colloidal Oatmeal, Shea Butter & Vitamin E, 3 Soap x 100g",Warehouse A,161,129,2025-02-28 07:57:00,32
919,ORD_920,9064,"Mamaearth 100 Percent Natural Berry Blast Kids Toothpaste, 50g & dusting Powder with Organic Oatmeal & Arrowroot Powder 15...",Warehouse A,441,414,2025-02-28 17:23:00,27
920,ORD_921,20920,"SOFTSWISS Baby Bath Sponge, In Fruits Design, UlraSoft, Specially for New Born Babies and Children (STRAWBERRY_2)",Warehouse B,337,313,2025-02-28 20:53:00,24
921,ORD_922,20925,Hopscotch Baby Girls Poly Cotton Sleeveless All Over Printed Casual Dresses in Red Colour,Warehouse C,509,496,2025-02-28 14:27:00,13
922,ORD_923,20944,"Tinchuk Regular Unisex Printed Shorts, Regular Shorts for Girls and Boy's, (Set of 6, Multi-Coloured)",Warehouse A,465,449,2025-02-28 18:24:00,16
923,ORD_924,9013,"Himalaya Baby Powder, 700g & Himalaya Diaper Rash Cream,100gm",Warehouse C,269,233,2025-02-28 15:43:00,36
924,ORD_925,9022,"OYO BABY Talc Free Baby Powder for New Born Babies, Kids 100gm",Warehouse B,72,33,2025-02-28 03:04:00,39
925,ORD_926,9011,"Neska Moda 0 To 6 Months Baby Boys & Baby Girls Cotton Rabbit Booties (Red,Baby Pink) -BT381andBT372",Warehouse C,62,43,2025-02-28 18:41:00,19
926,ORD_927,9001,BriKSHi Baby's Anti Slip Cotton Socks Ankle Length Multicolor Baby Socks Kids Multi Color and Designs Random Colors Baby S...,Warehouse A,108,90,2025-02-28 20:09:00,18
927,ORD_928,9000,BABYVERSE Baby Care Kit/Baby Grooming Scissors& Nail Clipper Set for New Born/Healthcare kit/Set of 5 Different Products,Warehouse A,397,383,2025-02-28 17:41:00,14
928,ORD_929,8993,ELEG & STILANCE womens Spft Cotton Face Towels Hankies (Pack of 6),Warehouse B,121,105,2025-02-28 13:28:00,16
929,ORD_930,20971,NammaBaby Premium Baby Girls Short Sleeves Frock Dress - Set of 1,Warehouse A,208,189,2025-02-28 15:56:00,19
930,ORD_931,20914,PRSTI New Born Baby's Cotton Summer Cloth Set - 5 Pcs (0-3 Months),Warehouse B,157,109,2025-02-28 16:39:00,48
931,ORD_932,20913,Himalaya Gentle Baby Wash (400Ml)&Baby Cream (50Ml),Warehouse A,381,363,2025-02-28 19:50:00,18
932,ORD_933,20910,"Khamasi Hand Casting Kit | 3D Couple Casting Kit, casting kit for couples,molding powder for hand casting, Best gift for c...",Warehouse B,338,297,2025-02-28 02:56:00,41
933,ORD_934,14939,"Himalaya Baby Powder, Pack of 700g and Shampoo (400 ml) Combo",Warehouse A,127,93,2025-02-28 03:26:00,34
934,ORD_935,14942,Zuvim Baby Girl’s Fit & Flare Knee Length Strip Print Satin Dress,Warehouse C,216,208,2025-02-28 11:23:00,8
935,ORD_936,14867,Amazon Brand - Jam & Honey baby-boys Overalls,Warehouse A,521,493,2025-02-28 05:55:00,28
936,ORD_937,12561,Whitewhale Men's Loose Fit Yoga Pant,Warehouse B,466,461,2025-02-28 09:14:00,5
937,ORD_938,15053,Chicco Body Lotion Offer Pack (200 ml),Warehouse A,208,197,2025-02-28 06:55:00,11
938,ORD_939,12440,Gini & Jony Baby Boy's T-Shirt,Warehouse A,164,138,2025-02-28 03:45:00,26
939,ORD_940,15067,"PDSPM Learning Cushion Pillow Book for Kids with 2 Languages ​​to Learn - English and Hindi, Soft Fabric Cloth Books, Deve...",Warehouse A,450,421,2025-02-28 08:26:00,29
940,ORD_941,12439,Mirada Dark Brown Cute Plush Stuffed Monkey with Glitter Eye Soft Toy - 25 cm,Warehouse B,263,256,2025-02-28 03:40:00,7
941,ORD_942,12447,"Little's Soft Cleansing Baby Wipes (Pack of 8, 80 Wipes)",Warehouse A,434,393,2025-02-28 02:57:00,41
942,ORD_943,12428,Supples Baby Diaper Pants L Pack of 3 Super Jumbo Box (2.5 kg - 12.0 kg) (186 Count),Warehouse A,477,470,2025-02-28 18:44:00,7
943,ORD_944,15089,"Himalaya Refreshing Baby Soap, 75g, Multicolor",Warehouse C,484,463,2025-02-28 05:44:00,21
944,ORD_945,12420,Hopscotch Boys and Girls Fabric Graphic Print Slip Ons in Purple Color,Warehouse A,400,394,2025-02-28 17:47:00,6
945,ORD_946,12417,"Sebamed Baby Powder, 200g & Clear Face Cleansing Bar, 100g",Warehouse B,285,255,2025-02-28 07:45:00,30
946,ORD_947,14884,Attache Baby Shower Foil Balloons Decoration items & Kit - 2 Pcs Baby Crawling Boy and Girl Foil Balloon For Baby Shower D...,Warehouse A,69,64,2025-02-28 17:29:00,5
947,ORD_948,14946,"SebaMed Baby Cleansing Bar (150g) & Baby Lotion, 400ml Combo",Warehouse B,396,359,2025-02-28 21:52:00,37
948,ORD_949,14960,"Neska Moda 6 To 12 Months Baby Boys & Baby Girls Pack Of 2 Pair Cotton Butterfly Frill Booties (Maroon,Blue) -BT82andSK137",Warehouse B,335,322,2025-02-28 08:43:00,13
949,ORD_950,12480,H2Y Winter Cap for boy furr Panda 1pc White,Warehouse C,286,262,2025-02-28 04:44:00,24
950,ORD_951,14890,Herbalife Formula 1 Nutritional Shake Mix Kulfi 500 g,Warehouse B,130,90,2025-02-28 03:30:00,40
951,ORD_952,12559,Nagar International Baby Breastfeeding Pillow (Sky) Adjustable With Back Support And Removable cover,Warehouse C,301,279,2025-02-28 19:53:00,22
952,ORD_953,14843,"PATPAT® Plush Animal Bunny Dancing Ears Hat, Rabbit Moving Ear Flaps and Press Paws for Girls Women Kids",Warehouse A,191,169,2025-02-28 12:02:00,22
953,ORD_954,14844,Teri Beri New Born Baby Dress Hosiery Cotton Jabla (0-3 Months) Pack of 4 (Combo 5),Warehouse C,276,244,2025-02-28 12:35:00,32
954,ORD_955,12545,"Neelam Boy's and Girl's of School Winter Woolen Cap (Green Colour, 5-10 Years) Pack of 1",Warehouse B,118,103,2025-02-28 15:21:00,15
955,ORD_956,14869,"DIVINE CHARM (Pack of 7) Fashionable Stylish Rings for Girls to wear Casually, for office, parties and Occasionally",Warehouse A,456,441,2025-02-28 07:49:00,15
956,ORD_957,14878,"Supples Baby Wet Wipes with lid Enriched with Aloe Vera, 72 Wipes/Pack (Pack of 4)",Warehouse A,319,309,2025-02-28 19:54:00,10
957,ORD_958,20849,"Luv Lap Tiny Giffy Kids Toothbrush, BPA Free, Toddler Manual Toothbrush for Boys & Girls, 18M+, Multicolour (Assorted Colo...",Warehouse A,498,467,2025-02-28 04:32:00,31
958,ORD_959,9096,Sunbaby Combo of Baby Anti-Skid Bathtub with Newborn Bather Sling Chair and Infant Potty Seat –Pack of 3 (Green),Warehouse A,201,163,2025-02-28 12:33:00,38
959,ORD_960,8930,VRITRAZ Printed Cap for Teen Girls and Boys 10-16 Years,Warehouse A,48,11,2025-02-28 15:24:00,37
960,ORD_961,21141,"Bembika Newborn Plain Knot Design Band for Baby Infant,Baby Girl Soft Cute Toddler Hairbands (Set Of 6)",Warehouse A,341,330,2025-02-28 06:16:00,11
961,ORD_962,21217,"KIDSKA Baby Boys & Girls Soft Bonnet Caps with Tai Knot Unisex Baby Cap Kids Cap, Multicolor, 3 to 6 Months, Pack of 3",Warehouse A,194,149,2025-02-28 10:54:00,45
962,ORD_963,21226,"Johnson's Baby Skincare Wipes with Lid, 72s Twin Pack (Buy 2 Get 1 Free) (432 Wet Wipes), White",Warehouse B,133,124,2025-02-28 02:42:00,9
963,ORD_964,21234,OYO BABY New Born Combo Baby Shampoo for Newborn Babies Badam Tel 100% Pure Sweet Almond oil 200ml each,Warehouse C,336,316,2025-02-28 02:01:00,20
964,ORD_965,8857,Hopop Newborn Baby's Safety Nail Scissors with Short Blade & Circular Cutter Head (HP-2006A-Pink),Warehouse C,193,160,2025-02-28 13:01:00,33
965,ORD_966,21239,"BeyBee Extra Absorbent Quick Dry Sheet for Baby, Baby Bed Protector, Waterproof Baby Sheet (Large - 140cm X 100cm, Dark Blue)",Warehouse A,92,58,2025-02-28 16:00:00,34
966,ORD_967,21246,BALUDA ENTERPRISE SEMI LYCRA CLOTHS FOR BABY BOYS,Warehouse A,515,482,2025-02-28 03:57:00,33
967,ORD_968,8844,"Salvus App SOLUTIONS Silver Kada for Kids(0-5 Years), Kids kada For Boy, Kids bracelets- Set of 2",Warehouse C,444,438,2025-02-28 15:09:00,6
968,ORD_969,21262,The ChipmunK Store’s Premium Combo for Baby and Adult - (Pink powder puff & Peach makeup puff),Warehouse A,155,137,2025-02-28 16:03:00,18
969,ORD_970,21269,A.T.U.N Girl's Cotton A-Line Mini Dress,Warehouse B,59,49,2025-02-28 03:27:00,10
970,ORD_971,21243,"LuvLap Instadry Extra Absorbent Quick Dry Sheet for Baby, Baby Bed Protector, Waterproof Baby Sheet - Royal Blue, 0m+ - La...",Warehouse C,28,17,2025-02-28 00:28:00,11
971,ORD_972,21211,BENKILS Empire Girls Dress Frock,Warehouse B,381,339,2025-02-28 21:43:00,42
972,ORD_973,21209,GOURAVSUMANA Baby Boy's & Baby Girl's Soft Woolen Winter Warm Kids Hand Gloves (Multicolor; Pack of 6) (2-3 Years),Warehouse A,178,130,2025-02-28 15:18:00,48
973,ORD_974,21144,"Pikipo Plush Soft Ball (Small Size, 11cm) and Kitty Face Soft Rattle Combo, Multicolor (Material: Polyester & Plush)",Warehouse A,330,295,2025-02-28 18:34:00,35
974,ORD_975,8904,SENZ Unisex Regular Fit Pyjama Pants,Warehouse C,487,479,2025-02-28 17:36:00,8
975,ORD_976,21136,MESH Planet Mosquito Net for Window with Fiber Glass Mesh 5/4feet(150/120cm) 60/48Inches 1 Year Guarantee Without Stitched...,Warehouse A,246,215,2025-02-28 09:05:00,31
976,ORD_977,8893,My Bub Casual Midi Frock | Printed Frock with Blue Shorts| Sleeveless Cotton Dress for Baby Girl | Kids Wear,Warehouse A,255,215,2025-02-28 00:03:00,40
977,ORD_978,8958,Tubination Cap Army Print Boy's Fishermen Bucket Cotton Camouflage Army Print Summer Outdoor Fishing Picnic Cap Hat,Warehouse A,245,200,2025-02-28 20:44:00,45
978,ORD_979,8925,NYRWANA DELIVERING SMILES IN INIDA 6 Fairies Angel Princess Action Figures Birthday Christmas Gift (3.93-inch) 6 Fairy Dolls,Warehouse C,65,42,2025-02-28 13:14:00,23
979,ORD_980,21116,Lillypupp New Born Baby Shoes for Boy Girl,Warehouse A,170,141,2025-02-28 22:27:00,29
980,ORD_981,8914,Himalaya Baby Lotion 700ml,Warehouse A,126,92,2025-02-28 07:43:00,34
981,ORD_982,20992,Tendercare Baby boy & Baby Girl Cotton Rabbit Dungaree Set with Tshirt || Baby boy Dresses for 0-6 Months || Newborn Baby ...,Warehouse B,244,230,2025-02-28 09:51:00,14
982,ORD_983,20995,Johnson's Baby Cream For Summer 200g (Pack of 2),Warehouse A,224,210,2025-02-28 10:53:00,14
983,ORD_984,8967,Bold N Elegant Jungle Animal Print Jurassic Joy Dinosaur 2 pc T-Shirt Pyjama Pajama PJ's Clothing Set for Infant Toddler B...,Warehouse A,257,245,2025-02-28 16:12:00,12
984,ORD_985,8966,Aya Papaya Ouchie Monster Print Mosquito Repellent Patches 100% Natural (Pack 2 = 48 Patches),Warehouse B,533,490,2025-02-28 07:58:00,43
985,ORD_986,21062,"Dr. Brown's Natural Baby Toothpaste Pear & Apple Flavour (Pack of 1, White)",Warehouse A,318,293,2025-02-28 02:37:00,25
986,ORD_987,21031,Anup Torda Chu Chu Duck Family Baby Bathing Toys Set,Warehouse B,99,51,2025-02-28 05:08:00,48
987,ORD_988,21040,"MPT.YOGI New-Born Baby Cotton Semi Colors Midi T-Shirt and Shorts and Pant Combo Set Pack of 3-D15 (0-3 Months, COLOR1)",Warehouse A,320,294,2025-02-28 03:36:00,26
988,ORD_989,8898,KC Creation Glam Elegance Boys Polycotton Blazer Style Printed Shirt and Pant Set with Bow,Warehouse B,79,45,2025-02-28 19:15:00,34
989,ORD_990,20835,EBMORE Kids Wool Socks for Boys Toddlers Girls Warm Winter Hiking Thick Cozy Thermal Boot Heavy Crew Socks 6 Pairs,Warehouse B,82,43,2025-02-28 01:46:00,39
990,ORD_991,20839,Puma Unisex Baby Jog Suit,Warehouse B,188,153,2025-02-28 18:55:00,35
991,ORD_992,20841,brown leaf non toxic soft toys kids new born baby 12 sounding baby bath toys best gift for new born baby-Multi color,Warehouse A,453,442,2025-02-28 11:22:00,11
992,ORD_993,9071,"Neska Moda 0 To 6 Months Baby Boys & Baby Girls Pack Of 2 Pair Cotton Rabbit & Butterfly Booties (Maroon,Baby Pink) -BT383...",Warehouse C,255,236,2025-02-28 20:54:00,19
993,ORD_994,9077,"FreshFoot Cute and Colourful New Born Baby socks Set 0-12 Months (Size 0-12 Months) (Pack of 8) (Light Sade),Multicoloured...",Warehouse C,310,262,2025-02-28 00:10:00,48
994,ORD_995,20789,"Himalaya Gentle Baby Bath (400ml) and Himalaya Gentle Wipes (72 Counts, Packs of 2) Combo",Warehouse A,425,419,2025-02-28 05:32:00,6
995,ORD_996,20747,Body & Soul Herbals' BABY BATH POWDER,Warehouse A,197,150,2025-02-28 09:20:00,47
996,ORD_997,20748,GION Rubber Outsole & Indoor and Outdoor Comfortable Unisex-Kids Bootie Soft Cotton Socks Shoes First Walkers Socks Shoes ...,Warehouse C,215,194,2025-02-28 05:16:00,21
997,ORD_998,20751,Sophie la girafe So Pure Teething Ring,Warehouse C,453,428,2025-02-28 02:49:00,25
998,ORD_999,9118,Farlin Feeding Bottle Cleaning Fluid (700ml),Warehouse A,489,444,2025-02-28 13:41:00,45
999,ORD_1000,9114,"Being Mama Multipurpose Liquid Cleanser,Anti Bacterial wash for Bottle, Utensils, Vegetables, Fruits Cleanser (500ml)",Warehouse A,164,146,2025-02-28 09:44:00,18
1000,ORD_1001,20767,"haakaa Silicone Baby Nasal Aspirator| Safe Baby Nose Cleaner| Easy-Squeeze Nose & Ear Bulb Syringe, 0m+ Newborn,Toddler -T...",Warehouse B,166,133,2025-02-28 02:18:00,33
1001,ORD_1002,20791,First Kick New Born Baby Gift Set Combo Pack for Baby Boys and Baby Girls Pack of 11 Pcs,Warehouse C,34,26,2025-02-28 16:33:00,8
1002,ORD_1003,20769,NCC Uniform Boot for Boys & Girls,Warehouse C,287,265,2025-02-28 06:14:00,22
1003,ORD_1004,20775,"Sebamed Baby Kit of 8pcs (Talc 400ml,Shampoo 150ml,Extra Soft Cream 200ml,Lotion 400ml,Body Wash 400ml,Diaper Rash Cream 1...",Warehouse A,222,186,2025-02-28 20:11:00,36
1004,ORD_1005,20776,"Superminis Baby Boys Rabbit Style Thick Base Booties/Shoes (3-6 Months, Purple)",Warehouse A,59,45,2025-02-28 13:41:00,14
1005,ORD_1006,9098,GoodFeel Cotton Cap for Baby Boys and Baby Girls [GFBCAP50][Pack of 6],Warehouse C,348,309,2025-02-28 22:48:00,39
1006,ORD_1007,20785,Hopscotch Baby Boys Cotton-Blend Graphic Print Shirt and Formal Set in Maroon Color,Warehouse B,67,44,2025-02-28 14:24:00,23
1007,ORD_1008,20833,Johnson's Baby Hair Oil 200ml (Pack of 2),Warehouse B,510,476,2025-02-28 04:20:00,34
1008,ORD_1009,9076,"Mamaganics Natural Tear-Free Baby Hair Shampoo, pH 5.5 for Baby's Sensitive Soft Skin with Avacado, Aloe Vera and Oatmeal,...",Warehouse B,218,176,2025-02-28 14:45:00,42
1009,ORD_1010,21170,"Neska Moda 6 To 12 Months Baby Boys & Baby Girls Pack Of 2 Pair Cotton Rabbit & Butterfly Booties (Maroon,Black) -BT85andS...",Warehouse A,333,307,2025-02-28 08:50:00,26
1010,ORD_1011,21186,Super Cute's Wonder Pullups Diaper Pants (XL) | Super Soft and Rash Free Diapers| Protection upto 12 hours with No Leakage...,Warehouse C,323,290,2025-02-28 09:00:00,33
1011,ORD_1012,8876,Baby Moo Animal Print Yellow Animal Hooded Towel,Warehouse A,419,390,2025-02-28 02:47:00,29
1012,ORD_1013,21194,"Toddylon New Born Baby Clothes & Bedding Combo Gift Pack (Multicolor, 0-6 Months)",Warehouse C,117,111,2025-02-28 09:23:00,6
1013,ORD_1014,21202,Usupso Kid's Crocs,Warehouse A,127,90,2025-02-28 12:09:00,37
1014,ORD_1015,8873,Mamaearth Face Pack Cream with Neem and Tea Tree For Pimples and Zits (100 ml),Warehouse C,397,356,2025-02-28 09:49:00,41
1015,ORD_1016,21176,Ibis Medical Muac Tape,Warehouse A,175,156,2025-02-28 09:24:00,19
1016,ORD_1017,20978,Trance Home Linen Waterproof - Quick Dry Ultrasoft Terry Baby Bibs,Warehouse B,359,310,2025-02-28 11:45:00,49
1017,ORD_1018,20973,"Johnson'S Baby No More Tears Baby Shampoo 200Ml And Johnson'S Baby Powder, 600G",Warehouse B,498,456,2025-02-28 08:35:00,42
1018,ORD_1019,9089,Sathiyas Baby Girl's A-Line Dresses,Warehouse B,154,136,2025-02-28 14:48:00,18
1019,ORD_1020,20804,INFANTSO Baby Rocker Portable With  Mosquito Net & U Shape Pillow with Calming Vibrations & Musical Toy MULTI,Warehouse B,475,470,2025-02-28 03:39:00,5
1020,ORD_1021,20815,"Hopscotch Baby Boys Cotton While Elasticized Ankle Booties With Gold Button in White Color, UK:5 (IVE-1785496)",Warehouse A,389,362,2025-02-28 19:49:00,27
1021,ORD_1022,20819,"Nat Habit Grain & Gram Baby Daily Ubtan, Baby Cleansing & Nutrition, 9mth - 2yr - 80 g (Pack of 1)",Warehouse B,226,220,2025-02-28 06:28:00,6
1022,ORD_1023,19143,AYSIS Double Sided Water Proof Baby Mat Carpet Baby Crawl Play Mat Kids Infant Crawling Play Mat Carpet Baby Gym Water Res...,Warehouse C,50,43,2025-02-28 07:40:00,7
1023,ORD_1024,12813,Aashiya Trades Unisex Cotton Turban Kont Bow Cap (Pack Of 1) (j01_Pink_0 Months-3 Months),Warehouse B,177,140,2025-02-28 13:48:00,37
1024,ORD_1025,33917,Trivitr Baby Health Care Kit for Newborn Babies Kids Nail Hair Grooming Brush with Comb Brush Nail Cutter Scissor with Pro...,Warehouse A,372,334,2025-02-28 18:30:00,38
1025,ORD_1026,2134,Kars Girl Baby White Cotton Pattu Frock for (6 Months- 4 Years),Warehouse B,465,436,2025-02-28 13:14:00,29
1026,ORD_1027,31582,"Neska Moda Unisex Baby Booties For 6 To 9 Months (White,Blue)",Warehouse B,127,122,2025-02-28 05:30:00,5
1027,ORD_1028,36940,"Mother Sparsh Plant Powered Diaper Rash Cream for Babies, 50 gm",Warehouse A,406,395,2025-02-28 19:59:00,11
1028,ORD_1029,33364,"Nestlé CERELAC Baby Cereal with Milk - Multigrain & Fruits - Stage 3 - BIB Pack, 300g",Warehouse C,334,300,2025-02-28 10:23:00,34
1029,ORD_1030,1837,MINI KLUB baby-girls Top And Bottom Set,Warehouse C,469,424,2025-02-28 23:53:00,45
1030,ORD_1031,36936,"SNOWIE SOFT® Cloth Books for Babies, 6pcs Nontoxic Fabric Soft, Early Education Toys, Waterproof Soft Books for Toddler, I...",Warehouse B,469,436,2025-02-28 14:35:00,33
1031,ORD_1032,36141,Nasal Aspirator Replacement Tips for Electric Baby Nasal Aspirator - 2 Sets/4 Pieces of White Reusable Tips,Warehouse A,195,178,2025-02-28 20:31:00,17
1032,ORD_1033,33936,Sahi Rates Himalaya Extra Moisturizing baby Lotion 400 ML pack of 1,Warehouse B,370,327,2025-02-28 03:02:00,43
1033,ORD_1034,33937,Xs and Os Women's Thigh High Cotton Lycra Socks (Pack Of 2),Warehouse B,45,15,2025-02-28 17:22:00,30
1034,ORD_1035,36931,"Medela Manual Harmony Single Hand Breast Pump with Flex Shields for Comfort & Expressing More Milk, 6 Count",Warehouse B,112,63,2025-02-28 07:32:00,49
1035,ORD_1036,33940,Max Baby-Boys Short,Warehouse B,283,253,2025-02-28 00:13:00,30
1036,ORD_1037,2140,Hopscotch Unisex Synthetic/PU Graphic Print Applique Casual Shoes in Blue Color,Warehouse C,318,310,2025-02-28 12:27:00,8
1037,ORD_1038,102,"BAYBEE Supersoft Cotton Baby Mittens, Booties & Cap Set for New Born Baby | Baby Cap | Infant Baby Cap Mitten and Booties ...",Warehouse A,222,173,2025-02-28 20:22:00,49
1038,ORD_1039,31591,Denil Leeroy New Combo of Winter Season Warmer Cotton Kids Cap Knit Hat for Boys and Girls [DLKCAP57+57],Warehouse B,442,413,2025-02-28 05:14:00,29
1039,ORD_1040,2128,A Baby Cherry - Baby hand print and Footprint kit || Ink Pad For Baby Foot Print || Foot Print for baby || Baby Foot Print...,Warehouse C,213,171,2025-02-28 17:32:00,42
1040,ORD_1041,31615,Gini & Jony Boys 4 Pocket Mild Wash Shorts (0451 Denimex_6-12 Months),Warehouse B,498,489,2025-02-28 04:48:00,9
1041,ORD_1042,1787,Haus Alchemy Non-Slip Sturdy Bathroom Western Toilet Baby Potty Trainer Seat with Handle Splash Guard & Soft Cushion Fits ...,Warehouse C,135,129,2025-02-28 12:55:00,6
1042,ORD_1043,33251,Haristar Potty Seat For Baby 1 to 6 Year Baby || Training seat For Small Baby || Cushion Seat || Griped Avilabel || (blue),Warehouse C,97,80,2025-02-28 08:55:00,17
1043,ORD_1044,33250,Hopscotch Boys PU and Fabric Casual Slip Ons in Black Color,Warehouse C,152,112,2025-02-28 10:52:00,40
1044,ORD_1045,33246,MAHAKAAL JEWELS® Two Tone Finish Copper Silver Stretchable Kids Protection Charms Kids Bangle Bracelet Free Size Nazariya ...,Warehouse A,54,31,2025-02-28 20:20:00,23
1045,ORD_1046,1725,"Kotex Overnight Period Panties (Medium/Large size, pack of 10 panties) for heavy flow period protection | with 360 degree ...",Warehouse C,283,255,2025-02-28 08:22:00,28
1046,ORD_1047,36817,Starvis Unisex Winter fluffy Snowflake Fleece white soft fur Lining Knit Thick thermal Warm Christmas Slipper Socks (Pack ...,Warehouse B,242,226,2025-02-28 13:31:00,16
1047,ORD_1048,2197,"PDY FASHION Nazar kada Bangle Set Black and white Nazariya Kade for New Born Baby boy,Girl Kid for New Born Baby Black Kad...",Warehouse C,270,259,2025-02-28 16:43:00,11
1048,ORD_1049,1723,Baby Moo My Pet's House Chu-Chu Sound Breathable Anti-Skid Sandals - Blue (8-12M),Warehouse C,167,129,2025-02-28 00:41:00,38
1049,ORD_1050,33237,SooWoo® Anti-Skid Grip Socks for Baby Boy/Girl - Multi-Colored(Assorted),Warehouse A,130,109,2025-02-28 07:24:00,21
1050,ORD_1051,33236,ARIF Collection Baby Girls Calf Length Casual Flawsome Elegant Girls Frocks & Dresse Jhabla Frock (Pack of 4PC) 4 Multicol...,Warehouse A,314,290,2025-02-28 23:05:00,24
1051,ORD_1052,31653,The Child Company Cotton Stylish Halfsleeve T-Shirt & Pant Kids Clothing Set for Baby Girl (Believe in Yourself),Warehouse C,68,63,2025-02-28 11:12:00,5
1052,ORD_1053,34145,"KNITROOT Monthly Birthday Teddy Special Unisex Baby Romper Half Sleeve Envelope Neck ""3 Month Old""",Warehouse A,81,60,2025-02-28 16:33:00,21
1053,ORD_1054,34149,"One94Store Kids U Shaped Toothbrush,U Shape Toothbrush,U-Shaped Training Toothbrushes for Kids 2-6Y,Silicone Bristles Mass...",Warehouse B,84,36,2025-02-28 10:03:00,48
1054,ORD_1055,33874,"Mamaearth 100 Percent Natural Berry Blast Kids Toothpaste, 50gand Easy Tummy Roll On for Digestion & Colic Relief with Hin...",Warehouse C,241,205,2025-02-28 18:47:00,36
1055,ORD_1056,31580,Instep Kids Socks Baby Boys & Baby Girls Full Terry Soft Cushion Special Design Calf Length/Ankle Length Pure Cotton Socks...,Warehouse C,71,36,2025-02-28 21:36:00,35
1056,ORD_1057,1839,Roots & Herbs Ayurvedic Natural Treatment 100% Vegan No Paraben Chandan De-Tan Kids Body Wash Ubtan - 100 gm,Warehouse C,480,463,2025-02-28 12:01:00,17
1057,ORD_1058,1817,Manan Shopee Baby Boys and Girls Unisex Coloured Cotton Brief Panty Innerwear Drawer Bloomers Combo Pack,Warehouse C,128,79,2025-02-28 23:41:00,49
1058,ORD_1059,33331,DIO LUSSO Baby Boy's and Baby Girl's Romper Baby Suit Dungaree,Warehouse C,500,461,2025-02-28 02:51:00,39
1059,ORD_1060,33329,Mamaearth Coco Soft Body Wash For Babies With Coconut Milk & Turmeric - 400 ml,Warehouse A,523,486,2025-02-28 21:08:00,37
1060,ORD_1061,3124,NammaBaby Baby's Cotton Leggings,Warehouse A,261,240,2025-02-28 06:06:00,21
1061,ORD_1062,127,Ravaiyaa - Attitude is everything Girl's Cotton Kaftan Stunning Pom Pom Decorated Dress Baby Girl Kid's Designer Top,Warehouse C,291,262,2025-02-28 05:45:00,29
1062,ORD_1063,2148,TILISM Girls Black Beauty Bubble Fluffy Dress Frock 1-11 Years,Warehouse A,360,343,2025-02-28 16:36:00,17
1063,ORD_1064,2150,PUMA Toddler Girls Cruise Rider P0p Gltch Ac Lace Up Sneakers Shoes Casual - White,Warehouse A,78,60,2025-02-28 17:48:00,18
1064,ORD_1065,33323,"Safety 1st Easy Fill Medicine Syringe, White",Warehouse B,77,32,2025-02-28 09:16:00,45
1065,ORD_1066,33982,StarAndDaisy Baby Potty Training Seat | Toddler Toilet Pot | Toilet Training chair for Kids | Toddlers-Comfortable Safe cu...,Warehouse A,128,88,2025-02-28 14:35:00,40
1066,ORD_1067,2147,"100% Muslin Cotton 4 Layer Dream Blanket for Newborn to 5 Years, Soft Baby Blanket, Muslin Baby Blankets for Girls & Boys,...",Warehouse C,520,477,2025-02-28 14:30:00,43
1067,ORD_1068,33999,"Huggies Complete Comfort Wonder Pants, Medium (7-12kg) Size Count 100 Baby Diaper Pants Combo Pack of 2, 50 count Per Pac...",Warehouse B,176,151,2025-02-28 04:03:00,25
1068,ORD_1069,31609,Mom & World Baby Boy Kit - Baby Wash + Baby Sunscreen Lotion + Baby Nourishing Lotion,Warehouse A,275,250,2025-02-28 17:44:00,25
1069,ORD_1070,34004,BeeBaby Round Edge Baby Comb Single Piece - Green,Warehouse B,318,284,2025-02-28 00:38:00,34
1070,ORD_1071,34005,Fareto® Combo of Baby Mattress with Net | Sleeping Bag | 4 Pcs Bedding Set(0-6 Months) (Purple),Warehouse A,117,93,2025-02-28 09:49:00,24
1071,ORD_1072,2156,"Baby Dove Rich Moisture Shampoo, 200 ml & Baby Dove Rich Moisture Bar, 75 g (Pack of 3)",Warehouse B,487,469,2025-02-28 01:48:00,18
1072,ORD_1073,33313,"Pack of 4 Baby Kids Tooth brush and Tongue cleaner with travel capsule holder, Portable capsule Toothpaste plastic storage...",Warehouse A,312,303,2025-02-28 18:27:00,9
1073,ORD_1074,33312,BABY ALIVE Shimmer ‘n Splash Mermaid Blonde Hair,Warehouse A,204,156,2025-02-28 11:42:00,48
1074,ORD_1075,31614,"Neska Moda 12 To 18 Months Baby Boys & Baby Girls Pack Of 2 Pair Cotton Butterfly Frill Booties (Light Green,Red) -BT1178a...",Warehouse A,310,278,2025-02-28 16:04:00,32
1075,ORD_1076,36960,Fareto Born Baby Double Layer 12 Cotton Nappies/Tying Langots/Cloths Nappies(Assorted)(Double Layer Cotton) (0-3 Months),Warehouse B,78,55,2025-02-28 19:59:00,23
1076,ORD_1077,1854,"Nestle LACTOGEN 1 Infant Formula Powder - Upto 6 months, Stage 1, 400g Bag-in-Box Pack",Warehouse C,229,188,2025-02-28 02:14:00,41
1077,ORD_1078,33881,Baby Moo Cute Puppy Checked Chu-Chu Sound Breathable Anti-Skid Sandals - Blue (2Y-2.5Y),Warehouse B,506,485,2025-02-28 08:28:00,21
1078,ORD_1079,31571,"Homiefix present Attrative Baby Potty Seater For Kids, Boys & Baby Girls In Green Colour.",Warehouse C,103,82,2025-02-28 06:18:00,21
1079,ORD_1080,1851,I Bears Half Sleeves Onesies Rompers for Baby Boys and Baby Girls Made of 100% Cotton Bodysuit Sleepsuits Overalls Summer ...,Warehouse B,263,251,2025-02-28 02:06:00,12
1080,ORD_1081,3143,MEDGEARS Digital Body Fever check Machine for Testing Kids Adults & Babies Thermometer Temperature (White),Warehouse A,68,32,2025-02-28 05:49:00,36
1081,ORD_1082,33385,Neska Moda Unisex Baby Booties For 12 To 18 Year (Maroon),Warehouse B,111,97,2025-02-28 23:26:00,14
1082,ORD_1083,33884,Sebamed Baby Powder 400g |With Olive Oil and Allantoin| For delicate skin,Warehouse C,150,128,2025-02-28 00:17:00,22
1083,ORD_1084,31574,Pom Pom Sweethearts Washable Reusable Cotton Hoisery U Shape Lace Nappy/Langot For New Born Baby - Pack of 10 (0-3 Months)...,Warehouse A,163,157,2025-02-28 11:04:00,6
1084,ORD_1085,33887,AmazBaby Baby Girl's A-Line Mini Frock Dress (Pack of 1),Warehouse A,255,207,2025-02-28 21:51:00,48
1085,ORD_1086,33902,Mammayo Baby Pajamas Unisex Boys and Girl Printed Summer Wear Lower Track Pant Leggings Cotton Regular Fit Pyjama (Set of 6),Warehouse B,233,220,2025-02-28 04:21:00,13
1086,ORD_1087,36947,AWSM COLLECTION Kids Fiber Foldable Cartoon Princess Sofa Cum Bed Small Baby Sofa Chair for Room Decoration Gift Purpose (...,Warehouse C,79,45,2025-02-28 13:26:00,34
1087,ORD_1088,96,Gini & Jony Baby-Girls Pedal Pusher,Warehouse A,434,408,2025-02-28 22:38:00,26
1088,ORD_1089,1733,little PANDA Baby Girls Fit & Flare Knee Length Net Dress,Warehouse A,297,250,2025-02-28 03:25:00,47
1089,ORD_1090,34122,Max Baby-Girl's Regular T-Shirt (M22ABT36MULTI_Multi 6-12M),Warehouse A,302,276,2025-02-28 06:01:00,26
1090,ORD_1091,1739,Kids Choice Shoes Soft Boy's and Girl's Canvas with Soft & Anti-Slip Sole (3-12 Months),Warehouse A,275,262,2025-02-28 19:50:00,13
1091,ORD_1092,36846,Cuddables 99% Water Baby Wipes | Natural Plant made cloth wipes - Super thick | 72pcs X 2 Packs = 144 Wet Baby Wipes,Warehouse B,454,414,2025-02-28 21:02:00,40
1092,ORD_1093,34092,SANTALON® Bath Toys Multiple Pack Cute and Sweet Swimming Turtle Bath Toys for Baby Floating Wind Up Toys for 1 Year Old B...,Warehouse B,324,293,2025-02-28 00:54:00,31
1093,ORD_1094,36845,Sahiba Gems 925 Exclusive Nazariya 925 Sterling Silver Bracelets Kada Bangle Nazariya Red/Maroon - Color Beads/Crystal for...,Warehouse C,282,260,2025-02-28 12:40:00,22
1094,ORD_1095,33272,"Mee Mee Multipurpose Diaper Bags, Stylish Waterproof Travel Backpack Mom/Mamas Bags/Diapers Bags for New Born Baby",Warehouse C,407,394,2025-02-28 14:36:00,13
1095,ORD_1096,1748,"Mamaearth Moisturizing Baby Bathing Soap Bar pH 5.5 with Goat Milk and Oatmeal, 75g (Pack of 2) & Mamaearth Anti Mosquito ...",Warehouse B,218,176,2025-02-28 14:49:00,42
1096,ORD_1097,166,KNITROOT Unisex Baby Bodysuit for Toddler Half Sleeve White Color Nani Ki Ladla,Warehouse B,161,153,2025-02-28 18:47:00,8
1097,ORD_1098,36837,"Neska Moda Set Of 2 Pair Unisex Baby Booties for 6 to 9 Months (Black,Pink)",Warehouse A,460,427,2025-02-28 04:31:00,33
1098,ORD_1099,31643,Kidozz Panda Sticker Cotton Light Weight Anti Skid Sole Baby Boy and Baby Girls Shoes/Booties for 0 to 12 Months,Warehouse B,66,42,2025-02-28 14:27:00,24
1099,ORD_1100,34106,QIUYI Toddler Low Heel Shoes Fashion Autumn And Winter Boys And Girls Slippers Flat Bottom Lightweight Short Warm Cute,Warehouse B,70,64,2025-02-28 00:48:00,6
1100,ORD_1101,34108,FIMALIA Dry Muslin Wash Cloth Organic Cotton Face Towel Handkerchief for Baby New Born/Infants/Toddlers (Color & Print May...,Warehouse B,94,72,2025-02-28 08:04:00,22
1101,ORD_1102,34109,Saumabhi Genuine Leather Soft Unisex Baby Shoes All Sorts of Colors O,Warehouse B,222,202,2025-02-28 02:15:00,20
1102,ORD_1103,36844,My NewBorn Baby Bath Sling - Pack of 1 (Green) | Smooth Toddler Bathing Chair for Use with or Without Bathtub | Infant Bat...,Warehouse B,194,163,2025-02-28 20:11:00,31
1103,ORD_1104,163,1st Step Powder Puff/Powder Box/Powder Case/Baby Grooming (Pink),Warehouse A,179,164,2025-02-28 09:00:00,15
1104,ORD_1105,31619,"Little Angel Extra Dry Baby Pants Diaper, Large (L) Size, 48 Count, Super Absorbent Core Up to 12 Hrs. Protection, Soft El...",Warehouse A,144,107,2025-02-28 17:02:00,37
1105,ORD_1106,34082,"Sapnasales Baby Boy's and Baby Girl's Woollen Monkey Cap (Multicolour, 0-6 Month)",Warehouse B,105,63,2025-02-28 17:01:00,42
1106,ORD_1107,1971,Shalimar Baby Diaper Disposable / Nappy Bag Size 30.5 Cm X 40.5 Cm 6 Rolls (90 Bags),Warehouse B,295,250,2025-02-28 05:36:00,45
1107,ORD_1108,31497,Kwitchy Baby Gift Pack New Born Complete Daily Items Combo (0-6 Months),Warehouse B,299,288,2025-02-28 13:10:00,11
1108,ORD_1109,33670,"Panda & Giraffe Muslin Baby Swaddle Blanket, Mulmul Swaddle for Newborn Baby Super Soft Premium Cotton Receiving Wrapper C...",Warehouse B,350,306,2025-02-28 19:25:00,44
1109,ORD_1110,1959,BODY LOTION NAT SENS 500ML INTL,Warehouse B,320,302,2025-02-28 17:26:00,18
1110,ORD_1111,31499,"STESHWK Multicolor Plain Cotton and Antislip Silicon Rubber base Shoes Cum Socks For Kid's, Soft Sole Baby Shoes, Breathab...",Warehouse C,492,475,2025-02-28 13:19:00,17
1111,ORD_1112,1958,"Skip Hop Moby Waterfall Bath Rinser, Grey, 1 Count (Pack of 1) (235052)",Warehouse A,211,171,2025-02-28 22:21:00,40
1112,ORD_1113,1956,"LuvLap Mobby Little Spout Sipper, BPA Free, 240 ml, 6m+ (Blue)",Warehouse B,372,339,2025-02-28 21:18:00,33
1113,ORD_1114,33509,SHUBH MUHURAT BABY CARE PACK,Warehouse B,64,55,2025-02-28 17:24:00,9
1114,ORD_1115,33688,"Mee Mee 100% Cotton Material Printed and Solid Gift Set for New Born Babies (Set of 9 Pieces, Red)",Warehouse C,372,336,2025-02-28 20:14:00,36
1115,ORD_1116,40,"Mamypoko Standard Baby Diaper Pants, Medium (7 - 12 kg) 36 Count",Warehouse A,338,305,2025-02-28 02:13:00,33
1116,ORD_1117,33689,Odomos Non-Sticky Mosquito Repellent Cream With Vitamin E & Almond - 50 Gm,Warehouse A,520,477,2025-02-28 19:33:00,43
1117,ORD_1118,33724,Boy and Girl Baby Natural Biowashed Cotton Trousers (1-2 Years),Warehouse C,87,42,2025-02-28 07:37:00,45
1118,ORD_1119,36829,Trickey Shopper™ Plain Reversible Bucket Hat Cap Cotton Blank Unisex Panama Outdoor Sports Two Side Wear Fishermen Sun Hat...,Warehouse C,325,317,2025-02-28 08:51:00,8
1119,ORD_1120,31660,SILORNA Elegantly Designed 925 Sterling Baby Nazariya With Black Beads For Babies,Warehouse B,250,244,2025-02-28 22:38:00,6
1120,ORD_1121,36807,Caiery 10pcs Baby Muslin Washcloths|Baby Washcloths Soft | Baby Muslin Washcloth | Face Towels for Newborn with Sensitive ...,Warehouse A,71,49,2025-02-28 21:10:00,22
1121,ORD_1122,36806,BENKILS Cute Fashion Embroidered Cotton Denim Casual Frocks Dress,Warehouse B,323,304,2025-02-28 10:48:00,19
1122,ORD_1123,1714,"Toddylon Baby Boy's & Girl's Cotton Mittens & Socks (Multicolour, 0-6 Months) Set of 6 Mitten and Set of 6 Booties",Warehouse A,294,274,2025-02-28 09:20:00,20
1123,ORD_1124,31661,OM KRAFT SALEs- 7 pcs Non-heat Curling Hair Band Hair Rollers Band Sports Hair Band Fabric Wave Hair Curling Wave Style Ha...,Warehouse C,458,428,2025-02-28 14:04:00,30
1124,ORD_1125,1713,HAPPU COLLECTION printed kids boot (white) 01,Warehouse A,371,356,2025-02-28 19:21:00,15
1125,ORD_1126,34165,MAPPERZ U Shaped Silicone Toothbrush for Kids/ 360 Degree Soft Oral Teeth Cleaning For Baby Infant Toddler Children - 2 to...,Warehouse B,92,74,2025-02-28 22:14:00,18
1126,ORD_1127,36800,U.S. POLO ASSN. Baby-Boy's Solid Regular Fit Shirt (UKSH6379_Lt Orange 1 to 2),Warehouse A,385,358,2025-02-28 18:20:00,27
1127,ORD_1128,2207,JwlDazz Baby Nazaria Evil Eye Anklet for Avoid Negative Energy for Child Baby Girl Boy Unisex,Warehouse B,176,153,2025-02-28 15:46:00,23
1128,ORD_1129,33221,Superbottoms NEW UNO Freesize Cloth Diaper Set of 2| Cloth diaper for babies 3M to 3Y | Washable & Reusable cloth diaper |...,Warehouse A,308,295,2025-02-28 16:34:00,13
1129,ORD_1130,34177,Dhruvi Women's Printed Rayon Anarkali Maternity Dress with Zippers,Warehouse A,382,368,2025-02-28 11:04:00,14
1130,ORD_1131,34178,"Adorazone® Kid's Super-Warm Velvet Thermal Ankle Socks (2-5 Year, 2)",Warehouse B,326,319,2025-02-28 18:59:00,7
1131,ORD_1132,178,SMARTOTS Kids Unisex Baby Casual Shoes Combo for Baby Boys/Girls Age 15 Months to 4 Years (Combo-Pack of 2 Pairs) BW-1&Bla...,Warehouse C,355,324,2025-02-28 07:43:00,31
1132,ORD_1133,33217,"LIKADO FASHION Girl's Stylish Reyon Frock Party Festive Ethnic Wear for Kid-1 Year to 8 Year,White and Braun Colour",Warehouse A,115,86,2025-02-28 21:57:00,29
1133,ORD_1134,36795,Baby Moo Cute Puppy Checked Chu-Chu Sound Breathable Anti-Skid Sandals - Blue (8-12M),Warehouse B,466,436,2025-02-28 07:00:00,30
1134,ORD_1135,34156,Hopscotch Boys and Girls Memory Foam Graphic Print LED Slip Ons Sneakers in Peach Color,Warehouse C,148,100,2025-02-28 00:05:00,48
1135,ORD_1136,34154,"The Purple Tree Moon and Star Cushion Baby Photo Shoot Prop Accessories (Pack of 1 Moon and 5 Star, Grey) Cute Props for B...",Warehouse A,112,100,2025-02-28 11:18:00,12
1136,ORD_1137,34025,"Masilo Organic Cotton Hooded Towel for Babies-Ideal for Babies 6 to 12 Months -Grrly Pink-Ideal As Baby Towel, Breathable",Warehouse B,400,369,2025-02-28 19:50:00,31
1137,ORD_1138,31657,"AHC Soft Baby Bean Bag with Safety Belt for New Born Baby to Toddlers , Lounge Bag, Couch, Recliner in Kids Print with Bea...",Warehouse C,445,415,2025-02-28 14:42:00,30
1138,ORD_1139,34026,"Neska Moda 0 To 6 Months Baby Boys & Baby Girls Cotton Lace Shoes/Booties (Black,Rani) -BT384andBT1132",Warehouse A,290,267,2025-02-28 07:55:00,23
1139,ORD_1140,34029,Baby Caps for New Born 0-6 Months Pack of 5 Multicolour,Warehouse B,348,335,2025-02-28 08:17:00,13
1140,ORD_1141,36866,Dermadew Baby Soap Pack Of 3(225 g),Warehouse A,157,122,2025-02-28 02:29:00,35
1141,ORD_1142,34036,First Kids Step Baby Boy's & Baby Girl's Shirt (shirt-frontopen_Multicolored_0-6 Months),Warehouse A,202,173,2025-02-28 20:43:00,29
1142,ORD_1143,159,TopiBaaz Boys and Girls Cartoon Design Summer Cap (Pack of 1) | Bell Inside The Balls | Cute Caps | Age - 2 to 8 Years,Warehouse A,397,374,2025-02-28 17:59:00,23
1143,ORD_1144,31621,PUMA Unisex-Child R78 Sneaker,Warehouse C,72,65,2025-02-28 03:22:00,7
1144,ORD_1145,34046,Max Girls Stonewashed Slim Fit Jeans,Warehouse B,406,373,2025-02-28 15:15:00,33
1145,ORD_1146,31622,Himalaya Baby Lotion 700ml and Himalaya Gentle Baby Wipes - 72 Pieces (Pack of 2),Warehouse A,238,210,2025-02-28 16:29:00,28
1146,ORD_1147,33301,Franco Sarto EDA,Warehouse C,488,442,2025-02-28 03:10:00,46
1147,ORD_1148,150,Kidbee Baby Soft Super Cotton Hosiery Boys & Baby Girls Printed Hosiery Shorts Multicolor (Pack of 3) (4-5 Years),Warehouse A,369,324,2025-02-28 00:45:00,45
1148,ORD_1149,153,"5pcs Baby Nasal Irrigator, Professional Baby Nasal Aspirator Nasal Irrigation Syringe, Portable Nose Cleaner Quick Rinsing...",Warehouse C,93,63,2025-02-28 02:22:00,30
1149,ORD_1150,33298,Hopscotch Girls Cotton Spandex Rainbow Print Sleeveless Dress in Pink Color,Warehouse A,343,334,2025-02-28 23:07:00,9
1150,ORD_1151,34056,Kidbee Baby Boys & Girls Mitten Ear Flaps Cap and Booty Set,Warehouse B,524,494,2025-02-28 02:20:00,30
1151,ORD_1152,2165,Aswadh Cute Cartoon Animal Uni Kids Toddler Soft Sole Baby Shoes Star - 12cm,Warehouse B,201,183,2025-02-28 10:07:00,18
1152,ORD_1153,34059,3BROS Newborn Baby Socks & Mittens Set 100% Cotton (Pack of 10 Pair),Warehouse B,321,303,2025-02-28 12:25:00,18
1153,ORD_1154,1781,Pom Pom Sweethearts New Born Baby Soft Cotton Printed Sleeveless 4 Jhabla/Vest/Baniyan & 4 Knotted Vest/Tank Top for Baby ...,Warehouse A,89,74,2025-02-28 19:17:00,15
1154,ORD_1155,34117,Truvic Baby Smart Newborn Premium Cotton Housiry Mittens Set/Hand Gloves/Muthi/to Keep Baby Hand Tender for Age 0 to 6 Months,Warehouse A,395,381,2025-02-28 04:18:00,14
1155,ORD_1156,34120,"THE LITTLE LOOKERS Swimming Bath Gown for Kids, Bath Gown for Baby Boys/Baby Girls | Swimming Gown for Kids (Bunny Lemon, ...",Warehouse A,56,24,2025-02-28 23:42:00,32
1156,ORD_1157,33228,"Softsens Baby TEAR FREE Shampoo | Mild, Hypoallergenic , Paraben & Sufate Free (200ml x Pack of 3)",Warehouse A,44,10,2025-02-28 16:22:00,34
1157,ORD_1158,33988,BabyMoon Strechable Bodysuit & Cap for Baby Boys Photography Photoshoot Props Costume,Warehouse C,254,212,2025-02-28 22:51:00,42
1158,ORD_1159,36046,TERI BERI Muslin Cotton Face Towels for Newborn Baby Extra Soft Hankies Reusable Napkins for Infants Toddlers (Pack of 5) ...,Warehouse B,242,218,2025-02-28 10:31:00,24
1159,ORD_1160,32141,Tiny Shadows Girls Tweed Bunnique Tweed Pearl Handbag,Warehouse C,248,230,2025-02-28 03:07:00,18
1160,ORD_1161,36045,"6 To 12 Months / 1 Year Baby Boys & Baby Girls Pack of 1 Pair Cotton Dog Face Booties (Black,Orange)",Warehouse B,233,215,2025-02-28 14:58:00,18
1161,ORD_1162,35445,"STESHWK Multicolor Cartoon Face Cotton and Antislip Silicon Rubber base Shoes Cum Socks For Kid's, Soft Sole Baby Shoes, B...",Warehouse C,384,362,2025-02-28 07:20:00,22
1162,ORD_1163,35448,MYSTIFY® Kids I Girl's Moving Ear Plush Fleece Cap for Winter Cap | Ear Trick | Rabbit Ears Jumping Hat Funny Bunny Plush ...,Warehouse A,329,313,2025-02-28 12:17:00,16
1163,ORD_1164,2809,"Mee Mee Mild Baby Liquid Laundry Detergent Refill Pack, 1.2L & Fresh Feel Baby Powder, 500g Combo",Warehouse B,74,34,2025-02-28 04:06:00,40
1164,ORD_1165,630,"Sebamed Baby Rash Cream, 100ml & Baby Cream, Extra Soft, 200ml Combo",Warehouse B,454,438,2025-02-28 12:10:00,16
1165,ORD_1166,32478,"Healofy Naturals Baby Safe Multipurpose Liquid Cleanser with Neem Extract, 500ml | For Fruits, Vegetables, Feeding Bottle,...",Warehouse B,265,219,2025-02-28 13:25:00,46
1166,ORD_1167,32102,"Mylo Care Baby Diaper Pants Extra Large (XL) Size, 12-17 kgs with ADL Technology - 56 Count - 12 Hours Protection",Warehouse B,171,164,2025-02-28 00:37:00,7
1167,ORD_1168,539,Kars Baby girls Knee-Length Dress (INFANTFOBT_Muslin_Multicolor_0 Months-3 Months),Warehouse A,220,202,2025-02-28 21:10:00,18
1168,ORD_1169,32619,Hopscotch baby-boys 1049892,Warehouse A,152,140,2025-02-28 10:03:00,12
1169,ORD_1170,36192,BabyMart Baby Boy Girl Knee Length Cotton Dungaree (Upto 2 Years),Warehouse A,37,31,2025-02-28 19:53:00,6
1170,ORD_1171,36191,Baby Kids Knit Woolen Cap Hat Neck Scarf Set Winter Soft Wool Teddy Monkey Desgin Skull Beanie Capset for Toddler (6 Month...,Warehouse A,440,422,2025-02-28 22:43:00,18
1171,ORD_1172,2545,Hopscotch Baby Boys and Baby Girls Cotton and Polyester Applique Solid Text Jeans in Blue Color,Warehouse C,404,399,2025-02-28 16:46:00,5
1172,ORD_1173,35437,Lillypupp Unisex Black Lace Up Shoes for New Born Baby Boy and Girl - Size 6 To12 Months,Warehouse B,363,343,2025-02-28 22:31:00,20
1173,ORD_1174,35245,U-GROW Baby Silicone Finger Brush (White) with Blue Case (Pack of 2 Brushes),Warehouse B,400,381,2025-02-28 06:08:00,19
1174,ORD_1175,32508,Gilli Shopee Newborn Baby Soft Cotton Caps with Tai Knot and Bonnet,Warehouse A,113,107,2025-02-28 12:42:00,6
1175,ORD_1176,35491,Jimmy Jammy Baby Girls Summer Dress Suits Printed Cotton T-shirts Top & Capri (Pack of 3T-shirts + 3 Capri Pants) Size up ...,Warehouse C,383,351,2025-02-28 13:54:00,32
1176,ORD_1177,652,Fareto 100% Cotton | 3 in 1 Baby Bed | Sleeping Bag | Carry Bag Nest | New Born Bedding | New Born Baby Gift(0-6 Months) (...,Warehouse C,448,438,2025-02-28 07:18:00,10
1177,ORD_1178,654,ZHUQUA 12 PCS Edge Protector for Furniture Table Corner Guards for Sharp Edges Silicon Corner Protector for Sharp Edges Ge...,Warehouse B,222,173,2025-02-28 09:48:00,49
1178,ORD_1179,32156,SMARNN Nazar kada Bangles Bangle Set Black Beige Nazariya for New Born Baby boy Girl Kid Child Jewellery with Black Beads ...,Warehouse B,65,51,2025-02-28 13:16:00,14
1179,ORD_1180,35494,Baby Moo My Pet's House Chu-Chu Sound Breathable Anti-Skid Sandals - Pink (2.5Y-3Y),Warehouse A,166,122,2025-02-28 15:46:00,44
1180,ORD_1181,36022,Mastela Infant Deluxe Baby Bather (Blue),Warehouse B,342,330,2025-02-28 10:44:00,12
1181,ORD_1182,35496,"Glamifirsto 3 piece baby Floral Flower Elastic Hair Bands Chiffon Headband for Babies, Kids and Girls",Warehouse B,59,22,2025-02-28 10:12:00,37
1182,ORD_1183,649,"Neska Moda 0 To 6 Months Baby Girls Cotton Butterfly Frill Booties (Mint,Baby Pink) -BT381andBT1126",Warehouse A,510,472,2025-02-28 03:42:00,38
1183,ORD_1184,35458,"Qbic Portable Baby Bather,Jelly Bath Support s Silicone Mesh Bathtub for Infants (Aqua)",Warehouse A,367,356,2025-02-28 13:16:00,11
1184,ORD_1185,2816,Tee Weavers Boy's Cotton Nightwear Top and Capri Set Combo (Pack of 3),Warehouse B,103,66,2025-02-28 08:06:00,37
1185,ORD_1186,32136,NCY 4 in 1 Adjustable Baby Carrier Cum Kangaroo Bag/Baby Carry Sling/Back/Front Carrier for Baby (Navy Blue),Warehouse A,342,309,2025-02-28 22:55:00,33
1186,ORD_1187,631,Pokory Face Napkins Made of Cotton Face and Hand Napkin for New Born Babies |Face Towels|Washable Reusable Napkins Soft Sm...,Warehouse B,481,456,2025-02-28 10:23:00,25
1187,ORD_1188,36054,"18 Pack Pop It Pop Its Rainbow Pop Fidget Toys Poppet Push Pop Bubble Fidget Popping Sensory Toy for Kids and Adults, Fidg...",Warehouse A,202,186,2025-02-28 07:30:00,16
1188,ORD_1189,32510,"Paras Pooja Garments Baby Girl's Baby Doll Knee-Length Frock Dress (6-9 Months, Beige)",Warehouse A,222,217,2025-02-28 01:43:00,5
1189,ORD_1190,1005,Coco Soul Baby Massage Oil with Extra Virgin Coconut Oil | Ayurvedic Herbs | 100% Natural | Paraben | Perfume & Mineral Oi...,Warehouse B,203,190,2025-02-28 12:05:00,13
1190,ORD_1191,1004,"Ashtavinayak Baby Powder Puff With Storage Container With Newborn Baby, Infant and Toddler Grooming Kit 4 in 1 Set with Ba...",Warehouse C,143,126,2025-02-28 07:23:00,17
1191,ORD_1192,2547,KATS LOVE Kids Baby Boy and Girls Chu-Chu Sound Musical Walking Sandal,Warehouse C,495,469,2025-02-28 16:29:00,26
1192,ORD_1193,2846,"Mamaearth Nourishing Hair Oil for Babies 100ml (0-10 Years) & Mamaearth Gentle Cleansing Natural Baby Shampoo, 400ml (White)",Warehouse C,306,298,2025-02-28 07:51:00,8
1193,ORD_1194,32483,ARVESA Special Occasion Theme Unisex Baby White Romper Onesie Half Sleeve Envelope,Warehouse B,86,47,2025-02-28 01:28:00,39
1194,ORD_1195,522,"WOBBOX Record Growth Milestones Baby Shower Cards (18 Pieces, Multicolor)",Warehouse B,217,195,2025-02-28 07:42:00,22
1195,ORD_1196,36216,Malvina Baby Boys & Girl's Winter Warm Knitted Cartoon Design Beanie Cap with Knitted Muffler Scarf Set,Warehouse B,415,392,2025-02-28 04:43:00,23
1196,ORD_1197,32636,"American Apple Unisex Baby Romper Onesie Personlized customice Dress Rompers for for Baby Boys and Baby Girls, Child Name ...",Warehouse B,175,140,2025-02-28 08:51:00,35
1197,ORD_1198,530,"BabyPro (Set of 2) Soft Cushioned 6.4ft Long Edge Guards with Strong 3M Adhesive for Covering Sharp Edges of Bed, Table, &...",Warehouse C,227,189,2025-02-28 11:20:00,38
1198,ORD_1199,32634,VENJA (LABEL) Baby Boy Girls Anti-Skid Socks Shoe for Toddler | All Season Wear Soft Breathable Sole Booties Kids Cute Sty...,Warehouse C,528,496,2025-02-28 15:56:00,32
1199,ORD_1200,1108,United Colors of Benetton Boy's Solid Regular Fit T-Shirt,Warehouse C,113,94,2025-02-28 01:55:00,19
1200,ORD_1201,35220,Nino Bambino 100% Organic Cotton Printed Long Sleeves Zipper Romper,Warehouse A,89,61,2025-02-28 08:31:00,28
1201,ORD_1202,32631,Hospcotch Boys Multi Coloured Checkered Shirt And Pant Set For 110(3-4 Yrs) (HJ-2883358),Warehouse B,424,396,2025-02-28 10:24:00,28
1202,ORD_1203,32627,Kiddery Wash Cloth | 100% Cotton Muslin Napkin Set | Soothing Scandinavian Prints for New Born Baby | Baby Shower Gifts | ...,Warehouse A,388,373,2025-02-28 15:14:00,15
1203,ORD_1204,35229,PEAHEN 5 in 1 Baby Cozy Carry Cot Cum Rocker (Brown),Warehouse C,207,161,2025-02-28 01:05:00,46
1204,ORD_1205,32626,B4 Nappi Cream 75gm - Diaper Rash Prevention Cream. PACK OF 1,Warehouse A,493,462,2025-02-28 04:54:00,31
1205,ORD_1206,32055,Katyani Newborn Baby Soft Feel Summer Top Short Hanki with Kada Set for Born Babies for Summer Wear Dress 0-3 Month (Pack ...,Warehouse C,48,42,2025-02-28 23:52:00,6
1206,ORD_1207,36175,"Neska Moda Pack of 2 Baby Girls Booties for 0 to 6 Months (Blue,Pink)",Warehouse C,330,305,2025-02-28 01:06:00,25
1207,ORD_1208,36146,"Mommypure 100% Natural Mosquito Repellent Fabric Roll-On | Upto 8-Hour Protect | Protects from Dengue, Malaria & Chikungun...",Warehouse B,544,496,2025-02-28 17:30:00,48
1208,ORD_1209,35310,MINI KLUB baby-girls Legging,Warehouse A,463,446,2025-02-28 20:35:00,17
1209,ORD_1210,36188,"Nautica Kids Kettle Gulf Protective Water Shoe,Closed-Toe Sport Sandal (Toddler/Little Kid)",Warehouse C,457,437,2025-02-28 16:16:00,20
1210,ORD_1211,35258,"Amazon Brand - Jam & Honey Rabbit Soft Toy (30 Cm, Pink)",Warehouse B,299,257,2025-02-28 05:08:00,42
1211,ORD_1212,32607,AHC Nasal Tweezer / Nose Cleaner / Nose Plucker to Remove Struck Dust Particles & Mucus From Baby Nose (Pink),Warehouse B,511,486,2025-02-28 13:17:00,25
1212,ORD_1213,2845,Sahiba Gems Exclusive Silver Baby Kada/Bangle Red And Blue Design With Ghungroo (Chandi Kada),Warehouse C,350,305,2025-02-28 02:45:00,45
1213,ORD_1214,2557,"MASTELA� Baby Dispenser Needle Feeder Medicine Dropper (Medicine Feeder 'Pink', Pack of 1)",Warehouse B,501,471,2025-02-28 18:03:00,30
1214,ORD_1215,32070,Nat Habit SUMMER Baby COMBO Body Massage + Hair Oil | Balamool Nimbuka Maahu | Brahmi Matsyakshi Hair Oil | Promotes Bone...,Warehouse A,170,127,2025-02-28 09:32:00,43
1215,ORD_1216,1087,"MY NEWBORN Baby Mitten Gloves Cap Booty Set for boy, Girl 0-3 Month - Pack of 3 & MY NEWBORN Baby Cotton Bibs -6 Pc- Fast ...",Warehouse A,191,174,2025-02-28 11:57:00,17
1216,ORD_1217,32600,KATS GIRRAFF Kids Baby Boy and Girls Walking Sandal,Warehouse A,205,184,2025-02-28 07:08:00,21
1217,ORD_1218,1085,Numuun Tom Unisex Kids Sandals for Boys & Girls Chu Chu Shoes for Baby Girls & Boys First Walking Sandals for Infants Boys...,Warehouse A,96,59,2025-02-28 05:12:00,37
1218,ORD_1219,544,Fareto® New Born Baby Essential Items in Single Pack 6 Baby Vest/6 Baby Front Open Full Sleeves Shirt/6 Teddy Print Single...,Warehouse C,91,43,2025-02-28 07:20:00,48
1219,ORD_1220,2531,Nino Bambino 100% Organic Cotton Green Colour Checkered Sleeveless Button Closure Jumpsuit/Onepice/Dress for Baby Girls,Warehouse C,354,310,2025-02-28 11:37:00,44
1220,ORD_1221,35209,superbottoms BASIC - Assorted Pack of 4 (2 Shell+2 Insert) Cloth Diaper For Baby |Washable & Reusable Cotton Cloth Diaper...,Warehouse C,504,464,2025-02-28 22:52:00,40
1221,ORD_1222,32044,United Colors of Benetton Baby-Boy's Boyfriend Slim Casual Pants,Warehouse C,68,24,2025-02-28 20:42:00,44
1222,ORD_1223,36027,"LWVAX Baby Bathtub, Baby Anti Slip Big Plastic Bathtub with Bath Toddler Seat Sling Non Slip Suction for Bathing, Size :- ...",Warehouse B,487,458,2025-02-28 01:08:00,29
1223,ORD_1224,973,Vrindam 925 Sterling Silver Nazariya Kada For baby Boys and Girls child Specially for 1 Year Baby to 3 Years kids | Tradit...,Warehouse C,160,152,2025-02-28 18:34:00,8
1224,ORD_1225,31849,Shrungarika Golden Ghungroo Heart Charms Kada/Bracelet For Baby Girls & Baby Boys Alloy Anklet,Warehouse B,208,184,2025-02-28 15:28:00,24
1225,ORD_1226,615,Bumchums baby-girls Clothing Set,Warehouse A,268,228,2025-02-28 04:45:00,40
1226,ORD_1227,2819,Bold N Elegant - Be Bold Inside & Elegant Outside Baby's Cotton Tshirt Pant Set,Warehouse B,231,192,2025-02-28 11:07:00,39
1227,ORD_1228,36084,"WOBBOX Baby Monthly Milestone Cards, Record 0-12 Months Growth Milestones Cards, (13 Pcs) Beige",Warehouse C,486,449,2025-02-28 13:40:00,37
1228,ORD_1229,36082,"HUG 'n' FEEL SOFT TOYS Mickey Mouse Stuffed Soft Toy for Kids (Multicolour, 26 cm) Lovely Toy Figure",Warehouse C,495,461,2025-02-28 00:23:00,34
1229,ORD_1230,36077,T2F Boys Pants,Warehouse A,54,33,2025-02-28 06:46:00,21
1230,ORD_1231,36073,"Little Angel Premier Pants Baby Diapers, Medium (M) Size, 100 Count, Cottony Soft Material, Breathable, Extra Dry Core, St...",Warehouse B,103,84,2025-02-28 04:11:00,19
1231,ORD_1232,32541,"VGRASSP Color Changing Cute Bird Bath time Musical Toy Whistle for Kids, Water & Bath Play Fun, Beautiful, Voice Changing ...",Warehouse A,324,287,2025-02-28 16:23:00,37
1232,ORD_1233,36086,KIDZVILLA Cotton Clothing Sets for Baby Boys & girls - Unisex Clothing sets Full Sleeve T-shirt & Pant,Warehouse C,409,361,2025-02-28 05:24:00,48
1233,ORD_1234,1027,"Neska Moda 0 To 6 Months Baby Boys & Baby Girls Pack Of 2 Pair Cotton Rabbit & Butterfly Booties (Black,Orange) -BT1115and...",Warehouse C,206,201,2025-02-28 01:12:00,5
1234,ORD_1235,622,"Fisher-Price Ultra Care Oral Hygiene Combo for Babies/Kids (Manual,Pack of Pink Set)",Warehouse A,371,354,2025-02-28 21:32:00,17
1235,ORD_1236,35393,Hopscotch Girls Cotton and Polyester Tie & Dye Print Sleeveless Casual Dress in Pink Color,Warehouse A,462,455,2025-02-28 15:19:00,7
1236,ORD_1237,36066,"Fareto Baby's Clothing Set (Multicolour, 0-6 Months) -Combo of 5 in 1",Warehouse B,93,55,2025-02-28 00:07:00,38
1237,ORD_1238,35409,"Brevi Goccia Bathtub 547-066, Fuchsia, from 0 Month to 15 kg, Water Capacity 14 LTR, Temperature Gauge.",Warehouse A,410,382,2025-02-28 18:17:00,28
1238,ORD_1239,33337,SATPURUSH Baby Boys and Baby Girls Dungaree Set with Shirt and Bow Tie (pack of 1),Warehouse C,362,316,2025-02-28 23:41:00,46
1239,ORD_1240,115,"Neska Moda 6 To 12 Months Baby Boys & Baby Girls Cotton Lace Shoes/Booties (Black,Blue) -SK138andSK145",Warehouse B,104,67,2025-02-28 02:14:00,37
1240,ORD_1241,33952,"Jhilmil Dresses Baby Girls Net Below Knee Party Frock Set (Sky Blue, Sleeveless)",Warehouse C,78,32,2025-02-28 11:00:00,46
1241,ORD_1242,36909,Promise Kid Girl's Cotton Midi/Knee Length Sleeveless Casual Dress (Pack of 1),Warehouse C,128,108,2025-02-28 05:02:00,20
1242,ORD_1243,3130,"Sanskruti Hub Baby Proofing Corner Safety Strip and Corner Guard, Table Corner Protector for Baby Proofing Cushion Edge Pr...",Warehouse A,353,306,2025-02-28 15:05:00,47
1243,ORD_1244,33956,Hopscotch Boys Cotton Text Print Short in Aqua Color,Warehouse C,85,39,2025-02-28 00:50:00,46
1244,ORD_1245,1815,"Bembika,Multi-Colour,,Nylon Headband For Girls, Hairbands for Kids infant Headband, 3P",Warehouse A,133,102,2025-02-28 10:11:00,31
1245,ORD_1246,33960,Sikander™ Kids Hat Scarf Set Warm Fleece Knit Beanie Cap Scarf Mask for Boy Girls Children Black Color,Warehouse A,489,440,2025-02-28 08:34:00,49
1246,ORD_1247,33962,Sahiba Gems Exclusive Silver/Chandi Baby Baby Krishna Bracelet Kada Bangle Nazariya Self Design for Babies ~ Fit for 1-2.5...,Warehouse C,57,42,2025-02-28 10:41:00,15
1247,ORD_1248,35411,Wembley Baby Play mat for Kids (Multicolor Turtle Play Mat),Warehouse C,526,485,2025-02-28 23:49:00,41
1248,ORD_1249,35362,"Voolex - Wooden Abacus kit for Kids, Abacus Shelf for Calculation (Counting, Addition and Subtraction), Toy Gift for Toddl...",Warehouse C,128,108,2025-02-28 04:38:00,20
1249,ORD_1250,1011,Max Girls Printed Full Sleeves T-Shirt,Warehouse A,169,120,2025-02-28 06:49:00,49
1250,ORD_1251,35422,"KidzzCart Baby Girl's Pure Cotton Frock Dress Full Sleeves (0-3 Months, Pink)",Warehouse A,466,428,2025-02-28 16:49:00,38
1251,ORD_1252,36037,"Kraftify Casting Kit for Baby,Hand & Footprint DIY Kit,Molding Clay Powder & Casting Powder for 3D Hand & Foot Impression,...",Warehouse A,498,481,2025-02-28 14:55:00,17
1252,ORD_1253,35465,BUMZEE Rust.White Front Open Full Sleeves Jablas for Baby Boys Age - 9-12 Months (Peb308692),Warehouse B,425,403,2025-02-28 15:54:00,22
1253,ORD_1254,985,"Disney by Jagannath Gangaram Pednekar Since 1965 18KT Yellow Gold, Baby & Boys Bracelet",Warehouse B,414,381,2025-02-28 10:52:00,33
1254,ORD_1255,35475,"Superminis Cotton Vests/Baniyan/Inner Wear - Regular Fit, Sleeveless, Printed Sandos for Girls, Boys and Kids",Warehouse C,408,387,2025-02-28 05:02:00,21
1255,ORD_1256,32148,DIO LUSSO Printed Cotton Boys Top and Bottom Set/T-shirt Shorts Combo,Warehouse A,288,276,2025-02-28 12:47:00,12
1256,ORD_1257,35479,Hopscotch Girls Cotton and Polyester Checkered Casual Dress in Blue Color,Warehouse B,222,186,2025-02-28 21:56:00,36
1257,ORD_1258,35480,"Toyshine Mid-sized Foosball, Mini Football, Table Soccer Game (51 Cms) - Lets Have fun Brown",Warehouse A,305,270,2025-02-28 00:06:00,35
1258,ORD_1259,35460,"MamyPoko Pants Extra Absorb NB76,Unisex Baby, Pack of 76 (Upto 5 Kg)",Warehouse C,385,378,2025-02-28 05:04:00,7
1259,ORD_1260,982,Mothercare Baby-Girls BB659,Warehouse C,334,324,2025-02-28 08:55:00,10
1260,ORD_1261,2583,Adidas Kids Unisex-Baby Superstar Crib Crib Shoe,Warehouse A,482,446,2025-02-28 12:10:00,36
1261,ORD_1262,2824,Pokory Kids Wash Tub with Anti Slip Base Useful for Baby Bathing Tub Cleaning and Washing Bucket|Water Kiddie Pool|Soft Cu...,Warehouse B,56,39,2025-02-28 10:26:00,17
1262,ORD_1263,613,Suelle Latest Embroidered N-Y Hiphop Style Cap for Boys & Girls,Warehouse B,208,195,2025-02-28 06:51:00,13
1263,ORD_1264,35414,RUKMINI Baby Boys & Girls Pure Cotton Printed Romper (0-3 Months),Warehouse A,485,441,2025-02-28 12:24:00,44
1264,ORD_1265,2584,Billy Bum Hosiery washcloth White Pack of 7,Warehouse C,144,102,2025-02-28 07:13:00,42
1265,ORD_1266,32550,LMN CHILD CARE Unisex Baby Booties For 0 To 6 Months (Royal Blue),Warehouse B,457,411,2025-02-28 08:47:00,46
1266,ORD_1267,2575,"1st Step Honey Comb Lining, Super absorbant Disposable Breast Pads Nursing Breast pad (Pack of 24)",Warehouse A,289,256,2025-02-28 15:47:00,33
1267,ORD_1268,36111,iota Microfiber 70X140CM & 350 GSM Ultra Soft & Hygeine Premium Brown Baby Bath Towel for Newborn Baby,Warehouse B,45,19,2025-02-28 11:22:00,26
1268,ORD_1269,32108,J0YJ0 LED Light Kids Shoes for 9 Months to 3 Years Boys & Girls,Warehouse A,483,452,2025-02-28 14:41:00,31
1269,ORD_1270,35345,"Prattle Foot Boys and Girls Stylish Sport, Running Shoe, Outdoor Shoes for Kids Casual LED Shoe for Kids, LED Shoe Velcro ...",Warehouse A,429,417,2025-02-28 18:06:00,12
1270,ORD_1271,1045,Sunlook Girl's Dress Girls Ethnic Dresses Frock Birthday Frock,Warehouse C,91,73,2025-02-28 06:38:00,18
1271,ORD_1272,32561,QYOOTY Denim Blue Jeans Handbag Shoulder Purse For Office And Casual Use,Warehouse C,426,383,2025-02-28 17:23:00,43
1272,ORD_1273,32560,"My Dream Baby Unisex Hosiery Clothing Set (Pack of 6 Set, Multi-Coloured, 0-6 Months)",Warehouse C,240,204,2025-02-28 07:56:00,36
1273,ORD_1274,602,YFXOHAR Baby Bath Tub for 0 to 5 Years Anti Slip with Drain Plug White and Sky Blue Color (Double Elite Bath Tub),Warehouse A,160,145,2025-02-28 11:39:00,15
1274,ORD_1275,2580,"Neska Moda 12 To 18 Months Baby Boys & Baby Girls Cotton Rabbit Booties (Orange,Yellow) -BT1157andBT1179",Warehouse C,295,257,2025-02-28 02:26:00,38
1275,ORD_1276,2826,3S Star 2 Pair Baby Knee pad Kids Safety Crawling Elbow Cushion Infant Toddlers Baby Leg Warmer Knee Support Protector Bab...,Warehouse A,464,453,2025-02-28 22:39:00,11
1276,ORD_1277,36097,Mothercare Deluxe Care Set (Multicolor),Warehouse B,397,366,2025-02-28 20:52:00,31
1277,ORD_1278,1037,"Fancy Walas Presents Newborn Baby Boy's and Girl's 2 Pieces Cartoon Print Cotton Suit Winter Wear Clothing Sets (Blue, 0-3...",Warehouse C,370,357,2025-02-28 15:00:00,13
1278,ORD_1279,36093,"Neska Moda Set of 2 Pair Baby Boys & Baby Girls Butterfly Cotton Booties For 12 to 24 Months (Maroon,Red) -BT1152andBT1156",Warehouse C,321,284,2025-02-28 15:31:00,37
1279,ORD_1280,2256,GoodFeel Woolen Cap for Baby Boys and Baby Girls [GFBCAP17],Warehouse C,252,239,2025-02-28 09:21:00,13
1280,ORD_1281,34271,"El Regalo Children Born Baby, Kids Cute Evil Eye Protection Thread Woven Rakhi",Warehouse C,119,74,2025-02-28 19:28:00,45
1281,ORD_1282,36732,"Farlin Baby Silicone Finger Toothbrush Parent Set with case for Easy Cleaning, Massaging, and Soothing Gums, Oral Hygiene",Warehouse C,111,68,2025-02-28 09:44:00,43
1282,ORD_1283,31692,CHIU Super Soft Velvet Baby Booties with Attractive Smiling Cat Face,Warehouse A,389,371,2025-02-28 18:26:00,18
1283,ORD_1284,36733,Himalaya Gift Pack & Himalaya Baby Hair Oil 200 ml,Warehouse A,478,441,2025-02-28 21:09:00,37
1284,ORD_1285,36722,BALENZIA Justice League High Ankle Socks for Kids with Anti-Skid Silicone Technology (Pack Of 3)(1-2 Years)(2-4 Years) Sup...,Warehouse B,63,30,2025-02-28 08:11:00,33
1285,ORD_1286,31691,"Neska Moda 0 To 6 Months Baby Boys & Baby Girls Cotton Lace Shoes/Booties (Black,Rani) -BT377andBT1132",Warehouse C,60,15,2025-02-28 13:43:00,45
1286,ORD_1287,1656,"Neska Moda 0 To 6 Months Baby Boys & Baby Girls Cotton Rabbit Booties (Mint,Yellow) -BT1112andBT367",Warehouse C,132,124,2025-02-28 06:29:00,8
1287,ORD_1288,34291,"Balku World in set of 3 Silicone Gel Finger Brush with Extra Soft Bristle for Tongue Cleaner For Baby Teething, Oral Hygie...",Warehouse B,234,192,2025-02-28 09:21:00,42
1288,ORD_1289,224,"Maxisoft Skin Nourishing Baby Wash 100 ml|With Aloe Vera, Coconut Oil, Tea Tree Oil, Glycerine & Vitamin E |pH Balanced|Su...",Warehouse C,120,83,2025-02-28 17:33:00,37
1289,ORD_1290,34295,"KIDSKA® Booties for New Born Baby/Baby Booties(Multicolor, 0-6 Month)-Set of 4 Pairs",Warehouse A,217,199,2025-02-28 01:50:00,18
1290,ORD_1291,34266,Hopscotch Girls Denim Polka-Dot Print Sleeveless Casual Dress in Blue Color,Warehouse A,33,20,2025-02-28 07:02:00,13
1291,ORD_1292,3072,Fflirtygo Baby Wear 100% Hosiery Cotton Infants Rompers with Booties/Onesies/Sleepsuit Full Sleeve I Have A Hero I Call Hi...,Warehouse B,364,357,2025-02-28 20:22:00,7
1292,ORD_1293,34248,"Nestlé Nan EXCELLAPRO 3 Follow-Up Formula Powder - After 12 months, Up to 24 months, Stage 3, 400g Bag-In-Box Pack",Warehouse C,241,229,2025-02-28 05:02:00,12
1293,ORD_1294,212,"Neska Moda 0 To 6 Months Baby Boys & Baby Girls Pack Of 2 Pair Cotton Butterfly Frill Booties (Maroon,Black) -BT368andBT1132",Warehouse A,205,158,2025-02-28 00:10:00,47
1294,ORD_1295,36734,LILBEE Potty Training Toilet Seat I Potty Seat with Handles Splashguard and Hanging Ring I Compact and Portable I White,Warehouse A,400,368,2025-02-28 15:28:00,32
1295,ORD_1296,3079,Fflirtygo Baby Wear 100% Hosiery Cotton Infants Rompers with Booties/Onesies/Body Suit/Jumpsuit/Sleepsuit Full Sleeve Main...,Warehouse A,381,354,2025-02-28 03:50:00,27
1296,ORD_1297,1655,Johnson's Baby Bed Time Jelly Natural Calm And Aroma 250 ml With Ayur Soap,Warehouse A,83,34,2025-02-28 14:25:00,49
1297,ORD_1298,36725,Shree Jewellers Exclusive 925 Silver 5 Ball Design Moti Black Thread Nazariya Baby Bracelet For Baby Girl & Baby Boy,Warehouse B,359,349,2025-02-28 18:07:00,10
1298,ORD_1299,34252,Nike Kids Alpha Menace 2 Shark Football (Toddler/Little Kid/Big Kid),Warehouse C,314,268,2025-02-28 19:58:00,46
1299,ORD_1300,31714,KIDZVILLA Baby Boy's & Baby Girl's Cotton Half Sleeve Front Jhabla/T-Shirt/Vest Pack of 3 - Multicolor-Design 8,Warehouse C,352,333,2025-02-28 10:01:00,19
1300,ORD_1301,33138,"BRANDONN New Born Hooded Supersoft Baby Blanket Wrapper Cum Sleeping Bag for Babies (White, 0-6 Months)",Warehouse A,533,488,2025-02-28 15:26:00,45
1301,ORD_1302,36742,"Electric Nail File Drill for Baby No Sharp Claws Hurt, 6 in 1 Safety Cutter Trimmer Clipper for Toes and Fingers (Blue) (P...",Warehouse B,353,335,2025-02-28 13:15:00,18
1302,ORD_1303,33137,"Himalaya Gentle Baby Soap Value Pack, 4 * 75g & Baby Shampoo (400 ml) & Baby Powder (400g)",Warehouse C,456,451,2025-02-28 23:47:00,5
1303,ORD_1304,34313,Neska Moda Baby Boy's & Girl's 5 Pair Striped Cotton Ankle Socks For 1 To 3 Years,Warehouse A,290,252,2025-02-28 16:31:00,38
1304,ORD_1305,36748,Antson 8 Pcs Edge Protector for Furniture Table Corner Guards for Sharp Edges Silicon Corner Protector for Sharp Edges Gel...,Warehouse C,463,418,2025-02-28 09:11:00,45
1305,ORD_1306,36749,Jo's 7 PCS PEPPA PIG & Friends Shoe Charms Decoration for Croc Shoes Bracelets - shoe charms make your shoes more interest...,Warehouse C,233,190,2025-02-28 01:30:00,43
1306,ORD_1307,36699,BigMart Kids Pure Copper Tube-Shaped Adjustable Simple Challa Kada Bracelet Bangle Free Size For for girls and boys (3 Yea...,Warehouse B,416,375,2025-02-28 18:39:00,41
1307,ORD_1308,33133,"FridaBaby Baby's Sick Day Prep Kit - Includes NoseFrida Nasal Aspirator, Medifrida Pacifier Medicine Dispenser, Breathe Fr...",Warehouse C,407,366,2025-02-28 08:05:00,41
1308,ORD_1309,33132,"OYO BABY Baby Bed Protector Dry Sheet for New Born Babies (Large (140cm x 100cm), Grey)",Warehouse B,273,246,2025-02-28 07:10:00,27
1309,ORD_1310,1642,My Newborn Baby Wrapper Blanket Daily Use Gift Hamper-Set of 5 Pcs (Kitty-Pink)&My Newborn Baby Mitten Cap and Booty Set -...,Warehouse A,29,23,2025-02-28 11:50:00,6
1310,ORD_1311,36695,"Neska Moda 12 To 18 Months Baby Girls Cotton Butterfly Booties (Mint,Blue) -BT1142andBT1153",Warehouse A,114,83,2025-02-28 03:20:00,31
1311,ORD_1312,3064,Health Up AD Vitamin Baby Oil - Ayurvedic Baby Massage Oil - 100% Safe for Baby's Soft Skin - 100mL - Pack of 02,Warehouse B,427,407,2025-02-28 23:47:00,20
1312,ORD_1313,239,Hopscotch Girls Cotton Floral Print Sleeveless Casual Dress in Multi Color,Warehouse C,445,440,2025-02-28 13:26:00,5
1313,ORD_1314,34318,URJO Unisex-Child Louis Sneaker,Warehouse A,366,330,2025-02-28 14:24:00,36
1314,ORD_1315,36703,BUMZEE Yellow & Orchid Half Sleeve Girls T-Shirt Pack of 2,Warehouse B,233,186,2025-02-28 02:40:00,47
1315,ORD_1316,34302,"LuvLap Naughty Duck Spout Sipper for Infant/Toddler, 210ml, Anti-Spill Sippy Cup with Soft Silicone Spout BPA Free, 6m+ (Y...",Warehouse B,404,359,2025-02-28 09:15:00,45
1316,ORD_1317,2249,"Bigbought Baby Boy and Baby Girl Cloth Set Combo Pack of Jhabla, Mittens, Booties and Cap, Pure Hosiery Soft Fabric, 0-4 M...",Warehouse A,231,202,2025-02-28 18:16:00,29
1317,ORD_1318,36714,ayushicreationa Kids Cotton Ankle Length Socks for Newborn Baby Infant Boys Girls Travel and Outdoor Breathable Multi-desi...,Warehouse A,158,110,2025-02-28 03:20:00,48
1318,ORD_1319,3051,Zeezeezoo Holi Baby Dress Romper Onesie Bodysuit Sleepsuit My First Holi,Warehouse A,304,295,2025-02-28 03:33:00,9
1319,ORD_1320,34306,"Styxon Kids Gym,Sport & Outdoor Space Hopper Ball Bouncing Inflatable Sit and Bounce Hop Ball 2 to 6 Year, Rubber - {Mult...",Warehouse A,377,331,2025-02-28 06:33:00,46
1320,ORD_1321,31746,Safe-O-Kid Silicone Baby Finger Brush with Case With Silicone Liquid Medicine Feeder/Dropper- Combo,Warehouse B,253,208,2025-02-28 07:41:00,45
1321,ORD_1322,1598,Hopscotch Girls Synthetic Graphic Print Mary Jane in Yellow Color,Warehouse C,401,366,2025-02-28 19:09:00,35
1322,ORD_1323,36674,Mammayo Baby Boy Pajama Girls Unisex Printed Summer Wear Lower Track Pant Leggings Cotton Kids Pajama Regular Fit Pyjama (...,Warehouse B,482,462,2025-02-28 15:28:00,20
1323,ORD_1324,34360,"Himalaya Diaper Rash Cream, 20g",Warehouse B,401,389,2025-02-28 09:31:00,12
1324,ORD_1325,34323,SMARTOTS Kids Casual Shoes for Baby Boys/Girls Age 15 Months to 4 Years L-4-RED,Warehouse B,183,156,2025-02-28 03:54:00,27
1325,ORD_1326,1683,"CottingtonLane- Baby Washcloths | Baby Muslin Washcloth | Pack of 10 for Newborn | 12"" x 12""",Warehouse C,329,312,2025-02-28 19:34:00,17
1326,ORD_1327,1685,THE LITTLE LOOKERS® Towel for Newborn/Baby/Kids| Super Soft Baby Bath Towel Set for Infants/Bathing Accessories| (0-2 Year...,Warehouse C,80,55,2025-02-28 06:41:00,25
1327,ORD_1328,34230,"Toddylon New Born Baby Gift Pack Daily Needs Items Combo (Multicolour, 0-6 Months)",Warehouse B,205,182,2025-02-28 16:35:00,23
1328,ORD_1329,31728,"B M C Newborn Baby Boys & Baby Girls Casual Bodysuit 1 Bib, 1 Cap, 2 Pajamas, 1 Upper Woolen Winter Wear Complete Clothes ...",Warehouse B,78,70,2025-02-28 14:26:00,8
1329,ORD_1330,1625,"Johnson's Baby Lotion For New Born, 500ml",Warehouse A,95,66,2025-02-28 01:37:00,29
1330,ORD_1331,34342,"Johnson's Baby Skincare Wipes with Lid, 144's +Johnson's Baby Powder 400g",Warehouse B,368,342,2025-02-28 13:45:00,26
1331,ORD_1332,34227,"Toddylon New Born Baby Gifts Combo Daily Needs Items (Multicolor, 0-6 Months)",Warehouse A,190,157,2025-02-28 21:46:00,33
1332,ORD_1333,34226,"Honest Company Diaper Rash Cream, Net Wt 2.5 oz(70.8g)",Warehouse B,215,194,2025-02-28 01:55:00,21
1333,ORD_1334,247,Stanwells Kids Cream and Pink Combo Baby Girls Knee Length Silk Frock (3months-7 Years),Warehouse A,482,449,2025-02-28 04:24:00,33
1334,ORD_1335,36758,"Neska Moda 12 To 18 Months Baby Girls Cotton Butterfly Frill Booties (Yellow,Red) -BT1147andBT1148",Warehouse A,463,425,2025-02-28 21:25:00,38
1335,ORD_1336,36764,Fancyflight Multi Color Girls Tutu Skirt for Fancy Dress Or Any Competition,Warehouse C,230,182,2025-02-28 10:21:00,48
1336,ORD_1337,34245,PROMISE KID baby-girls Kid dresses,Warehouse C,413,405,2025-02-28 01:51:00,8
1337,ORD_1338,33126,PUMA Toddler Girls Soft Sophia Lace Up Sneakers Shoes Casual - Green,Warehouse A,271,255,2025-02-28 11:34:00,16
1338,ORD_1339,34363,"MOMISY Baby Girl First Birthday Top and Bowknot Rainbow Skirt Romper with Shoes and Crown Headband Dress-12 to 24 Months, ...",Warehouse A,112,95,2025-02-28 23:51:00,17
1339,ORD_1340,34365,GJ Baby Baby-Boy's Regular Fit Shirt,Warehouse C,404,372,2025-02-28 01:19:00,32
1340,ORD_1341,36672,Mosrel Mosquito Repellent Cream clinically Proven Brand of Mosquito Repellent That Offers The Most Effective Protection fr...,Warehouse C,307,300,2025-02-28 07:58:00,7
1341,ORD_1342,34368,"Kidbee Baby Solid Super Soft Cotton Hosiery Color Boys & Girls Regular Shorts (Multicolor (Set of 5), 9-12 Months)",Warehouse A,156,113,2025-02-28 15:10:00,43
1342,ORD_1343,34369,"Pigeon Disposable Breast Pads,Comfy Feel,2X Softer,Gentle on Skin,Stay Dry All Day,Aloe Vera Extract,Dermatologically Tes...",Warehouse A,476,470,2025-02-28 08:38:00,6
1343,ORD_1344,2283,Hopscotch Unisex PVC Graphic Print Slip Ons in Yellow Color,Warehouse A,459,447,2025-02-28 10:35:00,12
1344,ORD_1345,34370,Babymoon Headbands Flowers Soft Cotton Hairbands for Baby Girls Infants Toddlers,Warehouse A,512,475,2025-02-28 07:29:00,37
1345,ORD_1346,34372,SYGA Baby Girls Rose Floral Headbands Hairbands Hair Accessories Rabbit Ears Nylon Elastic Headband Newborn Infant Toddler...,Warehouse B,246,228,2025-02-28 22:43:00,18
1346,ORD_1347,34220,"Himalaya Refreshing Baby Wash 400 ml & Himalaya Gentle Baby Shampoo (200ml) & Himalaya Diaper Rash Cream,100gm",Warehouse C,220,178,2025-02-28 20:48:00,42
1347,ORD_1348,3053,DOTMOM Premium Ultra Soft Organic Bamboo 3 in 1 Baby Hooded Bath Towel (White),Warehouse C,269,220,2025-02-28 15:51:00,49
1348,ORD_1349,33157,"Disney by Jagannath Gangaram Pednekar Since 1965 18KT Yellow Gold, Girls, Baby Bracelet",Warehouse B,83,37,2025-02-28 00:09:00,46
1349,ORD_1350,31742,Forest Essentials Baby Head Massage Oil Dasapushpadi|Baby Oil|200 ml,Warehouse C,267,257,2025-02-28 21:04:00,10
1350,ORD_1351,33188,Bold N Elegant Dog Cartoon Print Cotton Half Sleeve Tricolor Polo Tshirt with Shorts for Baby Boy Kids Clothes (Yellow - B...,Warehouse B,264,229,2025-02-28 05:30:00,35
1351,ORD_1352,34217,"Neska Moda 6 To 12 Months Baby Boys & Girls Pack of 3 Pair Cotton Lace Baby Booties (Black,Blue,Baby Pink) -SK145andSK137a...",Warehouse A,460,412,2025-02-28 00:03:00,48
1352,ORD_1353,231,Johnson's Baby Oil 200ml With Cotton-touch Newborn Massage Oil 100ml,Warehouse C,119,87,2025-02-28 02:27:00,32
1353,ORD_1354,34409,Gini & Jony Baby Regular fit Shirt (131010210652 1350_Green 12M),Warehouse A,456,436,2025-02-28 03:29:00,20
1354,ORD_1355,3042,Mee Mee Baby-Boy's Cotton Socks (Pack of 6)(Colors & Print May Vary),Warehouse A,204,189,2025-02-28 03:01:00,15
1355,ORD_1356,36658,Himalaya Babycare Gift Series,Warehouse A,383,368,2025-02-28 14:30:00,15
1356,ORD_1357,3046,"Neska Moda 12 To 18 Months Baby Girls Cotton Butterfly Booties (Red,Blue) -BT1142andBT1165",Warehouse B,306,297,2025-02-28 11:19:00,9
1357,ORD_1358,1575,TiniBerry Baby Boys Girls Cotton All Over Print Pajama Rib Pants Pack of 6 Assorted Prints Pack of 6,Warehouse A,74,28,2025-02-28 08:04:00,46
1358,ORD_1359,36661,HighEnd Baby's Jabla (JABLA PCOD 3_White_0 Months-3 Months),Warehouse A,197,164,2025-02-28 06:23:00,33
1359,ORD_1360,36663,"Mustela 2 in 1 Cleansing Gel, 200ml + Mustela Hydra Bebe Body Lotion, 300ml",Warehouse B,272,247,2025-02-28 13:51:00,25
1360,ORD_1361,36641,MY NEWBORN Baby Towel Bathrobe Hooded Blanket Wrapper- Meaw Pink,Warehouse C,155,109,2025-02-28 13:18:00,46
1361,ORD_1362,36639,Baby Moo Cute Puppy Checked Chu-Chu Sound Breathable Anti-Skid Sandals - Blue (18-24M),Warehouse B,390,342,2025-02-28 19:05:00,48
1362,ORD_1363,34211,Hopscotch Boys and Girls PVC Star Print Slip-Ons in Red Color,Warehouse B,50,10,2025-02-28 09:53:00,40
1363,ORD_1364,1561,Mini Storify Truly Organic Baby Finger Toothbrush soft bristles Reusable Silicon Made Food Grade Quality with Storage Case...,Warehouse B,125,107,2025-02-28 18:04:00,18
1364,ORD_1365,185,Pfroziel Baby laundry liquid detergent (5ltr) plant based surfactants I 5 bio enzymes I Formulated for babies skin with Ne...,Warehouse C,433,417,2025-02-28 16:01:00,16
1365,ORD_1366,36626,Fully soft sponge bath scrubber for babies for bathing use (Pink),Warehouse A,177,157,2025-02-28 00:07:00,20
1366,ORD_1367,3034,Philips Avent Ultra Air Pacifier Pack of 2 | High Ventilation | 98% Acceptance | BPA-Free | for Babies from 0-6 Months (Mo...,Warehouse B,122,78,2025-02-28 10:20:00,44
1367,ORD_1368,33044,CHIU Unisex Shoes,Warehouse B,59,53,2025-02-28 13:11:00,6
1368,ORD_1369,36621,"SAS Baby Girl Baby Boys Dungaree Set for Kids, a Fashioned Product,Print of t Shirt Might Differ with Cap",Warehouse C,466,438,2025-02-28 01:06:00,28
1369,ORD_1370,3096,"Chicco Baby Moments Essential Gift Pack Pink, Ideal Baby Gift Sets for Baby Shower, Newborn Gifting, New Parents, Birthday...",Warehouse A,140,91,2025-02-28 11:46:00,49
1370,ORD_1371,36646,"Mee Mee Mild Baby Liquid Laundry Detergent, 1.5L & Anti-Bacterial Baby Liquid Cleanser, No Alcohol, For Feeding Bottles/Bo...",Warehouse A,93,56,2025-02-28 04:31:00,37
1371,ORD_1372,34206,Capichino 2Pcs Winter Warm Earflap Beanie Cap with Knitted Muffler Set Baby Caps for Unisex Baby Boys and Baby Girls (Yell...,Warehouse B,34,15,2025-02-28 08:56:00,19
1372,ORD_1373,34215,"linenaffairs Swaddle for New Born Baby Swaddle Blanket, Muslin Swaddle for Newborn Baby Super Soft Premium Cotton Receivin...",Warehouse A,130,122,2025-02-28 18:07:00,8
1373,ORD_1374,34415,"Skinco New Born Baby Kit/Gift Pack (Blue), 12 Pcs Combo, All Essentials for 0-6 Months",Warehouse A,396,361,2025-02-28 19:28:00,35
1374,ORD_1375,34419,"Aquaphor Baby Healing Balm Stick With Avocado Oil and Shea Butter, 0.65 Oz/18.4g",Warehouse B,84,53,2025-02-28 03:40:00,31
1375,ORD_1376,33060,SuNZita Bath tub for Baby Inflatable Bath tub for Kids Baby Inflatable Bath - 2 Feet - Multi Color,Warehouse C,277,239,2025-02-28 05:55:00,38
1376,ORD_1377,36665,StarAndDaisy Sunrise Baby Stroller and Pram with Extended Mosquito Net and Ultra Soft Cushions & Reversible Handlebar Stro...,Warehouse A,302,264,2025-02-28 03:04:00,38
1377,ORD_1378,34390,Infantbond Baby Clothing Set(Total Items: 20)(0-3 Months)(Assorted),Warehouse A,32,19,2025-02-28 22:48:00,13
1378,ORD_1379,34416,"Himalaya Total Care Baby Pants Diapers, Medium, 78 Count and Gentle Soap Value Pack, 4 * 75g Combo",Warehouse B,137,118,2025-02-28 13:08:00,19
1379,ORD_1380,31676,"IKEA Home and Kitchen, Baby Care wash tub (Foldable).",Warehouse A,401,354,2025-02-28 03:16:00,47
1380,ORD_1381,1577,Cuckoos New Born Baby Winter Wear Keep Warm Cartoon Printing Baby Clothes 5Pcs Sets Baby Boys Girls Unisex Baby Fleece/Fal...,Warehouse C,412,373,2025-02-28 04:24:00,39
1381,ORD_1382,33079,"Dancing Cactus,Talking Cactus Toy,Sunny The Cactus Repeats What You Say,Electronic Dancing Cactus Toy with Lighting,Singin...",Warehouse A,487,450,2025-02-28 12:06:00,37
1382,ORD_1383,36650,Funvention- for Little Scientist in Every Kid Fun Fidgets - Assorted - Pack of 24 (6 x 4 DIY Miniature Mechanical Models (...,Warehouse A,463,446,2025-02-28 20:09:00,17
1383,ORD_1384,2231,KAVIN Set Of 2 Printed Design Feather Cap Festival Celebration Hat For Kids And Adults Random Colours Pack Of 1,Warehouse A,59,15,2025-02-28 10:17:00,44
1384,ORD_1385,3033,"FOOTPRINTS Boy's Organic Cotton Big Dot and Colorful Stripe Socks (Multicolor, 3-5 Years) - Pack of 8 Pairs",Warehouse B,503,471,2025-02-28 01:45:00,32
1385,ORD_1386,36615,"LuvLap Memory Foam Baby Head Shaping Pillow, Baby Pillow for Preventing Flat Head Syndrome, 25 cm X 21 cm X 4.2 cm, 0m+, B...",Warehouse C,233,211,2025-02-28 21:14:00,22
1386,ORD_1387,2265,"RYLAN Baby Kids Water Play Mat Toys Inflatable Tummy Time Leakproof Water Play Mat, Fun Activity Play Center Indoor and Ou...",Warehouse C,167,138,2025-02-28 14:42:00,29
1387,ORD_1388,34432,Mee Mee Baby Lotion With Fruit Extracts- 200 ml (Single Pack) & Mee Mee Baby Gentle Wet Wipes with Lemon extracts |72 pcs|...,Warehouse B,238,216,2025-02-28 12:25:00,22
1388,ORD_1389,263,Khasala Brothers® Jhoomer Merry Go Round Hanging Toy for New Born Baby with Rattles Soothing Sound for Kids ( Multicolor ),Warehouse A,236,217,2025-02-28 16:56:00,19
1389,ORD_1390,1557,VMart Infant Printed Knit-Knit Round Neck Coordinated Sets,Warehouse A,75,58,2025-02-28 01:26:00,17
1390,ORD_1391,2226,"Nestle LACTOGEN 2 Follow-Up Formula Powder - After 6 months, Stage 2, 400g Bag-in-Box Pack",Warehouse A,301,293,2025-02-28 06:11:00,8
1391,ORD_1392,2314,"Phillips Avent Microwave Sterilizing Bag SCF297/05 | Kills 99.9% Germs | Sterilizes Bottles, Breast Pump and Baby Products...",Warehouse C,472,443,2025-02-28 09:16:00,29
1392,ORD_1393,1549,"LuvLap Anti-Skid, Anti-Slip Footware for Baby & Toddler, Breathable Baby Soft Shoe Socks, Soft Flexible Rubber Sole",Warehouse B,354,314,2025-02-28 03:34:00,40
1393,ORD_1394,1696,"LuvLap 100% Cotton Muslin Baby Swaddle Set, Printed Muslin Swaddle Wrap for New Born Baby, Size-120cm x 100cm, 0-18 Mont...",Warehouse A,170,129,2025-02-28 09:49:00,41
1394,ORD_1395,33206,"Mamaearth Rice Hair Oil with Rice Bran & Coconut Oil For Damaged, Dry and Frizzy Hair 150ml",Warehouse A,497,456,2025-02-28 22:55:00,41
1395,ORD_1396,193,QIUYI Toddler Cartoon Slippers Fashion Autumn And Winter Boys And Girls Slippers Flat Bottom Non Slip Soft Warm Shoes,Warehouse C,392,359,2025-02-28 10:07:00,33
1396,ORD_1397,2289,iota Microfiber 70X140CM & 350 GSM Ultra Soft & Hygeine Premium Cyan Baby Bath Towel for Newborn Baby,Warehouse B,244,210,2025-02-28 17:12:00,34
1397,ORD_1398,1672,Hopscotch Boys Red Stripe Print Shirt & Pant Set With Waistcoat (6-12 Months) HSP-3691345,Warehouse B,201,165,2025-02-28 20:26:00,36
1398,ORD_1399,33144,"SAFE-O-KID - 2 Meter Bedrail, Plain Washable Bed Rails Full Bed Size, (6.5 ft/ 78 inches/199 cms/x 2.1 ft/ 25 inches/63 cm...",Warehouse A,320,313,2025-02-28 04:09:00,7
1399,ORD_1400,31711,"Himalaya Baby Shampoo (400 ml) & Himalaya Diaper Rash Cream,100gm",Warehouse B,30,14,2025-02-28 10:40:00,16
1400,ORD_1401,36708,RATNA'S Squeezy Baby with Duck Premium Quality Bath TIME and Playtime Toys for Infants,Warehouse B,272,224,2025-02-28 19:00:00,48
1401,ORD_1402,31688,HIBA Baby Girls Skirt Attached with Panty 0-6 Months Red,Warehouse B,126,115,2025-02-28 01:30:00,11
1402,ORD_1403,36707,"LuvLap Tiny Giffy Sipper for Infant/Toddler 300ml, Anti-Spill Sippy Cup with Soft Silicone Straw BPA Free, 18m+ (Green)",Warehouse A,397,380,2025-02-28 03:33:00,17
1403,ORD_1404,1558,"Neska Moda 12 To 18 Months Baby Girls Cotton Butterfly Booties (Yellow,Black) -BT1150andBT1166",Warehouse A,51,10,2025-02-28 16:24:00,41
1404,ORD_1405,31667,"NASA Winter Sweater Cotton Full Sleeve Romper for Baby Boys & Baby Girls 3D Printed Pack of 3 (18-24 M, White, Green, Yellow)",Warehouse C,249,203,2025-02-28 06:53:00,46
1405,ORD_1406,36632,"MWSLY Kids U-Shaped Silicone Toothbrush,Food Grade Soft Silicone Brush Head, 360� Oral Teeth Cleaning Design for Toddlers ...",Warehouse B,218,199,2025-02-28 09:38:00,19
1406,ORD_1407,2219,"BABY FOREST Dulaar Pyar Talc-Free Baby Powder| With Chamomile Flower Oil, Jojoba Seed Oil, Marigold Seed Oil & Corn Starc...",Warehouse C,302,284,2025-02-28 05:33:00,18
1407,ORD_1408,2217,Idol Look New Born Baby Unisex Cap (3-6 Months) Set of 3,Warehouse C,324,276,2025-02-28 11:20:00,48
1408,ORD_1409,31775,Johnson's Baby Lotion 500ml and Baby Cream 50g,Warehouse C,120,102,2025-02-28 01:13:00,18
1409,ORD_1410,2316,"Neska Moda 12 To 18 Months Baby Girls Pack Of 2 Pair Cotton Butterfly Frill Booties (Black,Red) -BT1159andBT1172",Warehouse B,305,266,2025-02-28 14:23:00,39
1410,ORD_1411,3097,"linenaffairs Swaddle Blanket 100% Organic Cotton Muslin, Wrap Cloth Cotton Swaddle for Newborn Baby Girl's and Boy's Soft ...",Warehouse A,97,58,2025-02-28 19:15:00,39
1411,ORD_1412,33040,Aveeno Daily Moisture Baby Lotion 8oz,Warehouse C,309,264,2025-02-28 13:21:00,45
1412,ORD_1413,2318,Himalaya Nourishing Baby Soap Combo (Pack of 3)125GM,Warehouse C,44,30,2025-02-28 00:23:00,14
1413,ORD_1414,1545,"Wakefit Pregnancy Pillows for Sleeping | 3 Month Warranty | Pregnancy Pillow, Maternity Pillow, Pregnancy Pillow for Pregn...",Warehouse C,311,289,2025-02-28 22:20:00,22
1414,ORD_1415,272,Himalaya Gentle Baby Wash (400ml),Warehouse B,273,255,2025-02-28 17:05:00,18
1415,ORD_1416,36610,1st Step Powder Box with Refillable Powder Puff (Pink),Warehouse A,466,461,2025-02-28 13:11:00,5
1416,ORD_1417,34458,MINI KLUB Baby-Boys T-Shirt,Warehouse C,244,207,2025-02-28 02:18:00,37
1417,ORD_1418,34202,"Only 4 Baby 100% Cotton Baby Boys & Girls Front Open Full Sleeve-Night Suit,Casual Wear Set",Warehouse B,288,244,2025-02-28 13:20:00,44
1418,ORD_1419,36633,Little Crowns Amelia Floral Turban with Bow for Baby Girl from 0 to 12 Months and Child from 1 to 6 Year Old in Premium Co...,Warehouse A,369,336,2025-02-28 23:56:00,33
1419,ORD_1420,1695,Smuktar garments Kid's BHARAT MATA Synthetic Costume,Warehouse B,243,200,2025-02-28 21:51:00,43
1420,ORD_1421,34430,"Neska Moda 0 To 6 Months Baby Boys & Baby Girls Cotton Lace Shoes/Booties (Red,Rani) -BT377andBT1138",Warehouse A,225,220,2025-02-28 18:49:00,5
1421,ORD_1422,33183,Puma Unisex-Kid Axel V2 Pre-School Black-Vibrant Orange-Deep Aqua Sneaker - 2UK (39461002),Warehouse A,514,481,2025-02-28 18:04:00,33
1422,ORD_1423,1972,Philips Avent NATURAL 2.0 BOTTLE 260ml Single SCF033/10,Warehouse A,257,210,2025-02-28 17:33:00,47
1423,ORD_1424,1995,Hopscotch Baby Girls Polyester Sequin Round Neck Tutu Dress in Pink Color for Ages,Warehouse C,240,206,2025-02-28 05:09:00,34
1424,ORD_1425,33609,Mama Panda Baby Grooming Set/Kit with Nail Cutter Foiler Scissors and Tweezer for New Born (Baby Pink),Warehouse C,329,294,2025-02-28 05:58:00,35
1425,ORD_1426,33534,"Tikitoro Premium Gift Box for Kids, Body and Hair Combo Pack - Contains Nourishing Body wash, Conditioning Shampoo & Sooth...",Warehouse B,323,290,2025-02-28 20:48:00,33
1426,ORD_1427,33628,DARSHRAJ JEWELLERS 925 Sterling Silver kada for Baby Boys & Baby Girls (5.4 gm Approx.) Adjustable Size-Best for 1-3 Years...,Warehouse C,384,349,2025-02-28 16:40:00,35
1427,ORD_1428,33634,Seven Mile Newborn Infant Boys 100% Bamboo Cotton Half Sleeve Front Open Romper Clothing Set Night Suit Dress Summer Rompe...,Warehouse B,336,303,2025-02-28 13:29:00,33
1428,ORD_1429,1985,Mamaearth Onion Hair Oil For Hair Growth With Onion & Redensyl For Hair Fall Control - 250Ml,Warehouse A,417,392,2025-02-28 18:06:00,25
1429,ORD_1430,37098,"PLUSPOINT Baby Phone Toy for 1 2 3 Year Old with Light, Music - Phone Toy for Baby 6-36 Months Toddler Kids Educational Ph...",Warehouse B,412,391,2025-02-28 12:32:00,21
1430,ORD_1431,1982,BUMZEE White & Orange Half Sleeve Baby Boys T-Shirt & Pajama Set Pack Of 2 Age - 18-24 Months,Warehouse A,168,152,2025-02-28 12:37:00,16
1431,ORD_1432,33526,Webby Green Soft Dinosaur Plush Stuffed Toy 30cm,Warehouse B,141,117,2025-02-28 14:59:00,24
1432,ORD_1433,33643,USHA Baby Girl's Knee length dress,Warehouse A,330,303,2025-02-28 08:00:00,27
1433,ORD_1434,33599,SHAYONAM 8 PCS Edge Protector for Furniture Table Corner Guards for Sharp Edges Silicon Corner Protector for Sharp Edges G...,Warehouse C,313,284,2025-02-28 11:52:00,29
1434,ORD_1435,33567,TERI BERI Baby Girls and Baby Boys Cotton Bloomers for Kids (Multicolour Pack of 6 Pcs),Warehouse C,259,236,2025-02-28 19:33:00,23
1435,ORD_1436,2041,Mamaearth Charcoal Nourishing Soap With Charcoal and Mint for Deep Cleansing - 5x75g,Warehouse C,479,436,2025-02-28 06:32:00,43
1436,ORD_1437,3,Kerwa Camisole Slips Under Dresses for Baby Girls Toddler Underwear Inner wear Cut Sleeveless Cotton Vest top Undershirt M...,Warehouse A,340,312,2025-02-28 12:34:00,28
1437,ORD_1438,24,DEV GUN 4 in 1 Nail Clipper Safety Cutter Scissor Manicure Pedicure Care Kit for Baby (Pink),Warehouse B,434,416,2025-02-28 02:03:00,18
1438,ORD_1439,33623,SMARNN Silver Plated Kada Bangles Bangle Set Nazariya for New born baby boy girl kid Adjustable (0-9 months),Warehouse C,520,490,2025-02-28 08:13:00,30
1439,ORD_1440,37007,"abracadabra Cotton Terry Hooded Towel with 2 Face Washers for Infants, Toddlers & Kids, 3 Pieces, Size 75 Cm X 75 Cm - Blo...",Warehouse A,127,122,2025-02-28 11:59:00,5
1440,ORD_1441,37003,"GURU KRIPA BABY PRODUCTS Infants Cotton Hosiery Mittens (Multicolour, 0-6 Months) - Pack of 12",Warehouse C,74,57,2025-02-28 10:37:00,17
1441,ORD_1442,1879,Brim Hugs & Cuddles Printed Baby Bag/Carry Bed/Bed (Blue),Warehouse C,88,40,2025-02-28 03:47:00,48
1442,ORD_1443,33828,Himalaya’s Baby Powder To keep cool and stay fresh (200 Gm) Pack of 2,Warehouse B,127,99,2025-02-28 21:18:00,28
1443,ORD_1444,33835,"Cetaphil Baby Daily Lotion 400ml, Pack of 2 (800ml Total)",Warehouse B,187,171,2025-02-28 14:11:00,16
1444,ORD_1445,37059,"Safe-O-Kid Wrist Link, Adjustable Strap Safety Link for Baby- Pink",Warehouse B,513,498,2025-02-28 05:42:00,15
1445,ORD_1446,33725,GURU KRIPA BABY PRODUCTS Presents Baby Banana Traning Toothbrush Teether With Soft Bristles Bendable Flexible 100% Safe Fo...,Warehouse C,497,482,2025-02-28 13:57:00,15
1446,ORD_1447,44,Boy's Cotton Goggles Printed Casual T-Shirt with Shorts set for baby boys,Warehouse C,204,167,2025-02-28 00:28:00,37
1447,ORD_1448,33612,MUKHAKSH (Set = 2 Pieces Kids/Boys/Girls/Unisex Winter Woolen Warm Red Beanie Cap with Scarfwinter Warm Hats,Warehouse A,115,104,2025-02-28 14:26:00,11
1448,ORD_1449,37105,"Mamaearth Anti Mosquito Fabric Roll On 8ml. DEET Free. Protects from Dengue, Malaria & Chikungunya & Natural Toothpaste, O...",Warehouse B,433,395,2025-02-28 02:19:00,38
1449,ORD_1450,33616,Baby's Cartoon Face Booty Cotton Socks (Pack Of 2) (SW-UNISEX-BABY-SHOES-05_Multicolour),Warehouse A,321,315,2025-02-28 08:30:00,6
1450,ORD_1451,33619,haus & kinder 100% Muslin Cotton Swaddle Wrap for New Born Baby - Pack of 5 (Blue),Warehouse A,270,227,2025-02-28 16:28:00,43
1451,ORD_1452,33622,MINI BERRY Baby Gift Set for New Born in 10 PCs,Warehouse B,495,482,2025-02-28 00:04:00,13
1452,ORD_1453,5,Mi Arcus Cotton Solid White Dress/Midi for Baby Girl Round Neck with Short Frill Sleeve Casual Comfortable Frock,Warehouse C,212,195,2025-02-28 19:21:00,17
1453,ORD_1454,2031,"Neska Moda 12 To 18 Months Baby Boys & Baby Girls Cotton Lace Shoes/Booties (Black,Rani) -BT1155andBT1184",Warehouse A,375,339,2025-02-28 11:30:00,36
1454,ORD_1455,33821,Vaipani Melorica Oil - 50 ml (Breast Massage Oil),Warehouse A,274,242,2025-02-28 14:12:00,32
1455,ORD_1456,37076,"Tiny Kids Running Led Shoes, Casual Led lace Up Shoes Light Weight Outdoor Sports Shoes for Boys & Girls",Warehouse C,279,262,2025-02-28 20:42:00,17
1456,ORD_1457,3176,Baby Boys & Girls Cotton Printed Multicolour T Shirt Pack of 3,Warehouse B,504,471,2025-02-28 00:54:00,33
1457,ORD_1458,33694,"Softsens Baby TEAR FREE Shampoo | Mild, Hypoallergenic , Paraben & Sufate Free 200ml",Warehouse C,209,187,2025-02-28 22:05:00,22
1458,ORD_1459,33500,MIST N FOGG Boy's and Girl's Regular Fit Cotton Shorts(Pack of 4),Warehouse A,90,50,2025-02-28 13:28:00,40
1459,ORD_1460,37067,Lwvax Baby Hair Brush and Comb Set for Newborn Baby Grooming Set for 0 Month to 5 Year(Random Color),Warehouse C,59,28,2025-02-28 05:55:00,31
1460,ORD_1461,33714,"Neska Moda 6 To 12 Months Baby Girls Pack Of 2 Pair Cotton Butterfly Frill Booties (Maroon,Black) -BT85andBT44",Warehouse B,384,352,2025-02-28 17:55:00,32
1461,ORD_1462,33717,Clever Baby Girl's Tshirt,Warehouse A,200,163,2025-02-28 05:47:00,37
1462,ORD_1463,33492,"Bikram Cotton Multicolor Vests for Baby (Pack of 6, PE01, 36)",Warehouse B,269,235,2025-02-28 17:24:00,34
1463,ORD_1464,37071,SYGA 3 Pcs Children Girl Baby Elastic Hairband Princess Wind Bow Flower Headband Suit Baby Headdress Photo Hair Accessorie...,Warehouse B,200,193,2025-02-28 07:31:00,7
1464,ORD_1465,31503,GIVA 925 Sterling Silver Rose Gold Lucky Hearts Kids Nazariya Bracelet | Birthday Gifts for Kids | With Certificate of Aut...,Warehouse C,294,270,2025-02-28 17:01:00,24
1465,ORD_1466,33524,Nirava Ayurveda Lakshadi Baby Massage Oil,Warehouse A,171,151,2025-02-28 14:50:00,20
1466,ORD_1467,37094,"Dr. Brown's Wide Neck Options Alternative Kit (270 Ml, Pack of 2, Green)",Warehouse C,382,336,2025-02-28 18:22:00,46
1467,ORD_1468,31495,Burt's Bees - Baby Bee Shampoo & Wash Tear Free Original - 8 oz.,Warehouse B,386,357,2025-02-28 00:48:00,29
1468,ORD_1469,33557,Optifit® Baby Fruit Spoon Scraper for Baby Feeding 2 in 1 Multifunction Serrated Grapefruit Fruit Spoon for Kids,Warehouse B,395,349,2025-02-28 02:35:00,46
1469,ORD_1470,33586,Mamaearth Argan Shampoo - 250 ml + Argan Conditioner - 250ml,Warehouse B,280,267,2025-02-28 09:24:00,13
1470,ORD_1471,37120,"Neska Moda 12 To 18 Months Baby Boys & Baby Girls Cotton Rabbit Booties (Blue,Red) -BT1156andBT1176",Warehouse C,385,362,2025-02-28 09:18:00,23
1471,ORD_1472,3192,Curatio Atogla Baby Cream - 100Ml (Pack Of 2),Warehouse A,48,12,2025-02-28 09:17:00,36
1472,ORD_1473,2017,"Oral B Vitality Criss Cross Electric Rechargeable Toothbrush with Travel Case, with replaceable brush head included (White...",Warehouse C,136,117,2025-02-28 20:32:00,19
1473,ORD_1474,33598,"baby wish Cotton Baby Hooded Towels for New Born Bath Towel Set Absorbent and Hypoallergenic, Natural Baby Towel Perfect f...",Warehouse A,459,428,2025-02-28 22:28:00,31
1474,ORD_1475,1977,Funky Baby Tutu Crochet Tube Top - Royal Blue,Warehouse C,46,14,2025-02-28 01:43:00,32
1475,ORD_1476,33503,Bodyguard Aloe Vera Based Natural Wet Wipes For Babies With Goodness Of Vitamin E | Moisturizing Baby Wet Wipes For Baby's...,Warehouse B,425,376,2025-02-28 08:13:00,49
1476,ORD_1477,31734,CHIU Unisex-Baby's Modern Shoes,Warehouse A,282,273,2025-02-28 12:03:00,9
1477,ORD_1478,33797,"Little Pumpkin Kiddie Kingdom Baby Stroller, 3 Position Recline, Pram for Kids and Infants, Adjustable Backrest, 360° Swiv...",Warehouse B,460,414,2025-02-28 09:24:00,46
1478,ORD_1479,63,Hopscotch Girl's Cotton Short Set,Warehouse C,57,27,2025-02-28 00:12:00,30
1479,ORD_1480,33799,Navjai Baby Girl's Woolen Sweater Skirt Frock with Pyajami Shawl Coller Full Sleeve Winter Dress Set for Kid Girl 1-3year ...,Warehouse A,73,57,2025-02-28 05:25:00,16
1480,ORD_1481,33441,Olbas Oil for Children 12Ml,Warehouse C,421,373,2025-02-28 23:05:00,48
1481,ORD_1482,33807,MINI KLUB Baby Boy's Cotton Cap (95IEBCP569_Off White_One Size),Warehouse A,437,420,2025-02-28 20:41:00,17
1482,ORD_1483,31533,"Soft Fur Booties, Mix Colors, for 0 Month to 12 Months Baby's",Warehouse A,47,41,2025-02-28 12:14:00,6
1483,ORD_1484,33734,Himalaya BabyCare Summer Combo (Refreshing Soap 75g*3 + Prickly Heat Powder 100g),Warehouse A,217,178,2025-02-28 19:41:00,39
1484,ORD_1485,49,10pcs Baby Lace Elastic Chiffon Flower Headbands Gold Headband for Baby Girl Toddler Hair Bands Princess Girls Hair Access...,Warehouse C,113,86,2025-02-28 04:53:00,27
1485,ORD_1486,33483,CLOTH KING Presents Kids Unisex Pure Cotton Baby Socks Kids Ankle Length Socks Kids Animal Print Socks Summer Socks Combo...,Warehouse C,61,40,2025-02-28 08:16:00,21
1486,ORD_1487,31518,Mudgal India Creations Baby Boys and Girls Cotton Printed Multicolor Bloomers (Pack of 6 Pcs),Warehouse B,373,332,2025-02-28 18:40:00,41
1487,ORD_1488,33752,"Mamaearth Nourishing Hair Oil for Babies 100ml (0-10 Years) änd Nourishing Baby Wash (400 Ml, 0-5 Yrs)",Warehouse C,478,466,2025-02-28 05:12:00,12
1488,ORD_1489,1919,"SNAANA Baby Powder, 50 Gm",Warehouse C,196,157,2025-02-28 21:53:00,39
1489,ORD_1490,37053,Hopscotch Boys Cotton Solid Slim-Fit Short in Gray Color,Warehouse A,201,195,2025-02-28 00:54:00,6
1490,ORD_1491,37029,"Figaro Baby Lotion with Goodness of Natural Olive oil enriched with vitamin E, Dermatologically tested, 400 ml",Warehouse C,475,458,2025-02-28 15:57:00,17
1491,ORD_1492,33182,"Elegant Baby Soft Hair Brush and Comb Baby Care Set for Newborns Baby, Grooming Hair Care Products for Babies & Infants Ba...",Warehouse C,346,338,2025-02-28 03:26:00,8
1492,ORD_1493,34223,Children Hub Electric Baby Nail Clippers - Nail Trimmer File with LED Light for Newborn Infant Toddler Kids - with 6 Grind...,Warehouse B,359,314,2025-02-28 03:38:00,45
1493,ORD_1494,34354,INFANEO� Quick Drying High Absorbent Seamless Prints Baby & Kids Super-Soft Muslin Square Cotton Bath Towel Wash Cloth - 1...,Warehouse B,341,306,2025-02-28 23:26:00,35
1494,ORD_1495,35820,"Himalaya Baby Summer Gift Basket (Pack of 7 with Teddy) & Himalaya Extra Moisturizing Baby Wash, 400 ml",Warehouse A,477,460,2025-02-28 23:33:00,17
1495,ORD_1496,34027,Lillypupp Baby Girl Shoes Sandals Footwear for New Born Baby Girl,Warehouse C,90,81,2025-02-28 08:38:00,9
1496,ORD_1497,34190,"Devek' s Women's Rayon Maternity Dress, Pregnancy Dress,Easy Breast Feeding, Breast Feeding Dress Zippers for Nursing Pre ...",Warehouse B,386,359,2025-02-28 06:28:00,27
1497,ORD_1498,31528,Baby Boy Dress Clothes Toddler Outfits Infant Tuxedo Formal Suits for Kids Long Sleeve Shirt Pants Set,Warehouse B,56,26,2025-02-28 04:30:00,30
1498,ORD_1499,37037,"VT VIRTUE TRADERS Baby Gloves Winter Warm Lovely Knitted Gloves Kid Mittens For 0-24 Months (Assorted Color, Pack Of 6 Pairs)",Warehouse C,361,335,2025-02-28 20:14:00,26
1499,ORD_1500,33450,"Maate Baby Hair Oil | Protein Rich Oil for Baby Hair Growth | Enriched with Hibiscus, Bhringraj & Vitamin Rich Almond Oil...",Warehouse B,334,314,2025-02-28 22:32:00,20
1500,ORD_1501,1901,Mee Mee Fluoride-Free Mild Toddler Toothpaste (Strawberry Flavour) 70 G,Warehouse C,216,176,2025-02-28 12:07:00,40
1501,ORD_1502,33792,"Johnson's Baby Skincare Cream, Milk + Rice, 100g",Warehouse B,192,169,2025-02-28 14:52:00,23
1502,ORD_1503,1898,Mothercare Baby-Girls ZA951,Warehouse C,301,292,2025-02-28 10:50:00,9
1503,ORD_1504,1909,Max Boys Colourblocked Crew Neck T-Shirt,Warehouse C,499,458,2025-02-28 01:50:00,41
1504,ORD_1505,3167,"Baybee Wooden Hammer Case Toy Knock Pounding Bench for Kids, Developing Fine Motor and Dexterity Skills, Early Educational...",Warehouse A,284,257,2025-02-28 21:37:00,27
1505,ORD_1506,3162,"Himalaya Gift Pack&Total Care Baby Pants Diapers, Extra Large, 74 Count",Warehouse A,302,280,2025-02-28 22:25:00,22
1506,ORD_1507,3154,DAYZ Kids Sports Shoes,Warehouse C,95,90,2025-02-28 12:26:00,5
1507,ORD_1508,36975,Mumkey Womens Cotton Striped Maternity Midi Dress with Front Zip for Nursing,Warehouse B,428,394,2025-02-28 12:27:00,34
1508,ORD_1509,33865,FWQPRA® Baby Bath Tub with Bath Stand Large Size Anti-Slip Bottom Non-Toxic Material Children Bathtub Bucket for Baby Bath...,Warehouse B,91,58,2025-02-28 22:42:00,33
1509,ORD_1510,36971,Googogaaga Boy's Cotton Full Sleeves Sweatshirt With Pant Set in Yellow Color (1Yrs),Warehouse C,380,334,2025-02-28 17:48:00,46
1510,ORD_1511,33871,Infantbond 11 in 1 New Born Baby Gift Pack | Combo Set | New Born Baby Items| New Born Baby Products All (0-3 Months)(Pink...,Warehouse A,83,34,2025-02-28 14:00:00,49
1511,ORD_1512,1856,"Mamaearth Nourishing Hair Oil for Babiesand Soothing Massage Oil for Babies (100 ml, 0-5 Yrs)",Warehouse C,60,31,2025-02-28 20:43:00,29
1512,ORD_1513,1871,KHODAL SAMRAJYA Boy's sweat shirt jogger set. (Little Boy-Pink-$Parent),Warehouse A,193,160,2025-02-28 06:11:00,33
1513,ORD_1514,37014,"LuvLap 4-in-1 Infant/Baby Car Seat & Carry Cot with Canopy, 0 to 15 Months (Dark Blue)",Warehouse A,112,106,2025-02-28 09:53:00,6
1514,ORD_1515,33434,Coco Soul Baby Ayurvedic Head to Toe Wash - From the Makers of Parachute Advansed 200ml,Warehouse C,65,16,2025-02-28 01:59:00,49
1515,ORD_1516,33817,APRIME ADDA Unisex Baby Crawling Anti-Slip Knee Pads Toddler Knee Protectors Learn to Crawl Socks Leg Warmers,Warehouse C,453,436,2025-02-28 17:03:00,17
1516,ORD_1517,37011,Babuline Baby Soap (Pack of 4),Warehouse A,265,246,2025-02-28 07:05:00,19
1517,ORD_1518,31537,GUCHIGU Unisex Baby Knee High Socks Toddlers Breathable Cute Print Sock Anti-mosquito Long Knit 2 Pair Cotton Ankle Socks ...,Warehouse C,296,259,2025-02-28 09:31:00,37
1518,ORD_1519,1882,"Young Birds Summer Casual Dress (12-18 Months, Pink Stripe)",Warehouse B,209,160,2025-02-28 03:32:00,49
1519,ORD_1520,68,Baby Jabla 0-3 Months New Born baby With Paint Pack Of 6,Warehouse B,163,156,2025-02-28 23:32:00,7
1520,ORD_1521,2089,"KASUMBI Soft Anti Cellulite Silicone Baby Bath Scrubber Hand Gloves Brush,Mini Small Baby Bath Brush for Bathing 1 to 2 Ye...",Warehouse B,432,393,2025-02-28 19:19:00,39
1521,ORD_1522,2111,My Milestones Half Sleeves Cotton Stripes T Shirt/Tops for Baby Girls (Pack of 2),Warehouse C,325,299,2025-02-28 15:10:00,26
1522,ORD_1523,33844,"R for Rabbit Caramello Baby Kid Diaper Bag for Mother, Waterproof, Large Capacity Maternity Backpack for Travel (Black)",Warehouse C,219,198,2025-02-28 20:22:00,21
1523,ORD_1524,33468,"SYGA Baby Girls Nylon Headbands Hairbands Hair Accessories Soft Double Flower Bow Headband for Newborns, Infants, Toddlers...",Warehouse B,302,297,2025-02-28 13:18:00,5
1524,ORD_1525,1862,Sanosan Baby Care Soap with Hydrolysed Milk Protein and Organic Olive Oil - 100gm,Warehouse A,46,21,2025-02-28 12:45:00,25
1525,ORD_1526,37049,Freshfoot Baby Boys & Girls Cute & Colorful Cotton Ankle Socks For New Born Baby (0-12 Months) (Pack of 6) Cartoon (Mixed 4),Warehouse A,521,498,2025-02-28 10:30:00,23
1526,ORD_1527,33763,"BeeBaby Silicone Finger Brush with Carry Case, (Violet) (Pack of 2)",Warehouse A,272,233,2025-02-28 12:16:00,39
1527,ORD_1528,33466,Hopscotch Boys Cotton and Spandex Full Sleeves Animal Printed Sweatshirt and Jeans Set in Beige Color,Warehouse C,395,358,2025-02-28 00:09:00,37
1528,ORD_1529,33460,coucal Embroidered Baby Girls' wear White,Warehouse A,142,120,2025-02-28 10:17:00,22
1529,ORD_1530,2077,Mamaearth Milky Soft Natural Baby Face Cream for Babies 60Ml and Mamaearth Natural Anti Mosquito Body Roll On 40Ml. Deet F...,Warehouse C,502,489,2025-02-28 08:22:00,13
1530,ORD_1531,33784,GLAN Baby Girls and Boys Round Cap for Summer Season Pink 20 Gram Pack of 1,Warehouse C,216,210,2025-02-28 15:05:00,6
1531,ORD_1532,33811,Kiwi Instant Polish - Brown Leather 85ml (Pack of 2),Warehouse B,63,52,2025-02-28 08:40:00,11
1532,ORD_1533,33812,"Hopscotch Baby Boys and Baby Girls Synthetic/PU Graphic Print Applique Casual Shoes in Blue Color, UK:3 (FWS-4330297)",Warehouse C,272,266,2025-02-28 03:41:00,6
1533,ORD_1534,33847,Mothercare Girl's Cotton VA349 Baby and Toddler Suit,Warehouse B,355,315,2025-02-28 09:51:00,40
1534,ORD_1535,33413,ROCKBURG India Baby Soft Cushioned Potty Training Seat | Back Support for Toddler Boys Girls | Kids Toilet seat for Wester...,Warehouse A,419,389,2025-02-28 06:56:00,30
1535,ORD_1536,33412,"Laley Reusable/Washable Baby Diapers 0-2 Years Babies Infant Toddlers, Adjustable Pocket Cloth Diapers for Newborn Baby wi...",Warehouse C,59,10,2025-02-28 03:11:00,49
1536,ORD_1537,36987,Susi - Baby Cradle Cloths with Mosquito Net - Net for Baby Jhula/Baby Swing with Zip Opening_0 to 3 Years_Sky Blue,Warehouse A,291,265,2025-02-28 02:40:00,26
1537,ORD_1538,36986,Baby Dreams Finger Toothbrush,Warehouse B,430,405,2025-02-28 13:41:00,25
1538,ORD_1539,36984,"Himalaya Baby Care All Soaps Combo, (Pack of 4) 125g",Warehouse B,185,159,2025-02-28 14:32:00,26
1539,ORD_1540,1863,"Little's Baby Pants Diapers with Wetness Indicator and 12 Hours Absorption, Small (S), 4 - 8 kg, 168 Count",Warehouse A,280,240,2025-02-28 20:24:00,40
1540,ORD_1541,36982,"Braj Sundari Frock Dress for Girls, Baby Girl Frock Dress, Knee Length Frock_Tony",Warehouse C,418,394,2025-02-28 23:05:00,24
1541,ORD_1542,36142,Baby Moo Cute Puppy Checked Chu-Chu Sound Breathable Anti-Skid Sandals - Multicolour (2Y-2.5Y),Warehouse C,119,82,2025-02-28 04:07:00,37
1542,ORD_1543,19333,Neska Moda 6 To 12 Months Cotton and Fur Polka Dot Baby Lace Booties -BT1433-GRP,Warehouse C,55,21,2025-02-28 06:58:00,34
1543,ORD_1544,442,7 Days Stretch Mark Cream | For Men Reducing Stretch Marks & Scars During Treatment- Effective & Fast Working -(100 g),Warehouse B,231,225,2025-02-28 05:08:00,6
1544,ORD_1545,31969,"TRASE Boys' Running Shoes |Easy to wear | Slip Ons | Ideal for Parks, Outdoor, Walking & All Day Casual Wear | Sky Blue, 1...",Warehouse B,218,178,2025-02-28 01:42:00,40
1545,ORD_1546,2479,DOREME Hooded Wrapper for Infants with Multi Prints | Beige,Warehouse B,36,28,2025-02-28 05:42:00,8
1546,ORD_1547,36329,U SHAPE,Warehouse A,488,482,2025-02-28 09:14:00,6
1547,ORD_1548,32735,Aliza Set of 29 Pcs Fancy Icecram Clip Head wear Accessories For Baby Girls/Toddlers Children's Suit Girls Baby Hair Clips...,Warehouse B,370,357,2025-02-28 06:51:00,13
1548,ORD_1549,35065,Kid's Care Cotton Funky Printed Half Sleeve T-Shirt and Half Pant Combo Set for Baby Boys,Warehouse C,343,298,2025-02-28 10:20:00,45
1549,ORD_1550,32732,"""7"" Embroidery Sleeveless T Shirt with Shorts",Warehouse B,417,377,2025-02-28 06:46:00,40
1550,ORD_1551,35071,"LuvLap Booster Car Seat, Backless Design, for Children & Kids from 6 to 12 Years (Black)",Warehouse B,516,468,2025-02-28 15:54:00,48
1551,ORD_1552,2834,Jordan Children 3-5 Years Kids toothbrush with Sand Timer BPA Free toothbrush (Pink - 3-5 Years),Warehouse A,63,51,2025-02-28 20:37:00,12
1552,ORD_1553,31975,Jimmy Jammy Front Button Full Sleeves Unisex Baby T-shirt and Pyjama Set - Pack of 5,Warehouse B,378,336,2025-02-28 13:13:00,42
1553,ORD_1554,31977,AE-Apparels Boys & Girls Cotton Bloomers(Multicolour)-Pack of 6,Warehouse C,89,45,2025-02-28 11:22:00,44
1554,ORD_1555,443,Hopscotch Girls White Sleeveless Fruit Print Casual Dress 100 (1-2yrs) FLM-3406996,Warehouse C,380,332,2025-02-28 21:16:00,48
1555,ORD_1556,35081,"T&H Organics 100% Organic Cold Pressed Virgin Coconut Oil, In Glass Bottle To Retain Purity, Baby Hair Oil and Baby Massag...",Warehouse A,302,280,2025-02-28 15:42:00,22
1556,ORD_1557,31979,Healing shoes no load removable closed toe treatment shoes Breathable medical shoes (XS),Warehouse A,326,298,2025-02-28 01:25:00,28
1557,ORD_1558,1171,SSC Animal Hat Plush Winter Ski Style Hat Cartoon Ear-flap Cap for Children Adults,Warehouse A,494,486,2025-02-28 09:17:00,8
1558,ORD_1559,36317,Seba-med Baby Shampoo (500ml),Warehouse A,458,412,2025-02-28 14:16:00,46
1559,ORD_1560,31980,"Masilo Organic Cotton Hooded Towel for Babies-Ideal for Babies 6 to 12 Months -Koala Grey-Ideal As Baby Towel, Wrap Towel,...",Warehouse C,111,92,2025-02-28 17:36:00,19
1560,ORD_1561,1168,Baby Bather Bath Seat Anti Skid Foldable Soft Mesh (Red),Warehouse A,293,286,2025-02-28 09:02:00,7
1561,ORD_1562,35092,"Mee Mee Colourful Mesh Activity Ball, Multicolor",Warehouse A,40,34,2025-02-28 01:27:00,6
1562,ORD_1563,2496,Kiddery Wash Cloth | 100% Cotton Muslin Napkin Set | Scandinavian Prints for New Born Baby | Baby Shower Essential Pack | ...,Warehouse C,292,253,2025-02-28 07:19:00,39
1563,ORD_1564,2900,Hopscotch Baby Girls Cotton Denim Dungaree with Text Print T-Shirt in White Color for Ages 18-24 Months (XHZ-2786072),Warehouse C,195,180,2025-02-28 14:44:00,15
1564,ORD_1565,1161,R for Rabbit XXL Size Baby Premium Feather Diaper for Baby 15+ kgs (92 Combo Pack Offer),Warehouse C,160,123,2025-02-28 17:28:00,37
1565,ORD_1566,35104,SCOOBA Super Soft 45cm Princess Doll - Polyfill Washable Cuddly Soft Plush Toy - Helps to Learn Role Play - 100% Safe for ...,Warehouse B,416,375,2025-02-28 17:04:00,41
1566,ORD_1567,31989,Aromeds Natural repellent | repellent mosquito |repellent for flies| yard repellent for mosquitoes and all insects -100 ml...,Warehouse C,34,27,2025-02-28 14:00:00,7
1567,ORD_1568,35108,"Mee Mee Fluoride-Free Toothpaste, Strawberry, 70g & Mee Mee Tender Tongue Cleaner Brush (Single Pack, Green)",Warehouse A,263,217,2025-02-28 14:51:00,46
1568,ORD_1569,36302,"Kol Kol Baby Carrier Bag, 100% Hand Woven Cotton, Light-Weight, Safe & Ergonomic Baby Carry Bag & 2 Carry Positions, for 4...",Warehouse B,105,87,2025-02-28 10:17:00,18
1569,ORD_1570,35114,AVEENO Baby Soothing Relief Emollient Cream 150 ml,Warehouse B,299,271,2025-02-28 20:32:00,28
1570,ORD_1571,36296,GHIME Baby Boys & Baby Girls Track Suit for Winter Wear Stylish & Regular Fit,Warehouse B,279,237,2025-02-28 04:52:00,42
1571,ORD_1572,35119,Allen Solly Baby-Girl's Regular Fit T-Shirt (AIGKCCRGFO62486_Blue 12 Months),Warehouse B,458,447,2025-02-28 12:37:00,11
1572,ORD_1573,32702,"Dash Coco Bath Tub, Bath Tub for 0-3 Years Baby, Bath Tub for New Born Baby, Baby Anti Slip Plastic Bathtub with Bath Todd...",Warehouse A,156,145,2025-02-28 05:01:00,11
1573,ORD_1574,2501,"Huggies Complete Comfort Wonder Pants with Aloe Vera, Small (S) size baby diaper pants, 86 count",Warehouse B,118,103,2025-02-28 01:51:00,15
1574,ORD_1575,2502,Ardo Gold Cream (10ml) - The 100% Pure Lanonlin Cream - Cares & Protects Sensitive and Dry Nipples,Warehouse A,112,69,2025-02-28 13:09:00,43
1575,ORD_1576,32698,Bhandari Fashion Baby Girl Raw Silk Knot Type Frock for 1 to 2 Year Babies,Warehouse B,69,47,2025-02-28 15:38:00,22
1576,ORD_1577,2886,Ekan Baby Boy's & Baby Girl's Soft Woolen Winter Warm Kids Hand Gloves (Multicolor Set Of 3) (1-3 Years),Warehouse B,280,246,2025-02-28 22:56:00,34
1577,ORD_1578,469,Jordan Children 6-9 Years Kids toothbrush BPA Free toothbrush with Stand (Yellow with Stand - 6-9 Years),Warehouse B,155,118,2025-02-28 14:57:00,37
1578,ORD_1579,2884,BabyChakra Natural Strengthening Baby Shampoo 30ml with Curry Leaf Oil & Black Seed Oil | 2X Stronger Hair | SLS & Paraben...,Warehouse B,355,340,2025-02-28 02:22:00,15
1579,ORD_1580,35091,KRISS-CROX Baby Girl Cotton Onesie Duck Frock| Comfortable and Designer Pink Frock for New Born Babies,Warehouse A,265,258,2025-02-28 08:57:00,7
1580,ORD_1581,35195,"Chicco Baby Moments Talcum Powder, New Advanced Formula with Natural Ingredients to Prevent Rashes & Irritation, Creates P...",Warehouse B,383,378,2025-02-28 07:59:00,5
1581,ORD_1582,35197,Himalaya Extra Moisturizing Baby Soap (White_75g_12 Pcs)- Pack of 3,Warehouse A,418,389,2025-02-28 14:30:00,29
1582,ORD_1583,32035,Mamaearth Tan Removal Combo(Ubtan - Face Wash 100ml + Face Scrub 100g),Warehouse A,182,133,2025-02-28 04:25:00,49
1583,ORD_1584,32665,"Mamaearth Deeply Nourishing wash for Babies (200 ml, 0-5 Yrs) & Anti Mosquito Fabric Roll On, 8ml Combo",Warehouse B,35,21,2025-02-28 17:58:00,14
1584,ORD_1585,35169,Dhairya Collection new born baby bootie shoes for boy and girl Baby Booties/Booties/New born baby shoes for baby boy and b...,Warehouse A,89,77,2025-02-28 20:28:00,12
1585,ORD_1586,36260,"Neska Moda 12 To 18 Months Baby Girls Cotton Butterfly Frill Booties (Maroon,Rani) -BT1155andBT1169",Warehouse C,223,195,2025-02-28 22:29:00,28
1586,ORD_1587,32688,"Storio Beach Sand Toys Castle Play Set with Fish, Crab Moulds for Kids & Toddlers, Useful for Gardening & Outdoor Tool Kit...",Warehouse B,93,77,2025-02-28 05:52:00,16
1587,ORD_1588,36283,"US Organic Baby Oil with Calendula, Unscented - Jojoba and Olive Oil with Vitamin E, USDA Certified Organic, No Alcohol, P...",Warehouse A,217,190,2025-02-28 01:57:00,27
1588,ORD_1589,1143,"Magic Baby Winter Warm Pilot Beanie Cap for Kids Girl's & Boy's (Pink, 01yrs-03Yrs)",Warehouse C,318,279,2025-02-28 12:24:00,39
1589,ORD_1590,2511,Baby Moo Blushing Bear Pink Toothbrush Holder,Warehouse C,80,73,2025-02-28 00:27:00,7
1590,ORD_1591,32013,Toddylon New Born Baby Complete Daily Needs Items Combo of Essential Bedding & Clothing Set (0-6 Months),Warehouse A,318,312,2025-02-28 02:42:00,6
1591,ORD_1592,32681,"Mamaearth Milky Soft Natural Baby Face Cream for Babies 60mL & Nourishing Baby Hair Oil with Almond & Avocado, 100ml & Soo...",Warehouse B,262,238,2025-02-28 06:58:00,24
1592,ORD_1593,35149,SPUNN Women's Cotton Non-Padded Wire Free Nursing Bra,Warehouse A,124,119,2025-02-28 02:33:00,5
1593,ORD_1594,32678,Printed Socks For Kid in Cotton Febric Pack of 12,Warehouse B,244,225,2025-02-28 07:44:00,19
1594,ORD_1595,35150,"Memories of Footprint & Handprint of Babies,Daughters,Baby Shower,Footprint of Guru",Warehouse C,294,275,2025-02-28 22:27:00,19
1595,ORD_1596,35194,"Sathiyas 480 GSM 4 Piece Bath Non-Terry Cotton Towel Ultra Absorbent Super Soft and Comfortable-Quick Drying Towel (Blue, ...",Warehouse B,451,432,2025-02-28 21:11:00,19
1596,ORD_1597,35188,"Pampers Premium Care Pants, Extra Large size baby Diapers, (XL) 36 Count, 12-17 kg Softest ever Pampers Pants,",Warehouse C,456,434,2025-02-28 02:00:00,22
1597,ORD_1598,35138,Mothercare Boys 4 Pocket Solid Shorts,Warehouse B,112,64,2025-02-28 18:26:00,48
1598,ORD_1599,36331,Bunnies Unisex-Child Walking Shoes,Warehouse B,508,484,2025-02-28 17:33:00,24
1599,ORD_1600,32690,GURU KRIPA BABY PRODUCTS Girls Cotton Slip Cami Summer Tank Top Spaghetti Strap Vest Sleeveless Hosiery Regular Fit Baniya...,Warehouse B,379,368,2025-02-28 02:07:00,11
1600,ORD_1601,494,Johnson's Baby Soap Bar - 3 oz,Warehouse A,306,275,2025-02-28 16:00:00,31
1601,ORD_1602,496,SR CREATIONS Baby t shirts and shorts set,Warehouse A,330,289,2025-02-28 09:21:00,41
1602,ORD_1603,497,Silver Shine Mosquito Net Single Bed Foldable 2.4 mm Strong PVC Coated Steel Mosquito Protection (White Black),Warehouse C,84,59,2025-02-28 22:45:00,25
1603,ORD_1604,36251,Philips Avent My Bendy Straw Cup 300ml/10oz (12M+) (Assorted),Warehouse C,106,58,2025-02-28 20:45:00,48
1604,ORD_1605,500,TiniBerry Baby Cotton Hosiery Babies Boys & Baby Girls Printed Regular Shorts (Multicolor (Set of 6),Warehouse C,123,109,2025-02-28 13:57:00,14
1605,ORD_1606,505,cute Landings Kid's Cotton Cap (Multicolor_3 Months-6 Months),Warehouse B,237,193,2025-02-28 04:07:00,44
1606,ORD_1607,35179,Kids Western Top Denim Jeans for Baby Girls,Warehouse B,164,126,2025-02-28 10:07:00,38
1607,ORD_1608,508,"Fisher-Price Baby Bear & Firefly Soother, Light-up Nursery Sound Machine with take-Along Plush Toy for Babies and Toddlers",Warehouse A,362,354,2025-02-28 05:54:00,8
1608,ORD_1609,2523,Max Girls Printed Cap Sleeves Casual T-Shirt,Warehouse A,173,133,2025-02-28 13:38:00,40
1609,ORD_1610,35185,Baby Moo Rainbow Chu-Chu Sound Breathable Anti-Skid Sandals - Pink (18-24M),Warehouse A,519,495,2025-02-28 20:04:00,24
1610,ORD_1611,32030,The Better Home Mosquito Repellent Patch for Babies (Pack of 1 (24 Patches)),Warehouse B,30,22,2025-02-28 21:54:00,8
1611,ORD_1612,34857,Anoma Women's Pregnancy Panty - High Waist | Anti Bacterial Cotton | Maternity Hygiene Panties- (Pack of 3),Warehouse C,50,20,2025-02-28 22:43:00,30
1612,ORD_1613,34854,KUKSHYA 925 Exclusive Nazariya Bracelet with Black & Silver Beads (Crystal) in 92.5 Sterling Silver for Baby Boys & Girls,Warehouse B,89,79,2025-02-28 22:28:00,10
1613,ORD_1614,36603,ROSEFAIR Jhoomer Musical Merry Go Round Automatic Toy Jhoomer with Soothing Sound for Toys (Multicolor),Warehouse B,123,103,2025-02-28 01:35:00,20
1614,ORD_1615,275,Shivranjani Sarees Nylon Mosquito Net Double Bed Nets For Size King Foldable Child Mosquitoes With Adults Maskito Of 6 Sav...,Warehouse C,328,289,2025-02-28 09:33:00,39
1615,ORD_1616,34480,"Baby Auricle Valgus Correction Patch, Newborn Baby Ear Aesthetic Correctors Kids Infant Protruding Ear Patch Stickers, Chi...",Warehouse B,322,314,2025-02-28 05:04:00,8
1616,ORD_1617,36596,Roble Baby Boy's and Baby Girl's Romper & Dungaree(6 Months -2 Years),Warehouse C,69,33,2025-02-28 19:36:00,36
1617,ORD_1618,3021,FUNKRAFTS Baby Girls' White and Red Crochet Booties - (Ideal for 6-12 Months),Warehouse A,249,210,2025-02-28 23:55:00,39
1618,ORD_1619,34490,Tiny Tycoonz Silicone Baby Tooth and Gum Finger Brush with case (White),Warehouse B,284,278,2025-02-28 15:04:00,6
1619,ORD_1620,1530,EIO New Born Baby Front Open Cotton Jhablas Pack of 4,Warehouse A,270,237,2025-02-28 04:24:00,33
1620,ORD_1621,34494,Johnson's Baby No More Tears Baby Shampoo 500ml (Pack of 2),Warehouse C,412,404,2025-02-28 07:25:00,8
1621,ORD_1622,31790,"FAVISM Pure Soft Cotton Newborn Baby Boys & Baby Girls Casual Dress Set, Tshirt Half Pant Pack of 3 pcs, White, 0-3 Months",Warehouse C,469,428,2025-02-28 04:33:00,41
1622,ORD_1623,31792,Baby Moo Cute Puppy Checked Chu-Chu Sound Breathable Anti-Skid Sandals - Blue (3Y-3.5Y),Warehouse A,495,462,2025-02-28 13:11:00,33
1623,ORD_1624,36589,"Prattle Foot Kids Running Led Shoes, Casual Led Velcro Shoes Light Weight Outdoor Sports Shoes for Boys & Girls",Warehouse A,331,324,2025-02-28 18:02:00,7
1624,ORD_1625,2325,"Nat Habit Milk & Nut Baby Daily Ubtan, Baby Cleansing & Nutrition, 6mth - 2yr - 80 g (Pack of 1)",Warehouse B,93,80,2025-02-28 00:25:00,13
1625,ORD_1626,36604,Bold N Elegant White Cotton Bunny Rabbit Cartoon Print Shirt Top and Shorts Summer Clothing Set for Infant Toddler Baby Girls,Warehouse A,434,396,2025-02-28 18:47:00,38
1626,ORD_1627,2359,"Kixre Hopper Ball for Kids Ages 3-6 Year Hop-Pity Hop Ball, Hopping Ball, Bouncy Ball with Handles, Sit & Bounce, Kangaroo...",Warehouse B,351,343,2025-02-28 07:36:00,8
1627,ORD_1628,34477,Hopscotch Boys and Girls Synthetic/PU Text Print LED Sneakers in White Color,Warehouse A,322,279,2025-02-28 08:25:00,43
1628,ORD_1629,2342,"Buddsbuddy BPA Free Super Heros Cartoon Kids Soft Bristles Tooth brush 2yrs+, Multicolor (combo of 4)",Warehouse C,393,365,2025-02-28 06:21:00,28
1629,ORD_1630,34533,Max Boys Colourblocked Shorts,Warehouse A,443,410,2025-02-28 00:31:00,33
1630,ORD_1631,3011,Sebamed Baby Bubble Bath 200ml|PH 5.5| Camomile|No tears Sugar Based Cleanser|Soap Free,Warehouse C,261,253,2025-02-28 15:41:00,8
1631,ORD_1632,289,CHICCO BRUSH AND COMB,Warehouse B,315,305,2025-02-28 10:37:00,10
1632,ORD_1633,34538,Mothercare Fragranced Wipes ( 60pcs x 5pkt) (Purple),Warehouse C,341,305,2025-02-28 23:02:00,36
1633,ORD_1634,1497,KGR SPlash Black & White Evil Eye Protection Beads Anklets (Mangati) with Adjustable size for New born Babys (0-0.9 Mont...,Warehouse C,154,124,2025-02-28 21:47:00,30
1634,ORD_1635,36566,"ambitieux Bucket hat Cap for Child boy or Girl of Age ''12 to 20"" Years with Sunshade Summer caps Men Women",Warehouse C,63,31,2025-02-28 07:54:00,32
1635,ORD_1636,1507,KOLOSSALZ Own The Excellence Galaxy Glow in Dark Kids Ceiling Acrylic Stickers || Kids b'day Gifts || Pack of 152 Stars ||...,Warehouse C,454,418,2025-02-28 11:49:00,36
1636,ORD_1637,34464,Curatio Atogla cream for baby | Moisturizing baby cream for all skin types|Protects Against rashes & prevents skin irritat...,Warehouse B,324,290,2025-02-28 12:02:00,34
1637,ORD_1638,33028,PUMA - Kids Ferrari Roma Via Perf Shoes,Warehouse B,430,401,2025-02-28 12:02:00,29
1638,ORD_1639,1538,Toonyport Infant Kids Cotton Printed Top and Bottom Set,Warehouse A,358,318,2025-02-28 17:08:00,40
1639,ORD_1640,34475,"Mee Mee Baby manual Toothbrush for kids(Pack of 3) (Easy Grip, Green)",Warehouse B,514,494,2025-02-28 15:06:00,20
1640,ORD_1641,1456,CUTEABLY Baby Banana Infant Toothbrush Silicone Teether Soft Bristles 100% Safe (Yellow),Warehouse A,461,412,2025-02-28 00:24:00,49
1641,ORD_1642,1112,"Vroxy Anti-Skid New Born Baby Infant Floor Walk Shoes Socks, Anti-Slip Knitted Bootie Footwear for Baby & Toddler, Breatha...",Warehouse A,301,295,2025-02-28 03:38:00,6
1642,ORD_1643,32979,Shnuggle Baby Bath with Plug & Foam Backrest- White & Pink,Warehouse B,213,181,2025-02-28 12:07:00,32
1643,ORD_1644,1492,"Neska Moda 0 To 6 Months Baby Boys & Baby Girls Cotton Rabbit Booties (Red,Yellow) -BT1113andBT372",Warehouse A,408,364,2025-02-28 11:36:00,44
1644,ORD_1645,2348,"OYO BABY Badam Rogan Oil for Baby Massage | 100% Pure | Sweet Almond Oil | Shirin oil Rich in Vitamin -E for Healthy Skin,...",Warehouse A,240,195,2025-02-28 20:38:00,45
1645,ORD_1646,3004,Neska Moda Unisex Baby Booties For 6 To 12 Months (Black),Warehouse C,53,20,2025-02-28 04:51:00,33
1646,ORD_1647,31816,Dopamine Combo Box & Lazy Bear Cap for Baby boy 1-2 Years Age Baby Girl Cap Kids Cap (Pack of 2),Warehouse A,56,28,2025-02-28 07:18:00,28
1647,ORD_1648,34566,Little Charlie Baby's Charlie Soft Sole Sandals,Warehouse B,427,411,2025-02-28 03:22:00,16
1648,ORD_1649,32972,"R for Rabbit Baby Tusky Pacifier Ultra Light Soft Silicone Nipple, Orthodontic Design, BPA-Free for Kids of 6 Months +|Med...",Warehouse A,245,226,2025-02-28 12:30:00,19
1649,ORD_1650,1485,Good knight 100% Natural Mosquito Repellent Fabric Roll-On | Paediatrician Certified | 8-Hour Protect | Citrus - 8 ml,Warehouse B,343,312,2025-02-28 16:07:00,31
1650,ORD_1651,36555,Zippyque Baby Girls and Baby Boys Ankle Length with Animal Print Soft Base Booties/Socks Shoes (0-6 Months),Warehouse C,467,434,2025-02-28 23:45:00,33
1651,ORD_1652,36554,Pure Elements Natural & Sulfate Free Aloe Hibiscus Kids Shampoo - 200 ml,Warehouse A,529,491,2025-02-28 16:00:00,38
1652,ORD_1653,34570,HIVER Adult Woolen Leg Warmers Women's Winter Over Knee High Footless Socks Knit Warm Long Leg Warmers,Warehouse A,354,321,2025-02-28 14:16:00,33
1653,ORD_1654,32964,Lilly Touch Lactonic Granules (Pack of 1) 200gm II For Breastfeeding Mothers,Warehouse B,90,71,2025-02-28 22:29:00,19
1654,ORD_1655,34580,Fareto Baby Boy's & Baby Girl's T Shirt,Warehouse C,362,337,2025-02-28 18:22:00,25
1655,ORD_1656,34586,BUMZEE Unisex-Baby Vest,Warehouse B,186,152,2025-02-28 22:13:00,34
1656,ORD_1657,34590,"Pampers All round Protection Pants, Large size baby diapers, 10 Count, Anti Rash diapers, Lotion with Aloe Vera",Warehouse C,313,305,2025-02-28 09:36:00,8
1657,ORD_1658,1466,Cuckoos New Born Baby Boys & Girls 100% Cotton Soft Cap Unisex Hat | Topi | Caps for New Born Baby Pack of 3 (0-6 Months),Warehouse C,238,204,2025-02-28 20:27:00,34
1658,ORD_1659,1463,Grab Classy Safe Inkless Baby Handprint and Baby Footprint Ink Pad with Imprint Cards 100% Non-Toxic & Mess Free Safe for ...,Warehouse C,393,382,2025-02-28 15:55:00,11
1659,ORD_1660,32980,Neska Moda Unisex Baby Booties For 0 To 6 Months (Red) (0_months),Warehouse A,294,248,2025-02-28 05:37:00,46
1660,ORD_1661,36558,Mamaearth Deeply nourishing wash for babies (200 ml),Warehouse C,397,375,2025-02-28 17:29:00,22
1661,ORD_1662,2999,Baby Nasal Aspirator and Booger Sucker for Newborns Toddlers & Adult - BPA Free - Ounce Bulb Syringe - Safe Nose Cleaner -...,Warehouse B,418,409,2025-02-28 20:35:00,9
1662,ORD_1663,34557,MINITATU Unisex-Baby Classic Track Pants,Warehouse B,493,446,2025-02-28 16:55:00,47
1663,ORD_1664,1453,BKDT Marketing Yo Yo Ball Toy for Boys Girls Kids Ball Play Set Adjustable Wrist Band yoyo (Pack of 1),Warehouse A,257,245,2025-02-28 02:25:00,12
1664,ORD_1665,2361,"JFUIOTU® Non-Slip Shower Bath Tub, Baby Bathing Tub, Comfort Baby Bathtub with Drain Plug (All Pink) (Green)",Warehouse A,172,164,2025-02-28 02:01:00,8
1665,ORD_1666,34610,"Milky Soft Shampoo with Oats, Milk and Calendula for Babies – 400 ml & Mamaearth Agent Apple Body Wash for Kids with Apple...",Warehouse B,507,479,2025-02-28 16:21:00,28
1666,ORD_1667,32953,"Foot Injury Shoe, Shock Absorption Walking Cast Shoe Canvas Fabric Breathable Adjustable for Post Op (YTH)",Warehouse A,245,205,2025-02-28 23:02:00,40
1667,ORD_1668,34599,Kuchipoo Baby Boys' & Baby Girls' T-Shirt (Pack of 5),Warehouse C,306,259,2025-02-28 05:35:00,47
1668,ORD_1669,1444,Tiny Kids Kids LED Casual Shoe/Kids Unisex Sneaker/Walking Shoe for Baby Boys and Girls / (T101)-NW-RS101(2),Warehouse B,437,432,2025-02-28 16:56:00,5
1669,ORD_1670,36533,JUSFAB Infant wear Printed Kidswear Baby Boy Girl Clothes Pure Cotton Tshirt Pants Top Bottom Set CD-Y_A_18-24 Months,Warehouse A,425,386,2025-02-28 11:50:00,39
1670,ORD_1671,36531,"Neska Moda 12 To 18 Months Baby Girls Cotton Butterfly Booties (Red,Black) -BT1150andBT1165",Warehouse C,60,16,2025-02-28 15:20:00,44
1671,ORD_1672,34626,Bumzee Full Sleeves Cotton Printed Sleepsuit Pack of 3 for Baby,Warehouse B,405,373,2025-02-28 13:02:00,32
1672,ORD_1673,34628,Sahiba Gems Exclusive 925 Sterling Silver Nazar Hay Charm Beads Nazariya Baby Bracelet/Kada/Bangle Nazariya for Babies Sin...,Warehouse C,347,301,2025-02-28 11:21:00,46
1673,ORD_1674,1422,KNITROOT Rakshabandhan Special Unisex Baby Romper Half Sleeve Ek Hazro Mein Meri Behana Hai,Warehouse C,145,125,2025-02-28 17:17:00,20
1674,ORD_1675,36524,Wembley Dancing Monkey Musical Toys for Kids Baby Spinning Rolling Doll Tumble Toy with Voice Control Musical Light and So...,Warehouse B,361,355,2025-02-28 17:05:00,6
1675,ORD_1676,36560,Stanwells Kids Baby Girl's Net Readymade Lehenga Choli,Warehouse C,255,207,2025-02-28 23:16:00,48
1676,ORD_1677,484,look like fashion Kid's Sterling Nazariya (Black and White),Warehouse A,472,443,2025-02-28 06:56:00,29
1677,ORD_1678,32675,"Eazy Trendz New Born Baby Pu Feel Ultra Thin Printed Bloomers,Shorts,Trousers (Pack of 12) (Age 0to6 Month)",Warehouse B,145,116,2025-02-28 10:39:00,29
1678,ORD_1679,35155,Sunshine Enterprise Bath Toys Swimming Turtle Toy Wind Up Water Floating Toy Bathtub Toy Tortoise for Baby Bathing Toy for...,Warehouse C,451,405,2025-02-28 12:52:00,46
1679,ORD_1680,19449,Ascetic Baby Bathing Rubber Squeaky Ducks Floating Play Water Pool Tub Toys,Warehouse A,152,114,2025-02-28 22:16:00,38
1680,ORD_1681,9820,BeeBaby Classic Powder Puff with Container for Baby (Pink) Soft Touch. 100% BPA Free.,Warehouse A,360,332,2025-02-28 09:02:00,28
1681,ORD_1682,9819,Linen Affairs Organic Cotton Baby Muslin Washcloth Baby Wash Cloth for New Born Face Towel for Kids Handkerchief for Toddl...,Warehouse A,137,125,2025-02-28 20:10:00,12
1682,ORD_1683,9816,Pom Pom Sweethearts New Born Baby Soft Cotton Printed Sleeveless 2 Jhabla/Vest & 2 Knotted Vest/Tank Top for Baby Boy & Gi...,Warehouse B,148,135,2025-02-28 14:57:00,13
1683,ORD_1684,19459,Baby Moo Rainbow Chu-Chu Sound Anti-Skid Breathable Denim Sandals - Navy Blue (2Y-2.5Y),Warehouse C,382,375,2025-02-28 08:51:00,7
1684,ORD_1685,19466,BabyChakra Moisturizing Natural Baby Sunscreen SPF 30+ PA+++ UVA/UVB Protection Non-Sticky & Water-Resistant (60gm),Warehouse C,347,312,2025-02-28 16:11:00,35
1685,ORD_1686,19474,"TechHark ® Folding Activity Throw Fun Activity Ball for Kids, Multicolour.",Warehouse B,249,205,2025-02-28 03:22:00,44
1686,ORD_1687,9834,Kuchipoo Baby Boys and Baby Girls T-Shirt - Pack of 5 (Tshrt-181),Warehouse A,359,325,2025-02-28 21:34:00,34
1687,ORD_1688,19415,"Memoir Silver Plated, Ghungroo nazariya, nazaria, for New Born Kids Jewellery Bangle, kada by Memoir (0-1 Yrs)",Warehouse A,44,35,2025-02-28 21:56:00,9
1688,ORD_1689,19339,VRION Summer Special Inflatable Kid Swimming Pool Baby Bath tub Without Air Pump I Bath Pool for Kids Age 1 to 5 Years I 6...,Warehouse A,454,439,2025-02-28 03:26:00,15
1689,ORD_1690,19342,"MAXI Zoom Car Soft Toothbrush for Baby & Kids, BPA Free, Boys & Girls, Toddler Toothbrush for 2+ Years, sports car shaped ...",Warehouse C,464,450,2025-02-28 22:00:00,14
1690,ORD_1691,19343,"MamyPoko Pants Extra Absorb XL42,Unisex Baby, Pack of 42 (12-17Kg)",Warehouse C,34,29,2025-02-28 15:30:00,5
1691,ORD_1692,19346,Kidology Wooden Rectangular Magnetic Fishing Toys for Kids | Games Letters ABC Numbers Alphabet Puzzle | Toddler Learning ...,Warehouse B,337,299,2025-02-28 17:54:00,38
1692,ORD_1693,19357,MYYNTI Baby Ankle Winter Socks Warm Soft Solid Cotton for Boys Girls Newborn Kids Children Toddler Infant Multicolor (Pac...,Warehouse B,504,479,2025-02-28 22:21:00,25
1693,ORD_1694,19359,"Jordan Step 1 Baby Toothbrush, 0-2 Years, Extra Soft Bristles, BPA Free Gentle to Babies. Made in Malaysia - 0 Months to 2...",Warehouse C,457,451,2025-02-28 23:18:00,6
1694,ORD_1695,19443,Hopscotch Unisex Cloth All-Over Print Casual Shoes in Blue Color,Warehouse C,246,234,2025-02-28 15:21:00,12
1695,ORD_1696,9870,Elk Baby Boys' & Baby Girls' T-Shirt (Pack of 6),Warehouse C,326,278,2025-02-28 09:40:00,48
1696,ORD_1697,3197,Quick Release Long Quick relesae,Warehouse B,379,355,2025-02-28 13:51:00,24
1697,ORD_1698,32785,"Lillypupp Linen, Cotton and Nylon Hairbands and Bows for Newborns, Infants and Toddlers (Pack of 3, 0-5 Years) (Style 8) M...",Warehouse C,143,101,2025-02-28 09:19:00,42
1698,ORD_1699,36370,"AJB New Baby Nail File Electric,Baby Nail Trimmer with 6 Grinding Heads Safe for Newborn Baby",Warehouse B,401,357,2025-02-28 10:37:00,44
1699,ORD_1700,36368,Hopscotch Boys Cotton Graphic Print T-Shirt And Overall Short Set in Yellow Color,Warehouse B,464,436,2025-02-28 18:05:00,28
1700,ORD_1701,34984,"Huggies Complete Comfort Dry Pants Extra Large (15-25kg) Size Baby Diaper Pants, 13 count, with 5 in 1 Comfort",Warehouse C,343,330,2025-02-28 22:13:00,13
1701,ORD_1702,2923,"little PANDA Born Baby Boys Girls Soft Cotton Cap, Mittens & Booties Set (0-6 Months) Combo Pack",Warehouse C,229,204,2025-02-28 17:33:00,25
1702,ORD_1703,32776,"Robo Alive Junior Mini Baby Shark by ZURU (3 Pack) Sing & Swim Electronic Bath Toy 3-Pack Amazon Exclusive, Battery Powere...",Warehouse B,396,361,2025-02-28 03:34:00,35
1703,ORD_1704,34987,Infantbond 56 in 1 New Born Baby Complete Daily Items Combo(0-6 Months)(Star) (Yellow for Baby Boy & Baby Girl),Warehouse B,188,139,2025-02-28 19:21:00,49
1704,ORD_1705,1223,GRAND PITSTOP Grandpitstop - Waterproof Mirror Mount Fully Waterproof Bike / Motorcycle / Scooter Mobile Phone Holder Moun...,Warehouse B,490,447,2025-02-28 16:39:00,43
1705,ORD_1706,34994,Mirada Coral Cute Plush Huggable Bunny Stuffed Soft Toy - 35 cm(Coral),Warehouse C,410,388,2025-02-28 16:34:00,22
1706,ORD_1707,32774,"TuddyBuddy Girl's 100% Cotton Graphic Prints Briefs/Panty/Underwear/Panties, Multicolor",Warehouse B,453,418,2025-02-28 17:39:00,35
1707,ORD_1708,34997,Bumtum Ultrahygiene Freesize Cloth Diaper for Babies 0 to 3 Years | Washable & Reusable Diaper and Cotton Soaker (Pack of ...,Warehouse B,153,105,2025-02-28 12:02:00,48
1708,ORD_1709,2459,Lillypupp Grey and Black Sandals with Cute Black Bow On Top for New Born Baby Girl (6-12 Months),Warehouse B,293,253,2025-02-28 13:27:00,40
1709,ORD_1710,31950,KIDZVILLA 100% Cotton Rompers/Sleepsuits/Jumpsuit/Night Suits for Newborn Baby Boys & Girls Pack of 2,Warehouse B,196,177,2025-02-28 23:14:00,19
1710,ORD_1711,9717,"Ikea Kalas Kid's Plastic BPA-Free Colorful Flatware, Bowl, Plate, Tumbler Set - 36 Pieces",Warehouse C,163,130,2025-02-28 13:20:00,33
1711,ORD_1712,19622,"Mommypure Dewy Love Natural Baby Face Cream With Cocoa Butter For Deep Moisturisation (50 gm)|Certified Clean, Natural & N...",Warehouse C,257,231,2025-02-28 14:57:00,26
1712,ORD_1713,19485,"Tikiri Toys Turtle Natural Rubber Rattle & Bath Toy, Sustainable & Organic Toys, for 0+ Kids, Multicolor",Warehouse B,408,380,2025-02-28 00:17:00,28
1713,ORD_1714,19556,Safe-O-Kid - Pack of 24(+6 Free) - 100% HERBAL Orange Color Mosquito Repellent Patches- Highly Effective Patches by Safe-...,Warehouse C,319,304,2025-02-28 04:40:00,15
1714,ORD_1715,19514,CREATIVE KIDS All-Over Printed Baby Girl Romper Dress with Bow & Flower,Warehouse C,268,223,2025-02-28 02:22:00,45
1715,ORD_1716,9772,Burts Baby Bee Shampoo & Wash - Calming 21oz,Warehouse C,48,24,2025-02-28 05:07:00,24
1716,ORD_1717,19519,Bold N Elegant Cool Jungle Fun Cartoon Bear Tiger Print T-shirt and Shorts Smart Casual Clothing Set for Boys Girls Kids,Warehouse A,266,235,2025-02-28 02:26:00,31
1717,ORD_1718,19562,"Zollyss Portable Baby Toilet Seat Foldable Western Kids Potty Trainer Cover for Toddler Boys Girls Travel, Blue (Plastic)",Warehouse B,436,398,2025-02-28 02:38:00,38
1718,ORD_1719,19533,"Safe-O-Kid Baby Bath tub with Temperature Sensitive Plug Folding Baby Bathtub for Kids (0 to 3 Years), Pink",Warehouse B,523,496,2025-02-28 16:02:00,27
1719,ORD_1720,19534,"Mee Mee BPA Free, 2 in 1 Convertible Sipper Cup for Babies, Toddlers, Kids with Soft Spout & Straw, Anti-Leak, Detachable ...",Warehouse B,375,346,2025-02-28 22:42:00,29
1720,ORD_1721,9763,"BabyChakra After Bite Roll On 40ml for Insects & Mosquito Bites with Chamomile, Calendula & Turmeric | No Mineral Oil | No...",Warehouse A,141,126,2025-02-28 09:06:00,15
1721,ORD_1722,19546,"Novo Baby Monthly Milestone Blanket | 1 to 12 Months | Best for Newborn Boy & Girl, multicolor, Cotton, skin friendly",Warehouse B,217,192,2025-02-28 07:42:00,25
1722,ORD_1723,9758,"VRITRAZ Kids Summer Fashion Straw Bucket Cap, Suitable for 3-12 Year Hat (Orange)",Warehouse C,445,401,2025-02-28 12:56:00,44
1723,ORD_1724,9755,Max Girls Sequinned Slim Fit Jeans,Warehouse C,131,88,2025-02-28 01:37:00,43
1724,ORD_1725,19532,Baby Eli Premium Cotton Reversible Monkey Cap for Baby Boy & Baby Girl,Warehouse B,177,139,2025-02-28 17:27:00,38
1725,ORD_1726,9716,"Neska Moda 0 To 6 Months Baby Girls Pack Of 2 Pair Cotton Butterfly Frill Booties (Maroon,Black) -BT383andBT1124",Warehouse A,328,322,2025-02-28 01:44:00,6
1726,ORD_1727,19632,"Bumtum Baby Diaper Pants with Double Layer Leakage Protection - 12 to 18 Kg (108 Count, X-Large, Pack of 2)",Warehouse C,240,233,2025-02-28 03:18:00,7
1727,ORD_1728,19631,Hopscotch Boy's Cotton Graphic Print Top and Pajama Set,Warehouse A,131,111,2025-02-28 08:12:00,20
1728,ORD_1729,9847,"KNITROOT Monthly Birthday Teddy Special Unisex Baby Romper Half Sleeve Envelope Neck ""11 Month Old""(KMTBR11-1,9-12 Months,...",Warehouse A,300,251,2025-02-28 18:51:00,49
1729,ORD_1730,19400,KIDSKA Soft Cotton Mittens and Booties for New Born Baby/Cotton Baby Mittens for Boys and Girls/Kids Mittens/Cotton Cloth ...,Warehouse C,227,194,2025-02-28 16:02:00,33
1730,ORD_1731,19413,MY NEWBORN Baby Bath Towel Robe Hooded Blanket Wrapper -White-Panda,Warehouse B,260,241,2025-02-28 02:26:00,19
1731,ORD_1732,9869,"Mother Sparsh Baby Laundry Liquid Detergent (Powered by Plants) with Bio - Enzymes and Eucalyptus Oil, Refill Pack (500ml)",Warehouse A,47,16,2025-02-28 21:07:00,31
1732,ORD_1733,9891,Hopscotch Boys Cloth Lace Up Booties in Black Color,Warehouse B,427,397,2025-02-28 04:39:00,30
1733,ORD_1734,19483,"Luv Lap Baby Diaper Pants S Size (Small) , with Aloe Vera Lotion for rash protection, Pack of 78 Count, with upto 12Hr pro...",Warehouse B,125,85,2025-02-28 02:59:00,40
1734,ORD_1735,9741,Luke and Lilly Baby-Girl's Regular Fit Dress,Warehouse B,17,11,2025-02-28 07:21:00,6
1735,ORD_1736,9734,Bow Kids Cap for Baby Girls - Red Color,Warehouse B,379,331,2025-02-28 23:20:00,48
1736,ORD_1737,19615,"Lappu Baby Boys & Baby Girls Summer Wear Cotton Sleeves Less Vest | Soft Jhabla | Top | Vest (Multi-Coloured, 6-9 Months)",Warehouse A,187,147,2025-02-28 09:37:00,40
1737,ORD_1738,9726,Giffee Baby Towels / New Born / Kids / Hooded / Soft Cotton / Infants (Pink || Green),Warehouse A,70,25,2025-02-28 13:11:00,45
1738,ORD_1739,19625,"Desitin Diaper Rash Ointment, 40%, 4 oz (3 Pack)",Warehouse C,61,43,2025-02-28 01:44:00,18
1739,ORD_1740,19628,United Colors of Benetton Baby Girl's tie-dye Regular fit T-Shirt,Warehouse B,509,464,2025-02-28 04:03:00,45
1740,ORD_1741,19629,Darshraj JEWELLERS 925 Sterling Silver 6 Ball In Black Thread Handmade Baby Nazariya For Baby Girls & Boy-Adjustable -(0-9...,Warehouse A,300,279,2025-02-28 12:40:00,21
1741,ORD_1742,32787,Neska Moda 6 To 12 Months Baby Girls Synthetic Leather Floral Sandal Booties (Golden)-BT1606,Warehouse B,364,343,2025-02-28 15:41:00,21
1742,ORD_1743,32018,"Dopamine Cute Bunny Baby Baseball Style Cap for Child Baby boy or Girl of Age 1 to 3"" Years with Sunshade Summer caps",Warehouse C,263,224,2025-02-28 10:39:00,39
1743,ORD_1744,36386,"New Jain Traders Jain Traders - Hand Made Vardhman Woolen nitted Sweater Set for Baby (3 Pcs Suit) (0-6 Months, White)",Warehouse C,164,125,2025-02-28 00:11:00,39
1744,ORD_1745,32803,"TOPFLY Camphor Top - Room, Car and Air Freshener &amp; Mosquito Repellent (Lemon Grass, Pack of 2)",Warehouse B,96,62,2025-02-28 14:30:00,34
1745,ORD_1746,1265,Baby Moo Rainbow Chu-Chu Sound Breathable Anti-Skid Sandals - Blue (2.5Y-3Y),Warehouse B,122,111,2025-02-28 18:53:00,11
1746,ORD_1747,1259,Smartots Baby Boys' Modern Shoes,Warehouse C,423,398,2025-02-28 19:55:00,25
1747,ORD_1748,1257,"Dhruv Enterprises Baby Bather for Newborn/Infants,Portable and Foldable Bathing wash Training Seat for Baby (Blue)",Warehouse B,169,123,2025-02-28 20:46:00,46
1748,ORD_1749,1255,South Sailor New Born baby 100% Cotton jabla and Nappy set(Pack of 5),Warehouse A,224,216,2025-02-28 02:25:00,8
1749,ORD_1750,1247,superbottoms Top & Shorts set | Tshirt with shorts | Evrydaywear™| Boys clothes | Girls clothes | Unisex | Cotton set comb...,Warehouse B,128,122,2025-02-28 17:09:00,6
1750,ORD_1751,32808,Bold N Elegant Giraffe Cartoon Print Polo T-shirt with Layered Cardigan Jacket & Pants Winter 3 piece Clothing Set for Inf...,Warehouse C,177,148,2025-02-28 07:58:00,29
1751,ORD_1752,2943,The Baby First Box Newborn Baby Essential Kit - 21 Items(Summer Kit for 0-3 Months)| Newborn Baby Gifts |Baby Shower Gift ...,Warehouse B,475,439,2025-02-28 04:17:00,36
1752,ORD_1753,36406,Odomos Naturals Non-Sticky Mosquito Repellent Cream 100g (Pack of 2),Warehouse A,209,168,2025-02-28 10:44:00,41
1753,ORD_1754,34904,"Bumtum Baby Diaper Pants with Double Leakage Protection - 9 to 14 Kg (62 Count, Large, Pack of 1)",Warehouse A,176,150,2025-02-28 13:08:00,26
1754,ORD_1755,34858,Oddrush Double Joy Black and Silver Kada for Babies,Warehouse B,346,335,2025-02-28 11:42:00,11
1755,ORD_1756,31899,Mini Berry New Born Baby Gift Set in Red Color 13 PCs,Warehouse B,293,286,2025-02-28 11:46:00,7
1756,ORD_1757,381,Hopscotch Girls Navy Polka Print Blouse And Shorts Set 6(9-12 Months) YTS-1465894,Warehouse B,172,164,2025-02-28 17:48:00,8
1757,ORD_1758,34861,Kiddeo Baby Boys and Baby Girls Bodysuit (03)(Pack of 5),Warehouse A,417,398,2025-02-28 10:26:00,19
1758,ORD_1759,1307,Kamal Child Care Booties unisex baby Shoes,Warehouse B,321,278,2025-02-28 03:48:00,43
1759,ORD_1760,32843,Party Propz POPIT UP Games- 6 Pcs Wrist Band Pop It Rainbow Pop Fidget Toys Poppet Push Pop Bubble Fidget Popping Sensory ...,Warehouse B,239,210,2025-02-28 19:09:00,29
1760,ORD_1761,31903,Hopscotch Baby Girls Cotton Text Printed T-Shirt in White Color for Ages,Warehouse C,397,365,2025-02-28 17:10:00,32
1761,ORD_1762,32842,JRD® Cute Cartoon Collapsible Wash Basin Water Container Bucket Large Capacity Portable PP Baby Bath Tub Folding Hand Wash...,Warehouse A,194,171,2025-02-28 23:33:00,23
1762,ORD_1763,404,"Pigeon Peristaltic Nipple L,For 9+ Month Babies,BPS Free,BPA Free",Warehouse A,284,258,2025-02-28 19:19:00,26
1763,ORD_1764,32672,Baby Cry Baby Castle 100% Hosiery Cotton Infants Rompers/Jumpsuit Sleepsuit Full Sleeve Romper for Boys and Girls Set of 3...,Warehouse C,189,180,2025-02-28 16:49:00,9
1764,ORD_1765,35159,BUNNIES A-3 Red Colour Walking Shoes for Kids Boys & Girls,Warehouse A,40,14,2025-02-28 23:18:00,26
1765,ORD_1766,489,"Funskool Games - Tambola 2 in 1 Game, A Complete Family Entertainment Game, Reusable Tickets, 2+ Players,for Kid 7 & Above",Warehouse B,185,136,2025-02-28 08:50:00,49
1766,ORD_1767,34855,Bushra Designer Studio Beautiful Unicorn Baby Dress,Warehouse A,160,132,2025-02-28 00:30:00,28
1767,ORD_1768,32740,"Fareto Born Baby Gift Pack Combo of 3pcs Baby Suit with Front Open Shirt Nappy and Cap(0-3 Months,Multi Colors)",Warehouse A,381,349,2025-02-28 13:28:00,32
1768,ORD_1769,2942,"Colgate Kids Barbie Manual Toothbrush,Multicolor,1 Piece",Warehouse B,354,312,2025-02-28 15:40:00,42
1769,ORD_1770,34916,kids sandal,Warehouse C,188,140,2025-02-28 21:38:00,48
1770,ORD_1771,32815,Max Girls Printed Cap Sleeves T-Shirt,Warehouse A,24,14,2025-02-28 10:16:00,10
1771,ORD_1772,32814,BabyChakra Diaper Rash Cream-50gm Treats & Prevents Diaper Rash Non-Sticky Formula,Warehouse A,210,168,2025-02-28 05:55:00,42
1772,ORD_1773,36394,Clarks Girl's First Walking Shoes,Warehouse C,96,82,2025-02-28 10:55:00,14
1773,ORD_1774,36425,Timios Banana and Honey Stars | Healthy Snacks for Kids | Natural Energy Food Product for Toddlers | Party Snack for Schoo...,Warehouse C,215,185,2025-02-28 17:19:00,30
1774,ORD_1775,32757,honeyB Baby Boys & Baby Girls Cotton Casual T-shirt Shorts (Multicolor),Warehouse B,161,150,2025-02-28 04:18:00,11
1775,ORD_1776,32752,"SebaMed Baby Wash Extra Soft, 200ml & SebaMed Baby Cleansing Bar - 100 g",Warehouse A,489,456,2025-02-28 00:15:00,33
1776,ORD_1777,2913,Aquaphor Advanced Therapy Baby Healing Ointment 14 Ounces (396 G),Warehouse B,282,254,2025-02-28 22:14:00,28
1777,ORD_1778,425,Nino Bambino Baby-Girls Shorts,Warehouse C,432,392,2025-02-28 13:34:00,40
1778,ORD_1779,1200,"little PANDA Kids Unisex Soft Hosiery Cotton Panties, Multi-Colored (Pack of 6)(5-6 Years) Multicolour",Warehouse A,385,347,2025-02-28 11:46:00,38
1779,ORD_1780,35032,I AM ROMPER Baby Bodysuits Newborn Romper Half Sleeve Envelope Neck Cotton Blend Cute Outfit Happy Birthday Happy B'day Pr...,Warehouse B,354,345,2025-02-28 09:12:00,9
1780,ORD_1781,36338,DC DECORIO® Tooth Brush Head 360 Degree Cleansing U Shaped Toothbrush for Kids baby (DONUT-BLUE),Warehouse A,182,169,2025-02-28 05:30:00,13
1781,ORD_1782,434,BUMZEE Blue Half Sleeves Baby Boys Thigh Length Romper,Warehouse B,149,128,2025-02-28 20:50:00,21
1782,ORD_1783,2475,"GION Baby Anti-Skid Breathable Soft Socks Shoes, Unisex Baby's Cotton Bootie Cute Stylish Kids Socks Shoes Prewalker/First...",Warehouse B,519,492,2025-02-28 03:26:00,27
1783,ORD_1784,36335,DARSHRAJ JEWELLERS 925 Sterling Silver(Chandi) Pure Silver Nazariya With Classic Red & Black Beads For Babies (6.120gm),Warehouse A,265,254,2025-02-28 23:15:00,11
1784,ORD_1785,36334,"Neska Moda 6 To 12 Months Baby Girls Cotton Butterfly Booties (Orange,Blue) -SK138andSK143",Warehouse A,292,258,2025-02-28 21:33:00,34
1785,ORD_1786,32741,"Huggies Complete Comfort Wonder Pants Extra Large (XL) Size Baby Diaper Pants, 24 count, with 5 in 1 Comfort",Warehouse B,262,233,2025-02-28 01:46:00,29
1786,ORD_1787,424,"AHC Nu Nu Pee Cap for Massage and Diaper Changing time (Boy's only, 6 Caps)",Warehouse B,67,53,2025-02-28 09:31:00,14
1787,ORD_1788,35019,Chicco Baby Moments Talcum Powder 150gm,Warehouse B,356,332,2025-02-28 01:45:00,24
1788,ORD_1789,32758,Lillypupp Blue Polka Dots with Bow Velcro Sandals for New Born Baby Girl (0-6 Month),Warehouse B,474,431,2025-02-28 22:30:00,43
1789,ORD_1790,1300,Okara Boy's and Girl's Cotton Diaper Fit Bottom Wear Pants Pack of 06 (Multi-Color),Warehouse A,120,112,2025-02-28 21:44:00,8
1790,ORD_1791,32836,"Chicco Baby Moments Diaper Rash Cream, New Advanced Triple Protection Skin Shield Formula with Natural Ingredients to Prev...",Warehouse C,369,339,2025-02-28 06:13:00,30
1791,ORD_1792,1291,CRAZYON Baby Girls Casual Dress Set Frock and Panty Cotton Combo Pack of 5,Warehouse A,393,382,2025-02-28 11:25:00,11
1792,ORD_1793,1288,Mothercare baby-boys onesies,Warehouse B,348,343,2025-02-28 03:50:00,5
1793,ORD_1794,34888,"Himalaya Extra Moisturizing Baby Wash, 400 ml",Warehouse C,350,315,2025-02-28 11:44:00,35
1794,ORD_1795,1283,"Prima Baby Squares, Soft and Gentle, Chemical Free for soft Baby Skin, (Pack of 2)",Warehouse C,355,334,2025-02-28 02:04:00,21
1795,ORD_1796,31911,BRATS N BEAUTY® - Boy's & Girl's Alphabet (ABCDE) Multicolor (Assorted - 3 Pair) Woolen Gloves 6-12 Month Kids,Warehouse A,60,31,2025-02-28 14:59:00,29
1796,ORD_1797,32826,W2S Girls Summer Frock Dress with Wings & Hat for Ages 6M-24M,Warehouse C,240,201,2025-02-28 04:48:00,39
1797,ORD_1798,32823,"Baby Washcloth - Bamboo Washcloths Towel - Soft Baby Washcloth - Face Towel for Baby, Adult and Infant - Baby Towels (Cool...",Warehouse B,226,199,2025-02-28 23:30:00,27
1798,ORD_1799,31913,"The Moms Co. Natural Baby Massage Oil with 10 Oils - Sesame Oil, Avocado, Organic Almond, Organic Jojoba, Organic Chamomil...",Warehouse C,391,374,2025-02-28 17:46:00,17
1799,ORD_1800,394,Mee Mee Gentle Baby Bubble Bath (with Cherry Extracts- 500 ml) & Mee Mee Mild Baby Shampoo (with Fruit Extracts - 500 ml)...,Warehouse B,184,150,2025-02-28 00:32:00,34
1800,ORD_1801,1245,92.5 Sterling Silver Kids Nazaria cum Bracelet for baby boy & baby girls with Heart Charms adjustable in size,Warehouse C,485,456,2025-02-28 11:33:00,29
1801,ORD_1802,32739,"Neska Moda 6 To 12 Months Baby Girls Cotton Butterfly Booties (Blue,Mint) -BT88andBT8",Warehouse A,145,117,2025-02-28 18:53:00,28
1802,ORD_1803,35014,ASHOPANU Kid's Rabbit Fur Padded Soft unisex Shoes Booties(1 Pair),Warehouse C,359,340,2025-02-28 01:17:00,19
1803,ORD_1804,31953,REVOLTEK Printed Vest baniyan Cotton Inner wear for Baby Summer wear Cloth Sleeveless Undershirts for Kids Sando ganji Tan...,Warehouse A,371,336,2025-02-28 16:04:00,35
1804,ORD_1805,35018,Caterpillar Soft Toys for Children Home Decor Big Size Lots Colors 55Cm' ZuKug,Warehouse B,344,303,2025-02-28 05:05:00,41
1805,ORD_1806,2338,HS HEER SILVER 1 by 1 Black Sterling-silver Half Nazariya for Baby Boys and Girls,Warehouse C,264,215,2025-02-28 10:21:00,49
1806,ORD_1807,31794,"Angel Baby Nail Trimmer File Electric, Safe Baby Nail Clippers with Light and 6 Grinding Pads for Newborn Infant Toddler, ...",Warehouse C,274,241,2025-02-28 09:58:00,33
1807,ORD_1808,34522,"MARMIX 2 Pack U-Shaped Toothbrush Kids, Food Grade Soft Silicone Brush Head, 360° Oral Teeth Cleaning Design for Toddlers ...",Warehouse C,432,398,2025-02-28 10:22:00,34
1808,ORD_1809,32270,"Himalaya Face Body Oil Baby Massage Oil For All Skin Types (500 ML) & Extra Moisturizing Baby Lotion 400 ml, White, (7004789)",Warehouse B,233,204,2025-02-28 04:27:00,29
1809,ORD_1810,35813,"Chicco Baby Moments Baby Cream, New Advanced Formula with Natural Ingredients to Prevent Dryness, Non-Sticky & Moisturizin...",Warehouse A,372,337,2025-02-28 07:51:00,35
1810,ORD_1811,35814,"Neska Moda 12 To 18 Months Baby Girls Pack Of 3 Pair Cotton Butterfly Frill Booties (Black,Maroon,Rani Pink) -BT1150andBT1...",Warehouse B,349,309,2025-02-28 01:29:00,40
1811,ORD_1812,35816,DHRUVS COLLECTION Exclusive 925 Silver Nazariya Bracelet With Heart Charms For Baby Girls & Baby Boys,Warehouse B,218,176,2025-02-28 12:15:00,42
1812,ORD_1813,35809,"Neska Moda 0 To 6 Months Baby Boys & Baby Girls Cotton Rabbit Booties (Blue,Yellow) -BT1113andBT370",Warehouse C,368,356,2025-02-28 19:06:00,12
1813,ORD_1814,768,VIDHIKA New Born Boys Girls Soft Cotton Sleeveless Printed Baby Vest Inner Wear for Infants Undershirt Toddler Sando Baniy...,Warehouse B,437,417,2025-02-28 21:42:00,20
1814,ORD_1815,35790,"SOMIH 10 Pcs Bath Toys and 6 Stacking Rings Toys for Kids, Bath Tub Toys, Baby Toys, Squeeze Sound Toys, Rainbow Toy for K...",Warehouse B,73,38,2025-02-28 18:24:00,35
1815,ORD_1816,35862,Fareto New Born Baby 3 in 1 Sleeping Bag Cum Baby Bed/Carry Bag/Baby Wrapper (0-6 Months)(Blue),Warehouse C,518,491,2025-02-28 15:30:00,27
1816,ORD_1817,35860,New Dew Soft Cotton Sleeveless Tops for Infants Girls Boys and Kids with All Over Prints (A Pack of 5 Shorts),Warehouse A,288,277,2025-02-28 03:41:00,11
1817,ORD_1818,35858,"Neska Moda 0 To 6 Months Baby Girls Cotton Butterfly Booties (Mint,Blue) -BT385andBT1118",Warehouse A,332,286,2025-02-28 11:04:00,46
1818,ORD_1819,35762,Hopscotch Unisex Cotton Strip Half Sleeve Short Set in Multi Color,Warehouse B,239,221,2025-02-28 12:47:00,18
1819,ORD_1820,32264,"Chicco Baby Moments Delight Gift Pack Green, Ideal Baby Gift Sets for Baby Shower, Newborn Gifting, New Parents, Birthday...",Warehouse A,409,371,2025-02-28 18:12:00,38
1820,ORD_1821,2733,SMARTOTS Kids Casual Multicolour Light Laces Shoes for Baby Boys/Girls,Warehouse B,127,88,2025-02-28 19:40:00,39
1821,ORD_1822,35897,Huggies Extra Small / New Born (XS / NB) Tape Baby Diapers (72 Count),Warehouse C,442,399,2025-02-28 00:14:00,43
1822,ORD_1823,35690,Mothercare Baby Boy's Dungaree,Warehouse B,388,350,2025-02-28 17:58:00,38
1823,ORD_1824,35738,Sebamed Baby Body Lotion 100 ml|Ph 5.5|Camomile & Allantoin| Dermatalogically tested| Sensitive skin,Warehouse C,188,182,2025-02-28 16:14:00,6
1824,ORD_1825,32320,"HUG 'n' FEEL SOFT TOYS Panda Teddy, Panda 3 Feet, Soft Toys, Teddy Bear 3 Feet for Girls, Soft Toys for Kids, Birthday Gif...",Warehouse A,189,182,2025-02-28 16:04:00,7
1825,ORD_1826,2721,Mothercare Unisex We All Know Baby Cotton Pads Pack of 60 (White_Free Size),Warehouse A,170,160,2025-02-28 13:54:00,10
1826,ORD_1827,790,Mamaearth Dusting Powder with Organic Oatmeal & Arrowroot Powder for Babies - 300g- white- Medium & Mamaearth Agent Apple ...,Warehouse A,339,291,2025-02-28 18:14:00,48
1827,ORD_1828,35835,"Rebizo Unisex Cotton Clothing Set (Multi-Colored, Pack of 10 Piece, 0-3 Months)",Warehouse A,393,344,2025-02-28 17:00:00,49
1828,ORD_1829,32284,Bold N Elegant Classy Stripe Boys Party T-shirt with attached Tie Waistcoat & Shorts Clothing Set for Infant Toddler Baby ...,Warehouse C,231,212,2025-02-28 10:18:00,19
1829,ORD_1830,32283,Hopscotch Boys and Girls Synthetic/PU Solid LED Sneakers in Orange Color,Warehouse B,435,390,2025-02-28 04:37:00,45
1830,ORD_1831,32280,Baby Boys & Baby Girl's Soft Cotton printed Full sleeve Shirt Pyjama Casual Dress Jhabla for Kids Newborn Infant Toddler C...,Warehouse C,540,498,2025-02-28 21:02:00,42
1831,ORD_1832,784,Toddylon Baby Products All New Born Combo of Daily Needs Items (0-6 Months),Warehouse A,246,227,2025-02-28 18:14:00,19
1832,ORD_1833,35802,Baby Forest Laad Pyaar Baby Bottle (160 ML),Warehouse C,431,419,2025-02-28 16:07:00,12
1833,ORD_1834,35805,Fareto New Born Baby Combo 4 in 1 Daily Use Essential(0-6 Months),Warehouse C,229,209,2025-02-28 22:36:00,20
1834,ORD_1835,2720,"Neska Moda 0 To 6 Months Baby Girls Cotton Butterfly Booties (Maroon,Blue) -BT378andBT1117",Warehouse C,378,362,2025-02-28 16:51:00,16
1835,ORD_1836,2729,ANGAAKAR CLOTHINGS New Born Baby Boys and Baby Girls Printed Cotton Front Open Vest for Infants Full Sleeves for Toddlers ...,Warehouse B,244,218,2025-02-28 18:55:00,26
1836,ORD_1837,778,TINY LOOKS unisex-baby Vest,Warehouse A,451,418,2025-02-28 08:18:00,33
1837,ORD_1838,2797,THE LITTLE LOOKERS for Philips Avent/Broad Neck Feeders Soft Plush Stretchable Baby Feeding Bottle Cover with Easy to Hold...,Warehouse A,32,23,2025-02-28 21:33:00,9
1838,ORD_1839,35549,SMARTOTS Kids Infant Laces CHU CHU Sound Shoes for Baby Boys/Girls CHU-CHU-1,Warehouse A,385,338,2025-02-28 01:17:00,47
1839,ORD_1840,696,Wavva® Safe Shampoo Shower Bathing Protection Bath Cap Tool for Hair Cut with Baby Finger Toothbrush for - Infant & Toddle...,Warehouse C,303,273,2025-02-28 17:36:00,30
1840,ORD_1841,698,Neska Moda 6 To 12 Months Baby Girls Synthetic Leather/Rexine Floral Baby Sandal Booties (Gold)-BT1209,Warehouse C,329,292,2025-02-28 00:28:00,37
1841,ORD_1842,35564,Raja Dresses Baby Cotton Front Open Half Sleeves Jhabla Half Sleeves Front Open T-Shirt Multicolored Solid Color Tees with...,Warehouse A,234,207,2025-02-28 11:12:00,27
1842,ORD_1843,943,"Runbugz Mosquito Repellent Patches, Anti Mosquito Patch - Blue, 24 Patches",Warehouse C,278,233,2025-02-28 08:12:00,45
1843,ORD_1844,32417,Mothercare Printed Cotton Girls Infant Trousers (S21VF020BL-P),Warehouse A,430,422,2025-02-28 21:56:00,8
1844,ORD_1845,694,moha: Moisturizing Lotion with Foot Care Cream (Lotion 100ml & Foot Care Cream 100ml),Warehouse A,412,364,2025-02-28 22:40:00,48
1845,ORD_1846,2650,Supples Baby Wet Wipes with Aloe Vera and Vitamin E - 72 Wipes/Pack (Pack of 9),Warehouse C,320,306,2025-02-28 00:41:00,14
1846,ORD_1847,36017,Himalaya Gentle Baby Bath 200 ml x Pack of 4,Warehouse C,58,35,2025-02-28 09:24:00,23
1847,ORD_1848,35509,"Johnson's Baby Soap, 150g",Warehouse C,431,418,2025-02-28 09:09:00,13
1848,ORD_1849,35515,"Sunuo Baby's Cotton Cloth Diapers/Langot Washable and Reusable Nappies (Multicolour, 0-6 Months) Pack of 10 Pieces (MULTI)",Warehouse A,536,491,2025-02-28 15:36:00,45
1849,ORD_1850,665,Baby Girl and Baby boy 3rd Birthday Number Printed Cotton t-Shirt,Warehouse B,132,110,2025-02-28 01:37:00,22
1850,ORD_1851,668,"Superminis Unisex Baby Mix Colors Printed Cotton Diaper Pyjama Pant Bottom for Toddler Kids, Assorted (Multicolor, 2-3 Yea...",Warehouse C,39,16,2025-02-28 11:42:00,23
1851,ORD_1852,35546,Baby Cry New Born Baby Cotton Housiry Mittens Set/Hand Gloves/Muthi/to Keep Baby Hand Tender for Age 0 to 6 Months,Warehouse B,431,389,2025-02-28 19:23:00,42
1852,ORD_1853,35854,"DRESSABLY Cotton Washcloth 450 GSM for New Born Baby/Infants/Toddlers Soft Bath Towel (Multicolour, Small, 48cm x 84cm)",Warehouse B,441,414,2025-02-28 11:14:00,27
1853,ORD_1854,958,AARAM Ultrasoft Waterproof Dry Rubber Cloth for Bed Protection/Toddler Sleeping Mattress Protector/Urine Non-Absorbent Reu...,Warehouse B,242,205,2025-02-28 12:43:00,37
1854,ORD_1855,32301,"Peach Cuddle Cute Animal Shaped Cushion for Kids Room (45x45 cm, Lion) Animal Cushion for Kids, Kids Furnishing, Decorativ...",Warehouse B,388,379,2025-02-28 06:45:00,9
1855,ORD_1856,765,"First Trend Baby's Mittens, Bootie, Cap Combo Set (Blue, 3-6 Months)",Warehouse B,422,399,2025-02-28 18:37:00,23
1856,ORD_1857,32298,CLAP Baby Booties Footed Leggings Pants Multicolor Set of 4,Warehouse B,311,303,2025-02-28 01:31:00,8
1857,ORD_1858,2712,"Rsmart Non-Slip Cotton Floral Print Ribbon Closure Booties Shoes for Baby Girl & Boy, Maroon & White",Warehouse A,95,70,2025-02-28 04:20:00,25
1858,ORD_1859,798,Levi's baby-girls Baby and Toddler Suit,Warehouse B,196,190,2025-02-28 11:03:00,6
1859,ORD_1860,797,"X&Y Furniture for Growth Pink Papaya Bookends, Book Organizer, Star & Moon, Wooden Kids Room Decorative, Book Stopper for ...",Warehouse A,324,295,2025-02-28 13:26:00,29
1860,ORD_1861,795,Goyal's Cartoon Baby Adjustable Walker - Music & Rattles with Parental Handle (Red),Warehouse A,526,486,2025-02-28 09:23:00,40
1861,ORD_1862,35841,"TONY STARK U Shaped Toothbrush For Kids , Manual U Type 360 Degree Soft Silicone Oral Teeth Cleaning Gift For Baby Infant ...",Warehouse A,205,175,2025-02-28 20:47:00,30
1862,ORD_1863,35867,Jewelz Multi-colored Cute Beaded Necklace And Stylish Bracelet Kids Jewellery Set Combo Of 2 For Kids In Playful Design,Warehouse A,64,44,2025-02-28 05:16:00,20
1863,ORD_1864,35499,USHA Baby Girl's Knee Length Fit & Flare Frock With Hair band,Warehouse A,284,240,2025-02-28 12:40:00,44
1864,ORD_1865,32171,ANKIMA Baby Girl & Boy Soft Winter Hand Gloves Kids Pack of 6 Multicolour (18-24 Months),Warehouse C,156,125,2025-02-28 21:08:00,31
1865,ORD_1866,687,HIBA Baby Girl Peacock Tutu Skirt for New Born Baby Photoshoot,Warehouse C,150,130,2025-02-28 01:40:00,20
1866,ORD_1867,35534,"Cucumber Baby Boys & Baby Girls Casual Vest (Multicolor) (Pack of 3) (6-12 Months, Peach-Yellow-Sky Blue)",Warehouse B,70,33,2025-02-28 06:16:00,37
1867,ORD_1868,961,Roble Baby Boy's and Baby Girl's Romper & Dungaree,Warehouse C,498,478,2025-02-28 13:48:00,20
1868,ORD_1869,32442,Huggies Little Swimmers Diapers - Large - 10 ct,Warehouse C,354,320,2025-02-28 20:10:00,34
1869,ORD_1870,35543,Merries Pants - Exceptional Breathability Baby's Extra Extra Large Size Diapers (26 Count),Warehouse B,489,458,2025-02-28 05:58:00,31
1870,ORD_1871,968,DentoShine Oral Care Combo Ages 2+ (Sticky Toothbrush for Kids + Lollipop Tongue Cleaner + Flavored Toothpaste 80 g x 2) (...,Warehouse A,111,88,2025-02-28 20:50:00,23
1871,ORD_1872,2566,Fisher Price SB04 Multi Utility Convertible Baby Sleeping Bag (Multicolor) (470.0mm L X 320.0mm W),Warehouse A,243,226,2025-02-28 13:38:00,17
1872,ORD_1873,35276,"benext Boys Cotton Dungaree (8-9 Years, Multicolour)",Warehouse C,205,168,2025-02-28 23:03:00,37
1873,ORD_1874,35277,"Neska Moda 12 To 18 Months Baby Boys & Baby Girls Pack Of 2 Pair Cotton Butterfly Booties (Maroon,Black) -BT1143andBT1159",Warehouse B,385,358,2025-02-28 12:29:00,27
1874,ORD_1875,1076,TopiBaaz Moving Ear Cap for Girls | Winter Cap | Ears Moves | Rabbit Ears | Plush Wool,Warehouse B,173,160,2025-02-28 01:05:00,13
1875,ORD_1876,32583,SIO Soft Socks for babies Cotton Woolen Mix Baby Boys Girls Socks Pack of 6 Pairs 6 To 12 Months,Warehouse A,399,364,2025-02-28 21:59:00,35
1876,ORD_1877,32075,Mee Mee Mild Baby Liquid Laundry Detergent (500ml - Refill Pack) And Mee Mee Anti-Bacterial Baby Liquid Cleanser Combo (50...,Warehouse C,331,306,2025-02-28 01:30:00,25
1877,ORD_1878,36163,Neska Moda Baby Girls Synthetic Leather Hook & Loop Loafer Booties/Shoes For 6 To 12 Months (Gold) -BT908,Warehouse C,363,327,2025-02-28 21:09:00,36
1878,ORD_1879,2842,"Safe-O-Kid- Extra Safe, Oral hygiene, Transparent Silicone Finger Brush Tongue Cleaner for Baby Teething/ Gums with Attrac...",Warehouse A,45,24,2025-02-28 09:26:00,21
1879,ORD_1880,2841,Eucerin Eucerin Baby Baby Wash & Shampoo - 13.5 oz,Warehouse A,384,377,2025-02-28 14:35:00,7
1880,ORD_1881,2838,"KidDough Baby Proofing Door Stopper Finger Pinch Guard | Accidental Door Lock and Slamming Door Protection for Child, Babi...",Warehouse B,253,223,2025-02-28 21:58:00,30
1881,ORD_1882,35299,FOOTPRINTS Organic cotton Kids Socks - Pack of 3 Pairs - Stripes,Warehouse A,496,466,2025-02-28 05:35:00,30
1882,ORD_1883,32593,1st Step Baby Nail Clipper Easy Grip (Blue),Warehouse B,313,291,2025-02-28 23:25:00,22
1883,ORD_1884,571,Kidbee Baby Boy's & Baby Girl's Woolen Monkey Cap,Warehouse A,122,90,2025-02-28 00:07:00,32
1884,ORD_1885,32090,"Zero Baby Boys & Girls Cotton All Over Print Pajama Bottom (Multi Pack) (1 Month - 3 Months, White)",Warehouse C,510,486,2025-02-28 00:52:00,24
1885,ORD_1886,575,Baby Cry Baby's Boy's Cotton Shorts Multicolor Pack of 5 (6-12months),Warehouse A,415,371,2025-02-28 17:56:00,44
1886,ORD_1887,581,MY BABY TOWN Baby Boy's and Baby Girl's full long sleeve Cotton Sleepsuit Romper,Warehouse B,295,265,2025-02-28 08:57:00,30
1887,ORD_1888,35321,Aarika baby-girls Clothing Set,Warehouse A,381,358,2025-02-28 16:54:00,23
1888,ORD_1889,36126,MINI KLUB Boys Blue Dungaree Set,Warehouse C,138,123,2025-02-28 07:52:00,15
1889,ORD_1890,36125,Passion Petals 5G Printed Kids Unisex Led Shoes - White,Warehouse A,123,98,2025-02-28 17:15:00,25
1890,ORD_1891,32569,Himalaya Baby Powder (700 GM),Warehouse B,355,317,2025-02-28 05:22:00,38
1891,ORD_1892,35325,"Mee Mee BPA Free, 2 in 1 Convertible Sipper Cup for Babies/Toddlers/Kids with Soft Spout & Straw/Anti-Leak/Detachable Hand...",Warehouse A,138,111,2025-02-28 11:19:00,27
1892,ORD_1893,2832,Mothercare Baby Boys' Dungaree,Warehouse B,447,433,2025-02-28 09:29:00,14
1893,ORD_1894,586,"Neska Moda 6 To 12 Months Baby Girls Cotton Butterfly Frill Booties (Black,Yellow) -SK127andBT44",Warehouse A,250,223,2025-02-28 15:21:00,27
1894,ORD_1895,1048,MOM CARE Cotton Hand Towel Soft Reusable Hankies Napkins for Kids Toddlers Kids Adults Pack of 12 Multicolor,Warehouse B,528,486,2025-02-28 16:28:00,42
1895,ORD_1896,32094,Kabello Warm Thigh High Knee High Leg Warmer For Men And Women Multi Color Pack Of 1,Warehouse A,140,111,2025-02-28 13:40:00,29
1896,ORD_1897,1058,Briskhi Baby Waterproof and Quick Dry Breakfast Lunch Dinner Towel Bibs Apron for Baby boy and Girl Pack of 3 ( Multi )BR-001,Warehouse A,500,458,2025-02-28 16:54:00,42
1897,ORD_1898,1059,BabyGo Garden & School Toy Swing Junior,Warehouse C,446,421,2025-02-28 21:26:00,25
1898,ORD_1899,36153,"Johnson's Baby No More Tears Shampoo, 200ml",Warehouse A,167,138,2025-02-28 08:36:00,29
1899,ORD_1900,35901,KRAAFTAR Handmade Newborn Baby Headband Baby Shower Photo Prop Hairband Rose Red,Warehouse C,458,412,2025-02-28 11:40:00,46
1900,ORD_1901,2704,VEESIL Kids Baby Boys' Girls Dinosaur Print Half Sleeves T-Shirts Shorts Night Suit Infant Toddler Top and Pyjama Cartoon ...,Warehouse A,436,387,2025-02-28 00:56:00,49
1901,ORD_1902,32332,Max Boys Checked Woven Bermuda Shorts,Warehouse A,94,55,2025-02-28 13:20:00,39
1902,ORD_1903,35700,HIKUJ Cotton Clothing Sets for Baby Boys & girls All Over Dionasure printed - Unisex Clothing sets Full Sleeve T-shirt & T...,Warehouse B,495,461,2025-02-28 12:42:00,34
1903,ORD_1904,35649,NAPPERS by Mother Sparsh Free Size Cloth Diaper for Babies | Reusable & Adjustable | with 1200+ GSM Dry Feel Absorbent Soa...,Warehouse B,214,191,2025-02-28 12:46:00,23
1904,ORD_1905,728,Johnson's Baby Milk Cream (30g),Warehouse B,251,238,2025-02-28 07:11:00,13
1905,ORD_1906,32370,Chicco Baby Soap pack of 4 75g,Warehouse A,253,237,2025-02-28 04:35:00,16
1906,ORD_1907,875,"Santa Claus Dress For Kids, Santa Claus Dress For New Born Baby Girl & Baby Boy| Christmas Costume Dress SIZE 1 - Red ( Ag...",Warehouse C,201,195,2025-02-28 04:37:00,6
1907,ORD_1908,863,"GUCHIGU Baby Toothbrush & Toddler Toothbrush for Age 2-10 Years Old, Extra Soft Toothbrush with 10000 Soft Floss Bristle f...",Warehouse A,426,406,2025-02-28 11:32:00,20
1908,ORD_1909,35905,Sahiba Gems Exclusive Stretchable Blue Evil Eye Nazariya 925 Sterling Silver Baby Bracelet Nazariya with Black Beads/Cryst...,Warehouse B,521,482,2025-02-28 10:13:00,39
1909,ORD_1910,862,DIVINE CHARM (Pack of 7) Fashionable Silver Stylish Rings for Girls to wear Casually and Occasionally,Warehouse B,392,349,2025-02-28 00:54:00,43
1910,ORD_1911,861,Bouncy Toonz New Born Baby Boys Girls Unisex Romper Onesie Bodysuit Infant Dress Pure Cotton Clothes Monthly Milestone Bir...,Warehouse C,520,493,2025-02-28 22:36:00,27
1911,ORD_1912,35679,"Mee Mee Advanced Digital Electric Breast Pump with 3 Modes - Massage, Suction & Let-Down |For Nursing & Breastfeeding (White)",Warehouse B,140,112,2025-02-28 06:05:00,28
1912,ORD_1913,32222,Red Tape Kids-Unisex Walking Shoes,Warehouse B,46,21,2025-02-28 20:01:00,25
1913,ORD_1914,32359,"Himalaya Anti Hair Fall Shampoo with Bringaraja, 1000 ml and Himalaya Gentle Baby Soap Value Pack, 4 * 75g",Warehouse C,47,42,2025-02-28 20:25:00,5
1914,ORD_1915,35870,Zalak || Exclusive Evil Eye Nazariya Black & Silver Beads Crystal With Silver Plated Bracelet for Baby Boys & Baby Girls,Warehouse A,317,277,2025-02-28 08:46:00,40
1915,ORD_1916,32237,Puma Girls Cruise Rider Peony Junior Sneaker,Warehouse C,183,152,2025-02-28 23:52:00,31
1916,ORD_1917,2805,Sunbaby Multi-Functional Front Baby Carrier Ideal for Kids 0 to 3 Years Soft Cushion Adjustable Straps (Blue),Warehouse B,159,115,2025-02-28 02:13:00,44
1917,ORD_1918,2635,"RBC RIYA R New Born Baby Clothes & Bedding Gift Combo (Multicolor, 0-6 Months)",Warehouse C,462,422,2025-02-28 05:35:00,40
1918,ORD_1919,741,KHUSHI Baby Girl's Frock for 1-2 Years,Warehouse C,226,216,2025-02-28 14:39:00,10
1919,ORD_1920,32343,BABIES HEART BabiesHeart Baby Girl's Stylish Soft Cotton Dress with Round Neck I Girl's Printed Dress with Short Sleeve,Warehouse B,50,26,2025-02-28 21:03:00,24
1920,ORD_1921,35704,LE FASHION Cotton Printed Kids Shorts for Baby Boys and Girls - Regular Fit Daily Use Multicolored Pack of 5.,Warehouse B,205,163,2025-02-28 08:27:00,42
1921,ORD_1922,35706,MINI KLUB Boys Blue Jogger Pack of 1,Warehouse A,38,29,2025-02-28 18:08:00,9
1922,ORD_1923,35707,odinbirds Combo of 4 Animals Soft Toy Kids (Baby) for Playing Soft Toy Panda Penguin Rabbit & Dog.All Best Stuff Toys for ...,Warehouse A,178,153,2025-02-28 06:52:00,25
1923,ORD_1924,2695,The Chipmunk Store’s Powder Puff with Unbreakable Powder Storage case and Soft Puff for Babies-Pink (Pack of 1),Warehouse B,535,486,2025-02-28 03:24:00,49
1924,ORD_1925,35881,"SebaMed Baby Powder, 200g & Baby Massage Oil, 150ml Combo",Warehouse A,457,426,2025-02-28 06:03:00,31
1925,ORD_1926,35713,Cetaphil Baby Wash & Shampoo with Organic Calendula 400ml and Baby Mild Bar 75g(2Pcs) (Pack of 3)- Combo,Warehouse B,242,195,2025-02-28 09:34:00,47
1926,ORD_1927,35720,"Episkey Baby Grooming Kit, Newborn Baby, Toddler, Kids Care Accessories Set, Portable Nursery Infants Care Kit with Scisso...",Warehouse A,316,310,2025-02-28 04:22:00,6
1927,ORD_1928,32336,Ducosoft baby bathing bar 75g (pack of 3),Warehouse B,505,483,2025-02-28 04:01:00,22
1928,ORD_1929,35879,MINI KLUB baby-boys Jacket,Warehouse C,80,65,2025-02-28 10:57:00,15
1929,ORD_1930,35702,"Thumb Sucking Stop for Kids, Silicone Baby Finger Guard with Breathable Wrist Band and Massage Bumps, Adjustable Thumb Suc...",Warehouse C,522,480,2025-02-28 18:32:00,42
1930,ORD_1931,2700,KNITROOT Unisex Baby Bodysuit for Toddler Half Sleeve White Color Cool Like My Mamu,Warehouse A,120,100,2025-02-28 10:33:00,20
1931,ORD_1932,32331,CHIRUK cotton [baby rompers/onesies/bodysuits] new born essentials [pack of 5],Warehouse C,70,34,2025-02-28 17:16:00,36
1932,ORD_1933,35722,Cetaphil Baby Wash & Shampoo with Organic Calendula - Pack of 2,Warehouse B,413,401,2025-02-28 00:07:00,12
1933,ORD_1934,829,Sahiba Gems Exclusive 92.5 Sterling Silver Plain Fashion Baby Kadas for Girls & Boys,Warehouse A,304,256,2025-02-28 00:54:00,48
1934,ORD_1935,825,1 to 2 Years Baby Boy Girl Cotton Summer Cloth Set Of T-shirt & Shorts I Printed Stretchable Soft Comfort Wear,Warehouse A,493,453,2025-02-28 11:51:00,40
1935,ORD_1936,330,Mothercare All We Know Baby Body Wash and Oil (300 ml Each),Warehouse A,242,215,2025-02-28 17:23:00,27
1936,ORD_1937,2980,"Little Angel Extra Dry Baby Pants Diaper, Small (S) Size, 44 Count, Super Absorbent Core Up to 12 Hrs. Protection, Soft El...",Warehouse A,375,327,2025-02-28 02:14:00,48
1937,ORD_1938,34688,"Parasoft Baby Soap Mild & Gentle Daily Moisturizing Bathing Bar with Jojoba Oil, Almond Oil & Vitamin E For Cleansing and ...",Warehouse B,173,157,2025-02-28 06:03:00,16
1938,ORD_1939,34731,"SNOWIE SOFT® Baby Nail Trimmer New Born, Electric Nail Cutter with 6 Grinder Bit for Kids Manicure Kit Nail Clippers Painl...",Warehouse A,81,44,2025-02-28 01:18:00,37
1939,ORD_1940,2986,Himalaya Baby Care Soothing Calamine Baby Lotion 100ML,Warehouse C,241,209,2025-02-28 22:16:00,32
1940,ORD_1941,34733,Printed Baby Vest for Kids Cotton Sleeveless Sando Baniyan Toddler Innerwear Baby Cloth for Boys & Girls Pack of 3,Warehouse C,316,305,2025-02-28 06:58:00,11
1941,ORD_1942,34805,Johnson's Lotion - Baby 100ml Bottle,Warehouse A,160,121,2025-02-28 00:01:00,39
1942,ORD_1943,1337,LBV 925 Sterling Silver Semi Precious Clear Quartz Birth Stone With Traditional black Thread Nazariya Bracelet For Boys an...,Warehouse C,355,334,2025-02-28 05:26:00,21
1943,ORD_1944,34817,Modicare Baby Spa Daiper Rash Cream 50g each (Pack of 2),Warehouse A,508,485,2025-02-28 17:31:00,23
1944,ORD_1945,34818,Lwvax Baby Nasal Aspirator Nose Cleaner Ear Syringe Bulb Syringe Nasal Snot Sucker Remover for Newborn Baby Toddlers BPA F...,Warehouse A,143,98,2025-02-28 20:57:00,45
1945,ORD_1946,1325,Onplay Junior New Born Baby Dress set Of Printed Tshirt and Shorts Cotton Combo Jhabla Clothing Sets For 0-3 Months New Bo...,Warehouse B,269,237,2025-02-28 01:16:00,32
1946,ORD_1947,32863,United Colors of Benetton Baby Boys' Regular Fit Shorts,Warehouse B,344,332,2025-02-28 00:55:00,12
1947,ORD_1948,32862,Kuchipoo Unisex Cotton Animal Print Pajama Bottom (Pack of 5),Warehouse B,288,246,2025-02-28 22:35:00,42
1948,ORD_1949,34798,Wowper Fresh Baby Diaper Pants | Small Size Diapers | Diapers with Wetness Indicator | Upto 10 Hrs Absorption | 4-8 Kg | 5...,Warehouse B,67,32,2025-02-28 16:14:00,35
1949,ORD_1950,34839,Baby's Cotton Cap (Pack Of 3) (391-ga-1088-cap_Multicolor_0 Months-3 Months),Warehouse C,334,294,2025-02-28 03:52:00,40
1950,ORD_1951,36500,"6 To 12 Months / 1 Year Baby Boys & Baby Girls Pack of 2 Pair Cotton Dog Face Booties (Black,Orange)",Warehouse A,265,222,2025-02-28 14:14:00,43
1951,ORD_1952,2381,The Little Lookers Watermelon Popsicle Baby Bathing Soap | 100% Handmade & Organic for Baby/Kids - 95g (Pack of 2),Warehouse A,308,300,2025-02-28 21:15:00,8
1952,ORD_1953,2985,NammaBaby Baby Girls' A-Line Mini Frock Dress,Warehouse B,175,128,2025-02-28 16:13:00,47
1953,ORD_1954,34652,"Neska Moda 12 To 18 Months Baby Girls Cotton Butterfly Booties (Rani,Red) -BT1147andBT1164",Warehouse C,486,469,2025-02-28 04:40:00,17
1954,ORD_1955,31842,Mini Klub Baby Boy's Regular fit Romper Suit (97BBRO653-ON_MULTI12_0 3 Months),Warehouse A,444,421,2025-02-28 07:31:00,23
1955,ORD_1956,34655,THE MODERN TREND The-Modern-Trend--Baby Head Protector Safety Head-0 to 3 Year Baby/Kid Helmet Yellow,Warehouse B,29,10,2025-02-28 05:33:00,19
1956,ORD_1957,34659,UJEAVETTE Baby Summer Shoes Sandals Anti-Slip Soft Sole 0-18M 7-12Months Pink,Warehouse B,335,298,2025-02-28 21:58:00,37
1957,ORD_1958,36517,"Mamaearth Daily Moisturizing Lotion, 200ml",Warehouse B,489,461,2025-02-28 13:54:00,28
1958,ORD_1959,34660,SIGNATRON Puzzle Flooring || Kids Interlocking Play mat || Baby Play Mat || Play mats for Kids || 12 MM Thick (Blue Yellow...,Warehouse B,102,64,2025-02-28 02:56:00,38
1959,ORD_1960,34662,"Neska Moda Baby Boys & Girls 6 Pairs Striped Ankle Socks For 0 To 6 Months (Purple,Pink,Grey,Dark Blue,Red)",Warehouse A,469,435,2025-02-28 08:44:00,34
1960,ORD_1961,36511,First Kick New Born Baby Soft Neck Supporting Pillow for Head Shaping Baby (0-18 Month) Beige,Warehouse C,492,464,2025-02-28 21:00:00,28
1961,ORD_1962,31844,Sharma Dresses Woolen V-Neck Winter Wear Poncho for Girls,Warehouse A,92,56,2025-02-28 07:13:00,36
1962,ORD_1963,1401,"Mamaearth Moisturizing Baby Bathing Soap Bar, Pack of 2, 75gms Eac & Dusting Powder with Oatmeal & Arrowroot Powder 150g &...",Warehouse C,200,194,2025-02-28 19:22:00,6
1963,ORD_1964,34678,Munchkin Fishin' Bath Toy,Warehouse B,498,478,2025-02-28 12:25:00,20
1964,ORD_1965,34679,Hopscotch Baby Girls Sequin Beaded Mary Jane in Gold Color,Warehouse A,146,117,2025-02-28 12:04:00,29
1965,ORD_1966,34681,Fflirtygo Baby Wear 100% Hosiery Cotton Infants Rompers with Booties/Onesies/Body Suit/Sleepsuit/Jumpsuit Full Sleeve My f...,Warehouse B,145,122,2025-02-28 13:03:00,23
1966,ORD_1967,2413,Silver Shine Mosquito Net Single Bed Foldable 2.4 mm Strong PVC Coated Steel Mosquito Protection (White Blue),Warehouse B,151,137,2025-02-28 03:33:00,14
1967,ORD_1968,1314,MY NEWBORN Designer Baby AC Blanket -Pack of 1 (White Bear) | Boy Girl New Born Wrapper | 0-12 Months | Skin-Friendly | Gr...,Warehouse C,289,254,2025-02-28 11:43:00,35
1968,ORD_1969,34777,AMAZARA Baby Proofing Edge & Corner Guards | Extra Long 16.4Ft Edge + 8 Pre-Taped Corner Protectors | Child Safety Furnitu...,Warehouse C,137,98,2025-02-28 07:38:00,39
1969,ORD_1970,32875,"Johnson's Baby Milk and Rice Cream for Summer, 200 g",Warehouse A,338,299,2025-02-28 07:00:00,39
1970,ORD_1971,34784,Decent Apparel SunLook Girl's Dress Girls Ethnic Dresses Frock Birthday Frock,Warehouse B,39,12,2025-02-28 05:34:00,27
1971,ORD_1972,34785,Baby Girls Midi/Knee Length Festive/Wedding Dress Sleeveless,Warehouse A,309,276,2025-02-28 11:51:00,33
1972,ORD_1973,1350,"Maate Baby Shampoo | Kids Shampoo for Soft & Shiny Baby Hair | Sulphate Free Shampoo for Daily Use | pH Balanced, Soap Fre...",Warehouse A,62,14,2025-02-28 18:15:00,48
1973,ORD_1974,32869,Hopscotch Girls EVA Floral Applique Infant Booties in Gray Color,Warehouse C,341,335,2025-02-28 20:41:00,6
1974,ORD_1975,362,First Kids Step Babies Cotton Shorts,Warehouse B,324,286,2025-02-28 16:53:00,38
1975,ORD_1976,34737,"VENUSIA Dr Reddy's Venusia Baby Intensive Moisturizing Lotion for Dry and Ultra Dry Skin Contains Cocoa, Aloe, Mango & She...",Warehouse A,421,379,2025-02-28 21:36:00,42
1976,ORD_1977,34853,"Vital Creations Non-Toxic BPA Free Soft Colourful CHU CHU Balls Toys with Sound | Toddlers Ball Toy Combo - Multicolour, P...",Warehouse A,141,106,2025-02-28 22:56:00,35
1977,ORD_1978,1416,"Dr. Brown's Baby Toothbrush And Finger Toothbrush (Pack Of 1, Pink)",Warehouse C,343,323,2025-02-28 21:20:00,20
1978,ORD_1979,2991,Tiny Kids Casual Shoe/LED Shoe for Baby Boys and Girls/Toddler Shoes / (T101)- NW-RS101(3),Warehouse B,289,258,2025-02-28 04:15:00,31
1979,ORD_1980,33005,Babies Bloom Pink Baby Girl Gift Bag/Baby Shower Party Favors (Set of 6),Warehouse A,421,382,2025-02-28 08:14:00,39
1980,ORD_1981,36580,Sanosan Baby Bath and Shampoo SLS free - 200ml,Warehouse A,77,60,2025-02-28 14:54:00,17
1981,ORD_1982,286,GJ Baby Baby-Boys Trousers,Warehouse A,167,152,2025-02-28 12:57:00,15
1982,ORD_1983,36578,"Sebamed Baby Cleansing Bar (150g) & Childrens' Shampoo, 500ml Combo",Warehouse B,426,410,2025-02-28 10:44:00,16
1983,ORD_1984,34509,"BeeBaby Orthodontic Silicone Baby Pacifier with Protective Cap, Pink (Pack of 2)",Warehouse A,61,26,2025-02-28 17:55:00,35
1984,ORD_1985,1512,"HUG 'n' FEEL SOFT TOYS Teddy Bear, Soft Toys, Teddy Bear 3 feet for Girls, Birthday Gift for Girls, Birthday Gift, Boyfrie...",Warehouse C,108,76,2025-02-28 11:33:00,32
1985,ORD_1986,1354,ANGAAKAR CLOTHINGS Baby Boy's Round Neck Striped Half Sleeves Kids T-Shirt Pack of 3 (Multicolored),Warehouse C,167,152,2025-02-28 08:25:00,15
1986,ORD_1987,2407,Koparo Clean Natural Dishwashing Liquid | 5 Litres Pack | Fragrance - Liime And Basil | Eco-Friendly & Plant Based With Te...,Warehouse B,270,250,2025-02-28 13:59:00,20
1987,ORD_1988,34845,Alya Premium Multi-Functional Baby Smart Medicine Needle Feeder Squeeze Medicine Dropper Teether (Blue;20ML;4 Months+),Warehouse B,461,430,2025-02-28 13:56:00,31
1988,ORD_1989,36440,GUSTAVE® Cap for Kids Spiderman Caps for Boys Girls Baseball Cap Sport Hat Cap Sun Hat for 3-4 Years Old Kids Spider Man M...,Warehouse C,250,212,2025-02-28 00:10:00,38
1989,ORD_1990,32855,Mi Arcus Headbands with Bow Applique (0-6 Months),Warehouse A,155,110,2025-02-28 18:22:00,45
1990,ORD_1991,377,Hopscotch Girls Polyester Floral Print Casual Dress in Multi Color,Warehouse A,158,147,2025-02-28 20:03:00,11
1991,ORD_1992,1309,Chicco Massage Oil 200 ML,Warehouse C,220,189,2025-02-28 21:13:00,31
1992,ORD_1993,1322,Mom's Love Baby-Boys Baby and Toddler Sleepers,Warehouse B,49,18,2025-02-28 12:07:00,31
1993,ORD_1994,34797,"MOM'S HOME Organic Muslin New Born Baby Gift Set - Blue White - 9 Items - Pack of 4 Muslin Swaddle, Pack of 5 Muslin Napkin",Warehouse C,84,56,2025-02-28 01:08:00,28
1994,ORD_1995,34796,WorldCare® 3mm Neoprene Diving Scuba Surfing Swimming Socks Snorkeling Boots L(42-44) (66000587JEL),Warehouse B,303,275,2025-02-28 05:58:00,28
1995,ORD_1996,32894,3 Pieces Kids Swim Caps for Boys Girls Age 1-6 Waterproof Swimming Cap Pool Cap for Kids Child Swim Caps for Toddler Youth...,Warehouse C,100,83,2025-02-28 03:21:00,17
1996,ORD_1997,2404,BUTUNU Printed Fashionable Baby Kids Girls Infant Cotton Front Open Full Long Sleeves Short Frock Dress Combo Set Pack of 3,Warehouse A,496,452,2025-02-28 22:19:00,44
1997,ORD_1998,34755,Tinny Tots Baby Silicone Soft Bristles Finger Tooth Brush With Tongue Cleaner Back And Travel Protective Case Soft Baby To...,Warehouse B,379,347,2025-02-28 11:28:00,32
1998,ORD_1999,36465,Nino Bambino 100% Organic Cotton Grey Colour Printed Sleeveless Round Neck Snap Closure Half Romper/Bodysuit/Onesies/Dress...,Warehouse B,309,280,2025-02-28 00:10:00,29
1999,ORD_2000,1377,SuperBottoms NEW UNO Freesize Cloth Diaper | Cloth diaper for babies 3M to 3Y | Washable & Reusable cloth diaper | Comes w...,Warehouse C,98,90,2025-02-28 05:42:00,8
2000,ORD_2001,348,Maanit Foldable Plastic Baby Bath Tub with Anti Slip Base with Shampoo Mug (Blue),Warehouse A,131,88,2025-02-28 00:52:00,43
2001,ORD_2002,893,"Himalaya Gentle Baby Soap (4N*75g) & Himalaya Diaper Rash Cream, 20g",Warehouse C,134,96,2025-02-28 13:55:00,38
2002,ORD_2003,32206,Milky Soft Diaper Rash Cream for Babies – 50g & Deeply nourishing wash for babies (200 ml),Warehouse B,65,31,2025-02-28 18:40:00,34
2003,ORD_2004,35628,NHR Creative Puzzle Block 140 Pieces Smart DIY Stick Toys Assembly Colorful Educational Building Smart City Blocks with Wh...,Warehouse B,114,102,2025-02-28 05:40:00,12
2004,ORD_2005,32385,"Little Peaches Pure Cotton Terry Baby Burp Cloths/Napkins for Babies, Baby Burpies (Pack of 4)",Warehouse A,447,417,2025-02-28 21:25:00,30
2005,ORD_2006,890,Samyak Combo of 40 Pcs Cute Mini Cartoon Character Crown Multi Designs Matte Hair Clutch Clips Claws For Kids Baby Girls,Warehouse B,138,118,2025-02-28 07:39:00,20
2006,ORD_2007,32209,LIGHTER HOUSE™ Children Soft-bristled Toothbrush Cartoon Dinosaur Soft Bristle Kids Oral Health Care 2-12 Years Old (02 Pc...,Warehouse C,407,400,2025-02-28 01:55:00,7
2007,ORD_2008,35613,"CITTA Foaming Baby Shampoo, Baby Body Wash & Moisturizing Baby Balm Pack of 3 - 150 ml 150 ml & 200 gm | Free from Harmful...",Warehouse A,167,127,2025-02-28 10:52:00,40
2008,ORD_2009,2670,Greendigo Organic Cotton Sleeveles Top/Jhablas/for Premature babies/Preemie babies - Pack of 1,Warehouse A,426,391,2025-02-28 02:44:00,35
2009,ORD_2010,35921,"Luv Lap LuvLap Steel Feeding Baby Bottle, BPA Free Anti Colic, Made of SS304 Steel, Handle, 3M+ - 240 ml",Warehouse B,391,347,2025-02-28 13:33:00,44
2010,ORD_2011,35635,Jordan Children 3-5 Years Kids toothbrush with Sand Timer BPA Free toothbrush (Green - 3-5 Years),Warehouse C,188,176,2025-02-28 14:16:00,12
2011,ORD_2012,32213,"Neska Moda 6 To 12 Months Baby Boys & Baby Girls Pack Of 2 Pair Cotton Butterfly Frill Booties (Light Green,Orange) -BT16a...",Warehouse B,478,447,2025-02-28 21:41:00,31
2012,ORD_2013,886,Mom's Love unisex-baby Baby and Toddler Sleepers,Warehouse A,407,363,2025-02-28 11:40:00,44
2013,ORD_2014,35632,Mothercare Baby-Girls Dress,Warehouse B,416,375,2025-02-28 19:45:00,41
2014,ORD_2015,32393,a baby cherry - Suction Plates for Baby & Toddler - 100% Food Grade Plates for Kids - BPA Free - Divided Plates for Self F...,Warehouse A,99,68,2025-02-28 07:46:00,31
2015,ORD_2016,720,STOP to start by Shoppers Stop Synthetic a-line Dress,Warehouse C,49,12,2025-02-28 11:47:00,37
2016,ORD_2017,35577,Velvet and Nylon Based Baby Frock for Kid Girls,Warehouse B,265,248,2025-02-28 05:28:00,17
2017,ORD_2018,32200,XMXM Baby Nail Trimmer with 6 Grinding Heads Safe for New Born Baby Nail Filer Clippers Electric with Light Painless Safe ...,Warehouse A,147,115,2025-02-28 21:01:00,32
2018,ORD_2019,36008,KHUSHI Komal Frock for 1-2 Year Baby Girl,Warehouse C,172,145,2025-02-28 23:52:00,27
2019,ORD_2020,671,"BRANDONN Baby Boy's and Girl's Terry Cotton Baby Bath Towel Cum Baby Wrapper Towel (White, Blue, 0-2 Years) - Combo of 2",Warehouse A,212,201,2025-02-28 09:38:00,11
2020,ORD_2021,2643,"Maxima Amulya Stainless Steel Baby Feeding Bottle, Steel Milk Feeding Bottle, Water Feeding Nipple Bottle | Steel Milk Fee...",Warehouse A,366,332,2025-02-28 18:39:00,34
2021,ORD_2022,36004,"Stylishbaby Crochet Booties with Ribbon Bow Detailing (3-6 Months, White)",Warehouse B,162,148,2025-02-28 20:08:00,14
2022,ORD_2023,36003,V.B.K® Baby Boys and Baby Girls Pure Organic Cotton Soft Combo Pack Of Mittens (Hand Gloves) (4 Pairs) and Booties (Socks)...,Warehouse C,214,184,2025-02-28 20:38:00,30
2023,ORD_2024,2803,"Dr.Bohrras Ultrasoft Rubber Sheet For Babies Patients Non Allegic Sterilizable (Large, Blue)",Warehouse C,198,163,2025-02-28 17:42:00,35
2024,ORD_2025,32165,Goyal's Luv Mee Musical Activity Walker - Orange,Warehouse A,307,283,2025-02-28 06:49:00,24
2025,ORD_2026,32459,"MAHI Fancy Lighting Sleeper for Kids Boys & Girls (Red & Brown, 2_Years)",Warehouse B,390,346,2025-02-28 11:11:00,44
2026,ORD_2027,32457,MOM CARE Newborn Baby Gift Set Has All Newborn Baby Essential Clothes in Baby Gift Set for or Girls Unisex 11 pcs Green,Warehouse C,337,290,2025-02-28 11:00:00,47
2027,ORD_2028,35523,SENZ Baby Pyjami- Made of Soft Cotton for Better Comfort and Design in Large Size,Warehouse C,524,482,2025-02-28 06:10:00,42
2028,ORD_2029,2800,Macitoz Stylish Dungaree for Baby Boys | Half Sleeves & Knee Length with Bow | Suitable as Casual & Party Wears Baby dress,Warehouse C,394,369,2025-02-28 15:19:00,25
2029,ORD_2030,35643,Mee Mee Baby Mini Napkins (Set of 6) | Soft Absorbent Cotton Napkins,Warehouse C,140,128,2025-02-28 10:30:00,12
2030,ORD_2031,32413,Fruhrer Best Toy for Your New Born Baby Bath Toys Cute Swimming Floating on Water Wind Up pandal Hand and for 1 2 Year Boy...,Warehouse C,99,78,2025-02-28 06:57:00,21
2031,ORD_2032,32198,"Neska Moda 0 To 6 Months Baby Girls Cotton Butterfly Frill Booties (Black,Red) -BT387andBT1124",Warehouse C,222,203,2025-02-28 16:48:00,19
2032,ORD_2033,35957,"Pack of 6 Baby Kids Tooth brush and Tongue cleaner with travel capsule holder, Portable capsule Toothpaste plastic storage...",Warehouse B,72,67,2025-02-28 18:45:00,5
2033,ORD_2034,36475,"MosQuick® Portable Hot Water Bag Small for Babies, Kids & Adults - 1 Pc Blue (Print May Vary)",Warehouse C,317,273,2025-02-28 12:00:00,44
2034,ORD_2035,1391,Pokory Nail Cutter for Kids Purple - Pack of 1| Suitable for Age 6 Months and Above|Useful for Nail Clipper Manicure Pedic...,Warehouse B,257,237,2025-02-28 22:02:00,20
2035,ORD_2036,1389,Baby Safety net for Staircase|Railing Guard for Baby Safety Balcony|Child Safety net for Balcony|Staircase Baby Safety|Sta...,Warehouse A,73,53,2025-02-28 19:52:00,20
2036,ORD_2037,1387,YUV Unisex-Baby T-Shirt,Warehouse C,338,324,2025-02-28 11:55:00,14
2037,ORD_2038,34708,Hopscotch Unisex Cloth Stripe Print Casual Shoes in Black Color,Warehouse B,346,314,2025-02-28 09:19:00,32
2038,ORD_2039,1386,"NIMYANK U Shaped Toothbrush for Kids, Food Grade Soft Silicone Brush Head, 360° Oral Teeth Cleaning Tools, Children Infant...",Warehouse A,396,384,2025-02-28 06:04:00,12
2039,ORD_2040,31857,BUMZEE Boys Full Sleeves Sweatshirt And Jogger Set,Warehouse A,412,405,2025-02-28 14:52:00,7
2040,ORD_2041,36486,"Party Propz Baby Welcome Home Decoration Kit 65Pcs Bunting, Balloon with Baby and Feet Foil Balloon for Baby Shower / Welc...",Warehouse B,393,365,2025-02-28 15:08:00,28
2041,ORD_2042,2382,Baby Gift Silver 92.5 Episode Spoon ABC - 60665,Warehouse A,451,431,2025-02-28 15:07:00,20
2042,ORD_2043,34723,"Kwitchy New Born Baby Daily Essentials Items Gift Combo (Multicolor, 0-6 Months) Grey",Warehouse B,89,58,2025-02-28 04:14:00,31
2043,ORD_2044,32909,"Himalaya Baby Gift Pack Basket,Pack of 1 Set,White & Himalaya Gentle Baby Wipes Mega Offer Pack (4N x 72's) Save Rs.101/-",Warehouse A,443,434,2025-02-28 17:20:00,9
2044,ORD_2045,1375,Philips Avent Natural 2. 0 Blue Feeding Bottle 260ml SCF035/10,Warehouse B,415,407,2025-02-28 08:59:00,8
2045,ORD_2046,36478,GOLURK Unisex Unisex Printed Pyjami For Kids,Warehouse C,85,68,2025-02-28 08:25:00,17
2046,ORD_2047,36477,babeezworld Baby Girls Knee-Length Fit And Flare Frock,Warehouse A,226,182,2025-02-28 00:36:00,44
2047,ORD_2048,32905,MINI KLUB Baby Girl's Cotton Cap (95IEGCP592_Off White_One Size),Warehouse C,65,18,2025-02-28 13:11:00,47
2048,ORD_2049,35202,MINI KLUB Unisex-Baby Jacket,Warehouse C,402,392,2025-02-28 19:02:00,10
2049,ORD_2050,3032,"Whitecherry Baby Bather for Newborn and Infants, Compact and Foldable, 0 - 12 Months (Blue)",Warehouse A,418,394,2025-02-28 13:39:00,24
2050,ORD_2051,2657,"Sunuo Baby's Cotton Cloth Diapers/Langot Washable and Reusable Nappies (Multicolour, 0-6 Months) Pack of 10 Pieces (W P)",Warehouse C,88,43,2025-02-28 14:41:00,45
2051,ORD_2052,708,"VRION 6ft Baby Bath tub Inflatable Rectangular Pool Bath tub for Adults & Kids Spa, Swimming 6ft Bath Tub | Multicolor",Warehouse A,284,239,2025-02-28 02:19:00,45
2052,ORD_2053,35579,"Qbic Portable Baby Bather,Jelly Bath Support s Silicone Mesh Bathtub for Infants (Pink)",Warehouse C,100,83,2025-02-28 21:47:00,17
2053,ORD_2054,2658,Hopscotch Unisex Cloth Stripe Print Boots in Red Color,Warehouse A,506,475,2025-02-28 17:29:00,31
2054,ORD_2055,35580,The Creators Unisex Sweater Set 0 to 6 Months Pack of 2,Warehouse B,29,11,2025-02-28 11:15:00,18
2055,ORD_2056,35583,Coolz Kids First Walker Sandals C-02 for Baby Boys and Baby Girls for 12-24 Months,Warehouse C,434,390,2025-02-28 19:08:00,44
2056,ORD_2057,929,"Blink Street Girl's Cotton Jumper (BS-1133-41_Pink,Blue_12M-18M_Multicolor2_12 Months-18 Months)",Warehouse C,449,422,2025-02-28 08:25:00,27
2057,ORD_2058,35948,"Earth Mama Angel Baby Shampoo and Body Wash, Calming Lavender Vanilla , 5.3 Ounce",Warehouse A,305,292,2025-02-28 13:14:00,13
2058,ORD_2059,32195,Babique Pluto Sitting Plush Soft Toy Cute Kids Animal Home Decor Boys/Girls (30 cm),Warehouse C,123,112,2025-02-28 17:07:00,11
2059,ORD_2060,32401,"Funskool Giggles - Activity Ball, Learning Activity Toy, Multicolour, 12 Months & Above, Infant And Preschool Toys",Warehouse B,156,129,2025-02-28 13:36:00,27
2060,ORD_2061,32399,KidDough Baby Proofing Finger Pinch Door Guard for Kids | Slamming Door Protection for Child Safety | (Pack of 3) Door Cra...,Warehouse A,452,439,2025-02-28 12:33:00,13
2061,ORD_2062,32197,FLIPZON Premium Baby Cushioned Potty Seat with Easy Grip Handles and Comfortable Seat / Toilet Seat with Handle for Kids /...,Warehouse C,267,244,2025-02-28 17:50:00,23
2062,ORD_2063,32397,"ADRIEL Bringing Joy Soft Woolen Romper Body Suit Set for New Born Baby - (0-3 Months, Blue)",Warehouse B,524,494,2025-02-28 16:36:00,30
2063,ORD_2064,32395,Fashion205 Baby Girl's White Leather Shoes - 5.0-5.5 Years,Warehouse C,417,406,2025-02-28 06:34:00,11
2064,ORD_2065,13028,"KIKE Baby Boy's and Baby Girl's Reusable Waterproof with Soft Lining Inside Absorbable Plastic Outside Panty (6-12 months,...",Warehouse A,274,251,2025-02-28 00:31:00,23
2065,ORD_2066,9193,AHC Maternity Nursing Feeding Breast Pad Reusable Washable Comfortable Light Weight (2x2 Pack),Warehouse B,35,30,2025-02-28 10:37:00,5
2066,ORD_2067,7010,"Morisons Baby Dreams Bottle and Accessories Cleaner, 500ml Pack of 2",Warehouse B,384,370,2025-02-28 21:03:00,14
2067,ORD_2068,23722,"GOURAVSUMANA Baby Boys & Baby Girl's Winter Warm Soft Kids Woolen Monkey Cap (Multicolor, Pack of 2) (9-12 Months)",Warehouse C,420,407,2025-02-28 02:47:00,13
2068,ORD_2069,24088,"Neska Moda 12 To 18 Months Baby Girls Cotton Butterfly Frill Booties (Baby Pink,Orange) -BT1154andBT1167",Warehouse B,378,350,2025-02-28 09:12:00,28
2069,ORD_2070,23548,"Huggies Complete Comfort Dry Pants Medium (M) Size Baby Diaper Pants, 26 count,7-12 kg with 5 in 1 Comfort",Warehouse B,268,263,2025-02-28 19:47:00,5
2070,ORD_2071,24094,Hopscotch Girl's Long dress,Warehouse B,108,74,2025-02-28 10:45:00,34
2071,ORD_2072,24100,EIO Baby Gifts Set for New Born Unisex Clothing Gift Hamper 6Pcs (Pink),Warehouse C,140,109,2025-02-28 02:28:00,31
2072,ORD_2073,24454,"Mee Mee Mild Baby Liquid Laundry Detergent, 300ml, White",Warehouse A,254,241,2025-02-28 03:31:00,13
2073,ORD_2074,24455,"Piku Store Hosiery Full Sleeves White, Yellow, Blue & Orange T-Shirt for Kids- Pack of 4",Warehouse A,405,385,2025-02-28 22:22:00,20
2074,ORD_2075,7011,Mee Mee Baby Talcum Powder |Dermatologically tested | Gentle for Newborns | Anti - rash | Paraben free | 0m+ (Fresh Feel -...,Warehouse B,222,194,2025-02-28 14:27:00,28
2075,ORD_2076,24464,"Softsens Baby Nourishing Lotion with Milk Cream & Shea Butter (200ml x Pack of 3, Green)",Warehouse C,43,36,2025-02-28 04:04:00,7
2076,ORD_2077,24466,MANMRA BLACK AND ORANGE BEADS BLUE EVIL EYE BABY NAZRIAN | BABY BRACELET FOR BABY BOY | BABY GIRL,Warehouse C,68,41,2025-02-28 18:04:00,27
2077,ORD_2078,24471,Johnson's Baby Cotton Buds x 200,Warehouse A,257,225,2025-02-28 18:52:00,32
2078,ORD_2079,24451,Lillypupp New Born Baby/Kid’s Girl Soft Hair Band Pack of 3 Gift Set for Birthday and Daily Use Hair Accessories Headband ...,Warehouse A,503,479,2025-02-28 02:46:00,24
2079,ORD_2080,7005,Little Angels New Born Baby boy Printed Cotton shorts Pack of 3 (3-6Months),Warehouse A,406,390,2025-02-28 16:34:00,16
2080,ORD_2081,6998,Kidology Baby Bath Toys for Kids | Mini Whale Fountain with LED Light Sprinkler Bathtub | Light Up Whale Spray Bathroom Sh...,Warehouse B,516,488,2025-02-28 05:45:00,28
2081,ORD_2082,24484,"SACHIMANI Baby Boy/Girl Booties Shoes Dori Sticker Soothing Colours, 0-3 Months (Multicolor, Pack of 3)",Warehouse A,459,421,2025-02-28 22:49:00,38
2082,ORD_2083,23714,"Buddsbuddy BPA Free Popo Baby Powder Puff With Storage Powder Case, (Pink)",Warehouse B,290,266,2025-02-28 14:55:00,24
2083,ORD_2084,23708,"Babyhug Combo of Daily Lotion, Milky Wash, Shampoo & Massage Oil -100 ml",Warehouse B,484,468,2025-02-28 14:02:00,16
2084,ORD_2085,7459,"Neska Moda 6 To 12 Months Baby Girls Cotton Butterfly Frill Booties (Mint,Orange) -SK140andBT42",Warehouse A,146,108,2025-02-28 13:18:00,38
2085,ORD_2086,7427,"Fareto New Born Baby Boy's & Baby Girl's Summer Season Essential Items. PID-Blue.Total Items: 33 (0-6 Months), Combo of 3,...",Warehouse A,333,298,2025-02-28 13:59:00,35
2086,ORD_2087,23769,"MamyPoko Extra Absorb Diaper pants, XXXL,Unisex Baby, Pack of 22",Warehouse A,421,387,2025-02-28 18:02:00,34
2087,ORD_2088,23776,"NPRC Baby Plastic Evil Eye Protection Fixed Nazariya Beads Bracelet, 0-3 Years (Black,White and Orange) Rotate",Warehouse A,127,82,2025-02-28 08:59:00,45
2088,ORD_2089,23779,Soku Shopee kids baby boy girl monkey jungle woolen winter warm booties/socks/shoes/prewalkers/newborn (0-12 months),Warehouse C,67,61,2025-02-28 11:58:00,6
2089,ORD_2090,23780,"Atogla Curatio Lotion for Baby, 400ml Intense Moisturizing Baby Lotion for All Skin Types, Protects Against Rashes & Preve...",Warehouse B,285,246,2025-02-28 22:42:00,39
2090,ORD_2091,23783,Yunicron Max Extra Soft Bristles Kids Toothbrush with Car Toy (Pack of 2),Warehouse A,468,452,2025-02-28 18:29:00,16
2091,ORD_2092,7445,TERI BERI Unisex Printed Panties for New Born Baby Multicolour (Pack of 12) (0-3 Months),Warehouse B,156,128,2025-02-28 10:34:00,28
2092,ORD_2093,7446,Adore Stuff Newborn Babies Kids Cotton Shorts Unisex Printed for Kids Boys and Girls for Unisex (Pack of 3),Warehouse A,181,150,2025-02-28 23:47:00,31
2093,ORD_2094,23732,Kothari Over All Printed Round Neck Short Sleeve Casual Fit Knee Length Frock for Infant Girls,Warehouse C,415,391,2025-02-28 08:22:00,24
2094,ORD_2095,23678,"JACK N JILL® Baby Boys And Girls Regular Anti-Skid Cotton Blend Socks (Pack of 6, Assorted) (BOYS, 18-24 Months) (Boy",Warehouse A,360,318,2025-02-28 16:46:00,42
2095,ORD_2096,23679,"Neska Moda 12 To 18 Months Baby Girls Cotton Butterfly Frill Booties (Yellow,Red) -BT1147andBT1173",Warehouse C,478,444,2025-02-28 16:34:00,34
2096,ORD_2097,7478,Bembika Baby Girls Headbands Chiffon Flower Lace Band Hair Accessories for Newborns Infants Toddlers (Set of 3),Warehouse A,381,332,2025-02-28 08:15:00,49
2097,ORD_2098,7477,Mee Mee 125Ml 2 In 1 Baby Feeding Bottle With Spoon (Green),Warehouse C,318,286,2025-02-28 00:46:00,32
2098,ORD_2099,23688,KIKE New Born Boys Girls Soft Cotton Sleeveless Printed Baby Vest Inner Wear for Infants Undershirt Toddler Sando Baniyan ...,Warehouse B,260,229,2025-02-28 16:12:00,31
2099,ORD_2100,23693,Gini & Jony Boys Round Neck Printed Tee,Warehouse B,311,287,2025-02-28 09:22:00,24
2100,ORD_2101,7466,StarAndDaisy Baby Bath Tub Seat Chair Supporter Foldable Support Baby Bath Chair (Pink),Warehouse A,259,244,2025-02-28 13:20:00,15
2101,ORD_2102,6988,"Baby Town Clothing New Born Baby Multi-Color Long Sleeve Body Suit,Romper, Sleep Suit for Boys and Girls Unisex Combo Pack...",Warehouse C,52,33,2025-02-28 16:16:00,19
2102,ORD_2103,6954,Karthi’s Star New Born Baby Soft Clothes 95% Baby Cotton Hooded Towel | Comfort Baby Wraps for New Born for 0 to 2 Years |...,Warehouse B,351,344,2025-02-28 03:19:00,7
2103,ORD_2104,24596,"Haus and Kinder Newborn Nursing Feeding Pillow, Breastfeeding Pillows with Removable Cover, Infant Support for Baby and Mo...",Warehouse C,87,42,2025-02-28 23:04:00,45
2104,ORD_2105,24598,Memoir Gold Plated Black and Gold Plated Child Bangle Kada Nazariya for Kids (0-1 Yrs),Warehouse C,480,460,2025-02-28 18:32:00,20
2105,ORD_2106,24576,"Buddsbuddy Combo of 3 Leo Kids Tongue Cleaner, 3 Pcs, BB3015 Multi Color",Warehouse A,365,352,2025-02-28 23:25:00,13
2106,ORD_2107,6946,TORPPEZA New Born Baby Bootie Shoes with Fur for Boys & Girls Printed Multicolor Booties,Warehouse C,362,327,2025-02-28 14:02:00,35
2107,ORD_2108,24620,"Pigeon Children Toothpaste, Orange 45g",Warehouse C,453,443,2025-02-28 15:55:00,10
2108,ORD_2109,24625,Himalaya Refreshing Baby Wash 400 ml & Himalaya Gentle Baby Shampoo (200ml),Warehouse B,413,366,2025-02-28 21:45:00,47
2109,ORD_2110,24601,Soku Shopee kids baby boy girl angry bird woolen winter warm booties/socks/shoes/prewalkers/newborn (0-12 months),Warehouse B,157,136,2025-02-28 04:07:00,21
2110,ORD_2111,24571,Roble Romper & Dungree Jumpsuit Outfits For Newbron Babies Boys,Warehouse C,154,145,2025-02-28 18:20:00,9
2111,ORD_2112,24514,Hopscotch Boys Cotton Kurta With Pyajma Set in Blue Color,Warehouse B,266,255,2025-02-28 19:45:00,11
2112,ORD_2113,6973,"Mee Mee 3 in 1 Baby Oil with Goodness of Sunflower, Coconut and Olive Oils for Soft and Smooth Skin of Baby(500ml)",Warehouse C,27,21,2025-02-28 12:56:00,6
2113,ORD_2114,6972,My Baby Town 100% Soft Cotton Fancy Cartoon Face Booties Socks (Random Design/Color) Pack-4,Warehouse C,79,65,2025-02-28 19:54:00,14
2114,ORD_2115,24527,Neppe's World New Born Baby Boy Multicolor Button Dress | Cotton Dress | Pack Of 5,Warehouse B,297,292,2025-02-28 05:47:00,5
2115,ORD_2116,24588,Sathiyas Baby Girl's Knee Length Dress (Pack of 5),Warehouse B,231,206,2025-02-28 07:31:00,25
2116,ORD_2117,24392,"JD FRESH New Baby Nail File Electric,Baby Nail Trimmer with 6 Grinding Heads Safe for Newborn Baby Baby Nail Clippers with...",Warehouse C,432,403,2025-02-28 14:31:00,29
2117,ORD_2118,24394,MOM CARE Muslin Cotton Face Towels for Newborn Baby Extra Soft Hankies Reusable Napkins for Infants Toddlers Boys and Girl...,Warehouse B,409,403,2025-02-28 11:38:00,6
2118,ORD_2119,24396,Aveeno Baby Daily Moisturizing Lotion - 227g (Pack of 2),Warehouse A,131,91,2025-02-28 00:04:00,40
2119,ORD_2120,24397,DUVON Disney Princess Body Wash For Girl Kids -250ml | Paraben Free | Sulphate Free | Dermatologically Tested (Royal Berry),Warehouse B,64,30,2025-02-28 12:17:00,34
2120,ORD_2121,24401,"Nasobuddy Baby's Aspirator + Saline Kit Most efficient way to relieve baby's nasal congestion, clear baby's nose (0-5 years)",Warehouse C,455,415,2025-02-28 10:51:00,40
2121,ORD_2122,24405,Jusfab Printed Kids Infant wear Tshirt Pant Set for 1 to 1.5 Years Baby Boy Girl -Pure Cotton Yellow Tee Blue Shorts,Warehouse A,467,434,2025-02-28 05:54:00,33
2122,ORD_2123,24406,DARSHRAJ JEWELLERS 925 Sterling Silver Single Elephant Beads In Black Thread Nazariya Anklet |Bracelet For Kids |Girls|Wom...,Warehouse A,246,207,2025-02-28 12:54:00,39
2123,ORD_2124,24409,Hopscotch Girls EVA Crown Applique Infant Booties in Pink Color,Warehouse A,88,73,2025-02-28 02:11:00,15
2124,ORD_2125,24413,"Cetaphil Baby Mild Bar 75gm, Kids Soap for Bath, White, Medium",Warehouse A,466,419,2025-02-28 18:23:00,47
2125,ORD_2126,24417,"Storescent Reversible Octopus Soft Toys for Kids, Octopus Stuffed Animal Plush Soft Toys for Boys and Girls | Octopus Plus...",Warehouse A,405,381,2025-02-28 15:28:00,24
2126,ORD_2127,7031,"Luv Lap Washable Maternity Nursing Breast Pads, 6 Pcs, Reusable, Leak-proof",Warehouse C,523,480,2025-02-28 23:13:00,43
2127,ORD_2128,7027,Breewell Soft Inflatable Baby Bath Tub | Multi-Color,Warehouse C,469,459,2025-02-28 02:41:00,10
2128,ORD_2129,7018,"BATA Boys RILEY Blue Casual Shoes, (4399088)",Warehouse C,207,171,2025-02-28 19:06:00,36
2129,ORD_2130,7034,LBV 925 Sterling Silver Semi Precious Garnet Birth Stone With Traditional Black Thread Nazariya Bracelet For Boys and Girl...,Warehouse A,75,67,2025-02-28 20:24:00,8
2130,ORD_2131,24495,"Pigeon Cotton Thin Stem Swabs for Baby,100% Soft Cotton Tips,Flexible & Soft Paper Stem,Eco Friendly,200 pcs,Pack of 2",Warehouse C,167,128,2025-02-28 10:31:00,39
2131,ORD_2132,24508,GOODMUNCHKINS Stainless Steel Feeding Bottle Joint Less 304 Grade No Joints BPA Free No Plastics New Born Baby/Toddlers/In...,Warehouse C,66,35,2025-02-28 12:07:00,31
2132,ORD_2133,24577,"DISNEY BY Jagannath Gangaram Pednekar Since 1965 18KT Yellow Gold, BABY BRACELET FOR GIRL",Warehouse B,419,395,2025-02-28 04:37:00,24
2133,ORD_2134,23762,Baby Girl Dress,Warehouse C,121,85,2025-02-28 01:42:00,36
2134,ORD_2135,7267,Mothercare Boy's VG483 Baby and Toddler Sleepers,Warehouse B,162,151,2025-02-28 21:51:00,11
2135,ORD_2136,24055,TuddyBuddy 100% Organic Cotton Multi Color Sleepsuit/Onesie/Romper for Baby Boy & Baby Girl,Warehouse C,240,198,2025-02-28 00:40:00,42
2136,ORD_2137,24056,looms & weaves - Baby Massage Oil (for Hair and Body) - 250 ML,Warehouse C,206,169,2025-02-28 06:23:00,37
2137,ORD_2138,24064,IBLAY Machardani Net Double Bed King Size - 8x8 Ft Mosquito Netting for Bed (Peach),Warehouse C,227,183,2025-02-28 01:38:00,44
2138,ORD_2139,24068,JAAMSO ROYALS Unisex 100% Organic Cotton and 100% Cotton Front Open Only T-Shirt 3 Qty Combo for New Born Baby Boys & Girl...,Warehouse B,312,286,2025-02-28 01:23:00,26
2139,ORD_2140,24072,AHHAAAA Kids Western Cotton Top and Denim Skirt dungaree Set for Baby Girls,Warehouse B,214,177,2025-02-28 05:49:00,37
2140,ORD_2141,7243,Baby Boy Shirt and Pent Set Full Sleeve Solid Pettan T-Shirt Trouser & Bowtie Dress Clothing Set for Infant Toddler,Warehouse C,118,88,2025-02-28 13:50:00,30
2141,ORD_2142,23953,"Manraj Collection Baby Boy Denim Dungaree Dress (Dark Blue, 12-18 Months)",Warehouse C,458,434,2025-02-28 10:13:00,24
2142,ORD_2143,7272,Neska Moda Baby Girls Booties For 0 To 6 Months (Pink),Warehouse B,497,466,2025-02-28 22:33:00,31
2143,ORD_2144,7315,Toddler's Jordan 1 Mid Ice Blue/Black-Sail-White (644507 401),Warehouse C,164,134,2025-02-28 03:23:00,30
2144,ORD_2145,23962,Hopscotch Unisex Synthetic/PU Text Print Casual Shoes in Gray Color,Warehouse B,26,20,2025-02-28 10:10:00,6
2145,ORD_2146,7308,"FunZoo Snow Penguin Soft Plush Stuffed Animal Toy for Kids,Childrens (Gray, 25 cm)",Warehouse A,294,266,2025-02-28 17:35:00,28
2146,ORD_2147,7300,"Mee Mee Mild Baby Shampoo with Fruit Extracts, 500ml & Baby Care Set (Travel Kit,White)",Warehouse C,273,238,2025-02-28 20:22:00,35
2147,ORD_2148,23974,"ambitieux Cute ok Kitty Cartoon Cap for Child Baby boy or Girl of Age 1 to 3"" Years with Sunshade Summer caps",Warehouse B,108,59,2025-02-28 23:42:00,49
2148,ORD_2149,24045,"Bigbought New Born Baby Care Cloth Set Combo (Set of 28, 4Jhabla, 8Nappy, 8Mittens,4Cap Hosiery Material and 4 Plastic ma...",Warehouse C,374,366,2025-02-28 14:00:00,8
2149,ORD_2150,23993,SYGA Baby Infant and Toddler Grooming Kit with Scissors (Pink Puppy),Warehouse C,172,123,2025-02-28 22:05:00,49
2150,ORD_2151,24034,little PANDA Baby Girl’s Fit & Flare Knee Length Satin Frock Dress,Warehouse C,263,216,2025-02-28 00:24:00,47
2151,ORD_2152,7397,"Mee Mee Gentle Baby Bubble Bath, White, 500ml & Mild Baby Shampoo with Fruit Extracts, 500ml Combo",Warehouse C,302,259,2025-02-28 13:23:00,43
2152,ORD_2153,23838,"Mamaearth 100% Natural Berry Blast Kids Toothpaste 50 Gm, Fluoride Free, SLS Free, No Artificial Fla & Mamaearth Dusting P...",Warehouse A,519,495,2025-02-28 19:42:00,24
2153,ORD_2154,23846,Coconess Just For Baby Combo Pack,Warehouse C,470,422,2025-02-28 11:25:00,48
2154,ORD_2155,23851,"Webby Plush Caterpillar | Ideal Gift for Girls, Teenager | Soft Toy for Car Accessories | Plush Stuffed Toy for Kids - 90 cm",Warehouse A,232,221,2025-02-28 12:46:00,11
2155,ORD_2156,23861,Cute Landings® New Born Baby Hosiery Cotton 4 Jhabla/Shirts with 4 Nappies/Langot and 4 Caps (3-6 Months),Warehouse B,62,34,2025-02-28 02:52:00,28
2156,ORD_2157,7388,"Luv Lap LuvLap Aqua Tales Baby Bather for Baby 0-12 Months, New Born Baby Bath Chair, 3 Position Adjustable, Washable Soft...",Warehouse A,56,44,2025-02-28 13:14:00,12
2157,ORD_2158,23807,"Mom & World Baby Wash - Tear Free Gentle Cleansing For Hair & Body, 200 ml, white",Warehouse B,482,443,2025-02-28 08:50:00,39
2158,ORD_2159,24027,"Himalaya Baby Powder, 700g & Gentle Baby Soap (Pack of 4N*75g)",Warehouse B,116,100,2025-02-28 03:02:00,16
2159,ORD_2160,24028,"SAS Baby Boy's Cotton, Nylon Dungaree Set",Warehouse C,441,410,2025-02-28 00:13:00,31
2160,ORD_2161,7431,Gubbarey Cotton Empire Dress,Warehouse A,28,19,2025-02-28 18:10:00,9
2161,ORD_2162,7561,Fabme Women's Cotton Textured Floor Length Nursing Nighty,Warehouse C,95,65,2025-02-28 01:21:00,30
2162,ORD_2163,23557,Vaseline 100% Pure Petroleum Jelly Baby 13 oz (Pack of 3),Warehouse A,312,290,2025-02-28 01:29:00,22
2163,ORD_2164,23564,Sebamed Baby Cream Extra Soft 50m|Ph 5.5| Panthenol and Jojoba Oil|Clinically tested| ECARF Approved,Warehouse C,350,345,2025-02-28 03:08:00,5
2164,ORD_2165,23565,Sebamed Children SHAMPHOO 150 ML (150 ml),Warehouse B,73,49,2025-02-28 08:07:00,24
2165,ORD_2166,7528,EIO Front Open Baby Jablas Pack 0f 4,Warehouse C,408,379,2025-02-28 07:30:00,29
2166,ORD_2167,23573,"SOFTSWISS Baby Bath Sponge, In Fruits Design, UlraSoft, Specially for New Born Babies and Children (MANGO1_ORANGE1), Pack ...",Warehouse A,144,99,2025-02-28 11:44:00,45
2167,ORD_2168,7546,Bold N Elegant Disney Minnie Mouse Daisy Duck Print Baby Girl Sleeveless Spring Summer Cotton Dress Tunic Frock for Girls ...,Warehouse C,304,265,2025-02-28 21:14:00,39
2168,ORD_2169,7545,Baby Boy Clothing Set | Stylist Black Tshirt and Jeans (3-4 Years),Warehouse C,367,327,2025-02-28 06:12:00,40
2169,ORD_2170,23588,"Toyshine Sun and Moon Wooden Shape, Objects, Color Recognition Rolling Bead Maze Labyrinth Toy",Warehouse C,401,395,2025-02-28 01:50:00,6
2170,ORD_2171,23599,"THE LITTLE LOOKERS Swimming Bath Gown for Kids, Bath Gown for Baby Boys/Baby Girls | Swimming Gown for Kids (Bunny Hood Le...",Warehouse C,512,477,2025-02-28 04:37:00,35
2171,ORD_2172,23572,"2-Pack Inkless Hand and Footprint Kit - Ink Pad for Baby Hand and Footprints - Dog Paw Print Kit,Dog Nose Print Kit - Baby...",Warehouse C,340,311,2025-02-28 23:23:00,29
2172,ORD_2173,7490,The Moms Co Natural Baby Shampoo (200 ml) & Natural Baby Wash (400 ml),Warehouse C,329,292,2025-02-28 19:37:00,37
2173,ORD_2174,7487,"Neska Moda 6 To 12 Months Baby Boys & Baby Girls Cotton Lace Shoes/Booties (Orange,Red) -SK172andSK136",Warehouse A,82,77,2025-02-28 18:20:00,5
2174,ORD_2175,23748,"Black .Sheep Cotton Premium Handkerchief or Face Towels for Kids, Washable, Reusable, Absorbent, Extra Soft Face Towels/Wa...",Warehouse A,143,94,2025-02-28 05:56:00,49
2175,ORD_2176,7433,"CLAP Baby Girls Diaper Leggings Cotton Rib Pajamas Multicolor Set of 3 (Pink Red Rani, 6-9 Months)",Warehouse B,349,305,2025-02-28 14:38:00,44
2176,ORD_2177,23755,"Babit Baby Massage Oil Combo Pack of 3 | Enriched with Vitamin E, Almond Oil, Wheat Grem Oil and Non-Sticky for Easy Sprea...",Warehouse C,371,323,2025-02-28 05:14:00,48
2177,ORD_2178,23602,DUCOSOFT BABY BATHING BAR PACK OF 2 (2X75G),Warehouse B,526,478,2025-02-28 19:25:00,48
2178,ORD_2179,23638,Max Boys Camouflage Print Elasticated Joggers,Warehouse B,211,187,2025-02-28 11:13:00,24
2179,ORD_2180,24015,Kitty Baby Boy Sneakers White Kids Casual Shoes,Warehouse C,233,216,2025-02-28 22:56:00,17
2180,ORD_2181,23975,J.B.COLLECTION Baby Girl's Pom Pom Frock,Warehouse A,318,287,2025-02-28 02:35:00,31
2181,ORD_2182,7406,Lillypupp New Born Baby high Ankle Velcro Booties|Socks for Boy Girl. Infant Toddler Cotton Boots. Size (0-6 Months),Warehouse A,291,286,2025-02-28 19:49:00,5
2182,ORD_2183,23608,"FLAX Kids Short for Baby Boys & Baby Girls Casual Printed Cotton Blend (Multicolor, Pack of 10)",Warehouse B,132,119,2025-02-28 12:04:00,13
2183,ORD_2184,23612,"BeeBaby Silicone Finger Brush with Carry Case, (Blue) (Pack of 2)",Warehouse B,266,225,2025-02-28 14:13:00,41
2184,ORD_2185,23619,BUMZEE Maroon Girls Full Sleeves Frock with Headband,Warehouse A,293,258,2025-02-28 15:44:00,35
2185,ORD_2186,23607,BENAVJI Cotton Printed New Born Baby Boys and Baby Girl Light Color Shirts PK03,Warehouse A,209,199,2025-02-28 16:20:00,10
2186,ORD_2187,23637,"Superminis Baby Boys Cotton Plain Shirt with Blue Color Collar - Regular Fit, Half Sleeves, Collared Neck for Casual Summe...",Warehouse C,362,331,2025-02-28 15:23:00,31
2187,ORD_2188,7507,Shadow Securitronic Happy Night Mosquito Repellent Vaporizer| Mosquito Repellent Liquid Refill | Active Indoor Natural Ora...,Warehouse B,240,202,2025-02-28 04:00:00,38
2188,ORD_2189,7501,Mosquito Repellent | Unica Natural Mosquito Repellent Refill Liquid | Pet & Baby Safe | Combo Pack of 5,Warehouse C,500,452,2025-02-28 15:29:00,48
2189,ORD_2190,7495,TICOSS Pajama Kids Boys and Girls Super Warm and Soft Track Pants for Winters,Warehouse A,308,295,2025-02-28 05:49:00,13
2190,ORD_2191,7493,Zuvim Baby Girls Pleated Knee Long Printed Satin Dress,Warehouse C,535,496,2025-02-28 20:22:00,39
2191,ORD_2192,6966,Mustela Stelatopia - Emollient Baby Cream - with Natural Avocado & Sunflower Oil Distillate - Fragrance Free - 6.76 Fl Oz,Warehouse A,110,102,2025-02-28 12:27:00,8
2192,ORD_2193,22890,Sahiba Gems Exclusive Chandi Silver Baby Kada Bangle Nazariya Kadli for Babies ~ Fit for 1-2 Years Babies ~ Watch Style,Warehouse B,134,121,2025-02-28 19:11:00,13
2193,ORD_2194,22897,Electomania Striped Baby Headband Girl Infant Hair Cloth Accessories Band Bow Turban Newborn Headwear Hairband Gift Toddle...,Warehouse A,181,139,2025-02-28 16:18:00,42
2194,ORD_2195,22900,VBaby Musical Chu Chu Shoes Baby Girl Baby Boy Baby Shoes Baby Bootie Sandals Shoes 1.2-1.5 Years,Warehouse A,482,472,2025-02-28 23:55:00,10
2195,ORD_2196,22907,Chicco Toothbrush 3-8Y Pink With Chicco Strawberry Tootpaste 12M+,Warehouse B,164,135,2025-02-28 03:20:00,29
2196,ORD_2197,22908,LuvLap Baby Silicone Finger ToothBrush & LuvLap Paraben Free wipes for baby skin With Lid Pack,Warehouse C,383,347,2025-02-28 03:03:00,36
2197,ORD_2198,7906,"Sirona Sanitary Disposable Bags - 30 Bags for Discreet Disposal of Tampons, Condoms, Sanitary Pads, Panty Liner and Person...",Warehouse C,307,302,2025-02-28 06:28:00,5
2198,ORD_2199,22923,"LuvLap Elegant Baby Hair Brush and Comb Set, 0m+ (White)",Warehouse B,348,323,2025-02-28 09:32:00,25
2199,ORD_2200,22928,Syga Baby Nail Clippers Set with Scissors 2 Piece Safety Suit (Blue),Warehouse B,175,139,2025-02-28 01:24:00,36
2200,ORD_2201,22929,Mee Mee Baby Oil With Fruit Extracts (200 ml) and Baby Lotion With Fruit Extracts- 100 ml Combo Pack with one free key ring,Warehouse A,204,159,2025-02-28 05:01:00,45
2201,ORD_2202,22941,HIBA CREATIONS Mermaid phtoshoot props for baby girl 0 months to 8 Months,Warehouse B,290,259,2025-02-28 19:20:00,31
2202,ORD_2203,22910,MINITATU Girl's Cotton Solid Pajama Bottom,Warehouse A,403,391,2025-02-28 12:24:00,12
2203,ORD_2204,22872,"Neska Moda 0 To 6 Months Baby Boys & Baby Girls Pack Of 2 Pair Cotton Butterfly Booties (Maroon,Rani Pink) -BT383andBT1120",Warehouse B,246,236,2025-02-28 20:42:00,10
2204,ORD_2205,22829,Azotiquee Cartoon Animated Baseball Cap for Boys (2 to 8 Years) Red,Warehouse C,332,292,2025-02-28 09:02:00,40
2205,ORD_2206,22835,ISHRIN Cotton Assorted Track Pant for Boys and Girls - Regular fit | Loose Fit Track Pants(Pack of 6),Warehouse A,235,209,2025-02-28 03:22:00,26
2206,ORD_2207,22891,1 Pcs Float and Squeak Rubber Duck Ducky Baby Bath Toy for Kids (Yellow),Warehouse C,412,379,2025-02-28 20:20:00,33
2207,ORD_2208,22742,Baby Girl 100% Cotton Jhabla Frock | New Born Stylish Dress | Printed Kids Dress Combo Pack of 6,Warehouse C,242,204,2025-02-28 11:03:00,38
2208,ORD_2209,22678,SYLVA Baby Girls Top and Bottom Clothing Set (Pack of 3),Warehouse C,310,282,2025-02-28 13:31:00,28
2209,ORD_2210,22679,"Prattle Foot Casual Leather Girl's Bellie, Trendy Bow Style Flat Ballet for Baby Girl's",Warehouse C,312,263,2025-02-28 08:39:00,49
2210,ORD_2211,22689,"Comfy Cheeks Baby Massage Oil | Soya Bean Oil, Sesame Oil, Coconut Oil, Olive Oil & Shea Butter (Pack of 1, 100ml)",Warehouse A,442,425,2025-02-28 13:14:00,17
2211,ORD_2212,8038,Mothercare baby-girls Bodysuit,Warehouse B,236,189,2025-02-28 12:31:00,47
2212,ORD_2213,22697,SG Cricket Shoes Sierra 2.0,Warehouse B,260,215,2025-02-28 11:39:00,45
2213,ORD_2214,8036,superbottoms Padded Underwear | Waterproof Pull up Underwear | Potty Training Pants for Babies | Pull up Unisex Trainers| ...,Warehouse A,169,120,2025-02-28 08:24:00,49
2214,ORD_2215,8035,"Classic Mosquito Net for Baby | Bottomless Net for Infants, for Safe & Easy Use | Ensures Your Baby's Safe Sleep |135cmX65...",Warehouse B,234,208,2025-02-28 22:14:00,26
2215,ORD_2216,8033,LOVE CROCHET ART Unisex Baby Flower Crochet Baby Booties Knitted Booties Woolen Booties,Warehouse C,231,225,2025-02-28 21:57:00,6
2216,ORD_2217,22717,"Neska Moda 6 To 12 Months Baby Boys & Baby Girls Cotton Lace Shoes/Booties (Mint,Yellow) -SK141andBT89",Warehouse A,314,285,2025-02-28 11:57:00,29
2217,ORD_2218,8006,"Amazon Brand - Solimo Sherpa Fleece New Born Baby Blankets, Set of 2 (Navy Blue, Oat Milk)",Warehouse A,164,120,2025-02-28 11:33:00,44
2218,ORD_2219,8051,HAPPU COLLECTION printed kids boots (black) 2c,Warehouse A,385,338,2025-02-28 02:01:00,47
2219,ORD_2220,7962,Gini & Jony Baby Boy's Plain Regular fit T-Shirt (131246510551 5000_Blue 12M),Warehouse C,70,54,2025-02-28 20:19:00,16
2220,ORD_2221,22519,"Beybee Baby Disposable Diaper Sacks, 50 Bags",Warehouse A,386,351,2025-02-28 16:20:00,35
2221,ORD_2222,22521,"Aveeno Baby Soothing Relief Moisture Cream Fragrance Free, 227g",Warehouse A,338,301,2025-02-28 02:17:00,37
2222,ORD_2223,8166,"Softsens Baby Massage Oil with Vitamin E & Olive Extracts, 200Ml (Pack of 3, White)",Warehouse B,160,142,2025-02-28 07:01:00,18
2223,ORD_2224,8168,Griva Enterprise Toddler Baby Girls Kids Printed Princess Dresses White Color Frock With Beautiful Flamingo Design,Warehouse B,480,469,2025-02-28 13:00:00,11
2224,ORD_2225,22425,"Mommas Baby Bath Towel/Wraps / 100% Cotton Washcloth in 500GSM for New Born Baby/Infants/Toddlers (Pink, 56x112 cm, Pack o...",Warehouse A,293,286,2025-02-28 02:52:00,7
2225,ORD_2226,8187,"Chicco Baby Moments Soap, 125g",Warehouse A,465,451,2025-02-28 02:42:00,14
2226,ORD_2227,22448,Allen Solly Baby-Boy's Regular fit Trousers,Warehouse B,37,20,2025-02-28 13:21:00,17
2227,ORD_2228,22450,DC DECORIO® Tooth Brush Head 360 Degree Cleansing U Shaped Toothbrush for Kids baby (RAINBOW-PINK),Warehouse A,368,348,2025-02-28 13:39:00,20
2228,ORD_2229,22451,Maimne Unisex Boy's & Girl's Kids First Walker Light Shoes | Multicolour Sport Shoes Combo Set,Warehouse A,464,453,2025-02-28 11:48:00,11
2229,ORD_2230,22454,OYO BABY Badam Rogan Oil 100 GM,Warehouse A,48,11,2025-02-28 12:04:00,37
2230,ORD_2231,22462,Rexzy® PCS Edge Protector for Furniture Table Corner Guards for Sharp Edges Silicon Corner Protector for Sharp Edges Gel T...,Warehouse B,431,406,2025-02-28 17:15:00,25
2231,ORD_2232,22466,Okbaby Onda Baby Shower Tub - Turquoise,Warehouse B,191,159,2025-02-28 13:41:00,32
2232,ORD_2233,22467,INSTABUYZ Baby Boy's and Baby Girl's Anti Slip Pre-Walker Purple Socks Cum Booties (0-12 Months),Warehouse C,335,315,2025-02-28 15:05:00,20
2233,ORD_2234,22470,"Pelo led Stress Relief Toys , Push Pop Bubble Flip Deformed Toy Set of 2 for Kids Adults",Warehouse B,404,387,2025-02-28 07:03:00,17
2234,ORD_2235,22471,ZEDAI Baby Boys & Girls Regular Fit Warm Fleece Track Pant for Kids Woolen Lowers Pajama Pants for Boys Bottom Rib Legging...,Warehouse C,100,59,2025-02-28 11:11:00,41
2235,ORD_2236,22453,Mothercare Baby-Boys ZB602,Warehouse B,206,177,2025-02-28 21:28:00,29
2236,ORD_2237,8144,Mom&dreams New Born Baby Cap Mitten Bootie Set- 2 Pc Pack,Warehouse C,478,439,2025-02-28 02:50:00,39
2237,ORD_2238,7939,"Neska Moda 6 To 12 Months Baby Girls Cotton Butterfly Booties (Orange,Black) -SK126andBT2",Warehouse A,443,402,2025-02-28 04:39:00,41
2238,ORD_2239,22857,"Sebamed Baby Cream, Extra Soft, 200ml & Clear Face Care Gel, 50ml",Warehouse B,463,424,2025-02-28 17:16:00,39
2239,ORD_2240,7937,"LAFILLETTE Electric Baby Nail File with Light, Safe Baby Nail Trimmer Clipper (Blue)",Warehouse B,522,484,2025-02-28 22:36:00,38
2240,ORD_2241,22866,"Mylo Essentials Baby Carrier Bag for 6 Months-15 Months Baby - Lightweight, Ergonomic, 3 in 1 Front, Back & Head Support K...",Warehouse B,470,435,2025-02-28 14:48:00,35
2241,ORD_2242,22867,Baby Moo Cute Puppy Checked Chu-Chu Sound Breathable Anti-Skid Sandals - Multicolour (3Y-3.5Y),Warehouse A,448,399,2025-02-28 05:37:00,49
2242,ORD_2243,22871,SHOP FRENZY Newborn Infant Twins Cartoon Animated 3 d face Booties | Socks | Shoes | Prewalkers/First Walkers for Kids Bab...,Warehouse A,445,397,2025-02-28 21:02:00,48
2243,ORD_2244,22659,"Kidology Fishing Game Toys with Slideway, Electronic Toy Fishing Set with Magnetic Pond, Learning Educational Toys with Mu...",Warehouse A,390,342,2025-02-28 19:23:00,48
2244,ORD_2245,22658,Enakshi 10 Pair Baby Foot Model Baby Shoe Stretcher Toddler Booties Shaper Stand 11cm (Craft Kits),Warehouse B,483,442,2025-02-28 13:57:00,41
2245,ORD_2246,22657,Baby Luv 0-6 Months Unisex Infant Toddler Baby Boys Girls Summer Sandal | Newborn Soft Breathable Sandal Bow Design,Warehouse B,93,48,2025-02-28 23:40:00,45
2246,ORD_2247,22494,Hopscotch Boys and Girls Synthetic Stripe Print LED Slip Ons Shoes in Black Color,Warehouse A,369,326,2025-02-28 02:07:00,43
2247,ORD_2248,22502,BEAU STUTI Battling Top DB Layer System B-193 Booster Bey Ultimate Valkyria .Lg.V'-9 Set with lr String Launcher Right-Spi...,Warehouse B,212,188,2025-02-28 21:24:00,24
2248,ORD_2249,22507,"Olay Total Effects Day Cream with Vitamin C, B5, Niacinamide, Green Tea for Normal, Dry, Oily & Combination skin, 20 gm",Warehouse A,60,50,2025-02-28 11:56:00,10
2249,ORD_2250,22512,Aswadh Cute Cartoon Animal Uni Kids Toddler Soft Sole Baby Shoes Tiger - 11cm,Warehouse A,257,210,2025-02-28 21:15:00,47
2250,ORD_2251,22513,"Softsens Baby 3-Step Bathtime Trio With Baby Milk Bar Soap (300G), Calming Massage Oil (200Ml) & Baby Powder (200G) | Soot...",Warehouse C,411,364,2025-02-28 02:51:00,47
2251,ORD_2252,14351,"Fairy Dolls Baby Girls Tutu Frock,Infant Tutu Frock",Warehouse A,80,44,2025-02-28 12:37:00,36
2252,ORD_2253,7969,Radhey Preet Baby Rompers or Jumpsuit for Kids Whose Ages 9 to 18 Months Available with Best And Comfortable 100% Cotton,Warehouse C,108,82,2025-02-28 07:01:00,26
2253,ORD_2254,24207,"OYO BABY - Quickly Dry Super Soft, Waterproof, Reusable Mat, Baby Blue,S (70cm X 50cm)",Warehouse B,271,265,2025-02-28 03:02:00,6
2254,ORD_2255,24175,"Pigeon Peristaltic Baby Nursing/Feeding Bottle KPP Nipple LL,for 12+ Month Babies,BPA Free,BPS Free,Square Base,Red,240 ml",Warehouse C,143,133,2025-02-28 10:29:00,10
2255,ORD_2256,7223,"MAYCREATE® 6 piece Baby Nylon Headbands,Turban Knotted Girls Hairband Super Soft and Stretchy Hair Wrap for Newborn Toddle...",Warehouse B,133,98,2025-02-28 10:55:00,35
2256,ORD_2257,7222,Fareto Baby Daily Essential Combo All in One(Total Items: 30)(0-6 Months),Warehouse A,321,301,2025-02-28 07:39:00,20
2257,ORD_2258,7216,"FabSeasons Kids Cotton Bucket Cap/Hat for Boys and Girls, for Sun Protection with Inner Adjustable fit,fits for 3-8 Years...",Warehouse A,489,467,2025-02-28 08:57:00,22
2258,ORD_2259,24122,AARU MALL New Born Baby Boys & Baby Girls Anti Slip | Booties Socks 3-12 Month Multicolor multidesign pack of 1 pair,Warehouse A,453,443,2025-02-28 04:54:00,10
2259,ORD_2260,24171,BABYVERSE Baby Grooming Kit/New Born Baby Nail Cutter/Baby Nail Scissor/Baby Healthcare Set (Purple),Warehouse C,83,69,2025-02-28 14:40:00,14
2260,ORD_2261,24131,"LuvLap Soft 100% Cotton Hooded Wrapper Cum Warm, Blanket, for New Born Baby to 3 Year Old, 75cmx75cm, Elephant Print (Pink)",Warehouse B,242,224,2025-02-28 00:08:00,18
2261,ORD_2262,7205,Piku Store Full Sleeves Hosiery Slogan/Cartoon Print T-Shirt for Baby Boy & Baby Girl,Warehouse B,291,259,2025-02-28 08:14:00,32
2262,ORD_2263,24140,UJEAVETTE 3Mm Neoprene Diving Scuba Surfing Swimming Socks Snorkeling Boots L(42-44),Warehouse A,268,224,2025-02-28 15:57:00,44
2263,ORD_2264,24143,"Angel Bear Chiffon Satin Lace Ribbon Boutique, Elastic Bow knot Head Band for Girls, Pack of 10 - Multicolour",Warehouse B,462,457,2025-02-28 19:45:00,5
2264,ORD_2265,24152,PWI Soft Plush Cartoon Shape Cushion Baby Sofa Seat or Rocking Chair for 0-2 Years Kid(Red_Cotton),Warehouse B,254,208,2025-02-28 20:53:00,46
2265,ORD_2266,24156,FOOTPRINTS Organic Cotton Kids Unisex Socks | 5-8 years | Pack of 3 Pairs | Colourful Stripes,Warehouse A,194,160,2025-02-28 06:39:00,34
2266,ORD_2267,24163,Zacharias Boy's & Girls Kids Woolen Cap & Muffler Set of 2 (Beige;4-8 Years) 1F-03,Warehouse B,345,303,2025-02-28 02:36:00,42
2267,ORD_2268,24129,Wish Karo Unisex Dugaree Dress for Baby Boys - Baby Girls,Warehouse C,287,256,2025-02-28 10:37:00,31
2268,ORD_2269,7141,Aya Papaya Ouchie Monster Print Mosquito Repellent Patches (24 Patches) & Ouchie Non-Toxic Printed Bandages - Pink (20 Str...,Warehouse A,206,172,2025-02-28 05:50:00,34
2269,ORD_2270,24237,"Baby Nail File Electric Nail Trimmer Manicure Set with Nail Clippers, Toes Fingernails Care Trim Polish Grooming Kit Safe ...",Warehouse C,219,208,2025-02-28 02:03:00,11
2270,ORD_2271,7103,BUMZEE Full Sleeves Fancy Sleepsuit for Baby Boys,Warehouse C,54,22,2025-02-28 01:46:00,32
2271,ORD_2272,24228,Babycenterindia Baby Bath Tub (White),Warehouse B,355,307,2025-02-28 07:42:00,48
2272,ORD_2273,24227,"Cello Portable Plastic Baby Bath Tub, Orange",Warehouse B,538,493,2025-02-28 05:23:00,45
2273,ORD_2274,24301,NAPPERS By Mother Sparsh Free Size Cloth Diaper For Babies | Washable & Reusable | With 1200+ GSM Dry Feel Absorbent Soake...,Warehouse A,184,147,2025-02-28 12:27:00,37
2274,ORD_2275,24557,Toddylon Baby Gift Combo Pack New Born Daily Needs Items in Single Packet (0-6 Months),Warehouse A,45,20,2025-02-28 00:08:00,25
2275,ORD_2276,6960,Lillypupp New Born Baby Sandals for Pre-Walker (10-15 Months) (Style4),Warehouse A,484,438,2025-02-28 23:35:00,46
2276,ORD_2277,6959,BUMZEE Orange Half Sleeves Baby Boys Thigh Length Romper,Warehouse B,329,294,2025-02-28 04:00:00,35
2277,ORD_2278,6968,2 PCs Evil Eye Heart Bracelets cum Anklets for Kids/Babies | Lucky Nazaria Adjustable Bracelets for Kids- Girls-Boys (Hand...,Warehouse B,514,474,2025-02-28 03:32:00,40
2278,ORD_2279,24182,Vensa Newborn Baby Girl Dress Romper/Onesie/Babysuit 100% Pure Cotton - Pack of 3,Warehouse C,480,451,2025-02-28 16:11:00,29
2279,ORD_2280,24186,Kids Basket Baby Boys and Girls 100% Pure Cotton White Vest Inner wear Combo Pack of 5 and 10 pc,Warehouse B,105,74,2025-02-28 06:15:00,31
2280,ORD_2281,24188,"Neska Moda 0 To 6 Months Baby Girls Cotton Butterfly Frill Booties (Baby Pink,Black) -BT382andBT1123",Warehouse A,124,86,2025-02-28 13:17:00,38
2281,ORD_2282,24190,Bestie toys Boomerang Glow in The Dark | Night Booma | Toys Kids & Adult | Returning Boomerang Multicolor,Warehouse B,154,120,2025-02-28 20:01:00,34
2282,ORD_2283,24193,Chirsh® Kids Cotton Pajama Pants,Warehouse B,235,194,2025-02-28 13:17:00,41
2283,ORD_2284,24194,DHRUVS COLLECTION Elegantly Designed 925 Pure Silver Hallmarked Baby Nazariya Bracelets With Black and Silver Crystal Bead...,Warehouse A,290,265,2025-02-28 17:36:00,25
2284,ORD_2285,24181,Baby Moo Rainbow Chu-Chu Sound Anti-Skid Breathable Denim Sandals - Navy Blue (18-24M),Warehouse C,60,22,2025-02-28 01:25:00,38
2285,ORD_2286,7166,Dr. Care MCP Forehead Strip Body Tempreture Indicator Strip Thermometer for Kids 0 to 5 Years Kids (Pack of 3),Warehouse C,73,58,2025-02-28 09:59:00,15
2286,ORD_2287,24213,"Johnsons Baby Aloe Vera Oil 300Ml - Pack of 1, 300mL",Warehouse C,516,477,2025-02-28 06:51:00,39
2287,ORD_2288,24219,Hopscotch Unisex Recycled Polyester/Memory Foam Solid Slip Ons in Yellow Color,Warehouse C,82,56,2025-02-28 03:07:00,26
2288,ORD_2289,24300,"WaterWipes Sensitive Baby Wipes, 60 count - 3 Packs",Warehouse A,141,125,2025-02-28 18:15:00,16
2289,ORD_2290,22795,"Chicco Baby Moments Mild Body Wash Protect, New Advanced formula with Natural Ingredients, No tears, Suitable for Baby’s B...",Warehouse C,309,282,2025-02-28 22:58:00,27
2290,ORD_2291,24265,"LuvLap Half Sleeve Frock, for Baby, Infants & Toddlers, Multicolour, 100% Cotton, Baby Girl Frock, Baby Girl Clothes, Kids...",Warehouse C,303,257,2025-02-28 21:25:00,46
2291,ORD_2292,24267,"Baybee 3 in 1 Invictus Convertible High Chair for Kids with Adjustable Height and Footrest, Baby Toddler Feeding Booster S...",Warehouse A,472,438,2025-02-28 09:43:00,34
2292,ORD_2293,7117,"Toys N Smile Metal Bey Blade Toy Pack with Ripchord Launcher 4 Bey Blade, Multi Color(Pack of 1 set)",Warehouse A,245,215,2025-02-28 10:18:00,30
2293,ORD_2294,24274,Max Girls Graphic Print T-Shirt with Long Sleeves,Warehouse B,138,97,2025-02-28 20:23:00,41
2294,ORD_2295,24096,CHIU Rabbit Baby Infant Soft Booties for 0-6 Month's and 6-12 Month's,Warehouse B,336,312,2025-02-28 04:01:00,24
2295,ORD_2296,23520,"Little Peaches Pure Cotton Baby Rompers, Baby Bodysuit, Onesies Newborn, Soft Fabric, 34th Sleeve",Warehouse B,451,441,2025-02-28 08:44:00,10
2296,ORD_2297,7989,VIKITA Girls Summer Pink Heart Print Sundress Short Sleeve Casual Cotton Dress,Warehouse A,352,312,2025-02-28 13:40:00,40
2297,ORD_2298,22770,Happy Matty Baby's Extra Absorbent Quick Dry Sheet Playmat Waterproof Reusable Washable Colourful Soft Comfortable Best fo...,Warehouse C,196,150,2025-02-28 09:46:00,46
2298,ORD_2299,7984,Trendy House Baby Girls & Boys 100% Cotton Night Suit Sets Cotton Shirts and Pyjama Set Pack of 2,Warehouse C,239,213,2025-02-28 08:18:00,26
2299,ORD_2300,22783,"Philips Avent Plastic BPA Free Material Aven Straw Cup SCF796/00 200 ML 1 Piece, Multi",Warehouse A,407,380,2025-02-28 14:45:00,27
2300,ORD_2301,7975,HUMPU Half Sleeve Denim Dungaree Dress Set with T-shirt for Baby Boys & Baby Girls,Warehouse B,427,395,2025-02-28 05:15:00,32
2301,ORD_2302,7974,Kitty Baby Boy Sneakers White Casual Shoes 6-12 Months,Warehouse B,177,151,2025-02-28 03:18:00,26
2302,ORD_2303,22792,Cherilo Little Bunny Spout Sipper for Infant/Toddler (210ml) | Anti-Spill Sippy Cup with Soft Silicone Spout & Straw | Det...,Warehouse C,62,29,2025-02-28 12:15:00,33
2303,ORD_2304,24308,TERI BERI Dry Muslin Wash Cloth Organic Cotton Face Towel Handkerchief for Baby New Born/Infants/Toddlers (White),Warehouse C,221,206,2025-02-28 14:35:00,15
2304,ORD_2305,7129,nauti nati Girls Casual Dress,Warehouse A,243,218,2025-02-28 13:04:00,25
2305,ORD_2306,24313,Mamaearth Dusting Powder with Organic Oatmeal & Arrowroot Powder for Babies - 300g and Mamaearth Anti Mosquito Fabric Roll...,Warehouse A,202,182,2025-02-28 07:12:00,20
2306,ORD_2307,24324,"COUNTRY HUB® Rainbow Magic Spring Fun Playing for Kids, Bangles Rings Size 6.5 cm, Pack of 1",Warehouse C,380,359,2025-02-28 19:46:00,21
2307,ORD_2308,24325,Jack's Star Kids Soft Cotton Trackpants Lowers Pajama for Infants Toddler Boys and Girls with Bottom Ribs (Pack of 6),Warehouse B,185,149,2025-02-28 11:40:00,36
2308,ORD_2309,24331,"100% Cotton Baby Cap+Mitten/Glove+Booty for 0-6 Months| Baby Boy, Baby Girl| Multi Color| Pack of 2 (Pink, Blue)",Warehouse C,329,284,2025-02-28 14:31:00,45
2309,ORD_2310,24348,HAPPU COLLECTION printed kids boot (brown) 01,Warehouse A,253,238,2025-02-28 14:21:00,15
2310,ORD_2311,24362,kids boys and girls sleeveless front open top and shorts for infant baby multi colors of 6,Warehouse B,265,224,2025-02-28 03:51:00,41
2311,ORD_2312,24363,"Pack Of 2 Infant Newborn, First Walking Shoe Unisex-Baby's Boy Girl Fashion Non Skid Comfortable All Seasons Soft Cotton A...",Warehouse A,300,252,2025-02-28 10:07:00,48
2312,ORD_2313,24365,Flutterbee 100% Organic Cotton Jumpsuit for Baby Girls,Warehouse C,365,348,2025-02-28 11:43:00,17
2313,ORD_2314,7114,"KNITROOT Half Birthday Unisex Baby Romper Whilte Color Half Sleeve"" Half Birthday Babe"" (9-12 Months, KSBR23-4)",Warehouse C,94,72,2025-02-28 10:02:00,22
2314,ORD_2315,24276,Jimmy Jammy Baby Boy & Girls Dress Soft Hosiery Cotton Blend T-shirt and Shorts Pack 4 T-shirt + 4 Shorts Multi colored Si...,Warehouse B,179,166,2025-02-28 20:44:00,13
2315,ORD_2316,7140,School Socks black for kids boys girls school uniform Bamboo Organic cotton blend Cushioned odour control Pack of 3 pair,Warehouse A,71,30,2025-02-28 20:43:00,41
2316,ORD_2317,24239,"CINDERELLA THE CREATIONS FACTORY Casual Frock for Baby Girls,Pack of 3",Warehouse B,436,409,2025-02-28 19:39:00,27
2317,ORD_2318,24240,Lwvax Professional Baby Nail Cutter with Magnifier/Baby Safety Nail Clipper/Baby Nail Scissors for New Born Children & Adu...,Warehouse C,236,231,2025-02-28 22:27:00,5
2318,ORD_2319,24243,Mee Mee Easy Grip Toothbrush - Blue,Warehouse C,455,423,2025-02-28 19:12:00,32
2319,ORD_2320,7130,KETKAR Baby Gloves Winter Warm Lovely Knitted Striped Gloves Kid Mittens_Pack Of 06(Multicolour),Warehouse B,457,427,2025-02-28 22:44:00,30
2320,ORD_2321,23810,"Sukha Jhari Baby Oil | Lal Tel | Sukha Jhari, Baby Massage Oil (100ml 2Pack)",Warehouse B,338,328,2025-02-28 09:12:00,10
2321,ORD_2322,4104,"Sebamed Baby Massage Oil, 150ml & Baby Cleansing Bar - 100 g & Baby Lotion, 100ml Combo",Warehouse B,337,311,2025-02-28 05:53:00,26
2322,ORD_2323,29775,SAFESHOP - (Pack of 4 Shorts) Regular Printed Shorts for Your Little One (Unisex) Multi-Coloured Shorts - Print/Colour May...,Warehouse C,356,329,2025-02-28 06:31:00,27
2323,ORD_2324,4100,Durable Comfortable Sports Shoes for Outdoor Indoor Winter Season for Baby BOY and Baby Girls of 3 Years | 3.5 Years | 4 Y...,Warehouse C,258,235,2025-02-28 11:32:00,23
2324,ORD_2325,4099,Amway NUTRILITE Fiber powedr (Pack of 200 gms powder),Warehouse A,312,304,2025-02-28 07:00:00,8
2325,ORD_2326,29760,ANNECA FASHION kid's baby girls softy cotton foil printed western tops and shorts clothing set,Warehouse B,284,275,2025-02-28 00:45:00,9
2326,ORD_2327,29715,"MamyPoko Pants Extra Absorb NB114,Unisex Baby, Pack of 114",Warehouse C,345,315,2025-02-28 05:57:00,30
2327,ORD_2328,29666,BAREPEPE Baby Girl Lace Socks Princess Ankle Length Colorful Childhood Baby-Girls Eyelet Ruffle Frill Socks for Girls 3 Ye...,Warehouse C,67,30,2025-02-28 03:41:00,37
2328,ORD_2329,4168,Mothercare Cotton Baby Skirts,Warehouse C,542,497,2025-02-28 09:01:00,45
2329,ORD_2330,29673,Zumrut® Silver Plated Om Namah Shivay/ॐ नमः शिवाय Embossed Designer Kada Wrist Bracelet Jewellery for Baby Girl & Boys (Up...,Warehouse C,458,425,2025-02-28 14:38:00,33
2330,ORD_2331,4157,"Little One's | 6 Plastic Shelves Foldable Baby Storage Box (Made in India), Unbreakable Material, (Steel Structure)| Jungl...",Warehouse C,255,212,2025-02-28 03:49:00,43
2331,ORD_2332,29685,SuperBottoms Dry Feel Langot - Pack of 6- Cotton Padded Langot / Nappy with Gentle Elastics & a SuperDryFeel Layer on top...,Warehouse B,382,337,2025-02-28 19:04:00,45
2332,ORD_2333,4147,vaghbhatt 2 Inches Baby Girls Hair Rabbit Ear Mini Boutique Elastic Hair Rubber Ribbon Hair Band Accessories for Kids Todd...,Warehouse B,535,487,2025-02-28 16:04:00,48
2333,ORD_2334,4161,Sahiba Gems Exclusive Silver Baby Kada/Bangle Rudraksh Om Design With Ghungroo (Chandi Kada),Warehouse C,46,23,2025-02-28 10:13:00,23
2334,ORD_2335,4218,"Juflix Water Shoes for Summer Barefoot, Swimming Sneakers, Non Slip Soft Thin Soled Shoes Swim Water Sport Quick Dry Aqua ...",Warehouse A,62,25,2025-02-28 02:33:00,37
2335,ORD_2336,4201,Fusion Baby on Board Pooh Sign,Warehouse C,346,303,2025-02-28 03:47:00,43
2336,ORD_2337,4217,FLAX ® Baby Boys & Baby Girls Regular Cotton Shorts (Pack of 10),Warehouse A,103,66,2025-02-28 15:00:00,37
2337,ORD_2338,29556,POLKA TOTS Kurta Pajama for Kids 100% Super Soft Cotton Night Suits for Boys & Girls,Warehouse B,252,205,2025-02-28 18:13:00,47
2338,ORD_2339,4211,Bold N Elegant PU Leather Sparkling Crown Baby Girl Birthday Party Moccasin Bootie Shoes Sandal Footwear for Newborn Infan...,Warehouse B,454,444,2025-02-28 02:09:00,10
2339,ORD_2340,4210,AHC Baby Ultra Soft Toothbrush With Micro Nano Bristles With Tongue Cleaner For 3-16 Years Kids (White),Warehouse A,62,44,2025-02-28 05:03:00,18
2340,ORD_2341,4206,Hopscotch Boys Cotton Stripe Print Romper in Red Color,Warehouse B,239,206,2025-02-28 02:17:00,33
2341,ORD_2342,29567,Kitty Baby Boys' White Moccasin -3 Kids UK,Warehouse B,527,494,2025-02-28 01:18:00,33
2342,ORD_2343,29575,Ganpati Enterprises Comb and Brush Set with Soft Bristles and Rounded Tips for Baby’s Sensitive Skin/Hair Care |Grooming A...,Warehouse A,160,143,2025-02-28 17:28:00,17
2343,ORD_2344,29554,YUV Infant Boys & Girls Multi-Color Pack of 3 100% Soft Cotton Printed Tshirts & Shorts with Shoulder Poppers 18-24 Months,Warehouse B,212,171,2025-02-28 10:44:00,41
2344,ORD_2345,4172,KUKSHYA JEWELLERS Exclusive 925 Sterling Silver Baby Boy Waist Belt/Tagri With Black Thread_Handmade_Comfortable (7 BALL T...,Warehouse B,82,47,2025-02-28 01:30:00,35
2345,ORD_2346,29730,WorldCare® 3mm Neoprene Diving Scuba Surfing Swimming Socks Surfing Snorkel Boots L (66000163JEL),Warehouse B,31,10,2025-02-28 00:45:00,21
2346,ORD_2347,29733,Neska Moda Pack of 3 Multicolor Baby Girl Frock for 6 to 12 Months KV6,Warehouse B,433,426,2025-02-28 19:05:00,7
2347,ORD_2348,29742,KIDS & BEBS Baby Girl Sticker Print Frock Soft and Comfortable 0-3 Months,Warehouse B,435,412,2025-02-28 04:55:00,23
2348,ORD_2349,4125,Babuline Baby Powder & Baby Soap Travel Kit,Warehouse A,358,347,2025-02-28 08:20:00,11
2349,ORD_2350,29718,The Moms Co. Tear-Free Natural Baby Shampoo (400ml) & Talc-Free Natural Baby Powder with Corn Starch | 100% Natural | Aust...,Warehouse B,273,261,2025-02-28 18:14:00,12
2350,ORD_2351,29702,WorldCare® 3mm Neoprene Anti-slip Scuba Diving Spearfishing Snorkeling Socks M(39-41) (66000581JEL),Warehouse C,401,356,2025-02-28 12:53:00,45
2351,ORD_2352,29527,"Little Angel Extra Dry Baby Pants Diaper, Medium (M) Size, 148 Count, Super Absorbent Core Up to 12 Hrs. Protection, Soft ...",Warehouse C,129,113,2025-02-28 08:44:00,16
2352,ORD_2353,29271,"Ghelonadi Baby Girls Headbands Hair Elastics Bands for Baby Girls Newborn Infant Toddlers Kids Red,White,Black Set of 3",Warehouse A,386,351,2025-02-28 00:56:00,35
2353,ORD_2354,4368,NEOBABY Boys & Girls Shoes Age-Group 12 Months to 3.5 Years,Warehouse A,403,368,2025-02-28 17:19:00,35
2354,ORD_2355,29321,Donuts Baby Girl's Cotton Leggings (281272731_Assorted_06M,Warehouse B,478,446,2025-02-28 23:08:00,32
2355,ORD_2356,29282,"MASTELA Rounded Lobes Soft Bristle Baby Hair Comb| Easy Grip Comb for Newborns/Kids/Babies/Toddlers (Comb Blue, Pack of 2)",Warehouse A,507,469,2025-02-28 12:03:00,38
2356,ORD_2357,4358,"MY NEWBORN Multipurpose, New Born Baby Blanket Wrapper Towel Robe with Sheet -Set of 2 Pcs (Brown and White) (762.0mm L X ...",Warehouse B,214,188,2025-02-28 14:28:00,26
2357,ORD_2358,4357,Baby Soft Feeding Bibs/Apron Cute Multi Print|with Tich Button| Waterproof Newborn Baby Bib Set,Warehouse C,425,376,2025-02-28 23:00:00,49
2358,ORD_2359,4356,Sahiba Gems Silver/Chandi Baby Kada Bangle Nazariya for Babies ~ Fit for 1-1.5 years babies ~ Light Weight,Warehouse A,169,136,2025-02-28 07:45:00,33
2359,ORD_2360,29307,Denim Shoe,Warehouse B,328,295,2025-02-28 21:19:00,33
2360,ORD_2361,4345,"Dr. Brown's Infant-to-Toddler Toothbrush, Giraffe",Warehouse C,230,186,2025-02-28 15:03:00,44
2361,ORD_2362,4296,"JIALTO Baby Nail Clippers 6 in 1 by Baby Safe Electric Baby Nail Trimmer,Automatic Nail Automatic Nail Trimmer || Addition...",Warehouse C,466,454,2025-02-28 09:52:00,12
2362,ORD_2363,29411,"LuvLap Hippo Spout Sipper for Infant/Toddler, 225ml, Anti-Spill Sippy Cup with Soft Silicone Spout BPA Free, 6m+ (Pink)",Warehouse A,290,243,2025-02-28 20:52:00,47
2363,ORD_2364,4252,"Neska Moda 6 To 12 Months Baby Boys & Baby Girls Pack Of 2 Pair Cotton Butterfly Frill Booties (Maroon,Light Green) -BT17a...",Warehouse C,504,484,2025-02-28 07:16:00,20
2364,ORD_2365,4245,Johnson's Baby Cream For Summer 200g,Warehouse C,255,249,2025-02-28 16:54:00,6
2365,ORD_2366,29491,Sahiba Gems Exclusive Pure 925 Sterling Silver With Silver Beads Nazariya For Babies 2 Pcs (One Pair),Warehouse C,256,245,2025-02-28 09:15:00,11
2366,ORD_2367,29494,VENJA (LABEL) Baby First Walking Shoes Kids Baby Toddler Sock Shoes Trainers Infant Toddler Baby Boys Girls Shoes Breathab...,Warehouse C,279,246,2025-02-28 13:34:00,33
2367,ORD_2368,29496,"MagicPop Colourful Socks for kids, Ankle length/Crew, Cotton, 1 to 9 Years, Pack of 5, Designer socks, Gift for Girls & Boys",Warehouse C,45,36,2025-02-28 17:09:00,9
2368,ORD_2369,4371,MSCREATION Baby Girl's Fit & Flare Knee Length Dress,Warehouse C,343,322,2025-02-28 18:48:00,21
2369,ORD_2370,29264,"Neska Moda 6 To 12 Months Baby Girls Cotton Butterfly Frill Booties (Maroon,Yellow) -SK127andBT84",Warehouse C,217,171,2025-02-28 14:29:00,46
2370,ORD_2371,29338,Cherry Crumble California Kids Girl's Little Black Polyester Dress (CTWS-PDRS-Z5218_Black),Warehouse A,295,274,2025-02-28 08:31:00,21
2371,ORD_2372,29352,Coolz Kids Unisex Casual Shoes Play-4 for 1-4 Years Boys and Girls,Warehouse A,357,317,2025-02-28 01:33:00,40
2372,ORD_2373,29354,Nino Bambino 100% Organic Cotton Multi-Color Crown Hat for Baby Infant Boy/Sun Hat for Baby Boy.,Warehouse B,334,318,2025-02-28 11:20:00,16
2373,ORD_2374,4323,"Mee Mee Soft Cushioned Potty Seat with Support Handles (Regular, Blue)",Warehouse B,470,425,2025-02-28 12:46:00,45
2374,ORD_2375,4316,The Little Lookers Kids Winter Wear/Warm Pyjamis/Woollen leggings with inside Fleece layer | Pyjamas/Diaper Pants for babi...,Warehouse B,416,389,2025-02-28 07:55:00,27
2375,ORD_2376,29375,SYGA Baby Nylon Headband Bow Head Flower Children's Headwear Hair Accessories Set Of 3 Pcs (HairBand 3 - Color 4),Warehouse C,300,288,2025-02-28 13:45:00,12
2376,ORD_2377,29386,"Dormyo Cradle Breast Feeding/Nursing Pillow (with Belt) Multifunction Pillow with 5 Different uses; 1 Year Warranty, Print...",Warehouse A,186,140,2025-02-28 13:28:00,46
2377,ORD_2378,4312,"Neska Moda 6 To 12 Months Baby Girls Pack Of 2 Pair Cotton Butterfly Frill Booties (Rani Pink,Light Green) -BT3andBT42",Warehouse C,237,221,2025-02-28 00:52:00,16
2378,ORD_2379,4319,"Newborn Organic Cotton Sleeveless Baby Top Dress Set for Infants - Unisex for Girls & Boys(Pack of 4) (0-3 Months, White P...",Warehouse B,157,132,2025-02-28 03:20:00,25
2379,ORD_2380,29325,"MamyPoko Pants Extra Absorb XL32,Unisex Baby, Pack of 32",Warehouse B,318,311,2025-02-28 14:21:00,7
2380,ORD_2381,4379,"Tikitoro Kids Daily Essentials Combo, Vegan Kids Body Wash (300 ml) & Conditioning Shampoo (300 ml)",Warehouse C,283,263,2025-02-28 12:09:00,20
2381,ORD_2382,29261,Hopscotch Girls Cloth Solid Slip On in Multi Color,Warehouse B,278,257,2025-02-28 03:31:00,21
2382,ORD_2383,29544,ZAVEZA - Home Kart Unicorn Velvet Cartoon Printed Pillow for Baby Pack of 2 ( Size -12 x 18 Inches ),Warehouse B,135,99,2025-02-28 05:31:00,36
2383,ORD_2384,29538,"HEYCANDY Baby Bath Chu Chu Colorful Animal Shape Toy (Multicolor, Multi Design) - Set of 12 Pieces",Warehouse A,496,464,2025-02-28 18:00:00,32
2384,ORD_2385,30882,Premsons® Hand Toy for Children/Kids - Starry Sky,Warehouse A,416,370,2025-02-28 00:13:00,46
2385,ORD_2386,3509,Sebamed Baby Wash Extra Soft 400Ml and Sebamed Baby Cleansing Bar (150G),Warehouse B,395,368,2025-02-28 17:31:00,27
2386,ORD_2387,30905,heartbury Cute and Colourful Organic Cotton Socks for New Born Baby Age 0-12 Months-Multicolored,Warehouse B,198,179,2025-02-28 11:19:00,19
2387,ORD_2388,31085,"StarAndDaisy 360° Baby Walker Adjustable Height, Multi-Function Anti-Rollover Folding Walker with Height Adjustable 6-18 M...",Warehouse C,383,345,2025-02-28 07:10:00,38
2388,ORD_2389,3411,TuddyBuddy Cotton Boxer Briefs Underwear Trunks for Boys,Warehouse C,375,369,2025-02-28 23:51:00,6
2389,ORD_2390,3410,Widely Pure Baby Nasal Aspirator for Nasal Suction Nose Cleaner Baby Mouth | Nose Cleaning Sucker Suction for Children New...,Warehouse B,373,348,2025-02-28 07:12:00,25
2390,ORD_2391,31105,Momisy Women's Cotton Lightly Padded Wire Free Maternity Bra,Warehouse C,387,370,2025-02-28 19:46:00,17
2391,ORD_2392,3418,COYOTX cotton romper for baby boys | jumpsuit for kids | sleepsuit for babies | Embroidered romper | long sleeve winter cl...,Warehouse C,303,266,2025-02-28 15:21:00,37
2392,ORD_2393,31112,baby wish Raksha Bandhan Baby Unisex Bodysuits Newborn Romper Men's & Boys Regular Fit T-Shirt and Romper Combo Big Brothe...,Warehouse A,344,296,2025-02-28 04:31:00,48
2393,ORD_2394,3401,"Nivihsa : Handmade Baby girl Booties with headband Gift, Ideal for 3-6 Month (Insole lenght 10cm) - 100% Cotton Yarn - Green",Warehouse A,398,366,2025-02-28 16:46:00,32
2394,ORD_2395,30918,"KNITROOT Monthly Birthday Teddy Special Unisex Baby Romper Half Sleeve Envelope Neck ""2 Month Old""(KMTBR02-1,0-3 Months,Wh...",Warehouse C,311,292,2025-02-28 15:55:00,19
2395,ORD_2396,31123,Sajani Flashing Plastic Magic Lattoo Top Toy // Toy with LED Lights Music Attractive Toy // Non-Toxic and Safe Spinning To...,Warehouse A,419,392,2025-02-28 09:37:00,27
2396,ORD_2397,30871,KiddySoft Pants Diapers Medium-10 (Pack of -3 with Free BABY SOCKS),Warehouse B,102,93,2025-02-28 10:49:00,9
2397,ORD_2398,30928,Mother Sparsh 99% Pure Water (Unscented) Baby Wipes I Natural Plant Made Cloth - Super Thick I 72 pcs/Pack - Pack of 3,Warehouse A,306,268,2025-02-28 22:43:00,38
2398,ORD_2399,3485,Sebamed Baby Care Combo Pack Shampoo 150ml Bar 150gm Cream 50ml (White),Warehouse C,58,40,2025-02-28 23:23:00,18
2399,ORD_2400,30935,"TECH LOGO ELECTRONICS Shower Little Wind Up Key Random Cartoon Floating Bath Animal Turtle Toys for Kids Toddlers, Child P...",Warehouse B,407,402,2025-02-28 14:22:00,5
2400,ORD_2401,30920,Hopscotch Unisex EVA Solid Infant Booties in Blue Color,Warehouse C,285,246,2025-02-28 16:26:00,39
2401,ORD_2402,30958,"H SOCKS Hand Woven/Knitted Baby Boy's Girl's Kids Woolen Winter Socks/Booties for New Born (Multicolor, 0-6 Months)",Warehouse B,241,199,2025-02-28 04:19:00,42
2402,ORD_2403,30959,GLAN Rajasthani Pagdi/Turban/Topi/Safa for Men Kids Boys Costume Competition Set of 2,Warehouse B,510,483,2025-02-28 01:24:00,27
2403,ORD_2404,30968,"GOURAVSUMANA New Born Baby Cotton Caps Booties Mittens Combo Set (White, 0-3 Months) (0-3 Months, White 4)",Warehouse C,123,86,2025-02-28 17:39:00,37
2404,ORD_2405,3468,babeezworld Baby Boys & Baby Girls Cotton Front Open t-Shirt with Shorts,Warehouse C,441,422,2025-02-28 04:22:00,19
2405,ORD_2406,30956,"SAFESHOP - Baby's Unisex Soft Cotton Winter Sweater and Pajami Suit with Cap, Sweater & Diaper fit Leggings Made of Wool &...",Warehouse A,280,268,2025-02-28 12:30:00,12
2406,ORD_2407,30853,OYO BABY Extra Virgin olive oil for baby massage 200ml,Warehouse C,472,466,2025-02-28 13:57:00,6
2407,ORD_2408,30856,Baby Mini Scissor Stainless Steel Safety Nail Scissors Size 4.5 inch Set of 1,Warehouse C,117,107,2025-02-28 07:18:00,10
2408,ORD_2409,3518,"Runbugz Mosquito Repellent Printed Boom Patches For Baby's (30 Patches, Multicolor, Pack Of 3)",Warehouse B,218,177,2025-02-28 01:58:00,41
2409,ORD_2410,31120,"Baby cry Soft Cotton Ear Flap Caps with Tie Knot for Baby Boys and Girls (Multicolour, pak of 2)",Warehouse A,115,80,2025-02-28 12:15:00,35
2410,ORD_2411,31128,ADKD Baby Nail File Grinder Set Safe Nail Trimmer Kit for Kids Safe & Amp; Effective Baby Manicure Manicure Tools (Random ...,Warehouse B,416,379,2025-02-28 18:02:00,37
2411,ORD_2412,29603,Hopscotch Boys Cotton Embroidered Romper in Peach Color,Warehouse B,120,71,2025-02-28 02:09:00,49
2412,ORD_2413,29614,J & J Top To Toe Gently Cleanses Newborn Skin & hair,Warehouse C,271,227,2025-02-28 22:17:00,44
2413,ORD_2414,4192,Spandex Solid Hosiery Febric Full Sleeve Shirt and Pant Set For Baby Boys,Warehouse A,328,284,2025-02-28 18:28:00,44
2414,ORD_2415,4191,"WEIRVI Kid's Multicolor Panda Face Shape Cotton and Silicon Rubber base Shoes Cum Socks, Antislip Soft Sole Children's Sho...",Warehouse C,194,163,2025-02-28 13:16:00,31
2415,ORD_2416,29622,FOOTPRINTS Organic cotton Baby Socks-12-30 Months - Pack of 4 pairs - Grey Navy,Warehouse C,177,150,2025-02-28 04:31:00,27
2416,ORD_2417,4184,NOFALL Anti Skid Socks for Kids Pack of 2 Robot & Car Design Socks - Black & Blue,Warehouse A,353,335,2025-02-28 10:48:00,18
2417,ORD_2418,29631,JIASUQI Kids Boys and Girls Summer Athletic Water Shoes Aqua Socks for Beach Swimming Pool,Warehouse C,344,327,2025-02-28 06:04:00,17
2418,ORD_2419,4180,BUMZEE Yellow & Blue Front Open Half Sleeves Jablas for Baby Boy Pack of 3 Age - 3-6 Months,Warehouse A,221,205,2025-02-28 14:09:00,16
2419,ORD_2420,29640,GJ Baby Girls' Yellow Knits Top | FleeceHand-wash | Regular Fit | 151246520388 C308,Warehouse A,157,144,2025-02-28 11:05:00,13
2420,ORD_2421,29641,GOLAZO Unisex-Baby's Bootie,Warehouse C,65,34,2025-02-28 16:40:00,31
2421,ORD_2422,29642,MOM CARE Newborn Baby Gift Set Has All Newborn Baby Essential Clothes in Baby Gift Set for or Girls Unisex 9 pcs (Red),Warehouse A,477,451,2025-02-28 13:40:00,26
2422,ORD_2423,29645,"Desitin Rapid Relief Diaper Rash Ointment, Creamy 4 oz (113 g)",Warehouse C,333,301,2025-02-28 07:20:00,32
2423,ORD_2424,4176,"Neska Moda 12 To 18 Months Baby Boys & Baby Girls Cotton Rabbit Booties (Maroon,Blue) -BT1151andBT1177",Warehouse C,208,180,2025-02-28 14:36:00,28
2424,ORD_2425,4181,"BuddsBuddy Polypropylene Sipper Cup - Green, 150ml",Warehouse C,421,393,2025-02-28 01:22:00,28
2425,ORD_2426,29595,Trendy World Baby Boy's & Baby Girl's Self-design Bomber Jacket,Warehouse B,343,323,2025-02-28 15:16:00,20
2426,ORD_2427,29530,Aringel Mosquito Repellent Cream (50gm Each) - Set of 5,Warehouse A,329,301,2025-02-28 14:17:00,28
2427,ORD_2428,29531,"Neska Moda 12 To 18 Months Baby Boys & Baby Girls Cotton Rabbit Booties (Blue,Yellow) -BT1148andBT1176",Warehouse C,86,76,2025-02-28 03:00:00,10
2428,ORD_2429,29532,"Cetaphil Baby Daily Lotion, 400ml and Baby Mild Bar 75g (Pack of 2) - Combo",Warehouse A,292,280,2025-02-28 06:02:00,12
2429,ORD_2430,3393,Baby Collection White Vest White Baniyan Cotton Inner wear Vest for Baby Boy & Baby Girls Vest Pack of 6,Warehouse A,266,219,2025-02-28 21:32:00,47
2430,ORD_2431,30839,"KOFANI Baby Nail Trimmer Electric Nail File Set - Safe Baby Nail Clippers with Light, 10 Replacement Heads 8 Sandpapers Ki...",Warehouse B,419,402,2025-02-28 12:27:00,17
2431,ORD_2432,31131,"ME STORES Kids Winter socks, Thermal Socks, Warm socks (Pack of 5 Pairs) (2-5 Years)",Warehouse A,477,434,2025-02-28 07:27:00,43
2432,ORD_2433,3391,Donuts Baby Boy's Plain Regular fit Shirt (280464837_White_18M_FS,Warehouse A,371,335,2025-02-28 00:19:00,36
2433,ORD_2434,31069,"Luvlap Soft Silicon Inverted Nipple Puller for Breastfeeding, BPA Free,White, Non Toxic",Warehouse B,306,266,2025-02-28 09:19:00,40
2434,ORD_2435,31067,"Neska Moda 6 To 12 Months Baby Girls Cotton Butterfly Frill Booties (Black,Rani) -SK139andBT44",Warehouse A,181,176,2025-02-28 03:58:00,5
2435,ORD_2436,31011,Baby Cry Baby's Regular Shorts Pack of 5 (Multicolor) (18-24 Months),Warehouse A,274,228,2025-02-28 10:22:00,46
2436,ORD_2437,31019,Kradyl Kroft Toddler Pillow with 100% Cotton Removable Cover - 20 X 15 Inches | Children Pillows | Baby Pillows - Whale Times,Warehouse A,428,417,2025-02-28 10:43:00,11
2437,ORD_2438,31022,"Himalaya Baby Lotion 700ml and Himalaya Baby Care Extra Moisturizing Baby Wash, 200ml",Warehouse C,131,95,2025-02-28 07:20:00,36
2438,ORD_2439,31023,SuperBottoms NEW UNO Freesize Cloth Diaper | Cloth diaper for babies 0 to 3 years | Washable & Reusable cloth diaper | Com...,Warehouse B,117,106,2025-02-28 07:00:00,11
2439,ORD_2440,31029,Hopscotch Boys and Girls Fabric Graphic Print Slip Ons Shoes in Gray Color,Warehouse C,435,407,2025-02-28 16:32:00,28
2440,ORD_2441,31030,"Pampers Taped Diapers, Large (LG), 18 count for Kids",Warehouse B,475,437,2025-02-28 15:14:00,38
2441,ORD_2442,3435,TOTOMO Bucket Cap Boys and Baby Girls Printed for Kids Age 2-4 Years,Warehouse A,509,489,2025-02-28 20:56:00,20
2442,ORD_2443,31034,"Just Born Baby Dresses Top and Bottom Sets (Multicolor, 0-6 Months, Pack of 3)",Warehouse C,181,175,2025-02-28 08:30:00,6
2443,ORD_2444,31055,Generic Nail Trimmer for Babies and Adults Nail Cutter with 4 Working Modes(Assorted Color),Warehouse B,388,349,2025-02-28 05:07:00,39
2444,ORD_2445,31060,"Himalaya Tiny Toes Diaper Rash Cream, 50 g - Pack of 5",Warehouse C,386,350,2025-02-28 22:47:00,36
2445,ORD_2446,4240,"My Tiny Wear 11 Piece New Born Baby Gift Set,Infant Gift Set,Cotton Clothing Set for Boys and Girls(0-3 Months) (Blue)",Warehouse C,220,212,2025-02-28 08:40:00,8
2446,ORD_2447,23951,"The Moms Co. Tear-Free Natural Baby Body Wash with Calendula, Avocado Oils & USDA-Certified Organic Oils Like Argan, Chamo...",Warehouse C,83,55,2025-02-28 16:43:00,28
2447,ORD_2448,4091,South Sailor New Born baby 100% Cotton jabla set(Pack of 5),Warehouse B,85,71,2025-02-28 17:32:00,14
2448,ORD_2449,4089,Saumabhi Korean Version Soft Sole Princess Shoes Large Children Single,Warehouse B,42,10,2025-02-28 09:43:00,32
2449,ORD_2450,4072,"HNYR (PACK OF 2) Silicone Tooth Brush Head 360 Degree Cleansing U Shaped for Kids baby Manual Training Brush, Food Grade S...",Warehouse B,49,35,2025-02-28 03:12:00,14
2450,ORD_2451,4084,"Shyamcollections Baby Boys & Girls 100% Cotton Vests, Jhabla T-Shirt with Shorts Dress Sets | for Kids Infant Toddler | Ca...",Warehouse A,292,265,2025-02-28 02:06:00,27
2451,ORD_2452,29815,Puma Unisex-Kid Socks,Warehouse A,431,411,2025-02-28 17:11:00,20
2452,ORD_2453,4080,"Qualtos Women's Slippers (Yellow Laugh, 7.5-8.5 UK Men/ 7-8 UK Women)",Warehouse A,340,318,2025-02-28 04:05:00,22
2453,ORD_2454,4074,"MotherMed Baby Bath Thermometer and Floating Bath Toy BathTub and Swimming Pool Thermometer , Green Fish",Warehouse B,123,110,2025-02-28 10:13:00,13
2454,ORD_2455,4087,Gini & Jony Baby Boy's Plain Regular fit Polo T-Shirt (131246520526 C472_RED 12M),Warehouse A,533,484,2025-02-28 03:12:00,49
2455,ORD_2456,29901,"New Era Born Baby's Hosiery Organic Cotton plain Mitten and Booties Set, Gloves & Socks (Multicolour, 0-1 Year)",Warehouse A,277,264,2025-02-28 15:25:00,13
2456,ORD_2457,29980,GAME BEGINS Boys Co-ordinated Sets Relaxed Pajama (GBS32621XXBFCS-GREEN- Green_20),Warehouse A,247,213,2025-02-28 23:34:00,34
2457,ORD_2458,3993,ANGAAKAR CLOTHINGS Baby Boys and Girls Cotton Half Sleeve Front Open Vest for Kids Innerwear Toddler Jhabla Multicolors Pa...,Warehouse A,453,407,2025-02-28 23:03:00,46
2458,ORD_2459,29986,"Mamaearth Moisturizing Baby Bathing Soap Bar, pH 5.5, with Goat Milk & Oatmeal. Pack of 2, 75gms each & Mamaearth India's ...",Warehouse C,127,104,2025-02-28 04:29:00,23
2459,ORD_2460,29826,"Zeezeezoo Premium Polo Collared Onesies Set of 2 (Navy & Yellow, 6-12 Months)",Warehouse A,440,405,2025-02-28 09:51:00,35
2460,ORD_2461,3887,"BeyBee 3 in 1 Blanket Wrapper-Sleeping Bag for New Born Babies, Beige Plain, 72 x 68 cm",Warehouse B,298,282,2025-02-28 01:51:00,16
2461,ORD_2462,3964,"Karrot by Shoppers Stop Printed Cotton Polo Neck Infant Boys Top & Bottom Set (Blue, 6 to 12 Months)",Warehouse A,234,188,2025-02-28 18:44:00,46
2462,ORD_2463,3969,Wish Karo Unisex Dungaree For Baby Boys-Baby Girls (bt86),Warehouse A,367,339,2025-02-28 16:28:00,28
2463,ORD_2464,30015,PUMA Unisex-Child Evolve Run Mesh Ac+ Sneaker,Warehouse A,258,218,2025-02-28 08:17:00,40
2464,ORD_2465,4063,GOCART WITH G LOGO Baby Safety Nail Scissors (Blue),Warehouse B,182,177,2025-02-28 15:40:00,5
2465,ORD_2466,4062,MINI KLUB Baby-Girl's Regular Fit,Warehouse C,249,232,2025-02-28 13:17:00,17
2466,ORD_2467,4056,"little PANDA Baby Girls Fit & Flare Knee Length Digital Printed Net Dress, Multi-Coloured",Warehouse B,512,482,2025-02-28 04:53:00,30
2467,ORD_2468,4054,3BROS Unisex Baby Cotton Printed Sleepsuit,Warehouse C,23,17,2025-02-28 01:21:00,6
2468,ORD_2469,4053,"Lillypupp New Born Baby Boy's And Baby Girl's Pre-Walker Booties (Multicolor, 12-18 Months)",Warehouse B,516,472,2025-02-28 16:33:00,44
2469,ORD_2470,29870,Hopscotch Baby Girls Viscose Floral Print Sleeveless Party Dress in Green Color,Warehouse C,367,331,2025-02-28 14:37:00,36
2470,ORD_2471,29878,"Mamaearth Milky Soft Shampoo with Oats, Milk and Calendula for Babies (400 ml) & Soothing Baby Massage Oil, with Sesame, A...",Warehouse C,461,436,2025-02-28 07:13:00,25
2471,ORD_2472,29881,"Himalaya Baby Powder, 700g & Himalaya Gift Pack",Warehouse C,302,267,2025-02-28 15:26:00,35
2472,ORD_2473,4044,BRATS N BEAUTY Baby Boy's & Baby Girl's Regular Cotton Socks (Pack of 3) (RS/KWS1/BG/3P/2-3Y_Multicolored_2-3 Years),Warehouse A,418,409,2025-02-28 21:50:00,9
2473,ORD_2474,29832,"Neska Moda 0 To 6 Months Baby Girls Cotton Butterfly Frill Booties (Black,Orange) -BT379andBT1124",Warehouse C,293,272,2025-02-28 12:55:00,21
2474,ORD_2475,29987,"LuvLap Instadry Extra Absorbent Quick Dry Sheet for baby, Baby Bed Protector, Waterproof baby sheet - Green, 0m+ - Large 1...",Warehouse C,285,258,2025-02-28 17:55:00,27
2475,ORD_2476,29973,Nino Bambino 100% Organic Cotton Printed cap Sleeves Onesie Dress For baby Girls,Warehouse B,433,415,2025-02-28 17:12:00,18
2476,ORD_2477,29951,BabyMoon Boys Crochet Cap (Pack of 1),Warehouse C,118,85,2025-02-28 18:17:00,33
2477,ORD_2478,4011,"Chinmay Kids Training U Shaped Toothbrush For 360 Degree Mouth-Cleaning For Kids, Pack of 2, Yellow Green",Warehouse C,75,63,2025-02-28 03:39:00,12
2478,ORD_2479,29786,"Baebyphant Baby Oil with Baby coconut oil, essential oil, olive oil and almond baby massage oil (250 ml) | Baby oil with b...",Warehouse C,321,307,2025-02-28 17:37:00,14
2479,ORD_2480,31471,Whitewhale Men's Loose fit Harem Pants,Warehouse B,519,485,2025-02-28 18:28:00,34
2480,ORD_2481,5655,Mamaearth Aqua Glow Gel Face Moisturizer With Himalayan Thermal Water and Hyaluronic Acid for 72 Hours Hydration 100ml,Warehouse B,258,219,2025-02-28 23:50:00,39
2481,ORD_2482,23877,"Braun Nasal Aspirator – Quickly and Gently Clear Stuffed Infant Noses, Toddler and Baby Nasal Aspirator with Two Adjustabl...",Warehouse B,431,392,2025-02-28 09:33:00,39
2482,ORD_2483,23883,"Mamaearth Niacin Toner For Face, with Niacinamide & Witch Hazel for Acne and Open Pores - 200 ml",Warehouse B,118,105,2025-02-28 11:46:00,13
2483,ORD_2484,23886,Flutterbee Newborn Premium Baby Boy Dress Romper/Onesie/Babysuit 100% Pure Cotton,Warehouse B,311,289,2025-02-28 14:50:00,22
2484,ORD_2485,23887,Runbugz Safe Natural Mosquito Repellent Patches for Kids|30 Patches-BOOK3,Warehouse B,497,448,2025-02-28 22:53:00,49
2485,ORD_2486,23892,"MosQuick Baby Girl's Hairbands, Soft and Elastic Bow Headband, Nylon Headband for Newborn, Infants and Toddlers, Pack of 3...",Warehouse C,398,357,2025-02-28 09:50:00,41
2486,ORD_2487,23893,Adore Baby Antibacterial Laundry Soap (Pack of 3),Warehouse C,429,414,2025-02-28 12:20:00,15
2487,ORD_2488,23875,"FUN FRY’S Bath Toys for Kids - Tortoise Combo Pack of 3 for Girls/Boys, Best Holiday/Birthday/Baby Shower Gifts for Boys/G...",Warehouse C,326,313,2025-02-28 04:17:00,13
2488,ORD_2489,23922,HIKIPO Presents 100% Cotton Born Baby Summer Wear Baby Clothes Sets For Gift,Warehouse B,160,150,2025-02-28 01:29:00,10
2489,ORD_2490,23940,BeeBaby 3 in 1 Weaning Silicone Spoon Set with Dual End Spoon for Feeding Newborn/Baby (Blue),Warehouse C,182,149,2025-02-28 11:38:00,33
2490,ORD_2491,23947,"Himalaya Baby Powder, 700g",Warehouse C,70,23,2025-02-28 07:10:00,47
2491,ORD_2492,29950,"Mamaearth Milky Soft Natural Baby Face Cream for Babies 60mL & Gentle Cleansing Baby Shampoo : New Borns, Babies and Kids...",Warehouse B,146,117,2025-02-28 11:06:00,29
2492,ORD_2493,29998,SR CREATIONS Baby Boy's Cotton Printed Half Sleeve T-Shirt and Shorts Combo (Multicolour; 12-18 Months) - Pack of 5,Warehouse B,283,276,2025-02-28 01:42:00,7
2493,ORD_2494,3977,HAPPU COLLECTION printed kids boots (brown) 2c,Warehouse A,542,495,2025-02-28 00:31:00,47
2494,ORD_2495,30008,The Root And Craft Kids Photoshoot Dress Chef New Born Baby Photography Shoot Master chef ( White) (6-12 Month),Warehouse A,304,287,2025-02-28 22:07:00,17
2495,ORD_2496,3974,"Runbugz Mosquito Repellent Patches, Anti Mosquito Patch - Yellow, 24 Patches",Warehouse B,333,296,2025-02-28 21:02:00,37
2496,ORD_2497,30013,FunBlast (Pack of 15 pcs) Baby's Plush Bathtub Bathing Squeeze Colorful Animal Bath Toys (Multicolor),Warehouse C,251,224,2025-02-28 12:49:00,27
2497,ORD_2498,4006,MINI KLUB Baby-Girls Baby and Toddler Sleepers,Warehouse A,483,444,2025-02-28 17:56:00,39
2498,ORD_2499,29967,"DROZIP Baby Nail Clippers with Light, Electric Baby Nail Trimmer, Safe Baby Nail File for Newborn to Toddler Toes and Fing...",Warehouse A,156,138,2025-02-28 23:51:00,18
2499,ORD_2500,29905,Mamaearth Anti Hair Fall Spa Range Hair Care Set: Onion Shampoo 250 ml + Onion Conditioner 250 ml + Onion Hair Oil 150 ml,Warehouse A,319,290,2025-02-28 07:44:00,29
2500,ORD_2501,4036,"Silver Bangle Bracelet for Babies, Bangle for Infant Easy to Wear and Take Off Bracelet for Toddlers Gift Exquisite for Ba...",Warehouse A,434,408,2025-02-28 18:20:00,26
2501,ORD_2502,29915,Wish Karo Baby Girl's A-Line Knee Length Dress,Warehouse C,179,155,2025-02-28 22:14:00,24
2502,ORD_2503,29921,MOMISY Baby Boy & Girls Kids Children Infant Sweater Jacket Front Button Open Cardigan,Warehouse B,45,16,2025-02-28 18:51:00,29
2503,ORD_2504,29931,Girls Clubs Unisex-Baby's Modern Shoes,Warehouse B,263,254,2025-02-28 17:02:00,9
2504,ORD_2505,29943,RC. ROYAL CLASS Born Baby Cotton Socks (Pack of 5 Pairs) (2-8 Months) Multicolour,Warehouse B,277,247,2025-02-28 23:46:00,30
2505,ORD_2506,30210,"Pear Head Chevron Baby Book Pink, 35117, one Size",Warehouse B,452,438,2025-02-28 00:19:00,14
2506,ORD_2507,3877,First Kick Baby Bath Towel New Born Hooded Soft Wrapper Cum Towel for Baby Boys and Baby Girls Pack of 1,Warehouse C,469,449,2025-02-28 02:09:00,20
2507,ORD_2508,29508,"Einstein Box Gift Set for Babies, Newborns and Infants of Age 1-3-6-9-12 Months | High Contrast Gift Set with Set of Rattl...",Warehouse B,245,231,2025-02-28 14:49:00,14
2508,ORD_2509,29467,"Hopscotch Boys Cotton Floral Print T-Shirt, Jacket and Pant Set in Navy Color",Warehouse C,342,326,2025-02-28 13:35:00,16
2509,ORD_2510,29782,"Shuban Fiberglass Mesh Mosquito Net Screen-Self-Closing with Magnet Closures Screen Heavy Duty Mesh , Keep Bugs Mosquito F...",Warehouse B,180,175,2025-02-28 22:34:00,5
2510,ORD_2511,3931,"Babique Plush Soft Toy Cute Kids Animal Home Decor Boys/Girls/Baby (10 cm, Rattle Ball)",Warehouse B,157,118,2025-02-28 10:44:00,39
2511,ORD_2512,30118,Kitty Baby Girls First Step Casual Ballerinas Kids,Warehouse C,172,165,2025-02-28 14:16:00,7
2512,ORD_2513,30121,Krystle Kid's Winter Warm Faux Fur Animal Panda Balaclava Hat Full Cover Earflap Hood Cap Neck Warmer Scarf (Red Color),Warehouse A,380,337,2025-02-28 06:06:00,43
2513,ORD_2514,30125,Nino Bambino 100% Organic Cotton Round Neck Fruit Print Short Sleeve Grey T-Shirt With Black Shorts Set For Baby Boy,Warehouse A,188,153,2025-02-28 18:50:00,35
2514,ORD_2515,3938,PEARSILK Pack of 3 Unisex Newborn Baby Booties Baby First Walking Shoes (0 to 12 Months) Booties (Toe to Heel Length - 12 ...,Warehouse B,536,487,2025-02-28 13:43:00,49
2515,ORD_2516,30126,"Dios Cotton Handbag, Office Shoulder Bag for Women's - 10x10 Inch | Blue and Grey",Warehouse B,175,130,2025-02-28 07:50:00,45
2516,ORD_2517,30138,SSKR Baby Bindi Mould - Baby Seratta - Pottu Achu - Pack of 1 with free Kumkum,Warehouse A,344,309,2025-02-28 06:13:00,35
2517,ORD_2518,3915,Hopscotch Unisex Synthetic/PU Text Print Casual Shoes in Black Color,Warehouse C,381,334,2025-02-28 20:16:00,47
2518,ORD_2519,3908,Rex Toddler/Infant Unisex PVC Soft Sole Non Slip Casual Wear Sandals/Floaters for Baby Boys and Baby Girls,Warehouse A,335,305,2025-02-28 04:53:00,30
2519,ORD_2520,30148,Mee Mee Multifunctional Unique Silicone Finger toothbrush with Soft Bristles and Carry Case for Gentle Cleaning/Oral Hygie...,Warehouse C,259,217,2025-02-28 05:21:00,42
2520,ORD_2521,3904,NOFALL Anti Skid Socks for Kids Pack of 2 Robot & Car Design Socks - Red & Light Grey,Warehouse A,79,52,2025-02-28 19:55:00,27
2521,ORD_2522,30155,Jaganath Creations Cotton T-shirt and Pant For Baby Boy/Girl I Love Dad Printed Comfortable T-shirt and Pant Set For Kids,Warehouse A,482,477,2025-02-28 09:55:00,5
2522,ORD_2523,29781,RAHAT Garments Cotton Blend Baby Girls Dungaree| Stylish Casual Wear Dungaree| Multicolor Light=(R=300),Warehouse C,415,406,2025-02-28 14:06:00,9
2523,ORD_2524,29510,Supples Baby Diaper Pants S(4-8kg) Super Jumbo Box (234 Piece) (78*Pack of 3),Warehouse C,112,85,2025-02-28 13:56:00,27
2524,ORD_2525,29516,Stripe Print Boys Party Suit Trouser & Bowtie Dress Clothing Set for Infant Toddler Boys,Warehouse B,527,486,2025-02-28 14:32:00,41
2525,ORD_2526,4239,Mothercare Baby-Boys Track Pants,Warehouse A,485,468,2025-02-28 23:56:00,17
2526,ORD_2527,4261,"LuvLap Boys Sleeveless T-Shirt & Shorts Set, For Baby, Infants & Toddlers, Multicolour, 100% Cotton, Pack Of 2 (18 to 24 m...",Warehouse B,397,391,2025-02-28 19:57:00,6
2527,ORD_2528,29471,KidDough Baby Nasal Aspirator 0-5 Years | Vacuum Suction Baby Nose Cleaner | Soft Silicone Nozzle | Manual Nose Cleaning S...,Warehouse C,410,405,2025-02-28 10:07:00,5
2528,ORD_2529,29413,Joy 'n' Me 100% Pure Cotton with Bio-Wash Skin-Friendly Allergy-Free Printed Jigs Clothing Set Suitable for New Born Baby ...,Warehouse A,173,152,2025-02-28 17:48:00,21
2529,ORD_2530,4283,"Reza Products Wise Guys Baby boy & Baby Girl Half Sleeves Stylish Dungaree Set with Tshirt (Pack of 1) (6-12 Months, Gold)",Warehouse B,434,405,2025-02-28 08:35:00,29
2530,ORD_2531,29434,"Kids Choice Baby Shoes for Girl's with Anti-Slip Sole- Party Juti, velly,",Warehouse A,281,261,2025-02-28 07:20:00,20
2531,ORD_2532,29438,"Kuchipoo Boys Regular Fit Cotton T-Shirt (KUC-TSHRT-165-12-18 Months, Multi-Colored)",Warehouse B,244,215,2025-02-28 00:14:00,29
2532,ORD_2533,29439,"LuvLap Hosiery Cotton Cloth Premium Baby Washcloth for New Born, Washable, Reusable, Absorbent, Extra Soft Face Towels/Was...",Warehouse B,50,17,2025-02-28 14:39:00,33
2533,ORD_2534,29444,"Baby Girls Knee-Length Halter Neck Dress (k babu, Off White, 0-3 Months)",Warehouse A,307,290,2025-02-28 06:05:00,17
2534,ORD_2535,29448,Black Silver Exclusive 925 Sterling Silver Adjustable Pink Enamel Kada/Bracelet For Baby Girls & Baby Boys,Warehouse B,322,274,2025-02-28 19:01:00,48
2535,ORD_2536,29451,advancedestore Baby Bracelet Crystal Bangle/Bracelet For Kids For Baby Girl's,Warehouse A,80,57,2025-02-28 10:34:00,23
2536,ORD_2537,4271,"LuvLap Instadry Anti-Piling Fleece Extra Absorbent Quick Dry Sheet for Baby, Baby Bed Protector, Waterproof Baby Sheet, Sm...",Warehouse C,218,192,2025-02-28 07:08:00,26
2537,ORD_2538,29458,"Neska Moda 6 To 12 Months Baby Boys & Baby Girls Cotton Lace Shoes/Booties (Baby Pink,Rani) -SK147andBT9",Warehouse B,490,469,2025-02-28 19:39:00,21
2538,ORD_2539,29459,LP fashion Baby girls Top & Bottom wear set || Girls clothes || Top And Shorts,Warehouse C,116,94,2025-02-28 16:08:00,22
2539,ORD_2540,29462,"Fun Ride Baby Walker 6 to 18 Months - Herby Foldable Activity Walker with Adjustable Height for Boys and Girls, 1 Qty, Gre...",Warehouse C,247,238,2025-02-28 02:06:00,9
2540,ORD_2541,30029,NewMom Seamless Caesarian Panty,Warehouse A,485,462,2025-02-28 01:57:00,23
2541,ORD_2542,30036,WorldCare® Neoprene Scuba Dive Sock Water Sport Beach Swimming Shoes for Adult Kid M (66020325JEL),Warehouse B,443,426,2025-02-28 19:26:00,17
2542,ORD_2543,30195,Himalaya Gentle Baby Shampoo (200ml) & Himalaya Gentle Daily Care Protein Conditioner | 200 ml,Warehouse B,166,126,2025-02-28 06:39:00,40
2543,ORD_2544,30256,"Johnson's Baby Wipes With Lid Combo Offer Pack 4 Plus 2 Free, 6 x 80s (480 wipes)",Warehouse B,350,303,2025-02-28 05:19:00,47
2544,ORD_2545,30267,baby wish Holi Baby Bodysuits Newborn Romper Half Sleeve Envelope Neck Cute Outfit BURA NA MAANO HAPPY HOLI,Warehouse A,393,383,2025-02-28 17:45:00,10
2545,ORD_2546,3843,"Neska Moda Baby Boys & Girls 5 Pair Cotton Dotted Ankle Socks For 3 To 5 Years (Red,Blue,Grey) -SK799",Warehouse C,199,161,2025-02-28 15:24:00,38
2546,ORD_2547,30272,Lillypupp Black Polka Dots Print Sandals with Cute Red Rose On Top for New Born Baby Girl (6-12 Months),Warehouse C,61,49,2025-02-28 22:09:00,12
2547,ORD_2548,30218,CRAZYON Baby Girls Full Sleeve Frock with Pant Set Dress 9-18 Months Combo Pack of 5 Multicolour,Warehouse C,118,108,2025-02-28 22:58:00,10
2548,ORD_2549,30215,"Bodyguard Premium Natural Anti Mosquito Repellent Patches (Green, 48 Patches)",Warehouse B,441,404,2025-02-28 10:48:00,37
2549,ORD_2550,30164,MamyPoko Pants Extra Absorb S52,Warehouse B,191,186,2025-02-28 08:47:00,5
2550,ORD_2551,30172,"PRIME DEALS Mix Cute Animals Swimming Water Toys Non-Toxic,BPA Free Colorful Soft Rubber Float Squeeze Sound Squeaky Bathi...",Warehouse B,34,17,2025-02-28 14:54:00,17
2551,ORD_2552,3888,Lappu Newborn Baby Comb & Soft Brush Set Grooming Hair Care Products for Babies & Infants Baby Brush (Blue),Warehouse C,434,396,2025-02-28 02:23:00,38
2552,ORD_2553,30178,"Sanvi Baby Dispenser Needle Feeder Medicine Dropper (Medicine Feeder Pink , Pack of 1)",Warehouse B,427,380,2025-02-28 10:18:00,47
2553,ORD_2554,30179,"Little's Easy Dry Bed Protector - Small, (Pink)",Warehouse C,461,449,2025-02-28 03:46:00,12
2554,ORD_2555,3883,QandSweet Baby Girl Knee-High Socks Toddlers Breathable Mesh Dance Sock Infant Cute Bow Sock,Warehouse C,73,38,2025-02-28 23:44:00,35
2555,ORD_2556,3882,SYGA Baby Girls Cotton Turban Wrap Headbands Hairbands Hair Accessories Soft Ball Headband Elastic Newborn Infant Toddlers...,Warehouse A,340,310,2025-02-28 14:15:00,30
2556,ORD_2557,30253,"Mamaearth Daily Moisturizing Lotion for Babies, 400ml & Deeply Nourishing wash for Babies (200 ml, 0-5 Yrs) Combo",Warehouse C,367,330,2025-02-28 15:57:00,37
2557,ORD_2558,30249,"Baby Nail Trimmer Electric Safe Baby Nail Clippers, Manicure Set, Trim Polish Grooming kit for Newborn Toddler or Adults T...",Warehouse B,240,227,2025-02-28 15:37:00,13
2558,ORD_2559,30041,SuperBottoms Dry Feel Langot - Pack of 12- Organic Cotton Padded Baby Nappy / Langot with Gentle Elastics & a SuperDryFeel...,Warehouse C,184,145,2025-02-28 21:58:00,39
2559,ORD_2560,30050,"Tiny Ideas Easy to Use Handprint Tin, Pink",Warehouse B,366,347,2025-02-28 17:33:00,19
2560,ORD_2561,30092,Hopscotch Baby Girl's Led Light Shoe,Warehouse C,101,93,2025-02-28 21:29:00,8
2561,ORD_2562,30051,"Aarushi Infants Cotton Mittens and Booties (ARSH_44, Multicolour, 3-6 Months)-Pack of 6",Warehouse A,350,321,2025-02-28 03:10:00,29
2562,ORD_2563,30062,FOOTPRINTS Organic cotton Baby Sock,Warehouse A,512,485,2025-02-28 22:51:00,27
2563,ORD_2564,3944,KidDough Furniture Safety Locks for Kids (4 Brown + 4 White Locks),Warehouse B,435,430,2025-02-28 18:16:00,5
2564,ORD_2565,30085,Little Hood Super Elastic Headband Soft Headwrap Crown for Baby Girls and Toddlers (Gold),Warehouse C,524,494,2025-02-28 15:51:00,30
2565,ORD_2566,30087,Fareto® Baby Combo Of 7 Daily Needs Items In Single Packet/ 1 Mosquito Net Bed/6 Front Open Shirts/6 Vest/4 Changing Mats/...,Warehouse A,389,358,2025-02-28 22:28:00,31
2566,ORD_2567,3959,Magic Baby Boy's & Girl's Knitted Hat & Scarf Kids Winter Set | Warm Baby Cap Beanie Pom Pom Hat & Neck Warmer Set Kids (...,Warehouse A,427,409,2025-02-28 05:22:00,18
2567,ORD_2568,3903,"3M Opticlude Orthoptic Eye Patch 5.7Cm X 8.2Cm, Box Of 20",Warehouse A,362,332,2025-02-28 08:36:00,30
2568,ORD_2569,3869,"Chicco Baby Moments Rich Cream, New Advanced Formula with Natural Ingredients for Extra Rich Moisturization, Suitable for ...",Warehouse B,137,128,2025-02-28 12:23:00,9
2569,ORD_2570,30229,Bold N Elegant Woolen Warm Pom Pom Monkey Cap Beanie Hat with Anti Flop Brim Winter Accessories for Baby Boys and Girls,Warehouse A,388,340,2025-02-28 17:30:00,48
2570,ORD_2571,30247,BLACK Kurta Pyjama For Baby,Warehouse C,337,288,2025-02-28 12:00:00,49
2571,ORD_2572,22529,"Baby Girl Hair Accessories Set Baby Head Band, Kids Rubber Band, Girls Hair Clip Pack of 55 in Combo",Warehouse B,142,127,2025-02-28 01:23:00,15
2572,ORD_2573,22600,Dermadew Baby Soap Pack Of 1(75 g),Warehouse C,312,305,2025-02-28 21:13:00,7
2573,ORD_2574,3486,Chinmay Kids Training U Shaped Toothbrush For 360 Degree Mouth-Cleaning For Kids | Soft Silicone Brush Head With Cover | E...,Warehouse B,128,119,2025-02-28 06:09:00,9
2574,ORD_2575,6700,"Orighty Baby Washcloths 24-Pack, Microfiber Coral Fleece Baby Face Towels, Soft and Absorbent Wash Cloths for Newborns, In...",Warehouse A,463,426,2025-02-28 05:47:00,37
2575,ORD_2576,25031,"Johnson's Top-to-Toe Baby Wash, 500ml",Warehouse B,357,342,2025-02-28 02:18:00,15
2576,ORD_2577,6699,"Himalaya Gentle Baby Soap (75g, Buy 3 Get 1 Free) & Himalaya Gentle Baby Shampoo (200ml)",Warehouse A,457,425,2025-02-28 21:52:00,32
2577,ORD_2578,24973,"RIANZ 4-in-1 Sling 'N Seat Tub, Convertible Newborn Baby to Toddler Bath Tub with Support and Seat",Warehouse A,157,109,2025-02-28 03:19:00,48
2578,ORD_2579,25096,"ANCHOR Ankle Length Cotton Socks for Baby Boy And Baby Girl, Pack of 5 Pairs, Multicoloured",Warehouse A,339,310,2025-02-28 06:41:00,29
2579,ORD_2580,25109,Amazon Brand - Jam & Honey Baby-Boy's Regular Romper Suits (BROMOP3-SL_Multicolor 1_6-9 Months),Warehouse C,355,342,2025-02-28 21:27:00,13
2580,ORD_2581,25168,"Himalaya Baby Summer Gift Basket (Pack of 7 with Teddy) & Himalaya Total Care Baby Pants, New Born (Count of 54)",Warehouse B,450,416,2025-02-28 03:57:00,34
2581,ORD_2582,6624,"Tiny Kids Boys and Girls Stylish Sport, Running Shoe, Outdoor Shoes for Kids Casual LED Shoe for Kids, LED Shoe Velcro for...",Warehouse A,278,258,2025-02-28 09:28:00,20
2582,ORD_2583,25191,"Rabitat Snap Lock Sipper Bottle (410ml, Yellow Sizzle)",Warehouse B,149,102,2025-02-28 15:33:00,47
2583,ORD_2584,25196,Hopscotch Unisex Synthetic/PU Graphic Print Applique Casual Shoes in Gray Color,Warehouse B,70,57,2025-02-28 05:35:00,13
2584,ORD_2585,8089,"Pampers Active Baby Taped Diapers, Small size diapers, (SM) 46 count, taped style custom fit",Warehouse B,82,43,2025-02-28 17:37:00,39
2585,ORD_2586,25197,"BOFFLE® Cotton Swing Chair for Kids Baby's Children Folding and Washable1-6 Years with Safety Belt/Home,Garden Jhula for B...",Warehouse C,511,497,2025-02-28 23:43:00,14
2586,ORD_2587,6616,CLOUDTAIL CHOICE 2 in 1 Go Potty Portable Travel Car Baby Potties Training Toilet Seat || Travel Potty Chairs Foldable Kid...,Warehouse C,274,233,2025-02-28 06:16:00,41
2587,ORD_2588,25202,"SYGA Unisex Cotton Blend Beanie Cap With Big Bow (Pack Of 1) (PrintedFlowerHat_Red&Black_Red, Black_0 Months-24 Months)",Warehouse C,33,15,2025-02-28 08:07:00,18
2588,ORD_2589,25210,ARTIFICIAL TREE Exclusive German Silver Nazariya Bracelet with Black & Silver Beads (Crystal) for Baby Boys & Girls (AT KI...,Warehouse A,148,135,2025-02-28 08:12:00,13
2589,ORD_2590,25211,Dabur Baby Wash: pH 5.5 balanced | No Harmful Chemicals & Tear Free Formula | With Ayurvedic herbs | Hypoallergenic & Derm...,Warehouse B,211,188,2025-02-28 03:54:00,23
2590,ORD_2591,6596,"TEC TAVAKKAL 3 year And Above Kids Toothbrush, Extra Soft Lovely Little Panda Toothbrush for Kids, BPA Free, Boys and Girl...",Warehouse B,196,153,2025-02-28 07:57:00,43
2591,ORD_2592,25224,Mothercare Cotton Infant Unisex Joggers,Warehouse A,95,49,2025-02-28 11:51:00,46
2592,ORD_2593,6710,"Annapurna sales Pure Soft Cotton New Born Babies Panties Set Combo Pack of 6 pcs, White, Peach, Green, Blue, Size 6-9 Mont...",Warehouse B,165,124,2025-02-28 03:46:00,41
2593,ORD_2594,25011,Runbugz Safe Natural Mosquito Repellent Patches for Kids|30 Patches-YELK3,Warehouse C,222,173,2025-02-28 23:46:00,49
2594,ORD_2595,6684,U.S. POLO ASSN. baby-boys Jacket,Warehouse B,96,87,2025-02-28 15:30:00,9
2595,ORD_2596,25074,HIKUJ Kid Infant Baby Girl Winter Outfit Knitted Sweater Long Sleeve Top A-Line Skirt Fashion Clothes Set Streetwear,Warehouse C,60,21,2025-02-28 21:08:00,39
2596,ORD_2597,25084,Lillypupp New Born Baby Shoes- Socks - for Boy Girl. Infant Booties for Toddler. Size (3-12 Months) Blue,Warehouse A,221,183,2025-02-28 00:26:00,38
2597,ORD_2598,25090,"Deoxys Baby Play Mat -Extra Large 77""x70""- Anti-Slip & Waterproof - Foldable Play Mat for Baby (0-3+), Double Sided, 2 Des...",Warehouse B,229,180,2025-02-28 17:40:00,49
2598,ORD_2599,6694,SYGA Pack of 5 Baby Girl Headband Nylon Flower Soft Chiffon Flower Bow Stretchy Hairband for Newborn Toddler Girl-Beige Ye...,Warehouse A,295,273,2025-02-28 08:17:00,22
2599,ORD_2600,25039,"Huggies New Dry Medium (M) Size Diapers for Babies(5-12 Kg),Combo Pack of 2,60 Counts Per Pack (120 Counts)",Warehouse C,280,248,2025-02-28 04:12:00,32
2600,ORD_2601,6733,Himalaya Baby Powder (400g) (Pack of 2),Warehouse C,47,18,2025-02-28 08:43:00,29
2601,ORD_2602,24999,"YOUSTYLO - YOU ARE PRIORITY Baby Nail Clippers, 4-in-1 Safe Baby Nail Kit with, Nail Clipper, Scissors, Scissor Safety Cas...",Warehouse A,529,482,2025-02-28 02:03:00,47
2602,ORD_2603,6719,"SILENCIO Baby Healthcare and Grooming Kit With Care Bag, 19 in 1 Baby Electric Nail Trimmer Set Newborn Nursery Health Car...",Warehouse B,277,242,2025-02-28 11:35:00,35
2603,ORD_2604,25007,KNITROOT Chachu Bua Special Unisex Baby Romper Half Sleeve Envelope Neck I Get My Awesomeness From My Bua,Warehouse C,144,125,2025-02-28 07:14:00,19
2604,ORD_2605,25009,"Aquaphor Baby Diaper Rash Cream, 3.5 Ounce, (Pack of 3)",Warehouse C,217,190,2025-02-28 06:16:00,27
2605,ORD_2606,25098,"Colgate Barbie Toothbrush for kids, Battery Powered Electric Toothbrush, Age 3+, Kids toothbrush with Extra Soft Bristles ...",Warehouse B,35,28,2025-02-28 00:23:00,7
2606,ORD_2607,24749,"Mamaearth Natural Anti Mosquito Body Roll On, 40ml & Deeply Nourishing wash for Babies (200 ml, 0-5 Yrs) Combo",Warehouse C,475,442,2025-02-28 17:47:00,33
2607,ORD_2608,24754,"Luv Lap Baby Powder Storage Container with Soft Acrylic Puff, Bpa Free, (Blue,Pack of 1)",Warehouse A,180,159,2025-02-28 13:14:00,21
2608,ORD_2609,24763,"Budds buddy Tom Shaped Kids Tooth Brush BB3014, (Yellow&Blue)",Warehouse C,501,471,2025-02-28 00:12:00,30
2609,ORD_2610,24768,"I Moist Baby Soap For Skin Nourishing with natural ingredients, 75 Gm (Pack of 4)",Warehouse A,74,48,2025-02-28 07:04:00,26
2610,ORD_2611,24775,jivo Vidyanjali®Kids Traditional Ethnic Festival Wear Dhoti Kurta Set for Baby Boys (Maroon gold),Warehouse C,479,457,2025-02-28 14:36:00,22
2611,ORD_2612,24789,"Babuline Baby Care Kit | Baby Soap, Baby Powder, Baby Lotion, Baby Massage Oil & Babziox Cream | Baby First Gift Combo Set...",Warehouse C,237,202,2025-02-28 14:28:00,35
2612,ORD_2613,6849,Salvus APP SOLUTIONS Gold Kada for Boy and Girls (0-5 Years) - Set of 2,Warehouse B,457,409,2025-02-28 17:15:00,48
2613,ORD_2614,6848,Modicare Baby SPA No-Tears Shampoo + Moisturising Lotion with Vitamin E -200ml each (Combo Pack),Warehouse A,414,385,2025-02-28 09:09:00,29
2614,ORD_2615,24713,Metanium Nappy Rash oitment Cream 30g,Warehouse B,314,302,2025-02-28 16:53:00,12
2615,ORD_2616,6918,ALL KIDSS CHOICE Printed Cotton Half Sleeve T-shirt & Shorts combo set | Boys & Unisex Co-Ordinate Dress set (Red-Black),Warehouse B,330,285,2025-02-28 21:01:00,45
2616,ORD_2617,6917,Buddsbuddy BPA Free XOXO Safety Nail Clipper for New Born Baby with Rounded Design (Pink),Warehouse A,50,42,2025-02-28 22:54:00,8
2617,ORD_2618,24659,My NewBorn Puppy Shape Baby Bath Robe Cum Ultra Soft Wrapper (Green),Warehouse B,500,465,2025-02-28 03:41:00,35
2618,ORD_2619,24666,SYGA Newborn Infant Baby Girls Soft Velvet Headbands Hairbands Hair Accessories Bow Headband Toddlers Kids 0-2 Years (Golden),Warehouse A,237,193,2025-02-28 14:03:00,44
2619,ORD_2620,24750,Hopscotch Boys PU and Fabric Casual Slip Ons in Red Color,Warehouse A,209,181,2025-02-28 06:34:00,28
2620,ORD_2621,25151,"BabyChakra 100% Natural Foaming Handwash for Infants & Kids, 99.9% Germ Protection & Baby-Safe Certified, Goodness of Tuls...",Warehouse B,299,253,2025-02-28 11:03:00,46
2621,ORD_2622,6662,"Baby Needs New Born Baby Gift Set for Baby Boy and Girl -13 Pieces, Yellow",Warehouse C,174,138,2025-02-28 10:32:00,36
2622,ORD_2623,25127,socho samjo Baby Girl's Frock Dress,Warehouse A,235,222,2025-02-28 20:34:00,13
2623,ORD_2624,25128,Modern Kids Caps for Winter Soft 100% Woolen Caps for Baby Boys & Baby Girls (Products for New Born Baby) Pack of 4,Warehouse A,152,130,2025-02-28 07:17:00,22
2624,ORD_2625,25131,1 to 2 Years Baby Head Support Pillows Safe for Baby Kid,Warehouse B,259,240,2025-02-28 18:52:00,19
2625,ORD_2626,25158,CUSTOMARY 5 Layers Bamboo Charcoal Baby Diaper Insert Pad Reusable And Washable For Cloths Diaper Set (Pack of 5),Warehouse A,173,164,2025-02-28 02:52:00,9
2626,ORD_2627,6655,KIDZHEART Multicolour Cute Stylish New Born Baby Infant Kids Accessories Winter Soft Cap with Fur Inside Set of 3 (1-2 Years),Warehouse A,150,131,2025-02-28 06:59:00,19
2627,ORD_2628,6651,"LUCKY CHOICE 925 Sterling Silver Black and Silver Beads Kids Bangles For Baby, WT : 21 GM Approx.",Warehouse C,395,367,2025-02-28 08:16:00,28
2628,ORD_2629,25147,Brand Conquer 3D Duck Cartoon Character Printed Little Cap for Kids and Baby Girls 3-12 Years Multicolour,Warehouse B,257,223,2025-02-28 09:31:00,34
2629,ORD_2630,25148,JUBINATION Cap Unisex Kids Boy Girl Toddler Woollen Hat Winter Knitted Cap Pack of One Age 6 to 18 Month Multicolour,Warehouse B,48,21,2025-02-28 18:46:00,27
2630,ORD_2631,25149,"FunBlast Kids Toothbrush – Cute Microfiber Soft Tooth Brush, Extra Soft Bristles Toothbrush for 3-6 Years old Children, Ma...",Warehouse B,201,189,2025-02-28 12:58:00,12
2631,ORD_2632,25137,Aashiya Trades Unisex Cotton Cap (j01_Pink_0 Months-18 Months),Warehouse C,406,380,2025-02-28 01:13:00,26
2632,ORD_2633,24969,HOMECUTE Umbrella Type Embroidered Polyester Baby Mosquito Net (Multicolour),Warehouse C,457,435,2025-02-28 20:39:00,22
2633,ORD_2634,6688,MOTT2 Unisex Baby Baby Bodysuit,Warehouse A,468,442,2025-02-28 21:15:00,26
2634,ORD_2635,25055,Munchkin 7oz Miracle 360° Trainer Sippy Cup - Green (Pack of 1),Warehouse B,195,153,2025-02-28 00:02:00,42
2635,ORD_2636,26415,Baby Bucket Baby Diaper Nappy Changing Baby Diaper Bag Mummy Bag Handbag-(Pack of 4 – Navy Blue),Warehouse A,67,57,2025-02-28 04:28:00,10
2636,ORD_2637,26440,Athom Living Disney Kids Bath Towel 350 GSM Pack of 2,Warehouse C,64,53,2025-02-28 06:50:00,11
2637,ORD_2638,5922,MURLI Romper Baby Suit Dungaree Jumpsuit Outfits for Newborn Baby Boys & Girls,Warehouse C,293,283,2025-02-28 08:53:00,10
2638,ORD_2639,26455,Johnson's Baby Body Lotion (200ml),Warehouse A,314,297,2025-02-28 13:20:00,17
2639,ORD_2640,26456,Sahiba Gems Exclusive Adjustable Nazariya Silver/Chandi Baby Nazariya Kada Bangle with Silver Ghungroo & Black Beads for B...,Warehouse C,110,80,2025-02-28 15:46:00,30
2640,ORD_2641,5926,"Cocoon Care Bamboo Fabric Face Towel/Washcloth Premium Absorbent for Newborn Baby,Toddler- Washable, reuasable, Extra Sof...",Warehouse B,502,474,2025-02-28 22:33:00,28
2641,ORD_2642,26474,Hopscotch Boys and Girls Synthetic Graphic Print Slip Ons in Black Color,Warehouse A,432,402,2025-02-28 04:26:00,30
2642,ORD_2643,26410,"M Cart DIY Building Blocks for Kids Building Blocks Toy for Kids Puzzle Games for Kids, Toys for Children Educational & Le...",Warehouse A,407,381,2025-02-28 18:11:00,26
2643,ORD_2644,26407,"Oral B Vitality Electric Rechargeable Toothbrush, Couple Pack, Gifting Pack with 2 brushes and 1 charger",Warehouse B,278,237,2025-02-28 18:52:00,41
2644,ORD_2645,26354,MINI KLUB baby-boys Dungaree Set,Warehouse B,245,208,2025-02-28 12:32:00,37
2645,ORD_2646,26372,"SILENCIO Baby Grooming Kit, 10Pcs Newborn Baby, Toddler, Kids Care Accessories, Portable Nursery Infants Care Kit with Sci...",Warehouse B,216,196,2025-02-28 20:07:00,20
2646,ORD_2647,26408,"SNOWIE SOFT® Sleeved Bib Baby Bib with Pocket, Toddler Bib, Smock, Waterproof Fabric, Fits Bibs for Baby Girls 6 to 24 Mon...",Warehouse C,522,486,2025-02-28 16:53:00,36
2647,ORD_2648,26380,Flaner International's Lace Walking Shoes for Boys,Warehouse B,425,415,2025-02-28 13:06:00,10
2648,ORD_2649,26432,VGRASSP Unicorn Family Baby Spoon and Fork Cutlery for Babies and Kids - Stainless Steel (304) Tableware Set with Comforta...,Warehouse B,527,499,2025-02-28 22:55:00,28
2649,ORD_2650,26426,Baby Moo Fun in The Ocean Blue Bather Blue 0-12M,Warehouse A,387,372,2025-02-28 05:06:00,15
2650,ORD_2651,26782,PINK WINGS Baby Girl Knee Length Birthday Dress,Warehouse B,355,350,2025-02-28 07:34:00,5
2651,ORD_2652,26785,Sahiba Gems Exclusive Nazariya Silver Baby Bracelet Kada Bangle Nazariya with Silver Beads for Babies,Warehouse A,319,287,2025-02-28 19:56:00,32
2652,ORD_2653,5730,"Luvlap Anti-Colic Essential Teat/Nipple for Slim Neck Bottle, 4pcs, Fast Flow, 6m+",Warehouse B,90,62,2025-02-28 02:40:00,28
2653,ORD_2654,26857,El Regalo Cute Evil Eye Nazaria Rakhi Box for Babies/ Toddler/ Kids/ Girls & Boys | Glass Faceted Beads Evil Eye Nazaria R...,Warehouse A,342,312,2025-02-28 11:22:00,30
2654,ORD_2655,26814,Grab Classy Safe Inkless 6-12 Months Baby Handprint and Baby Footprint Ink Pad with Imprint Cards 100% Non-Toxic & Mess Fr...,Warehouse B,48,22,2025-02-28 14:20:00,26
2655,ORD_2656,26826,SMARTOTS Kids Unisex Child Casual Laces Sports Walking Sneaker Shoes for Baby Boys/Girls SMT-BLADE-13,Warehouse B,463,433,2025-02-28 19:17:00,30
2656,ORD_2657,5711,"Little's Comfy Baby Pants - Premium, 12 Hours Absorption, Wetness Indicator, Cotton Soft, Large,White, 62 Count",Warehouse C,416,388,2025-02-28 12:20:00,28
2657,ORD_2658,26830,Frodo Handmade Baby Headbands Stretchy Nylon Headband with Elastics Bows for Newborns Toddler Infants Kids and Children,Warehouse A,364,353,2025-02-28 09:17:00,11
2658,ORD_2659,26836,Little Charlie Baby's Taylor Soft Sole Shoes,Warehouse C,360,333,2025-02-28 12:57:00,27
2659,ORD_2660,26620,GOCHIKKO Cotton Nursing Cover | Feeding Shawl | for Women & Mothers (Grey),Warehouse A,437,411,2025-02-28 02:44:00,26
2660,ORD_2661,26617,JOGGLER Baby Boy's and Baby Girl's Canvas Shoes with Anti-Slip Sole First Walking Shoes Kid's Fancy Winter Infant Bootie B...,Warehouse B,363,343,2025-02-28 22:30:00,20
2661,ORD_2662,26417,Johnson's Baby Powder 600g + Johnson's Baby Oil with Vitamin E 500ml,Warehouse C,356,314,2025-02-28 15:31:00,42
2662,ORD_2663,5955,FAYBY Baby Toddler Sock Shoes with Rubber Sole | Non-Skid Indoor Slipper Infant First Walking Floor Soft Sole Cotton Mesh ...,Warehouse A,220,183,2025-02-28 17:48:00,37
2663,ORD_2664,26392,Pigeon Natural Botanical Baby Water Gel 200ml,Warehouse B,426,406,2025-02-28 21:45:00,20
2664,ORD_2665,6693,MINITATU Pink.White Half Sleeves Unisex Baby T-Shirt & Pajamas Set Pack of 2 Age - 18-24 Months (Peb404550),Warehouse C,343,328,2025-02-28 06:53:00,15
2665,ORD_2666,26487,"Neska Moda 0 To 6 Months Baby Boys & Baby Girls Pack Of 2 Pair Cotton Rabbit & Butterfly Booties (Rani Pink,Baby Pink) -BT...",Warehouse A,460,428,2025-02-28 04:29:00,32
2666,ORD_2667,26495,JwlDazz Smiley Charm Bracelet for Children Teenagers for 10-16 years young,Warehouse B,318,301,2025-02-28 12:53:00,17
2667,ORD_2668,26502,Sahiba Gems Exclusive 925 Sterling Silver Nazariya / Nazar Bracelet for Baby Boy/Girls with Black Beads (Crystal) and 3 Si...,Warehouse B,411,402,2025-02-28 03:00:00,9
2668,ORD_2669,5891,ORIGINAL MART New Arriving Baby Swim Aid Floats Neck Collar Inflatable Tube Ring Cute Mini Swimming Ring for Babies,Warehouse C,117,106,2025-02-28 13:12:00,11
2669,ORD_2670,26509,"baby wish Organic Washcloths for Face Hand Washcloth Towels for Newborn, Super Hero Printed Washcloth Face Towels Burp Clo...",Warehouse A,67,19,2025-02-28 23:49:00,48
2670,ORD_2671,5890,SYGA Baby Winter Products Children's Warm Knit Cap Baby Stripe Woolen Knotted Hat Turban Hat,Warehouse B,363,325,2025-02-28 10:07:00,38
2671,ORD_2672,26515,6 piece Baby Girl Headbands Sparkly Glitter Sequins Hair Bows Ribbon Soft Stretchy Hair Bands for Infant Newborn and Toddlers,Warehouse A,302,286,2025-02-28 07:32:00,16
2672,ORD_2673,26518,"Besties Cotton Toddlers Training Seat Baby Safety Sofa Dining Chair/Learn to Sit Stool, 3-12 Months (Car Shape Sofa Blue)",Warehouse A,479,467,2025-02-28 13:38:00,12
2673,ORD_2674,5884,DARSHRAJ JEWELLERS Traditional 92.5 Pure Chandi Sterling Silver Nazariya For New Born Baby boy and Girls -1 Pair| (5.29gms),Warehouse A,127,120,2025-02-28 03:11:00,7
2674,ORD_2675,26523,TuddyBuddy 100% Soft Cotton Birthday Wear Knitted Dress for Baby Girl,Warehouse B,214,185,2025-02-28 01:09:00,29
2675,ORD_2676,26526,Ashtavinayak Silicone Tooth Brush Head 360 Degree Cleansing U Shaped Toothbrush for 2-5 years kid (pink),Warehouse A,33,20,2025-02-28 15:41:00,13
2676,ORD_2677,26529,"Himalaya Diaper Rash Cream,100gm & Himalaya Gentle Baby Soap (4N*75g) & Himalaya Baby Hair Oil 200 ml(1 Count)",Warehouse A,156,146,2025-02-28 20:47:00,10
2677,ORD_2678,5877,Baby Hair Brush for Newborns & Toddlers | Natural Soft Goat Bristles | Ideal for Cradle Cap | Perfect Baby Registry Gift (...,Warehouse A,288,267,2025-02-28 20:33:00,21
2678,ORD_2679,26537,R for Rabbit Hiltop Step Stool Potty-Trainer Seat Ladder Step Up Training Stool Non-Slip Steps Ladder Adjustable Foldable ...,Warehouse C,147,130,2025-02-28 14:15:00,17
2679,ORD_2680,26345,Hopop Baby Medicine Spoon & Dropper (Green),Warehouse C,422,404,2025-02-28 18:08:00,18
2680,ORD_2681,24636,Bold N Elegant Full Sleeve Layered Tshirt and Pyjama Jeans Pant Clothing Set for Infant Toddler Baby Boys n Girls,Warehouse A,265,251,2025-02-28 06:27:00,14
2681,ORD_2682,6270,KID'S CARE By Welfit Regular Fit Baby Boys Baby Girls High Neck Full Sleeves T-Shirt(KCHNYEL),Warehouse C,266,238,2025-02-28 18:31:00,28
2682,ORD_2683,25049,baby wish Newborn gifted to Baby Bodysuits Newborn baby Romper Half Sleeve Envelope Neck Cute Outfit Princess Has Arrived,Warehouse B,221,216,2025-02-28 21:35:00,5
2683,ORD_2684,25050,New Vastra Lok Multi Color Woolen Socks 3 Pair for 4-5 Year for Boy's & Girl's,Warehouse A,208,192,2025-02-28 10:25:00,16
2684,ORD_2685,5947,"Febrina New Born Baby Nail Care, Healthcare, Grooming, Baby Care Gifting Set of 6 (Blue)",Warehouse A,368,342,2025-02-28 19:17:00,26
2685,ORD_2686,26573,"Infantbond New Born Baby Clothing Set,Multicolor (Pack of 30)(0-3 Months)",Warehouse B,384,366,2025-02-28 06:07:00,18
2686,ORD_2687,26399,"BLOOMBUDDY Organic Growth Booster Fertilizer Manure for plants (1 KG, Granules), Pack of 1",Warehouse C,495,449,2025-02-28 10:10:00,46
2687,ORD_2688,26483,Farlin Baby Cloth Softener-600 ML,Warehouse A,342,312,2025-02-28 14:11:00,30
2688,ORD_2689,5862,"Anup Torda Tongue Cleaner for Kids Baby Antimicrobial cleaner, Antibacterial scrapper for Optimal Oral Hygiene (Pack of ...",Warehouse B,326,299,2025-02-28 16:13:00,27
2689,ORD_2690,26558,Johnson's Baby Soap Mild & Gentle Cleanse 125ml (Pack Of 3),Warehouse C,503,457,2025-02-28 08:36:00,46
2690,ORD_2691,5857,"Neska Moda 0 To 6 Months Baby Boys & Baby Girls Cotton Rabbit Booties (Orange,Blue) -BT378andBT371",Warehouse B,81,38,2025-02-28 09:52:00,43
2691,ORD_2692,26551,"Jordan Step 2 Kids Toothbrush, 3-5 Years, Soft Bristles, BPA Free (Pack of 2, 3-5 Years - Pink + Yellow)",Warehouse B,303,255,2025-02-28 12:02:00,48
2692,ORD_2693,26574,Baby Moo Cute Puppy Checked Chu-Chu Sound Breathable Anti-Skid Sandals - Blue (12-18M),Warehouse C,446,423,2025-02-28 15:11:00,23
2693,ORD_2694,26582,"Sunuo Washable Reusable Multicolour Hosiery Cotton Diapers,Nappy,Langot for New Born Baby (0-6 Months,Pack of 10)",Warehouse C,251,237,2025-02-28 11:07:00,14
2694,ORD_2695,5846,Baby Forest Narial Tailam- Organic Cold Pressed Coconut Oil| 100% Natural| For Babies| Skin and Hair Care| 200 ml | Pack Of 1,Warehouse A,59,47,2025-02-28 22:06:00,12
2695,ORD_2696,24677,MOMMAS BABY India Premature Baby Cap+Booty+Mittens Set (White) MB1102 (1 Set),Warehouse C,402,390,2025-02-28 01:11:00,12
2696,ORD_2697,6540,SHOP FRENZY kids unisex 3d face anti skid booties for baby boy and girl (0-6 months),Warehouse C,310,281,2025-02-28 04:23:00,29
2697,ORD_2698,6546,CHIU Soft Sole Shoes for 6-12 Month's Baby Girl and Baby Boys,Warehouse A,375,339,2025-02-28 19:04:00,36
2698,ORD_2699,6520,"Nestle CERELAC Baby Cereal with Milk, Wheat - From 6 Months - Bag-In-Box Pack, 300g",Warehouse B,424,406,2025-02-28 11:21:00,18
2699,ORD_2700,25347,KidDough Baby Proofing Extra Thick Safety Soft Cushion Edge Corner Protector Guard for Kids Safety - 10 pcs (Pre-Taped) (B...,Warehouse A,375,366,2025-02-28 21:35:00,9
2700,ORD_2701,6516,Hopscotch Girls Cotton Fruit Print Sleeveless Casual Dress in Pink Color,Warehouse C,188,145,2025-02-28 07:37:00,43
2701,ORD_2702,6511,BHAVANI FAB Baby Boys Party Ware Cotton 3 Piece Baba Suit Set Multi Color Multiple Size.,Warehouse C,115,105,2025-02-28 22:50:00,10
2702,ORD_2703,6510,"GOLURK Cotton Baby Pajama Pants/Track Pants, Daily use Lower Pant for Kids boy and Girls Unisex(Pack of 6)",Warehouse A,203,184,2025-02-28 15:53:00,19
2703,ORD_2704,6502,TotzTouch Baby Girl's Cotton Floral Pajama Pack of 5,Warehouse C,303,286,2025-02-28 18:56:00,17
2704,ORD_2705,25338,Crawl'in Boy's and Girl's Print Reusable Waterproof Panty with Soft Lining Inside Absorbable Plastic Outside (Multicolour;...,Warehouse A,134,124,2025-02-28 06:34:00,10
2705,ORD_2706,25254,"EMMY GARMENTS Girl's Kids Polyester Knee Length Casual, Frock Dress with Elegant Design",Warehouse B,154,125,2025-02-28 19:05:00,29
2706,ORD_2707,25256,"The Moms Co. Virgin Coconut Natural 10-in-1 Baby Hair Oil, 200 ml & Natural Baby Lotion(200ml) & Talc-Free Natural Baby Po...",Warehouse A,252,226,2025-02-28 06:31:00,26
2707,ORD_2708,25259,Superbottoms BASIC EASY - Pack of 8 |4 Cloth Diapers+ 4 Inserts - Freesize Adjustable & Reusable Cloth Diaper for babies ...,Warehouse C,374,339,2025-02-28 04:01:00,35
2708,ORD_2709,25263,OSG Presents Pure Silver Nazar Chaku Pendants Nazariya for New Born Babies Kids Pure Cotton Thread for Protection,Warehouse A,216,209,2025-02-28 06:44:00,7
2709,ORD_2710,6573,Aveeno Baby Daily Moisturizing Lotion18 oz.,Warehouse B,408,374,2025-02-28 10:45:00,34
2710,ORD_2711,25319,"TinyLane - Curated for you! 100% Cotton Super Soft Baby Vests, Pack of 5 Jhablas, 4-6 Months, Multi Color",Warehouse C,517,493,2025-02-28 04:15:00,24
2711,ORD_2712,25274,Mini Klub Boys Orange Stripes T-Shirt Pack of 1,Warehouse B,251,208,2025-02-28 01:06:00,43
2712,ORD_2713,25510,"Luv Lap Silicone Ball Teether, Super Soft Silicone Teething Toy, Soothing Teether for Babies & Toddlers, Easy-to-Hold, Soo...",Warehouse C,54,12,2025-02-28 11:28:00,42
2713,ORD_2714,6284,ADITYA Heavy Duty Sailboats Flip Up Folding Cleat Mount Marine Line Rope Mooring K,Warehouse B,355,328,2025-02-28 17:20:00,27
2714,ORD_2715,6304,HOLA Cosmetics Nappi cream for babies | Diaper Rash Prevention Cream | Baby Sensitive Skin Rashes Cream| Rash Natural trea...,Warehouse B,460,426,2025-02-28 19:10:00,34
2715,ORD_2716,25681,SOFSKIN (American Brand) Baby Oil (Perfumed) 350ML and Baby Powder (Perfumed) 675GM Combo,Warehouse B,173,130,2025-02-28 14:07:00,43
2716,ORD_2717,25687,BODYCARE Girls' Cotton Bloomers (Pack of 6),Warehouse A,381,334,2025-02-28 04:38:00,47
2717,ORD_2718,25690,ByGrandma Homemade Herbal Baby Bath Powder Full Body Wash for Babies | Smooth Skin for Baby | Natural Body Wash for Baby |...,Warehouse C,443,406,2025-02-28 20:13:00,37
2718,ORD_2719,25691,ZORKH - Fashion on you Baby Boy Baba Suit Cotton T-shirt And Denim Capri Set (Pack of 2),Warehouse C,336,294,2025-02-28 06:32:00,42
2719,ORD_2720,25700,"Infantbond Baby Boy's and Girl's Sleeveless T-Shirt and Short 100% Cotton Clothing Set (2-3 Years, Giraffe Set)",Warehouse B,368,341,2025-02-28 07:45:00,27
2720,ORD_2721,25701,Full Sleeves Floral Print Dress with Bloomer,Warehouse C,415,396,2025-02-28 07:36:00,19
2721,ORD_2722,25707,Little Surprise Box - Blue Joy Newborn Hamper Gift Set…,Warehouse A,287,273,2025-02-28 03:33:00,14
2722,ORD_2723,6302,Boniry pop it Fidget Toys Toy Set Rainbow poppit Push 100 Bubble for Kids Stress Relief Adults Anxiety Simple Popper Shape...,Warehouse A,489,464,2025-02-28 05:24:00,25
2723,ORD_2724,6324,"Toddylon New Born Baby Gifts Combo Daily Essential Products All (Multicolor, 0-6 Months)",Warehouse C,190,154,2025-02-28 09:59:00,36
2724,ORD_2725,6323,Hopscotch Unisex EVA All-Over Print Infant Booties in Black Color,Warehouse A,165,142,2025-02-28 17:49:00,23
2725,ORD_2726,6312,"Baby Hand Nazariya, Exclusive 925 Sterling Silver Evil Eye Nazariya Bracelet Set with Black & Silver Beads for Baby Boys &...",Warehouse C,395,378,2025-02-28 22:30:00,17
2726,ORD_2727,25753,"FabSeasons Kids Winter Skull Cap for Boys & Girls (3-8 Years), Covers Entire Ears for Better Protection from Cold",Warehouse C,327,304,2025-02-28 03:44:00,23
2727,ORD_2728,6327,"Philips Avent Ultra Air Pacifier for Girl, 6-18 Months, Pink Fashion Decos, 2 Pack, SCF343/22",Warehouse C,80,38,2025-02-28 18:18:00,42
2728,ORD_2729,25516,"Mamaearth Mineral Based Sunscreen (100 ml) änd Anti Mosquito Fabric Roll On, 8ml",Warehouse A,369,331,2025-02-28 12:37:00,38
2729,ORD_2730,25308,"JBG HOME STORE Soft Printed Baby Bath Towel 100% Heavy Microfiber Towel for New Born Baby | Kids | Small Child, Toddlers |...",Warehouse B,30,23,2025-02-28 01:54:00,7
2730,ORD_2731,25804,Ylllu Kids LED USB Charging Roller Skate Shoes with Wheel Light up Roller Shoes Rechargeable Roller Sneakers for Girls Boy...,Warehouse B,293,278,2025-02-28 09:56:00,15
2731,ORD_2732,6426,Baby Boys and Girls Unisex Winter Wear Cartoon Print Sweat Dress for New Born Baby Sweatshirt & Pyajama Pant Clothes Babie...,Warehouse C,120,105,2025-02-28 11:05:00,15
2732,ORD_2733,25451,SSRK Kids Girls Dress (Yellow| 6-9 months),Warehouse A,244,209,2025-02-28 02:12:00,35
2733,ORD_2734,6490,Mee Mee Caring Baby Wet Wipes with Aloe Vera (72 pcs) (Pack of 12),Warehouse C,418,413,2025-02-28 00:16:00,5
2734,ORD_2735,25383,Teri Beri Nappy Changing Mat/Water Proof Bed Protector with Foam Cushioned (0-3 Months) and Baby Bath towel / 100% Cotton ...,Warehouse C,341,310,2025-02-28 23:30:00,31
2735,ORD_2736,25384,Hopscotch Boys Cotton Text Print T-Shirt and Shorts Set in Blue Colour,Warehouse B,51,39,2025-02-28 12:23:00,12
2736,ORD_2737,25386,"HOTFIX® Kids U-Shaped Toothbrush, Manual Training Tooth Brush, Food Grade Soft Silicone Brush Head, 360° Oral Teeth Cleani...",Warehouse C,46,23,2025-02-28 10:38:00,23
2737,ORD_2738,25390,"Little Laughs New Born Baby Boy's & Baby Girls Open Jhabla | Sleeveless Jhabla Set for Born Babies (Pack of 3, Multicolore...",Warehouse A,505,499,2025-02-28 13:37:00,6
2738,ORD_2739,6483,Saumabhi Infant and Toddler Cartoon Bear Floral Waffle Round Neck Top,Warehouse A,118,106,2025-02-28 19:42:00,12
2739,ORD_2740,25398,Baba Baby Boy's & Baby Girl's Cotton Hooded Hoodie,Warehouse A,505,486,2025-02-28 15:26:00,19
2740,ORD_2741,25421,Splash About Designer Baby Girls Swim and Beach Shoes,Warehouse B,133,122,2025-02-28 01:42:00,11
2741,ORD_2742,25428,JZIKI Medical Non-Contact Infrared Forehead Digital Gun Thermometer with LED Display for Adults Baby and Infants,Warehouse B,527,495,2025-02-28 23:12:00,32
2742,ORD_2743,6453,"Toddylon Baby Gift Combo of Bedding and New Born Clothes (0-6 Months, Multicolour)",Warehouse B,243,222,2025-02-28 01:39:00,21
2743,ORD_2744,25438,"MY BABY TOWN Baby Multi-Color Long Sleeve Cotton Sleep Suit Romper for Boys and Girls Set of 3 (9-12 Months, Multi)",Warehouse A,307,258,2025-02-28 20:26:00,49
2744,ORD_2745,25244,"Dox Box Baby boy Monthly Milestone Cards, Months Growth Milestones Cards, Baby Shower Gift Scrapbook Photo Keepsake Monthl...",Warehouse C,472,460,2025-02-28 18:14:00,12
2745,ORD_2746,25501,"Kanisha eCrafts 24 Carat Gold Plated Ashtdhatu Adjustable kada Bracelet Nazariya for Kids, Kids Jewellery Pair (1-4 Year O...",Warehouse B,336,319,2025-02-28 16:49:00,17
2746,ORD_2747,25275,FUNMORE™ Soft Cotton Fabric Single Layer Newborn Baby Bonnets Caps/Hats for New Born Baby/Babies Caps Daily Essential Top...,Warehouse A,291,242,2025-02-28 09:39:00,49
2747,ORD_2748,6562,Himalaya Gift Pack & Himalaya Baby Lotion (400ml),Warehouse C,414,378,2025-02-28 09:20:00,36
2748,ORD_2749,6550,VIETNAM Baby Nail kit Kids Set New Born Trimmer Products Machine Electric Care Tool Safety Babies File Manicure Kid Infant...,Warehouse B,136,102,2025-02-28 09:24:00,34
2749,ORD_2750,6549,VARTI AYUSH Tested Cold pressed Magic Baby Massage Oil – 100% Chemical free & non sticky – Contains Benefits of Coconut Oi...,Warehouse C,162,131,2025-02-28 00:25:00,31
2750,ORD_2751,6494,Max Boys Typographic Print Crew Neck T-Shirt,Warehouse C,206,198,2025-02-28 00:37:00,8
2751,ORD_2752,25453,QUICK DRY Microfiber Bath Towel (Pink),Warehouse A,341,323,2025-02-28 12:47:00,18
2752,ORD_2753,25463,Fisher-Price Plastic Stacking Cups ( Multicolor ) (3 pieces),Warehouse B,254,219,2025-02-28 15:33:00,35
2753,ORD_2754,25471,"EPISKEY® Baby Knee & Elbow Guard/pad for Crawling, Toddlers, Infant, Girl, Boys, Safety Protector Comfortable Cap for Leg ...",Warehouse C,488,460,2025-02-28 16:04:00,28
2754,ORD_2755,6431,Portable Baby Toddler Nasal Aspirator Vacuum Sucker Soft Tip Cleaner Nose Mucus Cleaner Snot Sucker Pump (75 ML),Warehouse B,285,255,2025-02-28 05:39:00,30
2755,ORD_2756,25479,"SSRK Kids Girls Dress (Green, 6-12 Months)",Warehouse C,174,163,2025-02-28 06:49:00,11
2756,ORD_2757,25809,B4brain Traditional Wooden Walker for Babies 8 Month-2 Year,Warehouse A,372,351,2025-02-28 13:20:00,21
2757,ORD_2758,24682,Miarcus Cotton Baby Rompers/Bodysuits/Jumpsuit for Boys and Girls Unisex Onesie without Booties,Warehouse A,397,378,2025-02-28 23:44:00,19
2758,ORD_2759,6769,"Pallava Organic Baby Massage Oil For Baby's Delicate Skin and Hair, Certified Organic by Ecocert France - 100ml",Warehouse C,497,483,2025-02-28 07:31:00,14
2759,ORD_2760,24892,BOOMER CUBS Kids Unisex Winter Shoes,Warehouse C,287,265,2025-02-28 12:53:00,22
2760,ORD_2761,24887,"abracadabra Terry Face Towels for Newborns, Infants & Toddlers (Head & Tail, Set of 4) - White",Warehouse A,322,286,2025-02-28 09:28:00,36
2761,ORD_2762,24839,"Himalaya Gentle Baby Soap Value Pack, 4 * 75g, Massage Oil (500ml) and Gentle Wipes (72 Napkins of 2 Packs) Combo",Warehouse A,50,13,2025-02-28 13:33:00,37
2762,ORD_2763,24848,BM Jewellers 925 Pure Hallmarked Silver Kada With Certificate Of Purity For Baby Boy And Baby Girl (15.7 GM),Warehouse A,241,235,2025-02-28 08:51:00,6
2763,ORD_2764,6825,KORBOX Toilet Trainer Baby Potty Seat Cartoon Face with Removable Tray & Closing Lid baby potty seat for 0 to 5 years (BLUE),Warehouse B,122,83,2025-02-28 12:43:00,39
2764,ORD_2765,6804,"LandVK Toothbrush for Kids with U Shaped Silicone Brush Head for 360 Degree Cleaning Suitable For 2-6 Years, Manual,Heart ...",Warehouse B,399,393,2025-02-28 05:37:00,6
2765,ORD_2766,6801,Mama panda Baby Nail Trimmer Filer for New Born Electric with 6 Grinding Heads Safe for Kids Manicure Kit Nail Clippers Pa...,Warehouse B,118,105,2025-02-28 08:49:00,13
2766,ORD_2767,24880,"Neska Moda 6 To 12 Months Baby Boys & Baby Girls Cotton Rabbit Booties (Yellow,Rani) -SK147andSK148",Warehouse B,92,46,2025-02-28 14:55:00,46
2767,ORD_2768,24881,"Blue Nectar Baby Lotion with Ghee, Roses, Wheatgerm Oil for Soft Skin (12 Herbs, 200 ml)",Warehouse B,479,461,2025-02-28 22:56:00,18
2768,ORD_2769,24884,"Mothers Choice® King Waterproof PVC Plastic Mattress Protector/Bed Protection Sheet for Baby and Adult, 95 x 73 Inches - P...",Warehouse C,321,280,2025-02-28 16:40:00,41
2769,ORD_2770,25232,ANKIMA Baby Baby Fruit Feeder Pacifier 2 Pack-Fresh Food Feeder-Silicone Nipple Teething Toy-Silicone Pouches for Toddlers...,Warehouse B,99,78,2025-02-28 15:48:00,21
2770,ORD_2771,6583,"MOM'S PRIDE® Baby Care Baby Nail Clipper, Scissor, Tweezer and Nail Cleaning Sets, The Best Baby Shower Gift for Baby Girl...",Warehouse B,375,344,2025-02-28 07:34:00,31
2771,ORD_2772,24899,Infantbond Combo of Baby Bed with Net | Carry Bag | 4 Pcs Bedding Set(0-6 Months) (Lemon Yellow),Warehouse A,197,183,2025-02-28 16:31:00,14
2772,ORD_2773,24958,"NammaBaby Premium Baby Girls Short Sleeves Frock Dress. Frock, Round Neck Frock with Swing Tie, Rose Print Pattern Frill F...",Warehouse B,230,186,2025-02-28 20:19:00,44
2773,ORD_2774,25618,BabyNeeds Soft Cotton Ear Flap Caps with Tie Knot for Baby (3-6 Months),Warehouse A,113,106,2025-02-28 03:05:00,7
2774,ORD_2775,6759,"Cello Portable Plastic Baby Bath Tub, Yellow",Warehouse B,283,237,2025-02-28 20:01:00,46
2775,ORD_2776,24685,Neska Moda 12 To 18 Months Baby Boys & Girls Cotton Anti Slip Indoor Slippers Booties (Black)-BT1575,Warehouse A,492,471,2025-02-28 19:26:00,21
2776,ORD_2777,6899,"Philips Avent 125ml Classic Plus Feeding Bottle (Twin Pack), White Colour",Warehouse C,359,320,2025-02-28 20:36:00,39
2777,ORD_2778,24705,SuperBottoms Dry Feel Padded Langot - Pack of 3- Cotton Langot |Cloth Nappy with Gentle Elastics & a SuperDryFeel Layer on...,Warehouse C,240,205,2025-02-28 23:55:00,35
2778,ORD_2779,24674,Enfamil A+ Stage 2 Follow Up Formula - 400 g (6 Months Onward),Warehouse B,38,21,2025-02-28 08:22:00,17
2779,ORD_2780,24812,BUMZEE Unisex-Child Sleepsuit,Warehouse B,421,393,2025-02-28 02:43:00,28
2780,ORD_2781,6785,Chicco Baby Moments Gift Pack (Blue),Warehouse C,513,465,2025-02-28 22:46:00,48
2781,ORD_2782,6784,Johnson's Baby Gel Oil with Aloe & Vitamin E 6.5 Ounces,Warehouse A,321,288,2025-02-28 19:29:00,33
2782,ORD_2783,24908,"V.B.K® Baby Boy and Baby Girl Cloth Set Combo Pack/Baby Shower Gift Set With Jhabla (4 Pcs) and Nappy (Langot) (4 Pcs), Pu...",Warehouse B,245,212,2025-02-28 03:12:00,33
2783,ORD_2784,24927,TopiBaaz Antiskid Shoes for Baby Boys and Girls (Pack of 1)| Antislip Silicone Rubber Sole| Socks Cum Shoes| All Season wear,Warehouse C,48,28,2025-02-28 09:55:00,20
2784,ORD_2785,24933,"Pampers Premium Care Pants, Extra Large size baby Diapers, (XL) 24 Count Softest ever Pampers Pants,",Warehouse B,84,71,2025-02-28 11:49:00,13
2785,ORD_2786,6787,CATCUB Ultra Soft Cotton Baby Hooded Towel Combo - Pack of 2 (Blue & Green),Warehouse B,296,287,2025-02-28 07:22:00,9
2786,ORD_2787,6770,Aswadh Cute Cartoon Animal Uni Kids Toddler Soft Sole Baby Shoes Tiger - 13cm,Warehouse C,373,325,2025-02-28 20:45:00,48
2787,ORD_2788,24945,"Yimobra Monthly Milestone Blanket | 1 to 12 Months | Best for Newborn Boy & Girl, Multicolor, Cotton (Solid)",Warehouse C,257,231,2025-02-28 09:12:00,26
2788,ORD_2789,6761,"TOY FUN Plastic Build Up Beakers Stacking and Nesting Toy for Kids, Multicolour - 12 Pieces",Warehouse A,497,459,2025-02-28 13:53:00,38
2789,ORD_2790,24951,NAVYZONE Unisex Imported Cartoon Print Booties for Baby|Girls No Elastic No Marks | Cotton N Breatheble | Cute N Comfy Boo...,Warehouse B,424,383,2025-02-28 17:44:00,41
2790,ORD_2791,24955,ZUVINO Women's Maternity Feeding Tops for Mothers with Zip | Nursing Tops for Feeding Baby | Feeding Tops for Jeans | Plus...,Warehouse A,290,263,2025-02-28 12:41:00,27
2791,ORD_2792,25604,"Baby Dress Girl and Boy Sleeveless Soft Hosiery Vests,Jhabla Top with Capri Pants Dress Babies Fashion Suit Stylish Dress ...",Warehouse C,409,395,2025-02-28 10:50:00,14
2792,ORD_2793,25621,BuddsBuddy Olive Oil Based Natural Wipes With Lid for Babies with the goodness of Aloe Vera & Olive Oil | Moisturizing wip...,Warehouse B,129,120,2025-02-28 18:32:00,9
2793,ORD_2794,6276,"SOFTSPUN Microfiber Baby Hand & Face Wipes 30x30 Cms, 1 Piece Towel Set, 340 GSM, (Orange) Super Soft & Silky for Hand, Fa...",Warehouse C,134,111,2025-02-28 01:14:00,23
2794,ORD_2795,25556,Baby Moo Rainbow Chu-Chu Sound Breathable Anti-Skid Sandals - Blue (12-18M),Warehouse B,233,210,2025-02-28 13:19:00,23
2795,ORD_2796,25562,BRATS N BEAUTY® - Stylish Kids Girl's/Boy's (>12 Years) Winter Woolen Warm and Snow Proof Soft Beanie Cap/Hat (Pompom) and...,Warehouse A,455,412,2025-02-28 05:50:00,43
2796,ORD_2797,25575,AMAZARA Baby Proofing Edge & Corner Guards | 6.5Ft Edge + 4 Pre-Taped Corner Protectors | Child Safety Furniture Cushions...,Warehouse B,310,265,2025-02-28 08:04:00,45
2797,ORD_2798,6371,"Neska Moda 6 To 12 Months Baby Boys & Baby Girls Cotton Rabbit Booties (Mint,Orange) -SK140andBT16",Warehouse C,380,359,2025-02-28 23:13:00,21
2798,ORD_2799,25579,LEE BERRYS 100% Pure Cotton Checked Born Baby Jabla Combo of 6 – 6-12 Month,Warehouse B,427,392,2025-02-28 01:35:00,35
2799,ORD_2800,25559,Manan Shopee Newborn Baby Comb & Soft Brush Set Grooming Hair Care Products for Babies & Infants Baby Brush (Pink),Warehouse B,414,370,2025-02-28 23:43:00,44
2800,ORD_2801,6402,Hopscotch Unisex Leather Printed Slipon Pack of 2 in Multi Color,Warehouse C,473,436,2025-02-28 07:15:00,37
2801,ORD_2802,6294,PayalWala Nazariya 925 Silver Beads Platinum Plated Kids Bracelet (Preschooler 3-5 Years),Warehouse C,474,453,2025-02-28 05:24:00,21
2802,ORD_2803,6292,"Neska Moda 6 To 12 Months Baby Boys & Baby Girls Cotton Lace Shoes/Booties (Orange,Yellow) -SK141andSK136",Warehouse A,108,60,2025-02-28 13:02:00,48
2803,ORD_2804,25769,Max Baby-Boys Tshirt,Warehouse C,137,121,2025-02-28 16:58:00,16
2804,ORD_2805,25770,"Neska Moda 12 To 18 Months Baby Boys & Baby Girls Pack Of 2 Pair Cotton Rabbit & Butterfly Booties (Yellow,Red) -BT1173and...",Warehouse C,96,54,2025-02-28 03:29:00,42
2805,ORD_2806,25792,"Safe-O-Kid Newly Launched- Hair Washing Mug, Baby Shampoo Cup, Baby Shower, Baby Bath Tumbler, Rainer Blue",Warehouse C,492,469,2025-02-28 03:08:00,23
2806,ORD_2807,25793,Little Surprise Box - Green Twinkle Star Newborn Hamper Gift Set…,Warehouse A,278,268,2025-02-28 06:51:00,10
2807,ORD_2808,25794,"My NewBorn Baby Fleece Blanket (0-3Months, Blue) - Set of 5",Warehouse C,198,172,2025-02-28 20:58:00,26
2808,ORD_2809,6378,Stepee baby kids sandal for girls,Warehouse B,291,258,2025-02-28 17:23:00,33
2809,ORD_2810,25623,HENAL Women's Rayon A-Line Maternity Feeding Kurti With Zipper (H319_Maroon Printed Maternity Kurta_Maroon),Warehouse C,320,300,2025-02-28 14:36:00,20
2810,ORD_2811,25628,Wrap Concepts Peonies Head (24pcs) (Baby Pink),Warehouse B,372,325,2025-02-28 00:08:00,47
2811,ORD_2812,25602,Mothercare Boys VG810,Warehouse C,176,158,2025-02-28 01:57:00,18
2812,ORD_2813,25655,Morir Dual Tone Finish Silver Copper Adjustable Kids Protection Bangle Free Size Nazariya for Baby Boys & Girls Baby Kids ...,Warehouse B,377,335,2025-02-28 22:30:00,42
2813,ORD_2814,25659,Shash Empire's Happy Birthday Celebration Hats / Caps (Pack Of 10) (Boys/Girls),Warehouse C,253,243,2025-02-28 04:09:00,10
2814,ORD_2815,25661,"Neska Moda 6 To 12 Months Baby Girls Cotton Butterfly Booties (Blue,Orange) -SK140andBT8",Warehouse C,206,163,2025-02-28 00:55:00,43
2815,ORD_2816,25664,Hopscotch Baby Boys Cotton Full Sleeves Checked Printed Applique Bow Checked Printed Bodysuit in Navy Color for Ages 6-9 M...,Warehouse B,212,170,2025-02-28 12:54:00,42
2816,ORD_2817,25666,FreshFoot Organic Cotton New Born Baby socks for 0-12 Months (Mixed Colour),Warehouse A,178,147,2025-02-28 14:52:00,31
2817,ORD_2818,6359,"Bodyguard Moisturizing Baby Bathing Soap Bar for Kids – Pack of 2, 75gms each | pH 5.5, with Oatmeal Powder, Shea Butter, ...",Warehouse B,237,226,2025-02-28 01:17:00,11
2818,ORD_2819,25594,Chicco Baby Moments Gentle Body Wash and Shampoo (500ml) PACK OF 2 (500MLEACH),Warehouse B,151,116,2025-02-28 03:46:00,35
2819,ORD_2820,25528,Dabur Hepano Syrup - 200 ml (Pack of 3),Warehouse C,345,318,2025-02-28 15:50:00,27
2820,ORD_2821,25529,BELGIUMBEAUTY Belgium Leather Shoes for Boys/Baby boy Boots/,Warehouse C,204,184,2025-02-28 20:21:00,20
2821,ORD_2822,6397,"Neska Moda 0 To 6 Months Baby Boys & Baby Girls Cotton Rabbit Booties (Blue,Yellow) -BT1112andBT370",Warehouse C,465,433,2025-02-28 07:19:00,32
2822,ORD_2823,25535,"Himalaya Baby Care Extra Moisturizing Baby Wash, 200ml",Warehouse B,385,370,2025-02-28 14:39:00,15
2823,ORD_2824,25536,Designer Funky/Casual Full Length Socks for Babies/New Born/Infants- Pack Of 4,Warehouse A,386,355,2025-02-28 14:16:00,31
2824,ORD_2825,26850,WorldCare® Women Men Neoprene Scuba Diving Sock Water Sports Beach Snorkeling Shoes XS (66020329JEL),Warehouse B,35,27,2025-02-28 22:14:00,8
2825,ORD_2826,5689,Chicco Toothpaste Apple-Banana (50ml) and Strawberry (50ml) Combo (100ml total),Warehouse B,179,135,2025-02-28 09:04:00,44
2826,ORD_2827,23096,VS Collection Baby Girls Midi|Knee Length Festive|Wedding Dress Shooping Black (3-6 Month),Warehouse C,199,169,2025-02-28 16:23:00,30
2827,ORD_2828,23101,Mee Mee 2-in-1 Spout & Straw Sipper Cup (Red),Warehouse A,54,10,2025-02-28 09:26:00,44
2828,ORD_2829,23103,Ziory Fish Designed Baseball Cotton Cap- Yellow (6-12 Months),Warehouse A,133,113,2025-02-28 23:02:00,20
2829,ORD_2830,7802,"Luv Lap Steel Feeding Bottle,SS304 Steel, Rust Free Stainless Steel, Ergonomic Handle, BPA Free, Odour Free, Nipple has An...",Warehouse B,402,365,2025-02-28 16:56:00,37
2830,ORD_2831,23035,Nyamah Sales Baby Safety Pins Plastic Head Cloth Diaper Pins with Locking Closures Stainless Steel Nappy Pins Diaper Pins ...,Warehouse A,181,156,2025-02-28 17:02:00,25
2831,ORD_2832,23024,"Mamaearth Vitamin C Day Cream For Face, with Vitamin C & SPF 20, for Skin Illumination - 50g",Warehouse C,107,75,2025-02-28 15:56:00,32
2832,ORD_2833,22960,"Mee Mee Absorbent|Washable |Reusable |Soft Baby Bath Towel | Cotton Washcloth for Infants, New Born Babies and Toddlers (G...",Warehouse C,258,241,2025-02-28 00:51:00,17
2833,ORD_2834,22962,"Cable World® Musical Keyboard Mat Piano Gym Mat Gym & Fitness Rack,Pack of 1 set, Muticolor",Warehouse C,285,278,2025-02-28 08:20:00,7
2834,ORD_2835,7861,"Mee Mee Ultra Thin Super Absorbent Disposable Nursing/Maternity | Breast Feeding/Breast Pads (White,12 Pads) |Leak Proof C...",Warehouse B,377,338,2025-02-28 22:17:00,39
2835,ORD_2836,22984,Bold N Elegant Bright Yellow and Blue Pineapple Cute Print Twin Set Little Boy Girl Two Piece Set Kids Full Length Set Tsh...,Warehouse C,354,316,2025-02-28 18:29:00,38
2836,ORD_2837,7831,"HRK Blocks Set for Kids, Play Fun and Learning Blocks for Kids Games for Children Block Game Puzzles Set Boys, Children (M...",Warehouse A,236,199,2025-02-28 09:56:00,37
2837,ORD_2838,23012,"Johnson's Baby Soap, 50g",Warehouse C,212,204,2025-02-28 08:12:00,8
2838,ORD_2839,23014,Kuchipoo Regular Fit Baby Boys and Baby Girls Pyjamas - Pack of 5 (© DISNEY-PAJ-131),Warehouse A,323,276,2025-02-28 02:28:00,47
2839,ORD_2840,23015,GJ Baby Baby-Boy's Regular fit Jacket,Warehouse C,322,299,2025-02-28 12:58:00,23
2840,ORD_2841,23095,"Lavitra fashion headbands colorful flowers soft nylon hairbands for baby girls, kids infants toddlers - (pack of 5)",Warehouse B,495,479,2025-02-28 03:33:00,16
2841,ORD_2842,7850,"3 Piece Baby Bow Cap -Turban Bow Cap Baby Bow Cap -Turban Bow Cap,Baby Cap, Turban Cap, Baby Headwear Suitable for 0 to 12...",Warehouse B,90,84,2025-02-28 04:40:00,6
2842,ORD_2843,23457,"Mamaearth Foaming Baby Face Wash for Kids with Aloe Vera and Coconut Based Cleansers, 120 ml änd Natural Mosquito Repellen...",Warehouse C,225,210,2025-02-28 17:08:00,15
2843,ORD_2844,23424,Fareto® New Born Unisex Baby Daily Use Combo of Clothing Set/6 Front Open Shirts/6 Single Layer Nappies/6 Caps(Multi Colors),Warehouse A,439,415,2025-02-28 21:48:00,24
2844,ORD_2845,23426,HIKIPO Presents 1 PCS BPA Free Veggie Feed Nibbler Fruit Nibbler 1 PCS Silicone Baby Food Spoon Bottle 90ML with 1 Pack Gr...,Warehouse C,396,367,2025-02-28 18:09:00,29
2845,ORD_2846,23432,"Iba & Isba Baby Girls | Baby Boys Soft Cotton Socks with Mickey Mouse Bow, Multicolor",Warehouse A,375,359,2025-02-28 18:04:00,16
2846,ORD_2847,7622,MINI KLUB Baby-Girl's Regular Fit T-Shirt,Warehouse C,194,147,2025-02-28 04:22:00,47
2847,ORD_2848,7708,Crystal zone Washcloth for New Born 100% Hosiery Cotton/Reusable Extra Soft Face Towels washcloth for Babies Pack of 8 wipes,Warehouse C,171,156,2025-02-28 08:38:00,15
2848,ORD_2849,23250,"Johnson's CottonTouch Newborn Baby Lotion, 500ml, Made With Natural Cotton For Baby's Delicate Skin, pH Balanced, Hypoalle...",Warehouse A,299,270,2025-02-28 11:13:00,29
2849,ORD_2850,23050,"Morisons Baby Dreams Classic Powder Puff, Color May Vary",Warehouse A,241,201,2025-02-28 10:45:00,40
2850,ORD_2851,7826,"Luv Lap Turtle Shaped Baby Manual Toothbrush & Toddler Toothbrush, Extra Soft with 10,000 Ultra Soft Floss Bristle for Bab...",Warehouse A,68,46,2025-02-28 05:44:00,22
2851,ORD_2852,7823,"Nizomi Garden Toy Beach Toys Set for Kids, Mold Castle Toys Indian Made 5 Pcs Sandpit Bucket,Animal, Mould, Beach Shovel S...",Warehouse C,374,362,2025-02-28 09:57:00,12
2852,ORD_2853,23062,"Neska Moda 0 To 6 Months Baby Boys & Baby Girls Cotton Lace Shoes/Booties (Orange,Blue) -BT378andBT1136",Warehouse B,282,236,2025-02-28 13:27:00,46
2853,ORD_2854,23043,"SYGA Baby Hats for Spring Winter, Cute Rabbit Ears Head Hooded for Kids Babies for 1-3 Years",Warehouse B,435,393,2025-02-28 19:58:00,42
2854,ORD_2855,23075,Little one Kids Boy Clothing Sets Blazer type suit set for Baby Newborn,Warehouse A,277,248,2025-02-28 23:44:00,29
2855,ORD_2856,7836,"Chicco Baby Moments Talcum Powder, 150g Bottle",Warehouse A,283,267,2025-02-28 04:50:00,16
2856,ORD_2857,23113,"Synlark Baby Head Protector, Adjustable Size Baby Learn to Walk Or Run Soft Safety Helmet, Infant Anti-Fall Anti-Collisio...",Warehouse B,136,98,2025-02-28 07:57:00,38
2857,ORD_2858,23135,"Pampers Premium Care Pants, Large size baby Diapers, (L) 88 Count,9-14 Kg, Softest ever Pampers Pants",Warehouse A,368,339,2025-02-28 22:17:00,29
2858,ORD_2859,23146,NEW COMERS® Milestone Blanket and Props for Baby's Monthly Photoshoot|1 to 12 Month Cards|Multiuse Products|Ac Room Blanke...,Warehouse B,411,385,2025-02-28 09:43:00,26
2859,ORD_2860,23150,One Chance Footwear Unisex-Child Comfy Slip-on LED Unisex Shoes for Kids First Walker Shoe,Warehouse A,122,114,2025-02-28 14:43:00,8
2860,ORD_2861,7766,Buddsbuddy BPA Free XOXO Safety Nail Clipper for New Born Baby with Rounded Design (Blue),Warehouse A,196,163,2025-02-28 22:56:00,33
2861,ORD_2862,23167,"Baby Girl Dress 0-3 Months, 3-6 Months",Warehouse C,277,270,2025-02-28 23:12:00,7
2862,ORD_2863,23171,HAXERIO Non-Toxic Baby Squeeze Sound Bath Toy Colourful Chu Chu Set of 12 Pcs Mix Animal Shape Toy (12 Chu Chu Toys),Warehouse B,363,348,2025-02-28 14:45:00,15
2863,ORD_2864,23176,Ameeha Baby Girls Boys Clothing Sets Children's Clothes Baby Tops Tracksuits Suits /T-shirts and Trousers,Warehouse C,455,428,2025-02-28 12:35:00,27
2864,ORD_2865,23178,KIdzcrush Kidz Himalayas Refreshing Baby soap 75 g Pack of 6,Warehouse C,440,396,2025-02-28 04:05:00,44
2865,ORD_2866,23179,Mamaearth Vitamin C Oil-Free Moisturizer For Face With Vitamin C & Gotu Kola For Skin Illumination - 80 Ml,Warehouse B,234,221,2025-02-28 02:35:00,13
2866,ORD_2867,7757,Manan Shopee 360° U-Shaped Toothbrush with Food Grade Silicone Head| Soft bristles for Babies & Kids' Sensitive Gums & Tee...,Warehouse A,167,152,2025-02-28 13:55:00,15
2867,ORD_2868,7754,Mee Mee Anti-Bacterial Baby Laundry Detergent(1.5 Litre liquid),Warehouse A,151,146,2025-02-28 20:04:00,5
2868,ORD_2869,6935,"OYO BABY Mustard Seeds Pillow for Baby Head Shaper | sarso Pillow for New Born Baby 0 to 12 Month, Pink (Strawberry Printed)",Warehouse A,208,166,2025-02-28 15:08:00,42
2869,ORD_2870,26146,"IS IndoSurgicals Head Circumference Measuring Tape, PVC, Reusable (Pack of 10 Pcs.)",Warehouse B,316,269,2025-02-28 09:19:00,47
2870,ORD_2871,26154,VACHI Protective Baby Nail Clipper Cutter with Skin Guard (Blue),Warehouse C,94,86,2025-02-28 01:18:00,8
2871,ORD_2872,6075,Toddylon New Born Baby Cotton Jhabla/Shirts with Nappies/Langot & Caps (0-6 Months),Warehouse A,378,364,2025-02-28 16:02:00,14
2872,ORD_2873,26160,"Adore Milk Powder Container for Baby, Baby Food Storage Container or Dispenser (225 gm, Pink)",Warehouse B,397,391,2025-02-28 02:25:00,6
2873,ORD_2874,26169,JUSTLIST Collections Headbands Flowers Soft Cotton Hairbands for Baby Girls Infants Toddlers (Pack of 6) (multicolour),Warehouse A,203,186,2025-02-28 09:45:00,17
2874,ORD_2875,23143,"Neska Moda Unisex Set of 2 Pair Baby Sandal Booties for 6 to 12 Months (Black,Yellow)",Warehouse A,488,441,2025-02-28 16:54:00,47
2875,ORD_2876,23133,A.T.U.N Girl's Cotton a-line Mini Dress (GDRS HEI AZF_Fuchsia_4-5 YR),Warehouse A,435,416,2025-02-28 11:55:00,19
2876,ORD_2877,23119,"The Moms Co. Virgin Coconut Natural 10-in-1 Baby Hair Oil with Argan, Marula, Avocado, Bhringraj and Organic Amla, 200 ml",Warehouse B,65,23,2025-02-28 12:25:00,42
2877,ORD_2878,23120,BUMZEE Baby Girls Full Sleeve Bodysuit Pack Of 3,Warehouse B,63,45,2025-02-28 12:33:00,18
2878,ORD_2879,23201,Allen Solly Babygirl Dress,Warehouse C,466,452,2025-02-28 20:19:00,14
2879,ORD_2880,7743,Hopscotch Boys and Girls Memory Foam Solid Slip Ons Shoes in Black Color,Warehouse A,93,48,2025-02-28 22:09:00,45
2880,ORD_2881,7741,"Decals Design 'You are My Sunshine Rainbow' Wall Sticker (PVC Vinyl, 70 cm x 50 cm),Multicolor",Warehouse C,143,130,2025-02-28 06:34:00,13
2881,ORD_2882,23218,Himalaya Refreshing Baby Soap 75G (Pack of 5),Warehouse B,379,353,2025-02-28 04:01:00,26
2882,ORD_2883,7732,TILISM Short Midi Frock Dress for Kids Girls Flared Long Frock Gown Cocktail Dress Trendy Fancy Frock Western Party Gown f...,Warehouse A,181,168,2025-02-28 19:36:00,13
2883,ORD_2884,7745,little PANDA Baby Girls Dress Knee Length Skirt Dungaree with Full Sleeves Top Clothing Set Western Dress,Warehouse C,477,444,2025-02-28 16:14:00,33
2884,ORD_2885,23227,Max Girls Printed Round Neck Top,Warehouse A,484,473,2025-02-28 17:52:00,11
2885,ORD_2886,7723,Gurwala's Jewellers Artifical 5 Ball Silver Platted Beads and Black Cotton Thread Nazariya for Babies | Silver,Warehouse B,481,470,2025-02-28 00:12:00,11
2886,ORD_2887,23238,All Out Ultra Power+ Slider Mosquito Repellent Refill with Machine - 45ml,Warehouse B,532,488,2025-02-28 05:00:00,44
2887,ORD_2888,23240,SMARTOTS Baby Laces Shoes with CHU CHU Sound for Baby Boy/Girl MOGLI-3,Warehouse C,344,324,2025-02-28 19:25:00,20
2888,ORD_2889,7721,Kvitoe Set of 6 Winter Woolen Soft Mittens Gloves for Baby Girls and Baby Boys 1-2 Years Baby Gloves Multicolor,Warehouse A,495,458,2025-02-28 15:56:00,37
2889,ORD_2890,7750,"Bambo Nature Premium Baby Diapers - White, Large Size, 48 Count, for Toddler Baby - Super Absorbent, Eco-Friendly and with...",Warehouse C,159,152,2025-02-28 23:56:00,7
2890,ORD_2891,23186,KNITROOT Twins Baby Boys Bodysuit for infant Half Sleeve Envelope Neck If you think i'm cute,Warehouse A,438,429,2025-02-28 23:48:00,9
2891,ORD_2892,7789,"SARTHAM, Building Block Toy for Kids | Age 3 to 10 Years (Multicolor) | Large 7.5 Centimeters Blocks",Warehouse A,281,274,2025-02-28 10:31:00,7
2892,ORD_2893,23403,MINISO Penguin Plush Toy 28cm(Purple),Warehouse A,107,99,2025-02-28 12:14:00,8
2893,ORD_2894,7630,"Neska Moda Unisex Baby Sandal Booties For 6 To 9 Months (Red,Black)",Warehouse C,81,69,2025-02-28 14:56:00,12
2894,ORD_2895,22554,"Dwarakesh Enterprises® Kids U-Shaped Toothbrush for Manual Training & Clean Teeth in All Directions, Food Grade Soft Silic...",Warehouse B,220,210,2025-02-28 17:30:00,10
2895,ORD_2896,22559,"Toy'O Fun Marble Run Building Blocks, 84 PCS Classic Big Blocks STEM Toy Bricks Set Kids Race Track Compatible with All Ma...",Warehouse B,159,128,2025-02-28 19:36:00,31
2896,ORD_2897,22562,Little Pumpkin Classic Baby Bath tub for Kids Temperature Sensitive Plug Folding Baby Bath Tub for Kids of 0 to 3 Years Up...,Warehouse C,112,99,2025-02-28 07:07:00,13
2897,ORD_2898,22565,minicult Unisex Cotton Baby Vest (Pack of 6) (Multicolor)(Assorted Prints Will be Sent),Warehouse A,505,495,2025-02-28 21:30:00,10
2898,ORD_2899,22567,Jhalak Industries Baby Mitten Cap and Booty Set (Pack of 3) Multicolor,Warehouse A,80,36,2025-02-28 20:08:00,44
2899,ORD_2900,8110,DM MART Baby Girls and Baby Boys Ankle Length with Animal Print Soft Base Booties/Socks Shoes (0-12 Months),Warehouse A,207,193,2025-02-28 16:18:00,14
2900,ORD_2901,8106,"Aveeno Baby Aveeno Baby Daily Moisture Lotion, Fragrance Free (18 fl. oz, 2 pk.) Non-Greasy Formula Absorbs Quickly",Warehouse B,138,121,2025-02-28 07:12:00,17
2901,ORD_2902,8101,CEE 18 Women's Cotton Lightly-Padded and Non-Wired Maternity Nursing Bra|Womens Adjustable Shoulder Straps | Post Pregnanc...,Warehouse A,479,443,2025-02-28 04:48:00,36
2902,ORD_2903,7572,Dabur Odomos Naturals Non-Sticky Mosquito Repellent Cream - 50 Gm,Warehouse C,82,41,2025-02-28 00:26:00,41
2903,ORD_2904,22949,"KERWA Comfortable Printed Cotton Pajami Lower Trackpant Pyjama Nightwear for Kids and New Born Baby Boys & Baby Girls, Mul...",Warehouse B,333,320,2025-02-28 12:13:00,13
2904,ORD_2905,7683,"NVS Kids Winter Hat, Baby Girls Boys Winter Balaclava Cap, Thick Scarf Earflap Hood Scarves Skull Caps I Balaclava Cap I M...",Warehouse C,74,57,2025-02-28 05:55:00,17
2905,ORD_2906,23323,ShuShu Babies Calming Lavender Baby Face and Body Lotion | Calming Moisturizing Baby Lotion | Face Lotion for Kids | Body ...,Warehouse A,477,447,2025-02-28 16:17:00,30
2906,ORD_2907,23326,Bio-Oil Original Face & Body Oil Suitable for Scar Removal | Uneven Skin Tone| Stretch Marks & Ageing Signs for Glowing Sk...,Warehouse B,297,287,2025-02-28 03:23:00,10
2907,ORD_2908,23329,Chinmay Kids 4-in-1 Adjustable Baby Carrier Cum Kangaroo Bag/Baby Carry Sling/Back/Front Carrier for Baby with Safety Belt...,Warehouse B,463,440,2025-02-28 19:04:00,23
2908,ORD_2909,7671,"Toddylon New Born Baby Daily Needs Items Gifts Pack (Multicolor, 0-6 Months)",Warehouse B,481,446,2025-02-28 13:09:00,35
2909,ORD_2910,23339,Mamaearth Daily Moisturizing Natural Baby Lotion (400 ml) & Mamaearth Original Orange Body Wash For Kids with Orange & Oat...,Warehouse A,333,302,2025-02-28 11:39:00,31
2910,ORD_2911,8118,Clothing Set Half Sleeve Dresses for Baby Boys and Baby Girls| Kids Printed Casual Wear T-Shirt and Pant,Warehouse C,277,236,2025-02-28 04:12:00,41
2911,ORD_2912,23353,Hopscotch Unisex Synthetic/PU Graphic Print Sneakers in White Color,Warehouse B,86,43,2025-02-28 18:59:00,43
2912,ORD_2913,22549,"CUTE LANDINGS® New Born Baby Soft Pure Cotton Bow Frock/One Piece and Panties Set, Dresses/Infant/Toddlers/Newborn/Bodysui...",Warehouse A,401,387,2025-02-28 10:17:00,14
2913,ORD_2914,22607,Hopscotch Girls PVC Floral Print Mary Jane in Cream Color,Warehouse A,238,208,2025-02-28 04:10:00,30
2914,ORD_2915,22608,"Neska Moda 0 To 6 Months Baby Boys & Baby Girls Cotton Lace Shoes/Booties (Mint,Blue) -BT378andBT1135",Warehouse C,306,271,2025-02-28 17:28:00,35
2915,ORD_2916,22609,Pack of 3 Combo Premium Baby Skin Care Baby Powder Puff with Box Holder Container for New Born and Kids for Baby Face and ...,Warehouse A,31,22,2025-02-28 07:59:00,9
2916,ORD_2917,22610,Toyshine Kids Wooden Angle Geometric Blocks Stacker Shape Sorter Column Puzzle Stacking Set - B (21 pieces),Warehouse C,483,466,2025-02-28 08:38:00,17
2917,ORD_2918,22612,"Mamaearth 100 Percent Natural Berry Blast Kids Toothpaste, 50g & Deeply Nourishing wash for Babies (200 ml, 0-5 Yrs) Combo",Warehouse C,302,260,2025-02-28 10:35:00,42
2918,ORD_2919,22613,Dreamee Fashions - Newborn Baby Boys & Baby Girls Cotton Printed Rompers | Body Suit - (Prints May Vary) – Multi-coloured ...,Warehouse B,302,269,2025-02-28 15:19:00,33
2919,ORD_2920,22596,"Himalaya Herbals Babycare Gift Pack & Himalaya Extra Moisturizing Baby Soap (75g, Buy 3 Get 1 Free)",Warehouse C,476,427,2025-02-28 10:17:00,49
2920,ORD_2921,22627,PUMA Toddler Girls Rider Future Vintage Slip On Sneakers Shoes Casual - Beige,Warehouse A,103,93,2025-02-28 11:13:00,10
2921,ORD_2922,8075,"MOTHERS CHOICE Hosiery Cap For Baby (Pack of 3, Newborn, Multicolor)",Warehouse B,263,217,2025-02-28 21:04:00,46
2922,ORD_2923,8058,"Luv Lap Liquid Cleanser Refill, Anti-Bacterial, Food Grade, For Baby Bottles, Accessories And Vegetables, 1000ml (Clear)",Warehouse C,281,234,2025-02-28 12:57:00,47
2923,ORD_2924,22651,Hopscotch Boys and Girls Recycled Polyester/Memory Foam Stripe Print Slip Ons in Red Color,Warehouse C,229,192,2025-02-28 06:11:00,37
2924,ORD_2925,8088,"Nappy for New Born Baby - Set of 12 Pcs/Cotton Cloth Langot for Babies, 0-6 Months, Double Layer Nappies, V Shaped, Washab...",Warehouse A,331,312,2025-02-28 14:51:00,19
2925,ORD_2926,22590,baby wish Birthday gifted to Baby Bodysuits Newborn birthday Romper Half Sleeve Envelope Neck Cute Outfit My First Birthda...,Warehouse B,68,41,2025-02-28 01:49:00,27
2926,ORD_2927,22584,Fflirtygo No Hair Don't Care Baby Wear 100% Hosiery Cotton Infants Rompers with Booties/Onesies/Body Suit/Sleepsuit/Jumpsu...,Warehouse B,189,178,2025-02-28 08:58:00,11
2927,ORD_2928,22534,DHRUVS COLLECTION EXCLUSIVE Pair Of 925 Pure Silver Black Thread Adjustable Bracelet With Flower Charm and Silver Balls Fo...,Warehouse B,356,336,2025-02-28 10:45:00,20
2928,ORD_2929,8126,DECORE Brown Kurta Pyjama for Baby,Warehouse A,259,231,2025-02-28 00:16:00,28
2929,ORD_2930,23354,"Collapsible Kids U-Shaped Toothbrush, Teeth Dental Care Hand-Held, Food Grade Soft Silicone Brush Head, Up & Down Manual T...",Warehouse A,502,453,2025-02-28 04:56:00,49
2930,ORD_2931,7635,CHIU Super Soft Velvet Baby Booties with Attractive Smiling Rabbit Face,Warehouse B,391,379,2025-02-28 21:47:00,12
2931,ORD_2932,7654,"Mamaearth Natural Insect Repellent, Pack of 1 & Moisturizing Baby Bathing Soap Bar, pH 5.5 Pack of 2, 75gms & Easy Tummy R...",Warehouse B,520,492,2025-02-28 20:57:00,28
2932,ORD_2933,23477,"Baby Dress Boy and Girl Half Sleeves Soft Hosiery Vests,Jhabla T-Shirt with Shorts Pants Dress Babies Night Suit Dress for...",Warehouse C,290,259,2025-02-28 19:50:00,31
2933,ORD_2934,23485,"El Regalo 2 PCs Swim Cap Kids/ Toddlers, Comfortable Breathable Polyester Fabric Swimming Caps Cute Cartoon Dolphin, Shar...",Warehouse C,192,155,2025-02-28 18:13:00,37
2934,ORD_2935,23497,"MY NEWBORN Fleece Super Soft Baby Wrapper Cum Bath Towel Robe (Cute Rabbit, Meow Green) Pack of 2",Warehouse A,243,215,2025-02-28 17:04:00,28
2935,ORD_2936,7580,Sebamed Baby Cleansing Bar [ Pack Of 2 ] #Imported (2 x 100 g),Warehouse B,55,10,2025-02-28 09:01:00,45
2936,ORD_2937,23509,"Softsens Baby Natural Mosquito Repellent Spray with Eucalyptus, Citronella & lemongrass 100ml",Warehouse B,445,417,2025-02-28 18:32:00,28
2937,ORD_2938,7581,Little Charlie Baby's Hazel Soft Sole Sandals,Warehouse B,108,66,2025-02-28 16:56:00,42
2938,ORD_2939,23376,Chinmay Kids 4-in-1 Adjustable Baby Carrier Cum Kangaroo Bag/Honeycomb Texture Baby Carry Sling/Back/Front Carrier for Bab...,Warehouse B,55,22,2025-02-28 18:51:00,33
2939,ORD_2940,23462,"Mee Mee Mild Baby Shampoo with Fruit Extracts, 500ml and Nourishing Baby Soap with Almond and Milk Extracts, 75g",Warehouse A,47,10,2025-02-28 17:52:00,37
2940,ORD_2941,7642,"abracadabra Muslin Wipes, 25 cm X 25 cm, 0-36 Months (Hot Air Balloon, Set of 3) - Orange",Warehouse A,533,497,2025-02-28 00:20:00,36
2941,ORD_2942,23392,Dungaree Set with Tshirt For baby boys and baby girls Kids Dresses,Warehouse B,540,496,2025-02-28 18:22:00,44
2942,ORD_2943,23382,QYOOTY Women's Trendy Designer best denim shoulder handbag for classic look,Warehouse B,454,425,2025-02-28 23:26:00,29
2943,ORD_2944,23355,"HUG 'n' FEEL SOFT TOYS Unicorn, Soft Toy, Baby Toys, Kids Toy, Soft Toy, Toy for Girl, Birthday Gift for Girl/Boys, Toy Gi...",Warehouse C,247,242,2025-02-28 22:27:00,5
2944,ORD_2945,23287,Fareto Baby Boy's & Baby Girl's T-Shirts | T-Shirt | Tees(Pack of 5),Warehouse B,486,460,2025-02-28 08:40:00,26
2945,ORD_2946,7655,"Fashion Alley Headbands Elastic Floral Hair Band, Bows Wrap Headband for Baby Girls, Infants and Newborns - Multicolor (Pa...",Warehouse C,166,123,2025-02-28 22:28:00,43
2946,ORD_2947,23366,Bantoo New Born Baby Gifts Items Combo Daily Essential Bedding & Clothing Set (0-6 Months),Warehouse C,104,71,2025-02-28 05:04:00,33
2947,ORD_2948,23368,"Mamaearth Tea Tree Anti Dandruff Shampoo, With Tea Tree & Ginger Oil, 250ml",Warehouse A,454,436,2025-02-28 06:18:00,18
2948,ORD_2949,7684,"Chuchik Crab Bubble Bath Maker for The Bathtub. Blows Bubbles and Plays 24 Childrenââ‚¬â„¢s Songs ââ‚¬â€œ Baby, Toddler Ki...",Warehouse A,466,448,2025-02-28 05:38:00,18
2949,ORD_2950,7687,"CHAUDHARY Traders New Born Baby Clothes | Soft Woolen Vest Innerwear Lightweight Sweater, Trouser, Cap, Socks/Shoes for Ne...",Warehouse B,102,74,2025-02-28 10:04:00,28
2950,ORD_2951,23263,V L POLYMERS Plastic Multipurpose Bath Tub/Washing Unbreakable Plastic Bath tub Multipurpose Bath Tub Durable Plastic Live...,Warehouse B,305,256,2025-02-28 15:10:00,49
2951,ORD_2952,23271,"Chinmay Kids Baby, Infant and Toddler Grooming Nail Cutter Kit with Scissors/Baby Nail Clipper Safety Cutter & Manicure Pe...",Warehouse C,77,50,2025-02-28 14:08:00,27
2952,ORD_2953,23285,Baby Story Gentle Nail Cutter with Magnifier Zoom Lens for Newborn Babies/Toddler/Kids/Children,Warehouse C,194,183,2025-02-28 02:41:00,11
2953,ORD_2954,23292,Lillypupp Unisex Blue Solid Denim Print Velcro Strap High-Ankle Chu-Chu Sound Making New Born Baby Shoes- Size Range : 6 t...,Warehouse B,59,10,2025-02-28 17:48:00,49
2954,ORD_2955,7695,FridaBaby Baby's Nosefrida Hygiene Filters (Multicolour),Warehouse A,109,85,2025-02-28 06:02:00,24
2955,ORD_2956,23296,Jaganath Creations Cotton T-shirt and Pant For Baby Boy/Girl Star Printed Comfortable T-shirt and Pant Set For Kids,Warehouse A,182,165,2025-02-28 00:46:00,17
2956,ORD_2957,7692,MY NEWBORN Baby Towel Bathrobe Hooded Blanket Wrapper- White Bear,Warehouse A,126,110,2025-02-28 08:04:00,16
2957,ORD_2958,23305,Da Anushi Soft Cotton Washable & Reusable Multicolor Highly Absorbing/Comfortable and Easily Adjustable Feeding Bibs In Ap...,Warehouse A,101,75,2025-02-28 17:53:00,26
2958,ORD_2959,6082,"DAPHNE Baby Diaper Bag for Mother, Baby Products, New Born Baby Product, New Born Baby Gift, Baby Gifts for New Born, Baby...",Warehouse C,426,389,2025-02-28 18:17:00,37
2959,ORD_2960,5745,EIMOIE Unisex's Regular fit Romper Suit,Warehouse B,110,64,2025-02-28 18:05:00,46
2960,ORD_2961,6178,Curatio Baby Spoo Shampoo 125ml,Warehouse A,443,407,2025-02-28 04:14:00,36
2961,ORD_2962,6177,Portable Baby Toddler Nasal Aspirator Vacuum Sucker Soft Tip Cleaner Nose Mucus Cleaner Snot Sucker Pump - Pack of 1,Warehouse A,382,370,2025-02-28 09:41:00,12
2962,ORD_2963,6176,"Zemic Double Sided Water Proof Baby Play Mat - Play mats for Kids Large Size, Baby Carpet, Play mat Crawling Baby (Extra L...",Warehouse B,261,220,2025-02-28 09:59:00,41
2963,ORD_2964,25974,Sebamed Baby Rash Cream 100 Ml |With Olive Oil and Allantoin| For delicate skin,Warehouse B,293,253,2025-02-28 12:44:00,40
2964,ORD_2965,6169,Kemendra New Baby Nail File Electric || Baby Nail Trimmer with 6 Grinding Heads Safe for Newborn Baby Baby Nail Clippers w...,Warehouse B,372,351,2025-02-28 10:00:00,21
2965,ORD_2966,25986,"Haoser Baby Milestone Cards, Wooden Milestone Signs, Monthly Photos, Baby Shower Gift, Newborn Photo Props, Baby Monthly M...",Warehouse B,252,227,2025-02-28 06:19:00,25
2966,ORD_2967,6167,"SafeMyles Foldable Baby Mosquito Net, Bottomless Net for Baby, for Safe & Easy Use | Ensures Your Baby's Safe Sleep - Upto...",Warehouse A,428,402,2025-02-28 20:46:00,26
2967,ORD_2968,6166,Decals Design StickersKart Wall Stickers Kids Giraffe Height Chart Removable Large Vinyl (Multi-Colour),Warehouse B,40,35,2025-02-28 23:50:00,5
2968,ORD_2969,26001,Himalaya Gentle Baby Soap 125GM,Warehouse C,314,296,2025-02-28 14:19:00,18
2969,ORD_2970,5978,KNITROOT Unisex Baby Bodysuit for Toddler Half Sleeve White Color Showered With Love By My Nana,Warehouse B,339,325,2025-02-28 17:00:00,14
2970,ORD_2971,26347,LUNJIYA Punjabi Kids Juti Multicolor Baby Product,Warehouse A,348,324,2025-02-28 08:25:00,24
2971,ORD_2972,26712,U.S. POLO ASSN. Baby-Boys Regular Fit Jeans(UKJN5505_Dark Blue_18 Months-24 Months),Warehouse C,305,259,2025-02-28 04:56:00,46
2972,ORD_2973,26717,Tippy Toes Baby Girls Gold Synthetic Shoe,Warehouse A,103,74,2025-02-28 19:34:00,29
2973,ORD_2974,5768,Sahiba Gems Exclusive 925 Sterling Silver 4 Ball Silver Beads and Black Cotton Thread Nazariya for Babies ~ Pack in 2 Pcs...,Warehouse A,170,146,2025-02-28 16:35:00,24
2974,ORD_2975,26722,"Aenon Fashion Boy's and Girl's Cotton Colorful Socks (Multicolor, Pack of 24 Pairs)",Warehouse B,179,171,2025-02-28 15:13:00,8
2975,ORD_2976,26002,"Ash & Roh Nylon Headbands Chiffon Flower Soft Stretchy Hair Band Hair Accessories for Newborns, Infants, Toddlers and Baby...",Warehouse B,466,455,2025-02-28 21:34:00,11
2976,ORD_2977,6183,Passion Petals Sequence Sandals with Bow for Girls-Gold,Warehouse A,317,279,2025-02-28 22:41:00,38
2977,ORD_2978,25948,R C SARKAR JEWELLERS Sterling Silver Kajal Lata for Children,Warehouse B,214,168,2025-02-28 06:12:00,46
2978,ORD_2979,25949,Chicco Baby Moments Nappy Cream 100ml,Warehouse A,34,28,2025-02-28 17:23:00,6
2979,ORD_2980,6155,Game Begins Boys Co-ordinated Sets Relaxed Pajama,Warehouse B,141,104,2025-02-28 09:13:00,37
2980,ORD_2981,26017,Mother Sparsh 98% Pure Water Wipes | Plant Based | pH Balanced | 60 Pcs (Pack of 1),Warehouse B,430,397,2025-02-28 08:45:00,33
2981,ORD_2982,26019,"BabyChakra Baby Sunscreen, SPF 30+ PA+++ UVA/UVB Protection Non-Sticky & Water-Resistant, Toxin Free Dermatologically Test...",Warehouse A,464,424,2025-02-28 02:57:00,40
2982,ORD_2983,26023,Little Surprise Box Pink 0 to 12 months Baby Girl Gift Toy Wooden Pram Hamper,Warehouse C,376,369,2025-02-28 21:36:00,7
2983,ORD_2984,26040,HAPPU COLLECTION printed kids boot (white) 5c,Warehouse A,374,346,2025-02-28 04:25:00,28
2984,ORD_2985,26011,Lillypupp New Born Baby high Ankle furr Boots Shoes for Girl (Size 6-9 Months),Warehouse B,308,270,2025-02-28 22:49:00,38
2985,ORD_2986,26051,Hopscotch Boys and Girls PU Athletics Shoes for Kids in Red Color,Warehouse C,541,497,2025-02-28 12:39:00,44
2986,ORD_2987,26053,Bold N Elegant Big Happy Smiley Face Tricolor Half Sleeve T-shirt & Shorts Summer Clothing Set for Infant Toddler Kids,Warehouse C,373,359,2025-02-28 02:24:00,14
2987,ORD_2988,26056,Aveeno Twin Pack,Warehouse B,286,259,2025-02-28 03:00:00,27
2988,ORD_2989,6131,Max Girls Floral Printed Round Neck T-Shirt,Warehouse A,317,312,2025-02-28 12:38:00,5
2989,ORD_2990,26069,Baby's Extra Care Pant Diapers (XXXL) 50 Count,Warehouse C,42,12,2025-02-28 07:45:00,30
2990,ORD_2991,26042,"Luv Lap Naturals 100% Natural Baby Toothpaste 50g, Strawberry Flavour, SLS & Fluoride Free Kids Toothpaste, Removes Plaqu...",Warehouse B,307,267,2025-02-28 04:17:00,40
2991,ORD_2992,26010,HUMSAFAR Waterproof Mattress Protector-Water Proof Rubber Bed Sheet for Baby & Adult/Water Resistant Urine Mat/Oil Cloth/M...,Warehouse B,148,136,2025-02-28 01:54:00,12
2992,ORD_2993,26728,GOURAVSUMANA Baby Boys & Baby Girl's Stylish Soft Cotton Bath Towel (Multicolor) Pack of 3,Warehouse C,207,190,2025-02-28 12:05:00,17
2993,ORD_2994,6227,"Mamaearth Moisturizing Baby Bathing Soap Bar, Ph 5.5, With Goat Milk & Oatmeal. Pack Of 2, 75Gms Eac And Mamaearth Bathing...",Warehouse C,119,75,2025-02-28 23:16:00,44
2994,ORD_2995,5789,Mother Sparsh 98% Water Based Scented Wipes I Plant derived Fabric I mild Scented I 80 Pcs/Pack - Pack of 5,Warehouse A,275,234,2025-02-28 22:41:00,41
2995,ORD_2996,5783,Crawl'in Baby Panty for Boys and Girls Reusable Waterproof with Soft Lining Inside Absorbable Plastic Outside- Colorful Pr...,Warehouse B,449,429,2025-02-28 10:06:00,20
2996,ORD_2997,5747,YouGotPlanB Boy's Cotton Hunger Games Briefs - (Set of 3),Warehouse C,213,170,2025-02-28 18:02:00,43
2997,ORD_2998,5744,DHRUVS COLLECTION Silver Black Bead Nazariya Kada for Unisex - Child (Black),Warehouse C,322,280,2025-02-28 14:04:00,42
2998,ORD_2999,5687,Shiyara Jewells 92.5 Sterling Silver Black Bead Crystal Nazariya for kids NZ00002,Warehouse A,374,344,2025-02-28 21:06:00,30
2999,ORD_3000,26867,Donum Body Wash Tear Free for Babies with Green Apple Argan Oil & Vitamin F Chemical Free - 220 Ml,Warehouse B,496,453,2025-02-28 22:05:00,43
3000,ORD_3001,5678,Little's Organix Gentle Baby Powder I Enriched wIth Organic Ingredients - Neem & Aloe Vera extracts I Free from Parabens &...,Warehouse B,258,232,2025-02-28 18:31:00,26
3001,ORD_3002,5671,"Neska Moda 6 To 12 Months Baby Girls Cotton Butterfly Frill Booties (Baby Pink,Blue) -SK144andBT40",Warehouse C,472,459,2025-02-28 04:57:00,13
3002,ORD_3003,26860,"Neska Moda 0 To 6 Months Baby Boys & Baby Girls Cotton Rabbit Booties (Red,Black) -BT382andBT372",Warehouse C,377,352,2025-02-28 21:05:00,25
3003,ORD_3004,26891,Dressably Muslin Cotton Face Towels for Newborn Baby Extra Soft Hankies Reusable Napkins for Infants Toddlers (Pack of 5)...,Warehouse B,264,237,2025-02-28 06:05:00,27
3004,ORD_3005,26894,BABY FASHION ® MY BABY GIRL FRILL/LACE SOCKS (PACK OF 6 PAIRS) (Multi Color Assorted),Warehouse A,462,421,2025-02-28 21:29:00,41
3005,ORD_3006,26912,kerwa Combo Pack of 3 Soft Winter Woolen Monkey Cap for Baby | Baby Knit Hat | Baby Girls Boys Winter Hat | Woolen Cap for...,Warehouse A,42,24,2025-02-28 05:50:00,18
3006,ORD_3007,26915,"Nestlé CERELAC Baby Cereal with Milk - Ragi Apple (From 8 Months) - BIB Pack, 300g",Warehouse A,250,210,2025-02-28 17:23:00,40
3007,ORD_3008,5786,BabyNeeds Baby Cotton Unisex Full Sleeve Winter Hooded Jacket/reversible Jackets for Toddler Girls & Boys…,Warehouse A,65,36,2025-02-28 13:53:00,29
3008,ORD_3009,26677,SHAMPOO NAT SENS 300ML INTL,Warehouse C,390,342,2025-02-28 01:53:00,48
3009,ORD_3010,5757,Child Chic Premium Powder Puff with Powder Storage Powder Case with Puff (Blue) (WHITE),Warehouse C,444,427,2025-02-28 17:22:00,17
3010,ORD_3011,26752,Hopscotch Girls Cotton Floral Print Underwear in Red Color,Warehouse A,384,368,2025-02-28 12:31:00,16
3011,ORD_3012,26766,"FunBlast Robot Theme Cap for Kids - Kids Cap Hat for Boys Girls Toddlers, Cartoon Cap for 3 to 12 Years Old Kids, Cap for ...",Warehouse B,327,285,2025-02-28 09:47:00,42
3012,ORD_3013,26635,"ambitieux Panda Cartoon Cap for Child Baby boy or Girl of Age 1 to 3"" Years with Sunshade Summer caps",Warehouse B,499,470,2025-02-28 01:05:00,29
3013,ORD_3014,26641,CEE 18 Women's Cotton Non-Padded and Non-Wired Maternity Nursing Bra for Women's | Adjustable Shoulder Straps | Post Pregn...,Warehouse C,408,399,2025-02-28 09:34:00,9
3014,ORD_3015,26644,baby wish Birthday gifted to Baby Bodysuits Newborn birthday Romper Half Sleeve Envelope Neck Cute Outfit My Third Helicopter,Warehouse A,156,134,2025-02-28 20:09:00,22
3015,ORD_3016,26661,"First Kick Baby Boy's and Baby Girl's Luxury Flannel Wrap Sheet All Season Blanket, Wrapping Sheet, Baby Blanket for Babie...",Warehouse A,247,239,2025-02-28 07:23:00,8
3016,ORD_3017,26667,Fareto New Born Baby Gift Pack Teddy Print Mattress with Mosquito Net & Sleeping Bag Combo (Blue),Warehouse B,248,208,2025-02-28 09:19:00,40
3017,ORD_3018,25880,FK_Terry_Bath_Towels_Combos,Warehouse C,105,80,2025-02-28 04:26:00,25
3018,ORD_3019,26134,"Himalaya Gift Pack & Himalaya Extra Moisturizing Baby Soap (75g, Buy 3 + 1 Free)",Warehouse B,396,388,2025-02-28 07:05:00,8
3019,ORD_3020,6116,"KNITROOT Half Birthday Unisex Baby Romper Whilte Color Half Sleeve"" Half Birthday"" (9-12 Months, KSBR28-4)",Warehouse B,299,284,2025-02-28 23:13:00,15
3020,ORD_3021,26209,Sahiba Gems Exclusive Silver Baby Kada/Bangle Rudraksh Swastik Design (Chandi Kada),Warehouse B,407,396,2025-02-28 13:37:00,11
3021,ORD_3022,26217,"BabyChakra 99% Bamboo Water Soft Baby Wipes with Lid, Alcohol-Free 100% Natural Ingredients Dermatologically Tested, Made ...",Warehouse C,309,279,2025-02-28 05:40:00,30
3022,ORD_3023,26292,"BabyOrgano Hing Roll On for Colic, Constipation and Indigestion in Infants and Kids -100% Ayurvedic (40ml)",Warehouse B,385,373,2025-02-28 22:06:00,12
3023,ORD_3024,26303,Baby Boys & Baby Girls Regular Shorts V2 (Pack of 10),Warehouse B,258,247,2025-02-28 04:40:00,11
3024,ORD_3025,26320,Bubblegummers Girl's Walter First Walking Shoes,Warehouse C,541,492,2025-02-28 04:58:00,49
3025,ORD_3026,26322,Zacharias Boy's Kids Cotton Golf Cap (100033-kids_Black_8-14 Years),Warehouse A,274,234,2025-02-28 01:06:00,40
3026,ORD_3027,26324,VILRO Rubber Crocodile Bath Toy (Green),Warehouse B,414,380,2025-02-28 09:24:00,34
3027,ORD_3028,5987,"OREAYU™ Finger Toothbrush With Storage Case, Tongue Cleaner for Baby Teething/Gums, Food Grade Silicone Teeth Cleaner Oral...",Warehouse C,441,393,2025-02-28 07:00:00,48
3028,ORD_3029,5986,Sahiba Gems Exclusive Centre Silver Plated Heart Shape Bead and Black Stretchable Nazariya for Babies ~ Pack in 2 Pcs (Saf...,Warehouse B,128,99,2025-02-28 00:54:00,29
3029,ORD_3030,5984,ATORSE Baby Summer Shoes Sandals Anti-Slip Soft Sole 0-18M 7-12Months Pink,Warehouse B,376,341,2025-02-28 03:58:00,35
3030,ORD_3031,5983,"LOVEY DOVEY Soft Toys Long Soft Lovable hugable Cute Giant Life Size (Pig Set, 4pcs)",Warehouse B,383,343,2025-02-28 04:18:00,40
3031,ORD_3032,5980,"Wobbox Pregnancy Milestone Cards, Grey & Doodle Fonts, Pregnancy Journey, Weeks Growth Milestone Cards, Pregnancy Gift Scr...",Warehouse B,194,182,2025-02-28 17:32:00,12
3032,ORD_3033,6041,Fflirtygo Baby Wear 100% Hosiery Cotton Infants Jumpsuit/Rompers Half Sleeves/Onesies/Body Suit/Sleepsuit with Envelop Nec...,Warehouse B,412,364,2025-02-28 17:15:00,48
3033,ORD_3034,6007,"Luv Lap Baby & Mother Electric Nail Trimmer, Filer Cum Manicure Set, Ergonomic Design, Safe for Baby/Kid, Nail Filer and G...",Warehouse B,427,379,2025-02-28 08:02:00,48
3034,ORD_3035,6011,Mee Mee Bundle of Joy Gift Set for New Born Baby with Baby Bathing kit and Wet Wipes,Warehouse B,453,445,2025-02-28 20:25:00,8
3035,ORD_3036,6105,Himalaya Baby Hair Oil 200 ml(1 Count),Warehouse B,27,18,2025-02-28 15:41:00,9
3036,ORD_3037,26223,Shadow Securitronics 45 ML Happy Nights Lemon-Eucalyptus Oil Based Liquid Vaporizer with Machine & 100 ML Mosquito Repelle...,Warehouse B,284,269,2025-02-28 07:06:00,15
3037,ORD_3038,6093,Haus Alchemy Anti-Slip Grip Sturdy Bathroom Western Toilet 2 Step Potty Stool Trainer for Boys & Girls with Safety Handles...,Warehouse B,445,409,2025-02-28 20:41:00,36
3038,ORD_3039,26176,Mothercare All We Know Baby Lotion 300ml,Warehouse A,173,127,2025-02-28 01:42:00,46
3039,ORD_3040,6054,"Busy Kid Swing Seat for Kids, Age 3 to 10 Years with Hand Grip (Blue)",Warehouse B,308,261,2025-02-28 18:00:00,47
3040,ORD_3041,26200,Mothercare Unisex Round Neck Printed Bodysuit,Warehouse A,297,270,2025-02-28 21:55:00,27
3041,ORD_3042,6087,Mee Mee Mild Baby Shampoo (with Fruit Extracts - 500 ml) & Mee Mee Baby Lotion With Fruit Extracts- 200 ml (Single Pack),Warehouse C,322,281,2025-02-28 05:54:00,41
3042,ORD_3043,26092,BENKILS Baby Girl's Denim Skirt Top Dresses White and Blue,Warehouse C,385,360,2025-02-28 15:35:00,25
3043,ORD_3044,26096,The ChipmunK Store’s Premium Combo for Baby and Adult - (Pink powder puff & Pink makeup puff),Warehouse C,403,386,2025-02-28 07:17:00,17
3044,ORD_3045,26098,"Gilli Shopee 360 Degrees Rotation Cleaner Long Straw Brush for Babies,Straw Cleaning Brush | Straw Cleaning Brush for Stra...",Warehouse C,487,447,2025-02-28 23:28:00,40
3045,ORD_3046,6107,"Neska Moda 12 To 18 Months Baby Girls Cotton Butterfly Booties (Black,Red) -BT1147andBT1150",Warehouse A,158,135,2025-02-28 03:17:00,23
3046,ORD_3047,26106,Munchkin White Hot Inflatable Safety Duck Tub,Warehouse C,160,151,2025-02-28 14:41:00,9
3047,ORD_3048,26137,"Neska Moda 6 To 12 Months Baby Boys & Baby Girls Cotton Lace Shoes/Booties (Maroon,Yellow) -SK148andBT80",Warehouse C,116,87,2025-02-28 17:49:00,29
3048,ORD_3049,26124,MAHAKAAL JEWELS® Mix Metal Adjustable Kids Bangle Bracelet Free Size Nazariya for Unisex Babies Kids Jewellery Set of 2 (1...,Warehouse A,533,494,2025-02-28 11:09:00,39
3049,ORD_3050,6035,Urdhva Retail 2 Pieces Kids Infant Foot Rattle Socks (1 Pair Socks only),Warehouse B,461,450,2025-02-28 19:27:00,11
3050,ORD_3051,25866,"BAYBEE Baby Chair, with Tray Strong and Durable Plastic Chair for Kids/Plastic School Study Chair/Feeding Chair for Kids,P...",Warehouse A,384,344,2025-02-28 09:07:00,40
3051,ORD_3052,6195,"Chicco Baby Moments Mild Body Wash Relax, New Advanced Formula with Natural Ingredients, No Tears & Soap-Free, Mild formul...",Warehouse B,418,374,2025-02-28 19:37:00,44
3052,ORD_3053,25936,Rgk's Baby Girls' Bootie,Warehouse A,529,492,2025-02-28 20:48:00,37
3053,ORD_3054,25939,Chicco 500ml Body Lotion,Warehouse C,62,24,2025-02-28 09:14:00,38
3054,ORD_3055,25941,"Remote Control Dinosaur Toys for Kids 3 4 5 6 7, Mosasaurus Diving Toys RC Boat with Light and Spray Water for Swimming Po...",Warehouse B,327,297,2025-02-28 11:58:00,30
3055,ORD_3056,25943,HIVER Adult Woollen Leg Warmers Women Winter Warm Fur Long Leg Warmers Over Knee High Footless Socks- Unisex,Warehouse A,220,172,2025-02-28 12:57:00,48
3056,ORD_3057,6185,"Little's Easy Dry Cotton Bed Protector - Small, Multicolor",Warehouse B,147,130,2025-02-28 13:13:00,17
3057,ORD_3058,25886,MINI KLUB Boy's Regular Fit T-Shirt,Warehouse A,100,70,2025-02-28 02:26:00,30
3058,ORD_3059,25883,"Johnson's Baby Bath Top To Toe Baby Bath For New Born Combo Offer Pack, 2 x 500ml",Warehouse A,74,49,2025-02-28 12:24:00,25
3059,ORD_3060,25823,"Vicks BabyRub 25ml, Specifically for Babies-Moisturize, Soothe and Relax your baby",Warehouse C,424,386,2025-02-28 17:57:00,38
3060,ORD_3061,6252,Funvention DIY Spinning Top Kits (Solar System) - Pack of 18 (2 DIY Spinning Tops Per Pack + Free Colors) - STEM Learning ...,Warehouse A,446,423,2025-02-28 23:11:00,23
3061,ORD_3062,25835,Neska Moda Baby Boys and Girls Pack Of 2 Pair Pink and Black Baby Booties for 0 to 6 Months,Warehouse B,94,72,2025-02-28 03:56:00,22
3062,ORD_3063,6238,Fancy Bow Lace Baby/Kids Hairband/Headband for Girls (WHITE),Warehouse A,254,228,2025-02-28 04:51:00,26
3063,ORD_3064,6219,"Himalaya Extra Moisturizing Baby Lotion 400 ml, White, (7004789) & Baby Powder (400g)",Warehouse C,370,336,2025-02-28 13:13:00,34
3064,ORD_3065,25856,"Little Peaches Baby Clothing Set, Rompers/Jumpsuits/Bodysuits/Onesies for Newborns, Baby Set, 100% Cotton, Premium Fabric,...",Warehouse B,121,108,2025-02-28 09:45:00,13
3065,ORD_3066,25861,Prime Deals Monkey Heavy Plastic Ball Drop Toy for Babies and Toddlers | New 5 Layer Tower Run with Swirling Ramps and 3 P...,Warehouse B,73,63,2025-02-28 04:04:00,10
3066,ORD_3067,25927,DULCI® Silver Tone Tradtional Ethnic Ghungroo Bells Free Size Adjustable Kids Kada Bangle Anklet Nazaria Jewellery for New...,Warehouse C,437,401,2025-02-28 07:41:00,36
3067,ORD_3068,25890,Hamdard Safi Blood Purifier Syrup Skin Care Pimple Free for Natural Glowing Skin 500 ml,Warehouse C,406,381,2025-02-28 11:09:00,25
3068,ORD_3069,26229,Hopscotch Boys Cotton Full-Sleeve All-Over Print Tees - Pack of 3 in Multi Color,Warehouse C,435,429,2025-02-28 23:16:00,6
3069,ORD_3070,26232,Guru Kripa Baby Products Kids Toothbrush Oral Care Toy Head Tooth Brush Bpa Free Gentle to Teeth and Gums Cute Animal Char...,Warehouse B,370,325,2025-02-28 18:57:00,45
3070,ORD_3071,26238,"Nivihsa : Handmade Baby girl Booties with headband Gift, Ideal for 3-6 Month (Insole lenght 10cm) - 100% Cotton Yarn - purple",Warehouse B,128,100,2025-02-28 18:06:00,28
3071,ORD_3072,26251,Brigand Fashion Silicone Oral 360 Degree Teeth Cleaning Baby Brush U Shaped Soft Toothbrush for Small Kids (Multi-color) (...,Warehouse B,510,498,2025-02-28 11:15:00,12
3072,ORD_3073,6021,Khadi Natural Baby Shampoo With Rice & Triphala 200ml,Warehouse B,475,437,2025-02-28 17:22:00,38
3073,ORD_3074,26259,Himalaya Refreshing Baby Wash 400 ml and Himalaya Baby Massage Oil (500ml),Warehouse A,142,95,2025-02-28 06:38:00,47
3074,ORD_3075,26262,baby wish Holi Baby Bodysuits Newborn Romper Half Sleeve Envelope Neck Cute Outfit WATER GUN HOLI,Warehouse B,249,212,2025-02-28 22:01:00,37
3075,ORD_3076,26263,"Ducosoft Baby Shampoo, 100 ML",Warehouse A,432,412,2025-02-28 11:58:00,20
3076,ORD_3077,26268,Pigeon Training Toothbrush L-3 (Lime Green),Warehouse A,197,192,2025-02-28 01:16:00,5
3077,ORD_3078,26271,"Himalaya Baby Lotion (400ml) & Himalaya Extra Moisturizing Baby Soap (75g, Buy 3 Get 1 Free)",Warehouse B,493,475,2025-02-28 00:32:00,18
3078,ORD_3079,26272,ANAVI DIPANYA SHOPPE Baby Boy's & Baby Girl's Soft Woolen Winter Warm Kids Hand Gloves (Multicolor; Pack of 1 pair) (1-2 Y...,Warehouse B,494,453,2025-02-28 08:47:00,41
3079,ORD_3080,26256,"Neska Moda 0 To 6 Months Baby Boys & Baby Girls Pack Of 2 Pair Cotton Butterfly Frill Booties (Black,Yellow) -BT1115andBT1139",Warehouse A,375,349,2025-02-28 01:51:00,26
3080,ORD_3081,25892,Gowri baby-girls Baby Dress,Warehouse C,455,424,2025-02-28 17:16:00,31
3081,ORD_3082,25894,Saumabhi PU Tassel Snow Boots Warm Baby Shoes,Warehouse B,128,79,2025-02-28 03:22:00,49
3082,ORD_3083,25895,"The Moms Co. Natural Baby Massage Oil with 10 Oils - 200 ml & Natural Baby Lotion, Australia-Certified with Organic Aprico...",Warehouse C,443,409,2025-02-28 16:52:00,34
3083,ORD_3084,25897,Kuber Industries Baby Face Towel|Extra Soft Cotton Fill Reusable Napkins|Coral Fleece Baby Face Hankies for Infants and To...,Warehouse A,59,35,2025-02-28 00:50:00,24
3084,ORD_3085,25899,Coolz Kids Chu-Chu Sound Musical First Walking Shoes Star-7 for Baby Boys and Baby Girls for 9-24 Months,Warehouse C,208,183,2025-02-28 22:48:00,25
3085,ORD_3086,30925,Mother's Choice Baby Boy's Romper Suit,Warehouse B,400,372,2025-02-28 04:18:00,28
3086,ORD_3087,15803,SuperBottoms Cloth Diapers for babies - UNO Super Value Combo pack - 6 Freesize UNO- New Version| Reusable Cloth Diapers f...,Warehouse C,453,421,2025-02-28 04:02:00,32
3087,ORD_3088,16210,"Neska Moda 0 To 6 Months Baby Boys & Baby Girls Pack Of 2 Pair Cotton Butterfly Frill Booties (Black,Rani Pink) -BT1115and...",Warehouse A,394,364,2025-02-28 05:35:00,30
3088,ORD_3089,16211,"FreshFoot Cute and Colourful New Born Baby socks Set 0 to 12 months, Combo set-3 Pairs socks, 3 Pairs Head-caps, 3 pairs h...",Warehouse B,62,54,2025-02-28 15:49:00,8
3089,ORD_3090,15993,"Neska Moda 6 To 12 Months Baby Boys & Baby Girls Cotton Rabbit Booties (Rani,Black) -SK126andSK147",Warehouse C,437,399,2025-02-28 02:47:00,38
3090,ORD_3091,15990,Baby's Pride Girls Baby Knoted Frock,Warehouse B,72,34,2025-02-28 14:12:00,38
3091,ORD_3092,15785,Donuts Baby Girl's Cotton Leggings (281272790_Assorted_12M,Warehouse A,281,273,2025-02-28 04:50:00,8
3092,ORD_3093,15795,Gini & Jony Palm Tree Baby Boys' Regular Fit Shorts(131246510911 6000_Stone Wash(6000)_18-24 Months) Blue,Warehouse B,312,290,2025-02-28 04:27:00,22
3093,ORD_3094,12000,"Olay Natural Aura Vitamin B3, Pro B5, E With Uv Protection, 40g",Warehouse C,350,331,2025-02-28 15:41:00,19
3094,ORD_3095,11999,Nagar International Baby Bassinet & Cradle Bedding Set in Large Size Mosquito Net for 0-24 Months (Blue (0-24 Months)),Warehouse A,236,194,2025-02-28 12:25:00,42
3095,ORD_3096,15783,QYOOTY Denim Blue Jeans Handbag Shoulder Purse For Office And For Casual Use,Warehouse C,297,271,2025-02-28 02:36:00,26
3096,ORD_3097,15809,Alokik Enterprise Wind Up Swimming Tortoise Bath Toy | Toddlers Swimming Floating Playing Toy in Bathroom Beach Pool | Col...,Warehouse B,386,338,2025-02-28 14:14:00,48
3097,ORD_3098,11994,PartyToko Printed caps for Baby Theme Based Birthday Party Baby Printed caps Combo (Pack of 10 Caps),Warehouse B,135,109,2025-02-28 10:56:00,26
3098,ORD_3099,15821,HIKUJ Baby Girl’s A-Line New Flower Printed Frock Dress for Kids Girls,Warehouse C,486,442,2025-02-28 00:52:00,44
3099,ORD_3100,15827,"Nestlé CERELAC Baby Cereal with Milk, Multigrain Dal Veg – From 12 Months, 300g BIB Pack",Warehouse C,447,440,2025-02-28 21:01:00,7
3100,ORD_3101,15834,"Aringel Real Sleep Citronella Mosquito Repellent Herbal Incense Sticks (10 Pouches, total 120 Sticks, 30.5 cm)",Warehouse A,122,79,2025-02-28 06:24:00,43
3101,ORD_3102,15837,Big scale Classy Designer Bodysuit Solid Baby Boys and Baby Girls Dress Dungaree Set with Shirt and Bow Tie,Warehouse B,418,394,2025-02-28 21:39:00,24
3102,ORD_3103,15815,INFANTSO Baby Rocker Portable With  Mosquito & U- Shape Baby Pillow With Calming Vibrations with Music & Musical Toy BLUE,Warehouse A,212,196,2025-02-28 14:39:00,16
3103,ORD_3104,16199,"Himalaya Baby Powder, 700g and Herbals Lotion (400ml) Combo",Warehouse B,383,363,2025-02-28 13:45:00,20
3104,ORD_3105,11757,"BEEBABY Soft Silicone Spout Sippy Cup with Detachable Handle, 100% BPA Free and Leak Proof Sipper for 9 Months Toddlers an...",Warehouse B,156,122,2025-02-28 07:16:00,34
3105,ORD_3106,11741,Walktrendy Baby-Girl's Booties,Warehouse B,200,183,2025-02-28 23:27:00,17
3106,ORD_3107,16262,Hopscotch Baby Girls Cotton Start Printed Full Sleeves Hoodie and Pant Set in Black Color for Ages 9-12 Months,Warehouse B,486,469,2025-02-28 21:44:00,17
3107,ORD_3108,16264,PATPAT Wooden Vintage Music Box Hand Crank Music Box Wooden Music Box Gift Vintage Can't Help Falling in Love Engraved Mus...,Warehouse A,298,268,2025-02-28 17:19:00,30
3108,ORD_3109,16269,Hopscotch Girls EVA Floral Applique Infant Booties in White Color,Warehouse B,375,326,2025-02-28 21:41:00,49
3109,ORD_3110,16271,"Himalaya Baby Powder, 700g & Himalaya Baby Lotion 700ml",Warehouse A,210,169,2025-02-28 08:59:00,41
3110,ORD_3111,16273,"Chicco Baby Oral Pack 12m+ (Tooth Brush, Toothpaste 50ml and Soap 75gms)",Warehouse A,325,276,2025-02-28 10:21:00,49
3111,ORD_3112,16280,Baby Collection Baby Boy's & Girl's Cotton Front Open Vest Jhabla Perfect for Summer Wear Kids T-Shirt Baby Sando Innerwea...,Warehouse B,430,395,2025-02-28 11:09:00,35
3112,ORD_3113,16222,"BABY ARISE Cotton Muslin Baby wash Cloth/Wipes-4 Layers, Absorbent Washcloths and Napkins,Our Ultra-Soft and Gentle wash C...",Warehouse C,171,138,2025-02-28 23:45:00,33
3113,ORD_3114,16213,"Neska Moda 6 To 12 Months Baby Girls Synthetic Leather Sandal Booties (Black,Pink) -BT1237andBT1277",Warehouse A,197,160,2025-02-28 13:06:00,37
3114,ORD_3115,16186,Simply Baby Boys and Girls Panda Print Regular Towel,Warehouse C,351,320,2025-02-28 23:20:00,31
3115,ORD_3116,16187,United Colors of Benetton Boys' Regular Fit Striped Polo,Warehouse A,435,399,2025-02-28 12:47:00,36
3116,ORD_3117,16219,GR Fashion Baby Girls Party Dress with Hat,Warehouse A,376,348,2025-02-28 01:14:00,28
3117,ORD_3118,16190,"First Kick Baby Blankets Newborn Combo Pack of Super Soft Bathrobe Baby Wrapper Cum Baby Bath Towel for Baby Boys, Baby Gi...",Warehouse B,203,188,2025-02-28 08:48:00,15
3118,ORD_3119,15838,"Rompers/Sleepsuits/Jumpsuit/Night Suits for Baby Boys & Girls, Infants, New Borns",Warehouse A,408,365,2025-02-28 05:49:00,43
3119,ORD_3120,15782,"VENUSIA Dr Reddy's Venusia Baby Intensive Moisturizing Lotion for Dry and Ultra dry Skin Contains Cocoa, Aloe, Mango & She...",Warehouse C,495,490,2025-02-28 05:12:00,5
3120,ORD_3121,15931,"Neska Moda 12 To 18 Months Baby Boys & Baby Girls Pack Of 2 Pair Cotton Butterfly Frill Booties (Maroon,Black) -BT1143andB...",Warehouse B,60,19,2025-02-28 17:19:00,41
3121,ORD_3122,11901,Bold N Elegant Kid's Fun Cartoon Random Print Winter Warm Fleece Sweatshirt Hoodie for Infant Toddler Baby Boy and Girl,Warehouse A,84,77,2025-02-28 09:18:00,7
3122,ORD_3123,11899,Karrot by Shoppers Stop Printed Poly Blend Crew Neck Infant Girls Dress (S21700PDRS904-P),Warehouse A,424,382,2025-02-28 14:14:00,42
3123,ORD_3124,15977,House of Quirk Baby Diaper Bag Maternity Backpack,Warehouse A,163,140,2025-02-28 18:53:00,23
3124,ORD_3125,15978,Chicco Baby Nail Scissor (Blue),Warehouse B,342,294,2025-02-28 08:44:00,48
3125,ORD_3126,15986,baby wish Holi Baby Bodysuits Newborn Romper Half Sleeve Envelope Neck Cute Outfit GULAL WALI HOLI,Warehouse C,419,404,2025-02-28 18:37:00,15
3126,ORD_3127,11891,Neska Moda Unisex Baby Booties,Warehouse C,345,308,2025-02-28 13:13:00,37
3127,ORD_3128,15930,Nino Bambino 100% Organic Cotton Off White Casset Printed Sleeveless Round Neck Snap closure Bodysuit / Half Romper / Ones...,Warehouse C,195,164,2025-02-28 00:34:00,31
3128,ORD_3129,15929,"Infantbond New Born Baby Elastic Free Tying Mittens | Gloves(Pack of 6 Pairs)(Multicolor,0-6 Months)",Warehouse A,469,459,2025-02-28 23:58:00,10
3129,ORD_3130,15922,"Neska Moda 12 To 18 Months Baby Boys & Baby Girls Pack Of 2 Pair Cotton Butterfly Frill Booties (Maroon,Orange) -BT1143and...",Warehouse C,372,345,2025-02-28 06:26:00,27
3130,ORD_3131,11976,KATS POWER Kids Baby Boy and Girls Walking Sandal,Warehouse B,325,285,2025-02-28 15:46:00,40
3131,ORD_3132,11974,"SYGA Baby, Infant and Toddler Blue Grooming Kit with Scissors - The Best Unique Baby Shower Gift for Girls and Boys",Warehouse A,135,103,2025-02-28 16:41:00,32
3132,ORD_3133,11965,Casual Fashion Baby Girls Lycra Short Skirt and Top Set | Casual 3/4 Sleeve T-Shirt Top & Skirt for Girls | Pleated Dungar...,Warehouse A,353,309,2025-02-28 23:11:00,44
3133,ORD_3134,11953,"Baybee Stainless Steel Baby Spoon Set for Baby Feeding, Non Toxic BPA Free Training Feeding Spoon & Fork Set, Food Grade S...",Warehouse B,134,90,2025-02-28 11:12:00,44
3134,ORD_3135,15963,Manan Shopee Baby Tongue Cleaning Hygienic & Flexible New Born Baby Soft Silicon Tounge Cleaner Finger Toothbrush & Baby N...,Warehouse C,461,446,2025-02-28 10:35:00,15
3135,ORD_3136,15949,Orange and Orchid Baby-Girl's Regular Fit Dress,Warehouse B,234,218,2025-02-28 01:07:00,16
3136,ORD_3137,15944,Hopscotch Girl's dress,Warehouse B,126,100,2025-02-28 08:37:00,26
3137,ORD_3138,12051,Bold N Elegant Aeroplane Printed Kids Half Sleeve PC Shirt and Bib Shorts Dungaree with Suspender for Infant Toddler Baby ...,Warehouse B,308,296,2025-02-28 23:17:00,12
3138,ORD_3139,15722,New Era Baby boy & Baby Girl Teddy Bear Dungaree Set with Tshirt 0-1 Year || Dress for Baby boy || Clothes for Baby boy an...,Warehouse B,243,227,2025-02-28 10:46:00,16
3139,ORD_3140,12043,THE BEST Jaamna for Newborn Baby Boy Red/Orange,Warehouse A,404,364,2025-02-28 06:40:00,40
3140,ORD_3141,15741,Neska Moda 6 To 12 Months Cotton and Fur Bear Print Baby Lace Booties -BT1442-GRP,Warehouse B,162,143,2025-02-28 06:55:00,19
3141,ORD_3142,15744,"TechKing Baby Nail Trimmer Electric Safe Baby Nail Clippers, Manicure Set, Trim Polish Grooming kit for Newborn Toddler or...",Warehouse A,151,137,2025-02-28 17:04:00,14
3142,ORD_3143,12031,Blacktail Briefs for Women,Warehouse B,369,362,2025-02-28 12:27:00,7
3143,ORD_3144,15756,Himalaya Gentle Baby Soap - 4x75g Pack,Warehouse C,427,382,2025-02-28 06:20:00,45
3144,ORD_3145,15766,"OYO BABY Baby Bed Protector Dry Sheet for New Born Babies (Medium (100cm x 70cm), Voilet)",Warehouse C,422,401,2025-02-28 12:13:00,21
3145,ORD_3146,11988,"Neska Moda 0 To 6 Months Baby Boys & Baby Girls Cotton Rabbit Booties (Mint,Red) -BT387andBT367",Warehouse A,113,69,2025-02-28 17:16:00,44
3146,ORD_3147,15846,"Buddsbuddy BPA Free Robo Cartoon Kids Soft BristlesTooth brush, 2yrs+ Multicolor (Combo of 4)",Warehouse B,229,218,2025-02-28 07:04:00,11
3147,ORD_3148,15943,"VIC Kid® Bed Rail Guard for Baby/Kids Safety, 178cm x 90cm, Portable & Foldable, Baby Safety Essential, Adjustable Height...",Warehouse B,510,481,2025-02-28 06:22:00,29
3148,ORD_3149,11749,Hopscotch Girls Cotton and Polyester Sleeveless Ruffled Floral Print Onesies in Purple Color,Warehouse B,298,266,2025-02-28 03:40:00,32
3149,ORD_3150,10944,SYGA Infant Children Girl Headwear Gift Cat Shaped Box Set Hairpin Princess Kids Flower Bow Knot Hair Clips Hair Accessori...,Warehouse C,55,49,2025-02-28 14:26:00,6
3150,ORD_3151,10919,Navratri Special Unisex Baby Romper White Color Half Sleeve Navaratri First Ashtami(6-9 Months),Warehouse A,375,349,2025-02-28 05:05:00,26
3151,ORD_3152,17634,"Calamine Powder (Rash, Eczema, Skin Problems & Disease) (125 gm)",Warehouse C,209,194,2025-02-28 19:47:00,15
3152,ORD_3153,10916,"Neska Moda 12 To 18 Months Baby Boys & Baby Girls Cotton Rabbit Booties (Red,Black) -BT1150andBT1181",Warehouse B,171,156,2025-02-28 12:01:00,15
3153,ORD_3154,10923,"DISNEY BY Jagannath Gangaram Pednekar Since 1965 18KT Yellow Gold, BABY BRACELET For Girls",Warehouse A,81,64,2025-02-28 07:00:00,17
3154,ORD_3155,17587,"BeyBee Bed Protector Sheet (Small (50cm X 70cm),Cotton,Salmon Rose)",Warehouse B,295,259,2025-02-28 18:18:00,36
3155,ORD_3156,10991,BLUE C Milk Powder Container for Baby 3 Layers Milk Powder Dispenser Portable Multi Functional Spill-Proof Baby Food Stora...,Warehouse A,454,447,2025-02-28 13:52:00,7
3156,ORD_3157,17525,"Neska Moda 0 To 6 Months Baby Boys & Baby Girls Cotton Lace Shoes/Booties (Orange,Yellow) -BT1113andBT1136",Warehouse C,536,496,2025-02-28 01:58:00,40
3157,ORD_3158,17534,R for Rabbit Baby Oil 100ml Pure & Beyond Cold pressed Almond & Coconut Oil for Hair & Massage Non Sticky with Quick Absor...,Warehouse A,260,220,2025-02-28 13:02:00,40
3158,ORD_3159,10976,Jordan Children 6-9 Years Kids toothbrush BPA Free toothbrush with Travel Case (White with Travel Case - 6-9 Years),Warehouse C,296,291,2025-02-28 04:51:00,5
3159,ORD_3160,10968,"Funskool Star Links, Multicoloured Interlocking Learning Educational Blocks, Improves Creativity And Construction Blocks F...",Warehouse C,172,163,2025-02-28 17:32:00,9
3160,ORD_3161,17625,Trendy Baby Boys & Baby Girls Shorts (Pack of 10),Warehouse C,467,424,2025-02-28 13:22:00,43
3161,ORD_3162,10963,"Khadi Abeers Aaradhya Baby Massage Oil, 225 ml",Warehouse C,356,335,2025-02-28 13:46:00,21
3162,ORD_3163,11074,Hopscotch Girls Cotton Polyester All-Over Print Blouse and Shorts Set in White Color,Warehouse A,406,386,2025-02-28 15:27:00,20
3163,ORD_3164,17419,HAPPU COLLECTION printed kids boot for girls (white) 4c,Warehouse B,89,72,2025-02-28 12:59:00,17
3164,ORD_3165,17422,"Bambo Nature Premium Baby Diapers - Medium Size, 28 Count, for Infant Baby - Super Absorbent, Eco-Friendly and with a Wetn...",Warehouse A,133,96,2025-02-28 18:15:00,37
3165,ORD_3166,17423,BODYSTYLE Super Ultra Cotton Bloomers for Baby Boys & Baby Girls (Pack of 6) - Made in India,Warehouse C,73,27,2025-02-28 03:49:00,46
3166,ORD_3167,11065,Himalaya Baby Massage Oil (Coconut) 100 ml,Warehouse A,37,14,2025-02-28 08:19:00,23
3167,ORD_3168,17453,"Softsens Baby Gentle Cloth Wipes with Aloe & Vitamin E, with Lid, 72 wipes (Pack of 3)",Warehouse A,434,386,2025-02-28 05:39:00,48
3168,ORD_3169,17438,Babyhug Super dry diaper pants (L),Warehouse C,59,33,2025-02-28 16:07:00,26
3169,ORD_3170,17442,M S Gold Premium Hosiery Cotton Printed Socks For Baby Boys & Girls Combo Pack of 6 Pairs (Multi-Colored),Warehouse B,188,144,2025-02-28 04:28:00,44
3170,ORD_3171,11048,R for Rabbit Large L Size Premium Feather Diaper for Baby 9 to 14 kgs (140 Combo Pack Offer),Warehouse A,201,192,2025-02-28 07:40:00,9
3171,ORD_3172,11047,Baby Bucket Baby Boy's Polyester;Cotton Panties (Pack of 3) (LVLY BBY 3PC TRAINER-12_Grey Hard Print_3 Count (Pack of 1)),Warehouse C,133,97,2025-02-28 05:50:00,36
3172,ORD_3173,10995,Avani MetroBuzz Baby Cradle Mosquito Net Jhula Palna Stroller Infant & Toddler Beds Born Baby 1-2 Years Babies-Newborn Bab...,Warehouse B,78,68,2025-02-28 10:48:00,10
3173,ORD_3174,10993,"KIDSKA Baby Soft Cotton Fabric Caps with Tai Knot, Multicolor, 3 to 6 Months, Pack of 6",Warehouse A,476,460,2025-02-28 15:52:00,16
3174,ORD_3175,17600,Medela Calma Breast Milk Feeding Nipple,Warehouse B,135,113,2025-02-28 22:16:00,22
3175,ORD_3176,17611,Mothercare baby-girls Clothing Set,Warehouse C,362,341,2025-02-28 16:31:00,21
3176,ORD_3177,10931,"Mylo Essentials Premium 3 in 1 Comfortable & Adjustable Newborn Baby Carrier Backpack with Padded Shoulder Strap, Sturdy B...",Warehouse A,443,400,2025-02-28 23:42:00,43
3177,ORD_3178,11751,"Little's Baby Pants Diapers with Wetness Indicator & 12 Hours Absorption, Small, White, 4 - 8 kg, 84 Count",Warehouse A,207,193,2025-02-28 15:01:00,14
3178,ORD_3179,11877,"FunBlast Teddy Cap with Ears for Kids - Cartoon Cap for 3 to 15 Years Old Kids, Kids Cap Hat for Boys Girls Toddlers, Cap ...",Warehouse C,231,203,2025-02-28 21:21:00,28
3179,ORD_3180,16011,ZIXAD U Shaped Toothbrush for Kids Manual Whitening Toothbrush Silicone Brush Head for Kids Children Infant Toothbrush For...,Warehouse B,228,190,2025-02-28 02:49:00,38
3180,ORD_3181,16037,BABYMOON Bubble Layer Basket/Stroller Filler Balnket Baby Photography Shoot Prop,Warehouse B,341,294,2025-02-28 11:50:00,47
3181,ORD_3182,11852,"Bembika,Multi-Colour,knotted headband for baby girl,Nylon Headband For Girls, Hairbands for Kids infant Headband, 6V",Warehouse B,451,435,2025-02-28 09:38:00,16
3182,ORD_3183,11844,"Shop4Dreams Soft/Thin/Light Weight Cotton Caps with Tie Knot and Bonnet Infant Unisex Hat/Topi Pack of 3 (Red,Yellow,Dark ...",Warehouse B,59,39,2025-02-28 06:48:00,20
3183,ORD_3184,16062,FASTMART Table Corner Protector for Kids Table Guards for Baby Child Safety Self Adhesive Clear Safety Guard Gel Table and...,Warehouse B,420,406,2025-02-28 19:04:00,14
3184,ORD_3185,11841,Mamaearth Natural Mosquito Repellent Gel 50ml. (Pack of 1) & Natural Anti Mosquito Body Roll On 40ml. (Pack of 1) & Anti M...,Warehouse A,433,411,2025-02-28 05:25:00,22
3185,ORD_3186,16069,Ci Baby Massage Oil 200 ml (Pack of 3),Warehouse C,230,192,2025-02-28 19:21:00,38
3186,ORD_3187,11883,"Pigeon Strawberry Toothpaste, For babies and Children,Fluroide -free,SLS free,Color free,Paraben Free, PH friendly,45 pack...",Warehouse C,362,337,2025-02-28 01:37:00,25
3187,ORD_3188,16162,"PINK WINGS Baby Girl Tutu Dress, First Birthday Tutu Dress",Warehouse A,146,112,2025-02-28 01:14:00,34
3188,ORD_3189,16232,PIKIPOO Printed Baby Vest for Kids Cotton Sleeveless Sando Baniyan Toddler Innerwear Baby Cloth for Boys & Girls Pack of 6,Warehouse A,170,121,2025-02-28 17:11:00,49
3189,ORD_3190,11828,OYO BABY Diaper Rash Cream for baby/Diaper Rash Cream 50gm,Warehouse A,164,149,2025-02-28 14:51:00,15
3190,ORD_3191,17564,Giffee Baby Towels / New Born / Kids / Hooded / Soft Cotton / Infants (Green || Yellow),Warehouse B,517,472,2025-02-28 07:42:00,45
3191,ORD_3192,16155,Bold N Elegant Cartoon Panda Bear Print Boys Cotton Linen Blend Shirt and Denim Shorts Set Little Baby Boy Clothing Party ...,Warehouse B,537,489,2025-02-28 11:18:00,48
3192,ORD_3193,10956,Kars Girl Baby Cotton Combo Dress for 6 Months - 3 Years(Pack of 3),Warehouse B,407,369,2025-02-28 16:24:00,38
3193,ORD_3194,17394,Jimmy Jammy Baby Girl Cotton Frocks and Shorts Pack of 6,Warehouse A,313,285,2025-02-28 23:24:00,28
3194,ORD_3195,16822,"CURATIO Tedibar Baby Bathing Bar, 75 g Each - Pack of 6",Warehouse A,445,416,2025-02-28 01:07:00,29
3195,ORD_3196,11826,LITTLE SMART Baby Boy Full Sleeve T-Shirt Set (Pack of 6),Warehouse B,303,275,2025-02-28 12:45:00,28
3196,ORD_3197,16089,Bold N Elegant Cartoon Rabbit Bunny Print Cold Shoulder T-shirt Top & Shorts Summer Casual Clothing Set for Baby Girls,Warehouse B,370,329,2025-02-28 15:31:00,41
3197,ORD_3198,16096,Hopscotch Boys Mesh Mesh Solid LED Sneakers & Slip Ons in Green Color,Warehouse C,406,382,2025-02-28 06:33:00,24
3198,ORD_3199,16100,Pumpinose-CHIBOJI Nasal Aspirator for Baby | Powerful and Non-invasive Baby Nose Sucker | Hygienic & Comfortable Snot Clea...,Warehouse B,204,156,2025-02-28 10:20:00,48
3199,ORD_3200,16107,SOLDTRUE Inflatable Cartoon for Baby Bath tub 1 to 3 Years Bath tub for Kids Home and Travel More Fun with Size 2 Feet 24 ...,Warehouse C,89,77,2025-02-28 13:45:00,12
3200,ORD_3201,11808,Hopscotch Girls Cotton Sleeveless Applique Party Dress in Green Color,Warehouse B,405,358,2025-02-28 11:20:00,47
3201,ORD_3202,16085,"MamyPoko Diaper pants, New born, Pack of 8",Warehouse A,134,99,2025-02-28 04:25:00,35
3202,ORD_3203,11802,superbottoms A-line Dress | Aline Dress | Evrydaywear | Casual Dress | Girls Dress | Frocks | Kids Dress Girls | Knee-Leng...,Warehouse B,411,380,2025-02-28 02:01:00,31
3203,ORD_3204,11800,"Mamaearth Hot Towel Anti Hair Fall Care Range, for Hair Fall Control, (Hair Mask 200ml + Shampoo 250ml + Conditioner 250ml)",Warehouse B,68,52,2025-02-28 21:54:00,16
3204,ORD_3205,16146,"castley Unisex Cotton Pyjamas Soft, Stretchable Pyjamas for Kids (Multicolor)",Warehouse C,65,31,2025-02-28 21:01:00,34
3205,ORD_3206,11786,Hopscotch Girl's Tutu Long dress with Headband,Warehouse A,457,447,2025-02-28 10:35:00,10
3206,ORD_3207,16154,"abracadabra Cotton Head Shaping Mustard Seed Rai Pillow with Lavender Essential Oil (Size: 30 cm X 22 cm, 650 Grams, Sleep...",Warehouse A,506,472,2025-02-28 10:26:00,34
3207,ORD_3208,11946,"Alenza Exports KIDS ELEPHANT BRUSH | Soft Baby Toothbrush Set, BPA Free Baby Training Toothbrush with Soft Bristles and Ea...",Warehouse B,198,151,2025-02-28 03:24:00,47
3208,ORD_3209,11945,"Creative Educational Aids P. Ltd. Let's Find Out When Educational Games & Puzzle, [Multicolour] pack of 1",Warehouse B,118,102,2025-02-28 07:40:00,16
3209,ORD_3210,11581,GLAN Women's & Girl's Winter Warm Over Knee High Footless Socks Long Leg Warmers 1 Pair (16 Inch Black),Warehouse A,512,479,2025-02-28 00:43:00,33
3210,ORD_3211,16572,"Chicco Baby Moments Mild Body Wash Refresh, New Advanced Formula With Natural Ingredients, No Tears & Soap-Free, Mild Form...",Warehouse A,110,80,2025-02-28 15:24:00,30
3211,ORD_3212,16543,"Rustic Art Amala Shikakai Organic Shampoo Bar | Methi, Ginger, Mango Butter | Reduces hair fall, detangles | 75 Gm",Warehouse A,373,346,2025-02-28 06:35:00,27
3212,ORD_3213,16590,Zumrut® Handcrafted Copper Silver Ashtdhatu Adjustable kada Nazariya Open Ended Free Size Kada Bracelet Adjustable Kids Ba...,Warehouse C,147,101,2025-02-28 01:54:00,46
3213,ORD_3214,11556,"Himalaya Herbals Under Eye Cream, 15ml",Warehouse B,264,255,2025-02-28 19:46:00,9
3214,ORD_3215,16610,"Bhauvik Plastic Baby Bath Chu Chu Colorful Animal Shape Toy (Multicolor, Multi Design) - 12 Pcs Set",Warehouse C,46,18,2025-02-28 10:53:00,28
3215,ORD_3216,11554,Neska Moda 0 To 6 Months 1 Pair Cotton Booties and 3 Pair Cotton Ankle Socks Gift Combo Set-GS143,Warehouse A,409,361,2025-02-28 13:40:00,48
3216,ORD_3217,11553,AkinosKIDS Pearl chiffon lace flowers elastic infant newborn baby girl headbands Toddler band hair hairband Peach Pink,Warehouse B,460,433,2025-02-28 19:15:00,27
3217,ORD_3218,16616,Oncarnival Portable Folding Bathtub Jacuzzi for Adults and Baby,Warehouse B,386,354,2025-02-28 05:27:00,32
3218,ORD_3219,16537,Dazzlia Unisex child Loose Fit T-Shirt (Dbsadra_Assorted ),Warehouse A,165,126,2025-02-28 18:10:00,39
3219,ORD_3220,16448,Bold N Elegant 3D Monster Cartoon Summer Kid's Sleeveless Vest T-shirt Shorts Set for Baby Boys & Girls,Warehouse B,119,85,2025-02-28 04:08:00,34
3220,ORD_3221,16471,"FOKRIM Baby Nail Clippers Electric Baby Nail Trimmer New Born, Baby Nail File Kit Replacement Heads, Newborn Toddler Toes ...",Warehouse C,293,285,2025-02-28 02:06:00,8
3221,ORD_3222,16479,"Mamaearth Daily Moisturizing Natural Baby Lotion (400 ml) & Mamaearth Deeply Nourishing Natural Baby wash (400 ml, 0-5 Yrs)",Warehouse B,175,155,2025-02-28 18:24:00,20
3222,ORD_3223,16486,Baby Bucket Baby Diaper Nappy Changing Baby Diaper Bag Mummy Bag Handbag-(Pack of 4 – Navy Blue-1),Warehouse C,421,381,2025-02-28 08:08:00,40
3223,ORD_3224,16492,Saumabhi Girl Dance Shoes Princess Girl,Warehouse B,104,94,2025-02-28 05:07:00,10
3224,ORD_3225,16493,"Neska Moda 12 To 18 Months Baby Girls Cotton Butterfly Frill Booties (Red,Blue) -BT1142andBT1172",Warehouse A,243,200,2025-02-28 19:29:00,43
3225,ORD_3226,16556,Krystle Women's Classy Checkered Suede Golf Cap Grey,Warehouse B,428,423,2025-02-28 23:03:00,5
3226,ORD_3227,11583,"Chic Buddy Waterproof Wet Bag, Washable, Reusable for Travel, Beach, Pool, Stroller, Diapers, Dirty Gym Clothes, Wet Swims...",Warehouse A,303,268,2025-02-28 06:37:00,35
3227,ORD_3228,11671,AkinosKIDS Newborn Rose soft Lace LightPink Flower Headband.Kids Hair Accessory …,Warehouse A,273,254,2025-02-28 06:39:00,19
3228,ORD_3229,16369,EIO Unisex Kids Cotton Pajama Pants Pack of 6,Warehouse C,306,266,2025-02-28 16:16:00,40
3229,ORD_3230,16293,"CUTEABLY Baby Mittens and Booties, 4 Pairs of Hand Mittens and 4 Pair of Leg Booties, Hosiery Soft Material (0-12 M)",Warehouse B,481,443,2025-02-28 23:29:00,38
3230,ORD_3231,16296,Hopscotch Girls Cotton Floral Print Full-Sleeve Casual Dress in Multi Color,Warehouse A,481,438,2025-02-28 07:06:00,43
3231,ORD_3232,11703,Mee Mee Tender Tongue Brush (Orange) Pack of 2,Warehouse B,135,89,2025-02-28 16:17:00,46
3232,ORD_3233,16324,Sahiba Gems Exclusive 925 Sterling Silver Nazariya/Nazar Bracelet for Babies Boy/Girls with Black Beads (Crystal),Warehouse A,174,144,2025-02-28 17:19:00,30
3233,ORD_3234,16331,"Toy Park Baby Playpen Kids Activity Centre Safety Play Yard Home Indoor Outdoor, Happy Game Enclosure Ball Pool (Multicolo...",Warehouse B,154,112,2025-02-28 04:35:00,42
3234,ORD_3235,16332,"Dr. Brown's Preemie Flow Silicone Options Narrow Neck Nipple C (Pack of 2, White)",Warehouse C,35,20,2025-02-28 07:36:00,15
3235,ORD_3236,16343,"Pollo Loco Baby Booties Set, Booties for New Born Baby, Booties for Baby Boy, Booties for Baby Girl, 100% Cotton (3-12 Mon...",Warehouse A,162,136,2025-02-28 05:14:00,26
3236,ORD_3237,16350,"bosig® New Baby Nail File Electric,Baby Nail Trimmer with 6 Grinding Heads Safe for Newborn Baby | Grinder Set Nail Trimme...",Warehouse A,345,339,2025-02-28 12:55:00,6
3237,ORD_3238,16328,I Bears Baby New Born Clothes for Boys and Girls | Cap Combo Set | Size 1-3 Months | Pink & Blue Color | (1 Month - 3 Mont...,Warehouse C,139,104,2025-02-28 15:40:00,35
3238,ORD_3239,16501,NEW GEN Baby Boys DUNGREE Set with Tshirt for 2-3 Years (Green),Warehouse B,457,435,2025-02-28 11:43:00,22
3239,ORD_3240,28545,"Neska Moda 0 To 6 Months Baby Girls Pack Of 2 Pair Cotton Butterfly Frill Booties (Black,Baby Pink) -BT1115andBT1123",Warehouse C,392,381,2025-02-28 11:01:00,11
3240,ORD_3241,4803,"Toddylon Baby Gift Set for New Born Essential Items Combo (Multicolor, 0-6 Months)",Warehouse A,97,89,2025-02-28 21:57:00,8
3241,ORD_3242,28409,"Kwitchy New Born Baby Mittens and Booties Combo Gloves & Socks Set for 0-6 Months Infant,Multicolor",Warehouse B,535,492,2025-02-28 19:10:00,43
3242,ORD_3243,28417,URAL Baby Silicon Finger Toothbrush (3 Month to 3 Year) with Storage Case Extra Soft Toothbrush (Pack of 2),Warehouse C,240,200,2025-02-28 20:21:00,40
3243,ORD_3244,4837,"PATPAT®Crib Hanging Toy for Babies, Electric Rotation Crib Soothe Toy Multifunctional Crib Hanging Toy with Lullabies, Tim...",Warehouse C,464,417,2025-02-28 03:38:00,47
3244,ORD_3245,4834,"Himalaya Gentle Baby Soap (4N*75g) & Himalaya Herbals  Almond & Rose Soap, 75gm",Warehouse A,320,296,2025-02-28 03:54:00,24
3245,ORD_3246,28432,Aswadh Cute Cartoon Animal Uni Kids Fleece Shoes Baby White for 9-12 months,Warehouse A,137,116,2025-02-28 03:15:00,21
3246,ORD_3247,28435,Googogaaga Boy's & Girl's Cotton printed Sweatshirt with Pant set in White color (1.5-2 Years),Warehouse A,126,82,2025-02-28 16:38:00,44
3247,ORD_3248,28440,"Little's Soft Cleansing Baby Wipes with Aloe Vera, Jojoba Oil and Vitamin E (80 wipes) pack of 2",Warehouse C,75,26,2025-02-28 21:32:00,49
3248,ORD_3249,28444,"Huggies Complete Comfort Wonder Pants with Aloe Vera, Large (L) size baby diaper pants, 64 count",Warehouse B,292,275,2025-02-28 05:43:00,17
3249,ORD_3250,4812,EIO Baby Gifts Set for New Born Unisex Clothing Gift Hamper 6Pcs (Yellow),Warehouse B,214,178,2025-02-28 22:54:00,36
3250,ORD_3251,28448,MINI KLUB Baby-Boy's Regular Jogger,Warehouse C,248,200,2025-02-28 06:15:00,48
3251,ORD_3252,28457,"LuvLap 4 Stage Baby Oral Care Set for infant, baby, Toddler & Kids' primary teeth & gums, Infant Gum Massager, 2 Toddler b...",Warehouse A,422,407,2025-02-28 02:38:00,15
3252,ORD_3253,28458,Girls Clubs Unisex- Child Sky Blue Sports Shoes - 3- 3.5 Years,Warehouse B,210,179,2025-02-28 07:13:00,31
3253,ORD_3254,4808,Googogaaga Boy's Cotton Printed T-Shirt with Camouflage Shorts in Black Color,Warehouse B,477,441,2025-02-28 18:44:00,36
3254,ORD_3255,4818,"Neska Moda 12 To 18 Months Baby Boys & Baby Girls Cotton Rabbit Booties (Maroon,Yellow) -BT1157andBT1177",Warehouse B,268,240,2025-02-28 11:59:00,28
3255,ORD_3256,4845,"Neska Moda 0 To 6 Months Baby Girls Cotton Butterfly Frill Booties (Baby Pink,Red) -BT380andBT1123",Warehouse A,276,264,2025-02-28 20:31:00,12
3256,ORD_3257,4772,"LuvLap Boys Sleeveless T-Shirt & Shorts Set, For Baby, Infants & Toddlers, Multicolour, 100% Cotton, Pack Of 2 (3 to 6 mon...",Warehouse B,413,404,2025-02-28 17:19:00,9
3257,ORD_3258,4774,OMLI Baby Girl Dress Toddler Dress Long Sleeve Infant Casual Dress Ruffle Print Clothes Baby Girls Clothing,Warehouse B,422,375,2025-02-28 10:46:00,47
3258,ORD_3259,11604,Hopscotch Girls Polyester Viscose Sleeveless Floral Applique Party Dress in Turquoise Color,Warehouse B,405,376,2025-02-28 18:06:00,29
3259,ORD_3260,11603,Googo Gaaga Boy's T-Shirt,Warehouse C,100,87,2025-02-28 20:46:00,13
3260,ORD_3261,11602,"Baby Inn 100% Cotton Face Towel 28 cm X 28 cm, Multi Color, SG",Warehouse C,518,490,2025-02-28 11:58:00,28
3261,ORD_3262,16515,"Neska Moda 12 To 18 Months Baby Boys & Baby Girls Cotton Rabbit Booties (Blue,Orange) -BT1145andBT1176",Warehouse B,489,465,2025-02-28 15:50:00,24
3262,ORD_3263,16522,ASK - JS - LCD & CO Babies Boys and Girls Tops and Bottoms - Unisex - Sweater Dress - Socks & Cap for Toddler Girl & Boys...,Warehouse B,113,79,2025-02-28 17:33:00,34
3263,ORD_3264,16288,Hopscotch Baby Girls Cotton And Polyester Cold Shoulder Sleeveless Applique Floral Net Party Dresses In Pink,Warehouse B,478,468,2025-02-28 14:46:00,10
3264,ORD_3265,22414,DearJoy Big Fibre Filled Baby Pillow and Stuffed Animal Elephant Soft Toy of Plush Hugging Pillow Material for Kids Boy/Gi...,Warehouse C,268,258,2025-02-28 12:18:00,10
3265,ORD_3266,28481,MA BABY Rompers Jumpsuits Bodysuits For Boy & Girl Pure Soft Cotton Baby Clothing For New Born Infant Toddlers Baby Jumpsu...,Warehouse C,257,225,2025-02-28 19:44:00,32
3266,ORD_3267,4799,RAINBOWTEES Baby Boys' & Baby Girls' T-Shirt (RT-4006_Red_Free Size),Warehouse A,336,301,2025-02-28 02:29:00,35
3267,ORD_3268,4785,"TRU TOYS Wooden Montessori Analog Clock for Kids, Preschool Number Teaching Educational Learning Clock Toy - Multi Color (...",Warehouse B,302,289,2025-02-28 12:39:00,13
3268,ORD_3269,4783,Chandu Ki Dukan Doctor Coat Dress for Kids - 3-4 Years,Warehouse A,497,479,2025-02-28 07:00:00,18
3269,ORD_3270,28515,NammaBaby Newborn Premium Baby Hosiery Cotton Cloth Double Layer Nappies Multicolor (0-6 months) (18),Warehouse C,504,493,2025-02-28 16:29:00,11
3270,ORD_3271,16431,"Mee Mee Mild Baby Liquid Laundry Detergent (Bottle) (300 ml, Bottle)",Warehouse B,455,448,2025-02-28 15:41:00,7
3271,ORD_3272,16430,Infantbond Combo of Baby Bed with Net | Carry Bag | 4 Pcs Bedding Set(0-6 Months) (Blue Fox),Warehouse B,166,151,2025-02-28 04:33:00,15
3272,ORD_3273,16728,RSTER Silicon Corner Protector for Sharp Edges Table Corner Protector for Baby Bed Corners Edge Protector Child Safety Cor...,Warehouse C,382,372,2025-02-28 07:21:00,10
3273,ORD_3274,11527,Neska Moda Unisex Sandal Booties For 6 To 12 Months (Orange),Warehouse A,328,307,2025-02-28 14:26:00,21
3274,ORD_3275,16634,"Philips Avent Ultra Air Pacifier for Boy, 6-18 Months, Blue/Green Fashion Decos, 2 Pack, SCF342/22",Warehouse C,395,375,2025-02-28 10:07:00,20
3275,ORD_3276,16639,"Sathiyas Pure Cotton Baby Girls Dresses (3-6 Months,Pack of 5)",Warehouse A,195,152,2025-02-28 01:02:00,43
3276,ORD_3277,11548,Rsmart Cotton White Booties Shoes with Multicolour Flower and Ribbon Closure for Baby Girl & Boy,Warehouse A,321,299,2025-02-28 16:10:00,22
3277,ORD_3278,11546,"Hohner Baby Lotion with Natural Ceramides, Oat Lipids and Milk Protein with pH 5.5 (200 ml)",Warehouse A,317,277,2025-02-28 08:00:00,40
3278,ORD_3279,11545,Bembika Newborn Baby Girl's Cotton Soft Cute Turban Knot Printed Headbands (Multicolour) - Set of 6,Warehouse C,398,359,2025-02-28 00:05:00,39
3279,ORD_3280,11544,"FabSeasons Cotton Bucket Hat/Cap for Boys & Girls, Fits for 1-4 Years Kids - 50 cm Inner Circumference",Warehouse C,449,401,2025-02-28 14:41:00,48
3280,ORD_3281,11541,BONJELA TEETHING GEL (2M+) - 15G,Warehouse B,233,214,2025-02-28 14:21:00,19
3281,ORD_3282,11536,VRION Cartoon Baby Bath Tub for Kids/Toddler Ideal for 1 to 3 Years | Inflatable Bath Tub | Anti Slip New Born Baby Bather...,Warehouse A,368,350,2025-02-28 21:31:00,18
3282,ORD_3283,16662,SmartoKids Activity Box for 2 to 3 Year Old Baby Boys & Girls (11-in-1 Set) – Learning & Educational Gift Pack of Play-Bas...,Warehouse A,122,100,2025-02-28 05:35:00,22
3283,ORD_3284,16664,Bold N Elegant Girls Sparkling Glitter LED Light Up Moccassin Loafer Party Shoes for Toddler & Tween Girls,Warehouse C,85,60,2025-02-28 20:51:00,25
3284,ORD_3285,11534,"Neska Moda 0 To 6 Months Baby Girls Cotton Butterfly Frill Booties (Mint,Blue) -BT385andBT1126",Warehouse C,507,482,2025-02-28 06:19:00,25
3285,ORD_3286,16667,SMARTOTS Kids Casual Multicolour Light Laces Shoes for Baby Boys/Girls Age 15 Months to 4 Years L-9 Series,Warehouse A,208,173,2025-02-28 02:53:00,35
3286,ORD_3287,11543,HAPPU COLLECTION printed kids boots (white) 1c,Warehouse A,367,324,2025-02-28 13:59:00,43
3287,ORD_3288,16629,"Neska Moda 6 To 12 Months Baby Girls Cotton Butterfly Booties (Maroon,Orange) -SK140andBT85",Warehouse C,154,136,2025-02-28 19:13:00,18
3288,ORD_3289,16784,HARISTAR Scooter Style Baby Potty Seat with Wheel and Removable Tray for Kids | Available Wheel | Multi Color Scooter,Warehouse B,451,410,2025-02-28 09:17:00,41
3289,ORD_3290,16788,Neska Moda Unisex Baby Sandal Booties For 6 To 12 Months (Pink),Warehouse C,112,107,2025-02-28 01:04:00,5
3290,ORD_3291,11942,DIPANYA Shoppe B-185 Booster Vanish Faf. Tp .Kc-3 Tapered Kick-3 Left Spin DB Layer System with Launcher (Set of 2),Warehouse A,216,185,2025-02-28 15:28:00,31
3291,ORD_3292,16282,Appu Kids 100% Hosiery Cotton Unisex Long Sleeve Rompers/Onesies/Sleepsuit/Full Body-Suit for Baby Boy and Girl/Infants Co...,Warehouse C,253,240,2025-02-28 07:56:00,13
3292,ORD_3293,16824,"Himalaya Baby Powder, 700g & Himalaya Gentle Baby Wipes, 72 Wipes",Warehouse A,348,318,2025-02-28 17:43:00,30
3293,ORD_3294,16289,"Sticker Studio Minions Vinyl Wall Sticker (Multicolour, Surface Covering Area - 91*40 cm), Cartoon",Warehouse A,269,258,2025-02-28 20:10:00,11
3294,ORD_3295,16695,Alya Baby Grooming Essential Nail Pedicure Manicure Cutter Safety Kit 4 IN 1 Combo With Cute Portable Travel Transparent P...,Warehouse A,352,346,2025-02-28 18:23:00,6
3295,ORD_3296,16702,THE PEPPY TEND Four-Ever Young Baby Unisex Onesie-Romper Half Sleeves Regular Fit,Warehouse C,323,301,2025-02-28 22:36:00,22
3296,ORD_3297,16687,My Newborn Baby Boys and Baby Girls 3 in 1 Baby Blanket-Safety Bag-Sleeping Bag Pack of 2 Pcs&Himalaya Baby Lotion (400Ml),Warehouse B,264,217,2025-02-28 12:43:00,47
3297,ORD_3298,16703,Skips Unisex Soft Sole Shoes Infant Toddler Boys Girls- Lemon Print (12-18 Months),Warehouse C,521,474,2025-02-28 13:13:00,47
3298,ORD_3299,16713,Generic Maroon Bow with Cotton Cloth Turban Kont Bow Cap for Baby Girls & Baby Boys Turban Bow Cap Infant Head Cap,Warehouse B,47,31,2025-02-28 06:18:00,16
3299,ORD_3300,11498,"Neutrogena Pure & Free Baby Mineral Sunscreen Stick with Broad Spectrum SPF 50 & Zinc Oxide, Water-Resistant, Hypoallergen...",Warehouse B,536,497,2025-02-28 02:55:00,39
3300,ORD_3301,11493,WorldCare® Water Shoes Aqua Socks Yoga Exercise Pool Beach Swim Slip On Black 39-40 (66004518JEL),Warehouse C,118,91,2025-02-28 17:04:00,27
3301,ORD_3302,16789,Unisex Regular Cotton Socks (Pack Of 12 Pairs) (ALBELIAMOHITAASH-40_Multicolour),Warehouse C,189,166,2025-02-28 03:37:00,23
3302,ORD_3303,11657,"BSB HOME 100% Cotton Geometric Print Mix N Match Single Bed Sheet with 1 Pillow Covers for Single/Coat/Diwan Bed, Maroon B...",Warehouse C,366,352,2025-02-28 11:39:00,14
3303,ORD_3304,16763,3M Opticlude Orthoptic Eye Patch 5cm*6.2cm 1537/20 Box of 20,Warehouse B,447,412,2025-02-28 19:55:00,35
3304,ORD_3305,16770,"Pampers All round Protection Pants, Medium size baby diapers (MD), 28 Count, Anti Rash diapers, Lotion with Aloe Vera",Warehouse C,528,495,2025-02-28 00:21:00,33
3305,ORD_3306,11462,Seyor Newborn Baby Pant Printed Kids Shorts Trousers (Multicolors),Warehouse A,400,353,2025-02-28 10:58:00,47
3306,ORD_3307,16628,"Mamaearth Moisturizing Baby Bathing Soap Bar, Pack of 2, 75gms Eac & Milky Soft Natural Baby Face Cream for Babies 60mL & ...",Warehouse B,329,311,2025-02-28 19:51:00,18
3307,ORD_3308,16393,Johnson's Baby Milk Lotion (200ml),Warehouse C,53,33,2025-02-28 07:42:00,20
3308,ORD_3309,11666,GURU KRIPA BABY PRODUCTS Newborn Baby Frock Kids Soft Hosiery Jhabla Cotton Frock for Infant Girl Front Open Knee Length F...,Warehouse A,223,209,2025-02-28 19:24:00,14
3309,ORD_3310,11665,"V.B.K® Baby Boys and Baby Girls Clothing Combo Pack With Hand Mittens (Gloves) (4 Pair), Leg Booties (Socks) (4 Pair) and ...",Warehouse C,229,192,2025-02-28 14:36:00,37
3310,ORD_3311,16397,COTKIDS Baby Boys & Baby Girls Printed Caps Mitten & Booty Sets | Warm | 100% Cotton Soft | Color Green Blue Pink Green Pe...,Warehouse B,323,277,2025-02-28 13:17:00,46
3311,ORD_3312,16398,BUMZEE Rust & White Front Open Full Sleeves Jablas for Baby Boy Pack of 3 Age - 6-9 Months,Warehouse A,393,354,2025-02-28 18:08:00,39
3312,ORD_3313,16402,"WONDERCHILD New Born Baby Multi-Purpose Combo Pack of 5 Cotton Jabla, Reusable Cloth Diaper Nappy, Apron-Bib, Soft Towel S...",Warehouse B,373,340,2025-02-28 07:33:00,33
3313,ORD_3314,11670,Hopscotch Girls Synthetic Leather Glittery Print Mary Jane in Gray Color,Warehouse A,422,391,2025-02-28 18:34:00,31
3314,ORD_3315,16409,"SNOWIE SOFT® Electric Nail Trimmer for Baby and Adult, Baby Nail Cutter with LED New Born Toddler Toenail and Fingernail T...",Warehouse A,378,370,2025-02-28 05:22:00,8
3315,ORD_3316,16418,Kids Choice Shoes for Boy's and Girl's Canvas with Anti-Slip Sole (3-12 Months),Warehouse C,459,416,2025-02-28 06:35:00,43
3316,ORD_3317,16421,Safe-O-Kid - Effective Finger Guard for Hinged Doors - Pack of 4,Warehouse A,285,260,2025-02-28 19:43:00,25
3317,ORD_3318,11474,"The Little Lookers Baby Soap with Rabbit Eraser | 100% Handmade & Organic Soap for Babies, Kids - 120g (Rabbit, Pack of 3)",Warehouse A,361,316,2025-02-28 06:04:00,45
3318,ORD_3319,11482,Saumabhi New Baby Shoes Soft Soled Toddler Cotton,Warehouse A,288,279,2025-02-28 12:42:00,9
3319,ORD_3320,11449,BeeBaby Classic Powder Puff with Container for Baby (Blue) | Soft Touch. 100% BPA Free.,Warehouse B,198,177,2025-02-28 04:03:00,21
3320,ORD_3321,11443,myaddiction Shoulder Bag PU Leather Purse Gifts Handbags for Friends Daughter Work Pear Shape,Warehouse B,260,254,2025-02-28 14:06:00,6
3321,ORD_3322,16814,RONFILD Safety Door Handle Protective Cover for Baby's Room Avoid Collision Silicone Door Knob Covers Wall Protector Baby ...,Warehouse C,310,275,2025-02-28 14:34:00,35
3322,ORD_3323,16815,SELVEL Baby Girls Cotton Dress I Fit & Flare Cotton Casual Dress I Knee-Length Dress (FRK-PLK-1607),Warehouse B,231,225,2025-02-28 17:14:00,6
3323,ORD_3324,16817,BUMZEE Baby-Girls Baby and Toddler Sleepers,Warehouse C,260,235,2025-02-28 05:02:00,25
3324,ORD_3325,11434,"Wonder Wee Baby Jhabla (Shirt) for Baby Girl & Boys Pack of 5 | 100% Cotton Super Soft, Smooth & Soothing Mulmul Fabric - ...",Warehouse A,506,461,2025-02-28 11:32:00,45
3325,ORD_3326,16806,Poppy Kids Girls/Baby Girls Stylish Cotton Aqua Bug (Pack of 1),Warehouse B,95,59,2025-02-28 07:13:00,36
3326,ORD_3327,16780,Mamaearth Milky Soft Natural Baby Face Cream for Babies 60mL & dusting Powder with Organic Oatmeal & Arrowroot Powder 150g,Warehouse C,355,330,2025-02-28 03:13:00,25
3327,ORD_3328,11485,Honbon Multi Colors Soft Rubber Mini Hairbands Elastic Hair Ties Tiny for Baby Kids Girl 50 Pieces,Warehouse A,39,14,2025-02-28 13:12:00,25
3328,ORD_3329,16743,"Colgate Kid 6+ Years Toothpaste .Barbie (Pack Of 2) Toothpaste (160 g, Pack of 2)",Warehouse B,74,27,2025-02-28 08:17:00,47
3329,ORD_3330,11484,"Pampers All round Protection Pants, Large size baby Diapers, (L) 42 Count Lotion with Aloe Vera",Warehouse A,449,424,2025-02-28 11:30:00,25
3330,ORD_3331,11483,The Root And Craft Kids Birthday Photoshoot Outfit Dress (12 Month-Black & White),Warehouse A,222,199,2025-02-28 00:02:00,23
3331,ORD_3332,17409,Johnson Baby Care Collection kit Gift Pack Combo 8N Purple kit Pack of 1,Warehouse C,42,36,2025-02-28 06:29:00,6
3332,ORD_3333,11075,baby wish Organic Muslin Jhabla for Babies Newborn Clothes Ultrasoft Organic Cotton Jhabla Set Unisex Summer Vest for Infa...,Warehouse B,233,225,2025-02-28 18:20:00,8
3333,ORD_3334,17400,Liyana Collection Women's & Girl's Winter Warm Velvet Over Knee High Footless Socks Long Leg Warmers (Black & Skin) Pack Of 2,Warehouse C,484,471,2025-02-28 17:04:00,13
3334,ORD_3335,14248,"Wrappery 4 Layer Muslin Cotton Bath Towel - Large (White, 120 cm x 120 cm)",Warehouse B,334,287,2025-02-28 22:36:00,47
3335,ORD_3336,12869,Himalaya Herbals Baby Shampoo (200ml) (Pack of 2),Warehouse C,193,182,2025-02-28 19:16:00,11
3336,ORD_3337,12878,Appigo All Season Winter Woolen Beanie Pumpkin Face Cap for Baby Boy and Girl,Warehouse C,113,69,2025-02-28 22:50:00,44
3337,ORD_3338,12898,"Gorangani Women's Cotton Printed Soft Loose Embellished Multipurpose Sleepwear Maxi, Nighty, Gown, Nursing, Feeding and Ma...",Warehouse B,54,21,2025-02-28 15:49:00,33
3338,ORD_3339,14135,RASH X MOISTURISING NAPPY RASH CREAM,Warehouse A,167,142,2025-02-28 22:11:00,25
3339,ORD_3340,12947,THE LITTLE LOOKERS Kid's 420 GSM Microfibre Cotton Super Soft Cute Prints Quick Dry Hooded Towel (Pink and Lemon) -Pack of 2,Warehouse B,280,268,2025-02-28 10:40:00,12
3340,ORD_3341,12946,VRITRAZ Good Cartoon Character Printed Little Cap for Kids and Baby Girls 3-12 Years,Warehouse B,220,172,2025-02-28 18:10:00,48
3341,ORD_3342,12945,Devil Prime Boy's|Girl's Printed Kids Cotton Socks (Pack Of 6)-B079KD2YN2,Warehouse B,453,412,2025-02-28 01:24:00,41
3342,ORD_3343,14147,"Pigeon Apple Toothpaste, For babies and Children,Fluroide -free,SLS free,Color free,Paraben Free, PH friendly,45 g,Pack of 2",Warehouse C,507,489,2025-02-28 19:44:00,18
3343,ORD_3344,12944,Cotton Check Baby Shoes Regular,Warehouse B,267,223,2025-02-28 16:12:00,44
3344,ORD_3345,14151,"MamyPoko Tape Diapers for Babies, New Born mini, Pack of 30",Warehouse B,304,296,2025-02-28 09:26:00,8
3345,ORD_3346,12939,BODYSTYLE Cotton Printed Bloomers for Baby Boy's & Baby Girl's_Multicolor.,Warehouse A,504,492,2025-02-28 20:36:00,12
3346,ORD_3347,12931,Clarks Bradley Free Blk Tumbled Lea,Warehouse C,369,356,2025-02-28 05:40:00,13
3347,ORD_3348,12919,"VALKYRIE Baby Nail Trimmer Electric Safe Baby Nail Clippers, Manicure Set, Trim Polish Grooming kit for Newborn Toddler or...",Warehouse C,228,188,2025-02-28 20:08:00,40
3348,ORD_3349,14181,Neska Moda 6 To 12 Months Baby Girls Cotton Velcro Sandal Booties-BT1429-GRP,Warehouse C,209,171,2025-02-28 08:23:00,38
3349,ORD_3350,12871,Kidsville Mickey & Friends Printed Caps for Boys RED/Blue,Warehouse B,260,234,2025-02-28 18:19:00,26
3350,ORD_3351,14245,"Jesa Homes Polyester Adults Mosquito Net for Dubble Bed, Strong 30GSM net, High Durability, Foldable, Tent Shape Mosquito ...",Warehouse B,383,367,2025-02-28 01:57:00,16
3351,ORD_3352,14018,"Bows Holder for Baby Girls, Vimiv Bows and Headbands Holder for Baby,Baby Headband Holder Organizer Hanging Newborn Hair B...",Warehouse C,293,274,2025-02-28 04:40:00,19
3352,ORD_3353,14042,"Mee Mee Soft Bristled Comb Set | BPA Free (Easy Grip, Blue Orange)",Warehouse C,279,241,2025-02-28 06:22:00,38
3353,ORD_3354,14019,EIO Baby Gifts Set for New Born Unisex Clothing Gift Hamper 6Pcs (Purple),Warehouse C,175,165,2025-02-28 23:03:00,10
3354,ORD_3355,14214,KASSY POP CURATED JUST FOR YOU 4 pcs Baby Grooming Nail Care Set with Nail Clipper & Scissors for Newborn (White),Warehouse A,449,417,2025-02-28 04:51:00,32
3355,ORD_3356,12892,Mee Mee Toothbrush (Pink) Pack of 3,Warehouse B,327,286,2025-02-28 08:18:00,41
3356,ORD_3357,14220,Mothercare Baby-Girls VA338,Warehouse C,193,170,2025-02-28 11:07:00,23
3357,ORD_3358,14223,"BRANDONN New Born Baby Single Blanket Swaddle Wrapper Blanket for Babies Cum Baby Sleeping Bag(Grey,Pack of 1)",Warehouse A,122,76,2025-02-28 08:28:00,46
3358,ORD_3359,14228,"JB FASHION Baby Girl's Cotton Blend Sleeve Less Midi Frock | Multi Color Frock for Baby Girl (1-2 Years, White)",Warehouse B,339,300,2025-02-28 13:41:00,39
3359,ORD_3360,12885,"Chicco Baby Moments Shampoo, 500ml and Soap, 2x125g",Warehouse B,114,98,2025-02-28 19:43:00,16
3360,ORD_3361,14209,Mamaearth Nourishing Hair Oil for Babies 100ml (0-10 years) & Brave Blueberry Body Wash For Kids with Blueberry Oat Protei...,Warehouse A,168,150,2025-02-28 07:06:00,18
3361,ORD_3362,12877,"PATPAT® Baby Bath Toys, Fun Monkey Water Spray Toy Cartoon Bath Toy Sprinkler Toy Suction Cup Design Bathtub Toy Shower To...",Warehouse C,385,352,2025-02-28 11:55:00,33
3362,ORD_3363,12876,Mee Mee baby-girls Socks,Warehouse B,112,85,2025-02-28 02:46:00,27
3363,ORD_3364,15709,Raj Enterprises Super Print Boy's Girl's Unisex Cotton Underwear COM-12-STAR-PRINT-6-9-MANTHS with Soft Comfortable Fabric...,Warehouse C,205,192,2025-02-28 14:09:00,13
3364,ORD_3365,11254,Freshfoot Cute and Colorful Organic Cotton Socks For New Born Baby Age 0-12 Months,Warehouse C,334,317,2025-02-28 12:59:00,17
3365,ORD_3366,17146,kids nazariya | Duck design Nazariya | 5.5 inch black bead bracelet for kids | kada moti dhaga for baby by GoldNera,Warehouse A,359,328,2025-02-28 21:18:00,31
3366,ORD_3367,17153,"Real Basics bib Set of 6 for Kids, 100% Cotton, for New Borns, Girls and Infants.(Soft and Absorbent/Multicolour)",Warehouse B,183,170,2025-02-28 00:35:00,13
3367,ORD_3368,11242,Okbaby Jelly Bather - Turquoise,Warehouse B,137,97,2025-02-28 15:21:00,40
3368,ORD_3369,17165,KUKSHYA 925 Exclusive Nazariya Kada with Black & Silver Beads (Crystal) in 92.5 Sterling Silver for Baby Boys & Girls,Warehouse A,362,347,2025-02-28 18:39:00,15
3369,ORD_3370,11238,"Chic Buddy Silicone Brush for Baby,Infant Finger Brush with Hygiene case (Transparent) (Transperent & Pink case)",Warehouse B,72,62,2025-02-28 18:24:00,10
3370,ORD_3371,17168,"Baybee Daisy Baby Bouncer and Rocker Chair with Soothing Vibrations, Multi-Position Recline, 3 Point Safety Belt & Removab...",Warehouse A,289,243,2025-02-28 14:51:00,46
3371,ORD_3372,17142,"LuvLap Baby Bed with Thick Mattress, Mosquito Net with Zip Closure & Neck Pillow, Baby Bedding for New Born, 3M+, Stars Pr...",Warehouse A,403,383,2025-02-28 03:30:00,20
3372,ORD_3373,11264,ABS Plating LED Flash Light Various Glow Patterns in The Dark Stress Relief Spinner (Multicolor),Warehouse C,216,170,2025-02-28 06:23:00,46
3373,ORD_3374,11169,Looney Tuines Cartoon/Character Socks for Baby/New Born/Infants- Pack Of 4,Warehouse B,503,458,2025-02-28 14:37:00,45
3374,ORD_3375,17264,Mini Klub Girls Lt Pink Knit Top Pack of 1,Warehouse B,350,321,2025-02-28 16:00:00,29
3375,ORD_3376,11124,KNITCO Boys Woolen Acrylic Sweater Yellow Color Striper Regular fit Full Sleeves,Warehouse C,275,252,2025-02-28 12:53:00,23
3376,ORD_3377,11123,Gilli Shopee Newborn Baby Winter Wear Dress Suit Set 5 Pcs Pack 1-Pyjama 1-Legging 1-Vest 1-Bib 1-Cap 0-3 Months,Warehouse C,260,252,2025-02-28 23:53:00,8
3377,ORD_3378,17344,"Himalaya Baby Hair Oil 200 ml and Himalaya Gentle Baby Soap (75g, Buy 3 Get 1 Free)",Warehouse A,341,307,2025-02-28 04:16:00,34
3378,ORD_3379,11118,HUG PUPPY Home Product Image HUG PUPPY Baby Infant Toddler Helmet No Bump Safety Head Cushion Bumper Bonnet Adjustable Pro...,Warehouse B,165,136,2025-02-28 15:27:00,29
3379,ORD_3380,11117,"Summer Infant Bath Sponge, Aqua",Warehouse B,318,308,2025-02-28 12:12:00,10
3380,ORD_3381,17356,"Baybee Foldable Baby Bath Tub for Kids, Mini Swimming Pool with Drainer, Temperature Display, Non-Slip Base | Kids Baby Ja...",Warehouse B,284,270,2025-02-28 15:51:00,14
3381,ORD_3382,17126,BABBY NEST Baby ON Board (Bottle),Warehouse B,482,462,2025-02-28 02:35:00,20
3382,ORD_3383,17193,Fashion Dream Toddler Girl’s Ruffle Trim Top and Knee-Length Short Capri Set,Warehouse B,118,96,2025-02-28 03:05:00,22
3383,ORD_3384,11212,"Mini Baby Silicone Baby Medicine Feeder Dropper Graduated Pipette Liquid Food Dropper (5 ml) (Pack of 1, Blue)",Warehouse B,242,227,2025-02-28 00:18:00,15
3384,ORD_3385,17204,Chicco Baby Wash And Shampoo 200ml With Baby body Lotion 200ml combo Pack,Warehouse B,87,80,2025-02-28 15:21:00,7
3385,ORD_3386,17217,TechHark® Die-cast Model Sound and Light Pull Back Cars Toys,Warehouse A,263,239,2025-02-28 16:14:00,24
3386,ORD_3387,11198,"Aglare Frock, Frocks for Babies Frocks, Red. Frock for Christmas.Organza Beautiful Design.Red.",Warehouse A,478,429,2025-02-28 05:09:00,49
3387,ORD_3388,11193,Being Naughty Black solid Sleeveless Lycra Top with Blue Denim Dungaree for Girls,Warehouse C,182,164,2025-02-28 07:39:00,18
3388,ORD_3389,11184,"OYO BABY Baby Bed Protector Sheet (Extra Large-( 200cm X 140cm), Sea Blue)",Warehouse C,417,388,2025-02-28 01:50:00,29
3389,ORD_3390,17242,NL TRADERS Gyro Bowl for Baby and Kids Feeding Bowl Universal 360 Rotate Magic Funny Toys Baby Gyro Feeding Toy Bowl Dishe...,Warehouse A,507,485,2025-02-28 20:09:00,22
3390,ORD_3391,11171,"Supples Baby Wet Wipes with Aloe Vera and Vitamin E, 72 Wipes/Pack, (Pack of 6)",Warehouse C,355,313,2025-02-28 09:10:00,42
3391,ORD_3392,17174,Dabur Baby Wash: Gentle Nourishing babywash enriched with baby loving ayurvedic herbs- 200ml & Dabur Baby Shampoo: Gentle ...,Warehouse B,99,73,2025-02-28 00:48:00,26
3392,ORD_3393,17116,"GLAN Hand Made Woolen Sock For New Born Baby Kids Mittens 0-6 Month Baby Boy & Girls, 3 Pair",Warehouse C,70,28,2025-02-28 11:51:00,42
3393,ORD_3394,17372,Aarav Enterprise Kid New Squeeze Duck Family Chu Chu Sound Bathtub Toys for Toddler Kids (Yellow),Warehouse C,130,100,2025-02-28 23:44:00,30
3394,ORD_3395,12825,"Neska Moda 12 To 18 Months Baby Girls Cotton Butterfly Frill Booties (Baby Pink,Black) -BT1150andBT1167",Warehouse B,216,175,2025-02-28 18:13:00,41
3395,ORD_3396,14321,Ekan 4Pcs Fish Game Baby Magnetic Fishing Bath Bathroom Summer Water Toy for Beach Swimming Pool Kid Pretend Play,Warehouse B,153,125,2025-02-28 20:28:00,28
3396,ORD_3397,14306,Omved MRUDU Almond Milk and Saffron Extra Moisturizing Baby Soap - 100g (Pack of 2),Warehouse C,125,88,2025-02-28 04:09:00,37
3397,ORD_3398,14399,"baby wish Cotton Baby Hooded New Born Bath Towel Set for Boys and Girls Kids Ultra Absorbent and Hypoallergenic, Natural B...",Warehouse A,277,257,2025-02-28 14:39:00,20
3398,ORD_3399,12782,My Bub Midi Frock | Printed Frock with Shorts| Sleeveless Cotton Dress for Baby Girl | Casual Kids Wear,Warehouse A,315,282,2025-02-28 19:36:00,33
3399,ORD_3400,14499,"Funvention- for Little Scientist in Every Kid Engineered Wood Miniature Mechanical Models, Multicolour, 5 Years and Above,...",Warehouse A,204,186,2025-02-28 11:41:00,18
3400,ORD_3401,14502,MINI KLUB baby-girls Clothing Set,Warehouse B,168,146,2025-02-28 09:58:00,22
3401,ORD_3402,14516,"INFANTSO Non-Toxic Food-Grade Silicone Baby Teether, BPA-Free for Pain-Relief Easy Teething, for 2+ Months Babies (Waterme...",Warehouse C,488,470,2025-02-28 23:19:00,18
3402,ORD_3403,14526,little PANDA Baby Boy’s Cotton T-Shirt and Shorts with Cap Clothing Set,Warehouse B,453,431,2025-02-28 06:59:00,22
3403,ORD_3404,14528,Baby Moo Rainbow Chu-Chu Sound Breathable Anti-Skid Sandals - Blue (8-12M),Warehouse C,546,498,2025-02-28 18:42:00,48
3404,ORD_3405,12828,Supples-Comfy Pants-M-34,Warehouse B,310,303,2025-02-28 12:15:00,7
3405,ORD_3406,14302,The Moms Co. Everything for Baby with Suitcase Gift Box and 7 Skin and Hair Care New born Baby Products |Baby gift set for...,Warehouse C,407,386,2025-02-28 23:54:00,21
3406,ORD_3407,14293,"Neska Moda 12 To 18 Months Baby Boys & Baby Girls Pack Of 2 Pair Cotton Butterfly Frill Booties (Maroon,Baby Pink) -BT1177...",Warehouse B,170,154,2025-02-28 03:24:00,16
3407,ORD_3408,14355,"Burt's Bees Baby Bee Calming Body Lotion, 170 Grams (6oz.)",Warehouse C,430,423,2025-02-28 02:34:00,7
3408,ORD_3409,14360,"Toddylon New Born Baby Gift Combo Bedding & Clothing Set (Multicolor, 0-6 Months)",Warehouse B,319,280,2025-02-28 05:14:00,39
3409,ORD_3410,14342,"Neska Moda 6 To 12 Months Baby Boys & Baby Girls Cotton Rabbit Booties (Orange,Mint) -BT88andSK131",Warehouse A,419,407,2025-02-28 06:33:00,12
3410,ORD_3411,12798,Picksparrow Kerala Cotton Baby Girl Embroidered Frock/Dress with Bow (Offwhite) (2-3 Years),Warehouse B,439,420,2025-02-28 12:41:00,19
3411,ORD_3412,14385,Amso Portable Disposable Baby Diaper Nappy Garbage Bag with Removable Capsule Box (1 Capsule and 4 Multi Color Garbage Roll),Warehouse B,216,195,2025-02-28 20:44:00,21
3412,ORD_3413,14389,Baby Moo Rainbow Chu-Chu Sound Anti-Skid Breathable Denim Sandals - Navy Blue (3Y-3.5Y),Warehouse C,190,175,2025-02-28 21:51:00,15
3413,ORD_3414,12786,SR CREATIONS Baby Boys Clothing Set,Warehouse C,314,308,2025-02-28 10:55:00,6
3414,ORD_3415,14392,"Huggies Complete Comfort Wonder Pants, Small (S) Size Baby Diaper Pants, Combo Pack of 2, 56 count Per Pack, (112 count) w...",Warehouse B,434,406,2025-02-28 01:29:00,28
3415,ORD_3416,14340,"NammaBaby Premium Baby Girls Full Sleeves Frock with Pant Baby Girl's Cotton Frock with Leggings, Frill Frock - Pack of 1",Warehouse B,482,476,2025-02-28 12:24:00,6
3416,ORD_3417,14277,Aveeno Baby Calming Comfort Bath Lavender & Vanilla 18 Ounce,Warehouse B,483,462,2025-02-28 15:44:00,21
3417,ORD_3418,12846,"Philips Avent Comfort Manual Breast pump, Natural Motion technology, combines suction and nipple stimulation, soft cushion...",Warehouse B,486,453,2025-02-28 20:14:00,33
3418,ORD_3419,14284,MINI KLUB Baby-Boy's Regular Fit T-Shirt,Warehouse A,151,110,2025-02-28 03:18:00,41
3419,ORD_3420,12841,Krystle Unisex Woolen Pakol/Afghani Cap (Pack of 1) (Multicolor) (Unisex),Warehouse B,195,182,2025-02-28 12:50:00,13
3420,ORD_3421,12831,"Stanwells Kids Baby-Girls Knee Length Multi Colour Rainbow Frock, 6months-7Years",Warehouse A,511,462,2025-02-28 19:50:00,49
3421,ORD_3422,14077,"VRITRAZ Printed Character Little Baseball Cap for Kids, Baby Girls and Boys 3-12 Years",Warehouse C,449,412,2025-02-28 14:58:00,37
3422,ORD_3423,12965,ADRIEL BRINGING JOY® New Born Woolen Winter Wear (0-3 Months) Complete Clothes Set of 5 Pcs. | 1 pc. Baby Bib | 1 pc. Baby...,Warehouse B,230,187,2025-02-28 15:57:00,43
3423,ORD_3424,12964,MYYNTI Kids Ankle Length Cotton Cartoon Pattern 4-8 Years Socks for Winter Daily School Multicolor Pack of 5,Warehouse C,479,458,2025-02-28 04:36:00,21
3424,ORD_3425,14067,Himalaya Gentle Baby Shampoo (200ml) & Himalaya Baby Hair Oil 200 ml(1 Count),Warehouse A,367,360,2025-02-28 05:34:00,7
3425,ORD_3426,14109,"Outlay Home Supersoft Towel/Bath Towel / 100% Cotton Washcloth for Newborn/Babies/Kids Towel in Cartoon Print, 60x120 CM -...",Warehouse A,322,285,2025-02-28 20:53:00,37
3426,ORD_3427,12958,"SebaMed Baby Powder, 200g & Baby Cream, Extra Soft, 200ml Combo",Warehouse A,187,144,2025-02-28 22:39:00,43
3427,ORD_3428,14116,"KIDSKA Baby Boy and Baby Girl Dress | Jhabla for Baby, New Born Baby Jabla New Born Baby Dress 0 to 6 Month",Warehouse A,105,96,2025-02-28 18:00:00,9
3428,ORD_3429,12952,"Mommypure Dewy Love Natural Baby Face Cream With Cocoa Butter For Deep Moisturisation | Clean, Natural & Nourishing Protec...",Warehouse A,86,73,2025-02-28 19:17:00,13
3429,ORD_3430,12950,V R Toys Duck Mini Water Dispenser with Clay for Children Mini Drinking Fountain Pumps Water Juice Milk Drinking Fountain ...,Warehouse C,216,202,2025-02-28 18:05:00,14
3430,ORD_3431,12949,Shri Balaji Abhushan Bhandar Sterling Silver Anklets for Baby Girls and Baby Boys,Warehouse B,519,475,2025-02-28 07:50:00,44
3431,ORD_3432,14125,JB FASHION Baby Girl's Cotton Blend Sleeve Less Top and Short's with Bow Applique (Pink) (1-2 Years),Warehouse B,288,256,2025-02-28 12:45:00,32
3432,ORD_3433,14127,"Luv Lap Baby Diaper Pants XL Size (Extra Large) , with Aloe Vera Lotion for rash protection, Pack of 162 Count (54x3), wit...",Warehouse B,66,39,2025-02-28 03:26:00,27
3433,ORD_3434,14058,Glamifirsto 2 Piece Baby Girls Nylon Hair Bows Headbands Elastic Hair Band Hair Accessories for Kids - Multicolor,Warehouse C,173,156,2025-02-28 19:25:00,17
3434,ORD_3435,13994,obbi Baby's Cotton Cap (Pack Of 3) (Multicolor_0-3 Months),Warehouse C,279,234,2025-02-28 20:44:00,45
3435,ORD_3436,12979,POOJA BABY Cotton Baby Bodysuit Short Sleeve Half Romper Pack of 3 Soft & Comfortable for Kids Pack of 3,Warehouse A,334,324,2025-02-28 02:22:00,10
3436,ORD_3437,14269,"Pigeon Baby Cream, Enriched with Shea and Cocoa Butter, Paraben Free, 50 g, Pack of 2",Warehouse A,115,90,2025-02-28 18:43:00,25
3437,ORD_3438,14554,R for Rabbit XS New born Premium Feather Diaper nb Taped Size for Baby 0 to 5 kgs (66 Combo Pack Offer),Warehouse A,372,342,2025-02-28 18:11:00,30
3438,ORD_3439,14272,"Huggies Complete Comfort Wonder Pants Extra Large (XL) Size Baby Diaper Pants Sumo Pack, 168 count, with 5 in 1 Comfort",Warehouse A,187,180,2025-02-28 01:56:00,7
3439,ORD_3440,14555,A.T.U.N. All Things Uber Nice Cotton a-line Dress,Warehouse A,400,385,2025-02-28 07:16:00,15
3440,ORD_3441,14494,Koochie-Koo Set of 8 Cute Plastic Portable Baby Care Kit Nursery Kids Healthcare and Grooming Set Manicure and Pedicure Ac...,Warehouse B,378,352,2025-02-28 06:24:00,26
3441,ORD_3442,14491,Happy day Baby Slippers,Warehouse C,452,409,2025-02-28 18:20:00,43
3442,ORD_3443,12781,RC. ROYAL CLASS New Born Baby Cotton Ankle Length Multicolored Socks (pack of 5 pairs)(0-3 months),Warehouse B,194,162,2025-02-28 09:11:00,32
3443,ORD_3444,14406,"Chicco Toothpaste (Strawberry), 50 ml twin pack ( 2 paste of 50ml each)",Warehouse B,419,376,2025-02-28 03:54:00,43
3444,ORD_3445,14413,BUMZEE Boys Shirt Waistcoat & Pant Set With Applique Bow,Warehouse A,129,121,2025-02-28 05:12:00,8
3445,ORD_3446,14416,"Simply Baby Boys Summer Shorts, 100% Cotton Hot Pants, Button Closure, Ideal for Day Wear, Night Wear, Sleepwear, All Day ...",Warehouse A,307,294,2025-02-28 14:24:00,13
3446,ORD_3447,12776,"DEVICO Rai Mustard Seeds Pillow with Lavender, Baby-Round Head Shaping Baby Pillow,Neck Support Pillow Gifting 0-12 Months...",Warehouse A,272,251,2025-02-28 11:07:00,21
3447,ORD_3448,14423,"Woolen Socks & Mitten Combo for 6-12 Month Baby (2 Pair Socks & 2 Pair Gloves/Mitten, Multi)",Warehouse A,165,156,2025-02-28 09:25:00,9
3448,ORD_3449,12771,Himalaya Baby Shampoo (400 ml) & Himalaya Gentle Baby Soap (4N*75g),Warehouse A,461,453,2025-02-28 16:26:00,8
3449,ORD_3450,14456,"TuddyBuddy Baby Burp Cloth Towel Napkins for Baby Large 17x6 Inches, Premium Double Layer 100% Cotton (Horse)",Warehouse C,195,151,2025-02-28 00:55:00,44
3450,ORD_3451,14465,"COZY FURNISH Kids Towel with Baby Cap on Corner,Baby Towels, Baby Wrapper,Hooded Towels for Kids (Red)",Warehouse B,155,149,2025-02-28 16:22:00,6
3451,ORD_3452,12738,"Pigeon by Stovekraft Hard Anodised Pressure Cooker 3 Litre (14547) Induction Base, Inner Lid, Black, Aluminium",Warehouse C,475,439,2025-02-28 12:31:00,36
3452,ORD_3453,14478,"G&W GIGGLES & WIGGLES Premium Hooded Towel, Cute Animal Embroidery Unisex Hooded Towel, Extra Absorbent Knit Pink Color Te...",Warehouse B,267,248,2025-02-28 05:24:00,19
3453,ORD_3454,14490,ZEDAI Printed Baby Vest for Kids Cotton Sleeveless Sando Baniyan Toddler Innerwear Baby Cloth for Boys & Girls Pack of 6,Warehouse A,408,401,2025-02-28 16:34:00,7
3454,ORD_3455,12851,Qualtos Womens Pink Indoor Slipper -6-8 UK Men/ 5-8 UK Women (Wide) (pink love),Warehouse C,528,487,2025-02-28 01:01:00,41
3455,ORD_3456,10887,Teddyy Baby Easy Pant Diapers Medium 74 Count (Pack of 1),Warehouse C,412,388,2025-02-28 22:04:00,24
3456,ORD_3457,17711,"Neska Moda Unisex Pack Of 2 Lace Booties For 6 to 12 Months (Red,Black) - SK135andSK145",Warehouse B,395,367,2025-02-28 08:11:00,28
3457,ORD_3458,10875,"SINI MINI Girl's Cotton Printed Cute Capri Set (Purple Red, 10-11 Years) - Pack of 2",Warehouse A,198,153,2025-02-28 03:22:00,45
3458,ORD_3459,17719,"Cocomo Natural Olive & Coconut Oil Kids Face & Body Wash, Minty Fragrance, Soft & Healthy Skin | Minty Sea 300ml (Age: 4+)",Warehouse B,178,142,2025-02-28 01:45:00,36
3459,ORD_3460,17720,Mee Mee Elegant Lightweight & Adjustable Baby Sling Carrier | 4 Carry Position Baby Carrier with Padded Support for 0 to 2...,Warehouse C,447,410,2025-02-28 12:27:00,37
3460,ORD_3461,10858,"Triviso Cotton Baby Pajama Pants/Track Pants, Daily Use Lower Pant For Kids Boy And Girls Unisex Pack Of 5 (1 Month - 5 Ye...",Warehouse C,304,289,2025-02-28 00:34:00,15
3461,ORD_3462,17726,"Neska Moda 12 To 18 Months Baby Boys & Baby Girls Cotton Rabbit Booties (Orange,Blue) -BT1151andBT1179",Warehouse B,120,91,2025-02-28 23:28:00,29
3462,ORD_3463,10890,"EASY SHOPE Baby Folding Mat Play Foam Crawl Waterproof Portable Kids Baby Toddler,Pack of 1,Multicolor",Warehouse B,88,80,2025-02-28 04:23:00,8
3463,ORD_3464,10813,"Grafters Dinosaur Toy Pull Back Cars, 6 Pack Dino Toys for 3 Year Old and Up, Pull Back 4 Toy Cars and Friction Powered 2 ...",Warehouse A,408,380,2025-02-28 18:41:00,28
3464,ORD_3465,17808,Kitty Baby Boy Sneakers Blue Kids Casual Shoes,Warehouse C,488,461,2025-02-28 10:00:00,27
3465,ORD_3466,10775,"HUG 'n' FEEL SOFT TOYS Teddy Bear 6 feet, Soft Toy, Teddy Bear 6 feet for Girls, Teddy Bear 6 feet for Girls,Birthday Gift...",Warehouse C,424,414,2025-02-28 03:09:00,10
3466,ORD_3467,17887,CUTE THREADS Baby Girls Regular Fit Multicolor Cotton Shorts (Pack of 6) - 0 to 24 Months,Warehouse B,85,66,2025-02-28 02:43:00,19
3467,ORD_3468,17889,"Luv Lap Baby Safety Electrical Socket Plug Cover Guards, White,5Pcs",Warehouse C,378,331,2025-02-28 01:19:00,47
3468,ORD_3469,10771,"Giggles - Baby Giraffe Rattle , Colourful Animal rattle for New born baby, Stimulates Senses,Rattling sound, 6 months & ab...",Warehouse A,258,239,2025-02-28 22:09:00,19
3469,ORD_3470,17900,Moozo Baby Grooming Kit for New Born Baby Comb & Hair Brush for Kids Set (Sky Blue),Warehouse B,75,43,2025-02-28 12:56:00,32
3470,ORD_3471,17875,LILTOES Premium Baby Safety Helmet (Spaceship),Warehouse B,519,476,2025-02-28 19:18:00,43
3471,ORD_3472,11082,Mee Mee Nourishing Baby Oil with Fruit Extracts - 200 ml (Pack of 2),Warehouse A,354,331,2025-02-28 06:29:00,23
3472,ORD_3473,10836,"Neska Moda 6 To 12 Months Baby Girls Cotton Butterfly Frill Booties (Black,Yellow) -SK141andBT44",Warehouse B,174,165,2025-02-28 08:32:00,9
3473,ORD_3474,17769,4INFANTSONLY® Baby Super Soft Cotton Jhabla | Vest (Pack of 5) (0-6 Months),Warehouse C,97,59,2025-02-28 04:10:00,38
3474,ORD_3475,17774,The Baby CRY Cotton Front Open Half Sleeves Jhabla Half Sleeves Front Open Tshirt Multicolored Cotton Jhabla Vest (0-3 Mon...,Warehouse C,45,20,2025-02-28 21:44:00,25
3475,ORD_3476,17760,Intex Combo of 4ft Bath Tub and Air Pump (Multicolour),Warehouse B,191,161,2025-02-28 18:26:00,30
3476,ORD_3477,17776,Sahiba Gems Exclusive 925 Silver 4 Ball Silver Beads and Black Cotton Thread Nazariya for Babies ~ Pack in 2 Pcs (Safe for...,Warehouse A,325,290,2025-02-28 02:47:00,35
3477,ORD_3478,17788,100% Organic Bamboo Cotton Unisex Solid Baby Pants Plain Pajama Solid Lower Leggings Newborn Pajami Diaper Fit Without Pri...,Warehouse C,38,32,2025-02-28 18:37:00,6
3478,ORD_3479,17793,Mudgal India Creations Cotton Cute Collection Summer wear(Pack of 4 Nos) Dress Cum Baby Girl Jhabla/Frock (Color May be Ch...,Warehouse B,239,232,2025-02-28 16:58:00,7
3479,ORD_3480,10822,MINI KLUB Boys T-Shirt,Warehouse C,47,21,2025-02-28 08:50:00,26
3480,ORD_3481,10818,"Kadambaby - Baby Sweatshirt Pullover, Winter Wear Full Sleeve Tshirt, All Day Outerwear for Light Winter",Warehouse A,146,140,2025-02-28 20:04:00,6
3481,ORD_3482,10816,"Sebamed Baby Lotion, 100Ml And Sebamed Baby Cream Extra Soft, 50Ml",Warehouse A,466,445,2025-02-28 15:55:00,21
3482,ORD_3483,17805,"Neska Moda 12 To 18 Months Baby Girls Cotton Butterfly Frill Booties (Rani,Yellow) -BT1148andBT1171",Warehouse C,388,379,2025-02-28 20:45:00,9
3483,ORD_3484,17759,"Mee Mee Protective Baby Nail Clipper Cutter with Skin Guard for Kids (Green, Pack of 2)",Warehouse B,22,14,2025-02-28 20:04:00,8
3484,ORD_3485,17755,Menarini Olemessa Baby Massage Oil 200ml Pack of 4,Warehouse B,448,421,2025-02-28 14:09:00,27
3485,ORD_3486,17902,"Dash Butterfly Baby Walker, Walker Baby 6-18months boy, Walker, Activity Walker with 3 Position Adjustable Height and Musi...",Warehouse B,391,345,2025-02-28 08:55:00,46
3486,ORD_3487,17911,"Bumtum 200 ML Natural Baby Massage Oil for Babies/Child/Kids All Skin Type Nourishing for Baby No Sulphates, No Parabens (...",Warehouse B,53,28,2025-02-28 12:24:00,25
3487,ORD_3488,17042,Nyamah Sales Baby Powder Puff Holder Portable Powder Sponge without Box Container Perfect for Home and Travel Multicolor P...,Warehouse B,163,119,2025-02-28 17:41:00,44
3488,ORD_3489,17864,Toyztrend Toysbox Mind Your Own Business (Gold - Note),Warehouse A,174,159,2025-02-28 13:24:00,15
3489,ORD_3490,10805,Okara Baby Boys & Girls Winter Woolen Multicolor Gloves Pack Of 12 For Age-3-24 Months,Warehouse B,349,327,2025-02-28 08:50:00,22
3490,ORD_3491,17682,"Himalaya Baby Cream, 200ml and Massage Oil (500ml) Combo",Warehouse B,470,429,2025-02-28 16:20:00,41
3491,ORD_3492,17464,"LuvLap Baby Nasal Aspirator 0-5 Years with Snotsucker mechanism (Blue) & LuvLap Liquid Cleanser, Anti-Bacterial, Food Grad...",Warehouse B,202,168,2025-02-28 23:14:00,34
3492,ORD_3493,17468,"Paddy Baby Romper Winter Body Suit for New Set For Born Baby New Born Woolen Hood (0 - 3 Month, Green 1)",Warehouse C,319,311,2025-02-28 13:42:00,8
3493,ORD_3494,17471,"Little Peaches Pure Cotton Terry Burp Cloths for New Born Baby, Baby Napkins, Baby Hand Towel, Baby Wash Cloth (Pack of 4)",Warehouse B,144,138,2025-02-28 04:25:00,6
3494,ORD_3495,17481,MOROVIK 4 PCS Edge Protector for Furniture Table Corner Guards for Sharp Edges Silicon Corner Protector for Sharp Edges Ge...,Warehouse A,443,429,2025-02-28 23:09:00,14
3495,ORD_3496,17488,Fareto® New Born Baby Gift Pack Jhabla & Nappies(Pack of 8)(0-6 Months),Warehouse A,439,409,2025-02-28 06:30:00,30
3496,ORD_3497,11012,Picksparrow Baby Boy Kerala Kasavu Jhabla-Shorts/Ethnicwear (0-2 Months),Warehouse C,180,140,2025-02-28 14:18:00,40
3497,ORD_3498,17493,"Bantoo Baby Bedding Set New Born Play Gym Bed Mattress with Mosquito Net (0-6 Months, Green)",Warehouse A,316,308,2025-02-28 22:59:00,8
3498,ORD_3499,17501,First Kick New Born Baby Gift Set Combo Pack for Baby Boys and Baby Girls Pack of 5,Warehouse B,306,273,2025-02-28 09:49:00,33
3499,ORD_3500,17517,Baby Boys Knit Woolen Hat Cap Neck Scarf Soft Wool Warm Acrylic Lycra Monkey Beanie Winter Capset for Unisex Kids (6Month...,Warehouse A,255,229,2025-02-28 02:45:00,26
3500,ORD_3501,17856,Fully Set of 8 Pcs Soft Cotton Towels for Babies Cotton Face Towels Unisex Multicolor 15 Grams Pack of 1,Warehouse C,138,133,2025-02-28 22:23:00,5
3501,ORD_3502,17913,KNITROOT Monthly Birthday Special Unisex Baby Romper Half Sleeve White Color first months,Warehouse B,322,310,2025-02-28 02:49:00,12
3502,ORD_3503,17850,"SebaMed BABY TRAVEL PACK (Shampoo, BABY WASH, Baby Cream) 50ml pack",Warehouse A,491,472,2025-02-28 04:24:00,19
3503,ORD_3504,17918,Hopscotch Girls Faux Leather Solid Sneakers in Yellow Color,Warehouse A,504,483,2025-02-28 03:11:00,21
3504,ORD_3505,10749,"Desi Rang Baby Hand and Footprint kit, Foot and Handprint, Hand Foot Impression Print DIY, No Touch, Safe Non Toxic Ink pa...",Warehouse C,376,366,2025-02-28 10:47:00,10
3505,ORD_3506,17874,"Modern Homes® Ultra-Soft Organic Muslin washcloth for New Born Baby, 10"" x 10"" (Pack of 4, Multi Designs)",Warehouse C,362,322,2025-02-28 22:02:00,40
3506,ORD_3507,17812,"Baby Organo Soothing Baby Massage Oil, 100ml Pack of 2 | Super Blend of 6 Ayurvedic Herbs Oils | 100% Ayurvedic, Absolutel...",Warehouse C,502,472,2025-02-28 08:16:00,30
3507,ORD_3508,17816,"Tiny Kids Boy and Girls Casual LED Sport, Running Shoe",Warehouse C,332,306,2025-02-28 15:20:00,26
3508,ORD_3509,17821,"TONY STARK BIG SIZE Foldable Baby Mosquito Net, Bottomless Net for Infants, for Safe & Easy Use | Ensures Your Baby's Safe...",Warehouse A,436,428,2025-02-28 16:02:00,8
3509,ORD_3510,17822,WHISKET Baby Girls Turban Headbands Newborn Round Knot Wide Headwrap for Infant Toddler Boys Hair Accessories [Multi Color...,Warehouse A,413,379,2025-02-28 08:30:00,34
3510,ORD_3511,17823,"Gilli Shopee Newborn Baby's Soft Cotton Printed Housiry Caps/Topi with Tai Knot and Bonnet (Plain Coloured, 3-6 Months) - ...",Warehouse C,393,357,2025-02-28 06:37:00,36
3511,ORD_3512,10782,Marks & Spencer Baby-Girl's Regular Fit Vest,Warehouse C,232,206,2025-02-28 12:21:00,26
3512,ORD_3513,17833,"Neska Moda 0 To 6 Months Baby Boys & Baby Girls Pack Of 2 Pair Cotton Butterfly Frill Booties (Maroon,Blue) -BT368andBT1133",Warehouse A,373,351,2025-02-28 16:35:00,22
3513,ORD_3514,10798,"Chicco Toothpaste Apple-Banana 50ml, Pack of 2 (100ml total)",Warehouse C,362,351,2025-02-28 16:53:00,11
3514,ORD_3515,10797,"abracadabra 100% Cotton Terry Hooded Towel with 2 Face Washers for Infants, Toddlers & Kids, Extra Absorbent Knit Terry, S...",Warehouse C,495,467,2025-02-28 10:49:00,28
3515,ORD_3516,17843,Infantbond Born Baby Clothing Set(0-3 Months)(Colors & Designs May Vary),Warehouse C,405,381,2025-02-28 06:36:00,24
3516,ORD_3517,17107,DevFas Creation Baby Girl�s Tutu Style A-Line New Flamingo Frock Dress for Kids Girls,Warehouse B,44,22,2025-02-28 22:48:00,22
3517,ORD_3518,17103,"Kids choice Shoes Baby Boy's and Baby Girl's Canvas with Anti-Slip Sole Combo of 3 Pair Booties (3-12 Months | Red, Black,...",Warehouse C,287,275,2025-02-28 12:49:00,12
3518,ORD_3519,16906,"PALAY® Bucket Hat for Kids,Cotton Kid Hat for 2-5 Year-Old Kids,Cartoon Calf Hat,Kid Summer Outdoor Hat,Bucket Hat for Gir...",Warehouse B,80,65,2025-02-28 17:46:00,15
3519,ORD_3520,11380,Tiny Shadows Girls PU Leather Propergal Mini Bag,Warehouse B,507,468,2025-02-28 09:36:00,39
3520,ORD_3521,16932,"FAMEZA Baby Girls Red Bowknot Headband Hair Bows, Elastic Glitter Sequin Hair Band Accessories for Infant Newborn (Red, Si...",Warehouse C,440,419,2025-02-28 02:36:00,21
3521,ORD_3522,16941,KidzzCart Baby Boys & Baby Girls Pure Cotton Front Open T-Shirt with Shorts_Multicolor_Pack of 3 (6-12 Months),Warehouse A,256,243,2025-02-28 00:10:00,13
3522,ORD_3523,11383,Nino Bambino 100% Organic Cotton Denim Black Half Sleeve Collar Shirt for Baby Boys,Warehouse A,234,202,2025-02-28 19:30:00,32
3523,ORD_3524,16947,INFISPACE Boy's Fedora Short Brim Straw Hat,Warehouse B,454,409,2025-02-28 01:22:00,45
3524,ORD_3525,16952,Luv Lap 3 in 1 Rocker Napper - with Musical Vibrations - Red,Warehouse C,193,154,2025-02-28 20:21:00,39
3525,ORD_3526,16962,"Similac Advance Follow-Up Infant Formula Stage 2 - 400g,after 6 months",Warehouse A,384,335,2025-02-28 11:10:00,49
3526,ORD_3527,11335,"Odomos Non Sticky Mosquito Repellent Cream with Vitamin E and Almond Oil, 100g Carton",Warehouse B,436,390,2025-02-28 16:52:00,46
3527,ORD_3528,16983,RunBugz Mosquito Repellent Patches (Printed)(Star)(Pack of 1 ),Warehouse C,489,470,2025-02-28 13:10:00,19
3528,ORD_3529,16987,Cotton Grey Cheks Printed Degined Double Colors Clothing Set for Baby Boys,Warehouse A,405,386,2025-02-28 07:55:00,19
3529,ORD_3530,16833,"Mee Mee Mild Baby Liquid Laundry Detergent, 1.5L & Anti-Bacterial Baby Liquid Cleanser (300ml) Combo",Warehouse C,443,413,2025-02-28 19:41:00,30
3530,ORD_3531,17294,"DRESSABLY Soft Absorbent Baby Towel (Color & Prints May Vary) (Pack of 3)(Light Color, Small_48cm x 84cm)",Warehouse C,307,278,2025-02-28 11:55:00,29
3531,ORD_3532,11424,SOGRA Socks For Kids Baby Girls and Baby Boys Cotton Multicolor Ankle Socks pack of 4 Assorted Colours for All Season Socks,Warehouse C,254,213,2025-02-28 13:57:00,41
3532,ORD_3533,17329,"Neska Moda 6 To 12 Months Baby Boys & Baby Girls Pack Of 2 Pair Cotton Butterfly Frill Booties (Baby Pink,Blue) -BT4andSK137",Warehouse A,272,224,2025-02-28 13:11:00,48
3533,ORD_3534,17379,"Chicco Toothbrush for kids,Manual,Pink,6m-3 yrs",Warehouse A,353,309,2025-02-28 07:38:00,44
3534,ORD_3535,11087,Hopscotch Boys and Girls PVC Stripe Print Slip-Ons in Black Color,Warehouse B,379,359,2025-02-28 12:47:00,20
3535,ORD_3536,11105,"Angelcare Bath Support, Grey",Warehouse C,143,124,2025-02-28 17:49:00,19
3536,ORD_3537,17262,Baby Boy's & Baby Girl's Regular Fleece & Cotton Socks (Pack of 4) (Assorted),Warehouse B,55,39,2025-02-28 19:55:00,16
3537,ORD_3538,11125,"Dabur Baby Super Pants |Large Size Baby Diapers | Natural Skin Protection | Infused with Aloe Vera, Shea Butter & Vitamin ...",Warehouse A,363,332,2025-02-28 04:46:00,31
3538,ORD_3539,17265,Puma Unisex-Baby Smash V2 Lil V Inf Sneaker,Warehouse A,494,450,2025-02-28 02:22:00,44
3539,ORD_3540,11162,The Better Home Mosquito Repellent Patch for Babies (72 Patches),Warehouse C,198,186,2025-02-28 13:29:00,12
3540,ORD_3541,17275,"Neska Moda Set Of 2 Pair Baby Boys & Baby Girls 6 to 12 Months Velvet Booties (Black,Brown) -BT781andBT788",Warehouse B,370,365,2025-02-28 00:26:00,5
3541,ORD_3542,11157,Trinkets & More - Hammer Ball Musical Xylophone Musical Toy Wooden Pounding Bench with Box Case Instrument for Kids 2+ Yea...,Warehouse C,500,452,2025-02-28 16:19:00,48
3542,ORD_3543,17280,DECORE Cotton Kurta Pyjama Set,Warehouse C,292,244,2025-02-28 08:34:00,48
3543,ORD_3544,11152,"Himalaya Baby Powder, 700g & Baby Gift Pack Series,Pack of 1 set,white",Warehouse B,493,454,2025-02-28 23:59:00,39
3544,ORD_3545,11149,"Mee Mee Mild Baby Shampoo with Fruit Extracts and Fresh Feel Baby Powder, 500g",Warehouse C,161,135,2025-02-28 08:55:00,26
3545,ORD_3546,17306,Max Girls Solid Woven Shorts with Crochet Detail,Warehouse C,175,131,2025-02-28 10:42:00,44
3546,ORD_3547,16836,Max Boys Printed T-Shirt - Set of 3,Warehouse A,175,155,2025-02-28 01:50:00,20
3547,ORD_3548,11415,"Ketkar Baby Kid's Combo of School Winter Woolen Cap/Skull Cap and Gloves Set Soft Knit for Winter (Green, 5-10 Years) (Pac...",Warehouse C,164,139,2025-02-28 18:19:00,25
3548,ORD_3549,17092,"Nestlé NAN PRO 2 Follow-up Formula Powder - After 6 months, Up to 12 months, Stage 2, 400g Bag-In-Box Pack",Warehouse B,394,349,2025-02-28 01:44:00,45
3549,ORD_3550,17101,"Toyshine Waterproof Comfy Bathing Caps Non-Slip for Long Hair Durable Silicone Swimming Caps for Women, Floral White ( Pac...",Warehouse B,314,266,2025-02-28 04:00:00,48
3550,ORD_3551,11299,Hopscotch Boys Cotton and Polyester Graphic Print Sweatshirt And Jogger Set in Maroon Color,Warehouse C,59,14,2025-02-28 23:28:00,45
3551,ORD_3552,16998,"superminis Baby Girl's Cotton Flower Print Panties with Frill, Pack of 3",Warehouse C,504,465,2025-02-28 18:35:00,39
3552,ORD_3553,11325,SPONGY kids Half Sleeve Kid's Cotton Blend Teddy T-Shirt Print with Dungaree Shorts Bodysuit for Baby Boy & Girl,Warehouse C,432,416,2025-02-28 19:44:00,16
3553,ORD_3554,17002,Mothercare Kids Envelope Neck Printed Babysuit - Pack of 3,Warehouse B,282,265,2025-02-28 16:30:00,17
3554,ORD_3555,11320,Ratna's Junior Smiley Ring Stacking & Sorting Multicoloured 5 Rings for Infants & Toddlers to Learn Colour & Size,Warehouse B,454,437,2025-02-28 13:23:00,17
3555,ORD_3556,17025,Smartots Boys' Casual Shoes,Warehouse C,294,275,2025-02-28 12:51:00,19
3556,ORD_3557,17026,"Mee Mee Absorbent|Washable |Reusable |Soft Baby Bath Towel | Cotton Washcloth for Infants, New Born Babies and Toddlers (P...",Warehouse A,141,135,2025-02-28 06:06:00,6
3557,ORD_3558,11305,Hopscotch Girls Skirt Set,Warehouse B,325,277,2025-02-28 20:26:00,48
3558,ORD_3559,17034,SMARTOTS Kids Slipon Baby Casual Musical CHU CHU Sound Walking Running Shoes for Baby Boys/Girls Age 3 Months to 21 Months,Warehouse A,245,231,2025-02-28 02:09:00,14
3559,ORD_3560,17036,Dressify- Embroidered Cotton Army Cap for Boy's & Girl's Green,Warehouse C,133,118,2025-02-28 10:53:00,15
3560,ORD_3561,17087,Colgate Kids Anti cavity extra Soft Tongue Cleaner Toothbrush Batman + Barbie & Anticavity Batman + Barbie Toothpaste For ...,Warehouse C,231,188,2025-02-28 00:48:00,43
3561,ORD_3562,17082,myaddiction Fun Chicken Feet Socks Modern Animal Paw Pattern for Gifting Halloween Gifts 55cm,Warehouse B,81,49,2025-02-28 17:25:00,32
3562,ORD_3563,16855,"Neska Moda 6 To 12 Months Baby Girls Cotton Butterfly Booties (Yellow,Rani) -SK129andBT7",Warehouse B,411,406,2025-02-28 09:23:00,5
3563,ORD_3564,11280,"Luv Lap LuvLap Baby Diaper Pants New Born Size (NB), with Aloe Vera Lotion for rash protection, Pack of 180 Count (60x3)up...",Warehouse B,178,136,2025-02-28 01:38:00,42
3564,ORD_3565,16875,Himalaya Baby Lotion 400ml and Baby Cream 100ml,Warehouse B,392,357,2025-02-28 02:39:00,35
3565,ORD_3566,16882,"Milky Soft Shampoo with Oats, Milk and Calendula for Babies – 400 ml & Milky Soft Diaper Rash Cream for Babies – 50g",Warehouse C,106,76,2025-02-28 17:05:00,30
3566,ORD_3567,16891,Gurwala's Jewellers Artifical 5 Ball Golden Platted Beads and Black Cotton Thread Nazariya for Babies | Golden,Warehouse B,93,74,2025-02-28 02:06:00,19
3567,ORD_3568,11389,"Neska Moda 0 To 6 Months Baby Girls Cotton Butterfly Frill Booties (Baby Pink,Yellow) -BT1112andBT1123",Warehouse B,114,75,2025-02-28 01:21:00,39
3568,ORD_3569,16894,Kassy Pop Printed 6 Layer Bamboo Muslin Blanket Cum Swaddling Towel for Toddler Baby/AC Quilt/Multi-Purpose Blanket - (110...,Warehouse B,182,146,2025-02-28 11:44:00,36
3569,ORD_3570,11402,"Grab Classy - Safe Inkless“Clean-Touch”Baby Handprint and Baby Footprint Ink Pad with Imprint Cards, 100% Non-Toxic & Mess...",Warehouse C,421,411,2025-02-28 20:06:00,10
3570,ORD_3571,11330,LMN CHILD CARE Cartoon face Fancy Rattle Booties Cum Socks for Baby (0-6 Month) (White -Blue),Warehouse B,526,477,2025-02-28 02:16:00,49
3571,ORD_3572,16994,Bold N Elegant Flower Emboss Cute Ruffle Top Tshirt and Shorts Summer Baby Girl Clothing Set for Infant Toddler Kids,Warehouse B,501,462,2025-02-28 17:48:00,39
3572,ORD_3573,17056,"Salvus APP SOLUTIONS Handmade Metal Unisex Kada For Kids, Set of 2 (0-5 years)",Warehouse A,225,198,2025-02-28 22:06:00,27
3573,ORD_3574,17063,Baby Moo Rainbow Chu-Chu Sound Anti-Skid Breathable Denim Sandals - Navy Blue (2.5Y-3Y),Warehouse B,202,193,2025-02-28 18:20:00,9
3574,ORD_3575,17066,Himalaya Baby Hair Oil - 100 ml (Pack of 2),Warehouse C,82,44,2025-02-28 16:36:00,38
3575,ORD_3576,17067,First Kick New Born Baby Gift Set Combo Pack for Baby Boys and Baby Girls Pack of 6,Warehouse A,471,459,2025-02-28 10:27:00,12
3576,ORD_3577,11292,DADDY - G® Baby Gifts Set for New Born Unisex Clothing Gift Hamper 6Pcs,Warehouse B,72,61,2025-02-28 07:58:00,11
3577,ORD_3578,14003,"Koochie-Koo Dry Muslin Wash Cloth Organic Cotton Face Towel Handkerchief for Baby New Born/Infants/Toddlers (Pack of 3, Wh...",Warehouse C,390,377,2025-02-28 20:24:00,13
3578,ORD_3579,27768,"Neska Moda 6 To 12 Months Baby Boys & Baby Girls Cotton Rabbit Booties (Rani,Baby Pink) -SK175andSK147",Warehouse B,233,212,2025-02-28 07:28:00,21
3579,ORD_3580,27567,"SaleOn DIY Take Apart Toys Free Wheel Unbreakable Toys Puzzle Disassembly, Assembly, Removable, Educational and Learning T...",Warehouse C,401,360,2025-02-28 02:19:00,41
3580,ORD_3581,27578,Neska Moda Baby Boys & Girls 6 Pair Striped Multicolor Cotton Ankle Socks For 1 To 3 Years -SK832,Warehouse B,475,433,2025-02-28 14:02:00,42
3581,ORD_3582,5309,Stylie Modern Alternatives Pack of 2 Kids Cartoon Printed Extra Soft Electric Battery Powered Toothbrush for Kids Electric...,Warehouse C,175,154,2025-02-28 17:15:00,21
3582,ORD_3583,27555,"Giggles Funskool Digger The Dog, Pull Along Toy, Encourages Walking,Funny Walking Style, 12 Months & Above, Infant And Pla...",Warehouse B,327,288,2025-02-28 03:29:00,39
3583,ORD_3584,5214,PLAY TOOL 50 Baby Air Multi Colour Balls - Fifty Piece of 5.8 cm Size Ball for Kids - Indoor & Outdoor Activities and Exce...,Warehouse A,225,209,2025-02-28 13:48:00,16
3584,ORD_3585,5208,Philips Avent Natural Teat One Slot Variable Flow - 3months+ (2Pc. Pack),Warehouse A,56,22,2025-02-28 14:31:00,34
3585,ORD_3586,5204,Maanit Baby Toilet Training Potty Seat with Upper Closing Lid with Removable Bowl (Blue),Warehouse B,393,379,2025-02-28 01:18:00,14
3586,ORD_3587,5198,Mi Arcus Unisex Printed Soft New Baby Boys and Girls Pyjama - Cuddle (Pack of 3),Warehouse C,107,77,2025-02-28 17:11:00,30
3587,ORD_3588,27744,Marvel Avengers Boy's MAPBBO0973 Red Booties,Warehouse B,505,498,2025-02-28 11:18:00,7
3588,ORD_3589,5187,JIALTO Baby Nail Trimmer New Born Grinder Set Safe Nail Trimmer Kit for Kids Safe&Amp; Effective Baby Manicure Manicure To...,Warehouse C,116,71,2025-02-28 09:39:00,45
3589,ORD_3590,5181,"Himalaya Baby Care All Soaps Combo, (Pack of 4) 75g",Warehouse B,475,455,2025-02-28 21:44:00,20
3590,ORD_3591,5178,"Kwitchy New Born Baby Products All Complete Daily Items Combo (Multicolor, 0-6 Months)",Warehouse B,367,354,2025-02-28 19:26:00,13
3591,ORD_3592,27820,AHC Baby Ultra Soft Toothbrush With Micro Nano Bristles With Tongue Cleaner For 3-16 Years Kids (Light Green),Warehouse C,176,129,2025-02-28 16:20:00,47
3592,ORD_3593,5320,"Himalaya Total Care Baby Pants Diapers, Large (9-14 kg), 76 Count, White & Himalaya Baby Lotion 700ml",Warehouse C,432,399,2025-02-28 01:53:00,33
3593,ORD_3594,27612,"Neska Moda 6 To 12 Months Baby Girls Cotton Butterfly Booties (Baby Pink,Red) -SK172andBT4",Warehouse A,278,261,2025-02-28 21:37:00,17
3594,ORD_3595,27615,Saumabhi Toddler Shoes Tassel Soft Sole Solid Color Casual,Warehouse A,425,410,2025-02-28 22:58:00,15
3595,ORD_3596,27620,Dermadew Baby Cream - 80 g (Pack of 2),Warehouse B,315,303,2025-02-28 21:30:00,12
3596,ORD_3597,27621,"Toyshine Stunt Tricyle Toy Lights and Sound Electric Car Model Toy Vehicles Toys for Toddlers Baby Kids Children Birthday,...",Warehouse C,461,438,2025-02-28 22:25:00,23
3597,ORD_3598,5283,Hopscotch Boys and Girls Fabric Solid Slip Ons Shoes in Navy Color,Warehouse A,350,305,2025-02-28 02:45:00,45
3598,ORD_3599,27629,"Buddsbuddy BPA Free Animal Shaped Ola Kids Soft BristlesTooth brush, 2yrs+ Multicolor (Combo of 4)",Warehouse C,136,125,2025-02-28 21:55:00,11
3599,ORD_3600,27634,EIO New Born Baby Gift Set -13 Piecess (Orange),Warehouse C,310,274,2025-02-28 19:29:00,36
3600,ORD_3601,27538,The Baby First Box Newborn Baby Essential Kit - 21 Items(Winter Kit for 0-3 Months)| Newborn Hamper Gift Set| Shopping Gif...,Warehouse B,133,94,2025-02-28 07:22:00,39
3601,ORD_3602,27548,Dopamine Babies Cute Cartoon Stylish Cap for Child Baby boy or Girl of Age 2 to 4 Years with Sunshade Summer caps (Pack of1),Warehouse A,379,342,2025-02-28 06:16:00,37
3602,ORD_3603,5326,"Petlicious & More® Squeezing Squawkin' Pig, Rubber Screaming 9"" Inch Long Squeaky Toys (Color May Vary, Pack of One)",Warehouse A,74,61,2025-02-28 12:28:00,13
3603,ORD_3604,27784,CHIU Kids LED Light Shoes with Chu Chu Musical Sound for Baby Boys and Girls,Warehouse B,356,315,2025-02-28 19:38:00,41
3604,ORD_3605,27738,"My Newborn Baby Mittens Caps Gloves and Booty Combo Set - Pair of 4 (Assorted Colours, 0-3 Months) | Unisex Booty Set | Du...",Warehouse C,87,49,2025-02-28 17:52:00,38
3605,ORD_3606,3648,"Jordan Step 3 Kids Toothbrush, 6-9 Years Tooth brush , Soft Bristles, BPA Free Kid Toothbrush (6-9Years Kid-Stand-Yellow)",Warehouse C,133,108,2025-02-28 10:01:00,25
3606,ORD_3607,3647,"Pidilite Fevicreate Educational Game, Toddler's Craft Kit for Early Development, 7 Fun Learning Activities for Toddlers & ...",Warehouse B,337,318,2025-02-28 14:04:00,19
3607,ORD_3608,30659,Amazon Brand - Jam & Honey Baby-Boys Shorts,Warehouse B,416,407,2025-02-28 20:07:00,9
3608,ORD_3609,3637,NEOBABY Unisex-Baby's Casual Shoe,Warehouse C,483,444,2025-02-28 15:35:00,39
3609,ORD_3610,30668,"Mothercare All We Know Baby Body Wash and Lotion, 600ml (White) - Set of 2",Warehouse C,235,204,2025-02-28 19:46:00,31
3610,ORD_3611,30671,CLOTHERA Fedora Jute Round Hat (Pack of 2) Multicolor & Beige for Babies Photoshoot (6 Months to 9 Months) Black,Warehouse A,92,45,2025-02-28 10:30:00,47
3611,ORD_3612,30672,DHRUVS COLLECTION Exclusive 925 Sterling Silver Pair Of Baby Nazariya Silver Bracelets With A Combination Of Soft Black An...,Warehouse B,95,74,2025-02-28 17:55:00,21
3612,ORD_3613,3629,"Mee Mee Moisturizing Baby Lotion with Fruit Extracts, 500ml & Caring Baby Wet Wipes with Aloe Vera (72 pcs/Pack) (Pack of ...",Warehouse A,345,304,2025-02-28 01:28:00,41
3613,ORD_3614,30663,"Toddylon Baby Gift Set for New Born Essential Products All (Multicolor, 0-6 Months)",Warehouse C,386,373,2025-02-28 05:11:00,13
3614,ORD_3615,30628,"Pigeon Liquid Cleanser Naturals Refill,200 ml,Pack of 2 & Pigeon Liquid Cleanser Naturals Refill,200 ml",Warehouse C,109,93,2025-02-28 09:15:00,16
3615,ORD_3616,30580,"Goyal's Hammer Ball Toys for Kids- Pounding Game Set for Baby Kids and Toddlers for Early Development, Best Toy for 1 Year...",Warehouse C,186,161,2025-02-28 11:09:00,25
3616,ORD_3617,30581,ambitieux Kids Cute Alien Cartoon Baseball Style Cap for Child Baby boy or Girl of Age 0 to 1 Years with Sunshade Summer c...,Warehouse C,465,430,2025-02-28 13:08:00,35
3617,ORD_3618,30584,Kiddiehug Organic Knitted Cotton Sleveless Shirts Jhablas Dresses for Baby Girls and Boys Kids Infant Clothing Combo (Mult...,Warehouse A,301,272,2025-02-28 05:12:00,29
3618,ORD_3619,3677,Maanit Foldable Plastic Baby Bath Tub with Anti Slip Base (Red),Warehouse B,448,400,2025-02-28 09:33:00,48
3619,ORD_3620,30589,"KNITROOT Mundan Special Unisex Baby Romper Half Sleeve Envelope Neck ""How's My New Look""(KMDR08-2,3-6 Months,Peach)",Warehouse B,366,343,2025-02-28 12:32:00,23
3620,ORD_3621,3651,Baby Bucket Baby Girls Cotton Panties (Pack of 6) (New 10LC 6PC PK 7891_Multi-18MC_12 Months-18 Months),Warehouse C,220,195,2025-02-28 10:44:00,25
3621,ORD_3622,27737,Hopscotch Boys Cotton Text Print Short in Navy Color,Warehouse A,431,407,2025-02-28 03:15:00,24
3622,ORD_3623,27668,Kids Choice Baby Shoes & Sandal for Boy's and Girl's Canvas with Anti-Slip Sole (Red & Black),Warehouse C,486,458,2025-02-28 09:16:00,28
3623,ORD_3624,27677,Tickles Blue Shark Soft Toy Stuffed Soft Plush Toy For Kids 38 Cm,Warehouse A,348,329,2025-02-28 19:38:00,19
3624,ORD_3625,27692,"Pampers Baby Dry Diapers, New Born, 11 Count",Warehouse C,76,65,2025-02-28 20:16:00,11
3625,ORD_3626,27696,Disney Princess Girl's DPPGBO0916 Pink Booties,Warehouse A,383,343,2025-02-28 09:22:00,40
3626,ORD_3627,27699,Sahiba Gems Light Comfortable Traditional Plain Hollow Self Design Small Blue Crystal Head Baby Kada/Bangles in Solid Silv...,Warehouse C,449,403,2025-02-28 10:02:00,46
3627,ORD_3628,27701,Jimmy Jammy Baby Girls Summer Dress Suits Printed Cotton Top & Capri (Pack of 3 Dresses | 3 Baby Tops + 3 Capri | Size 6 M...,Warehouse A,126,95,2025-02-28 00:09:00,31
3628,ORD_3629,5244,"Elysian Plastic Unbreakable Dhamela/Tub/Tagari Home, Kitchen, Animal Care Feeding, Baby Bathing, Agriculture Multipurpose ...",Warehouse C,273,233,2025-02-28 18:38:00,40
3629,ORD_3630,27704,PUMA Toddler Boys Pacer Easy Street Slip On Sneakers Shoes Casual - Pink,Warehouse B,147,140,2025-02-28 12:53:00,7
3630,ORD_3631,27725,The Little Lookers Comb and Brush Set with Soft Bristles and Rounded Tips for Baby’s Sensitive Skin/Hair Care |Grooming Ac...,Warehouse A,182,137,2025-02-28 17:00:00,45
3631,ORD_3632,27726,Kwitchy New Born Baby Gift Pack Daily Essential Items Combo for 0-6 Months Baby Boy's & Baby Girl's,Warehouse A,438,427,2025-02-28 11:09:00,11
3632,ORD_3633,5651,"Honey Shopee Baby Nose Cleaner Blister Pack/Aspirator Vacum Sucker Nose Mucus Snot Cleaner Pump With Newborn Baby, Infant ...",Warehouse A,476,430,2025-02-28 20:36:00,46
3633,ORD_3634,4381,TAGAS Baby-Girls Dress,Warehouse C,178,135,2025-02-28 11:48:00,43
3634,ORD_3635,29256,Keshvam Big Size Building Blocks for 2 Year Kids Educational Toys & Lerning Toys Smart Activity Fun Indoors Games(70 pcs L...,Warehouse C,240,200,2025-02-28 02:51:00,40
3635,ORD_3636,30634,Fflirtygo It's My Mundan I Promise I Won't Cry Baby Wear 100% Hosiery Cotton Infants Rompers with Booties/Onesies/Body Sui...,Warehouse C,453,445,2025-02-28 00:27:00,8
3636,ORD_3637,27606,Cotton Diaper Inserts Reusable (Pack of 6) Baby Washable Cloth Diaper Nappies Wet-Free Inserts for Babies Diaper having 5 ...,Warehouse B,453,419,2025-02-28 01:47:00,34
3637,ORD_3638,5298,Babique Octopus Sitting Plush Soft Toy Cute Kids Animal Home Decor Boys/Girls (17 cm),Warehouse C,201,188,2025-02-28 00:33:00,13
3638,ORD_3639,5300,CUTE LANDINGS® New Born Baby Hosiery Cotton 6 Knot Vest/Jhablas and 6 Single Layer Nappy (0-3 Months)(Hug Me Kiss Me Print),Warehouse B,125,119,2025-02-28 07:49:00,6
3639,ORD_3640,5113,"My Tiny Wear Baby Girl Half Sleeve Cotton Frock, Midi Dress with panty, Front Open Frock Set for New Born Girl (Orange, 0-...",Warehouse A,469,423,2025-02-28 17:44:00,46
3640,ORD_3641,27916,MINI KLUB Baby Boy's Cotton Solid Sleepsuit (95IEBSL491_Multi_NB_Multicolour_0 Months-3 Months),Warehouse C,144,137,2025-02-28 16:31:00,7
3641,ORD_3642,27946,"TIDY SLEEP Diaper Changing Mat/Sleeping mats/Water Proof Bed Protector with Foam for New Born Baby, 3 Sheets (65cm x 45 c...",Warehouse A,379,359,2025-02-28 03:30:00,20
3642,ORD_3643,5095,O'mumsie- Bathing Baby Shampoo + Wash | Tear Free Formula For babies | Super moisturising For Normal To Sensitive Skin | N...,Warehouse C,115,72,2025-02-28 20:53:00,43
3643,ORD_3644,5087,"Chicco Toothpaste, Strawberry Flavour for 12m+ Baby, Fluoride-free, Preservative-free,Cavity Protection (50 millilitre)",Warehouse A,443,409,2025-02-28 22:19:00,34
3644,ORD_3645,27977,Bodyguard Natural Anti Mosquito Repellent Patches - 168 Patches,Warehouse A,276,229,2025-02-28 00:32:00,47
3645,ORD_3646,5128,Mi Arcus Baby Boy Comfy Knitted Sleep Suit - Safari (Pack of 2),Warehouse B,364,351,2025-02-28 10:52:00,13
3646,ORD_3647,27839,Mothercare Baby Boy's Regular (ZC599_Multicolor_9-12M),Warehouse C,487,450,2025-02-28 22:17:00,37
3647,ORD_3648,27854,"Mee Mee Premium Baby Grooming Care Set, Yellow, Set of 1 & Mee Mee Soft Nipple Baby Pacifier (Red/Blue)",Warehouse B,354,329,2025-02-28 04:44:00,25
3648,ORD_3649,27858,"Himalaya Massage Oil Bottle - Baby, 100ml",Warehouse C,467,436,2025-02-28 06:22:00,31
3649,ORD_3650,27860,"PICKSPARROW Newborn Baby Gift Set/Baby Shower Gift/Newborn Essentials/Clothing Set (Pack of 12, Unisex, Embroidered)",Warehouse C,328,318,2025-02-28 14:39:00,10
3650,ORD_3651,27861,"Cetaphil Baby Daily Lotion, 400ml, Baby Shampoo and Wash, 230 ml and Shampoo-200 ml (Pack of 3) - Combo",Warehouse B,351,326,2025-02-28 07:21:00,25
3651,ORD_3652,5125,Sathiyas Akash 100% Cotton Embroidered Baby Towels - Pack of 2 (Cream || Pink),Warehouse B,226,208,2025-02-28 10:19:00,18
3652,ORD_3653,5137,"Chicco Toothpaste, Strawberry Flavour for 1Y to 6Y Baby, Fluoride-Free, Preservative-Free,Cavity Protection (50g)",Warehouse C,233,200,2025-02-28 03:36:00,33
3653,ORD_3654,27888,"Neska Moda 12 To 18 Months Baby Boys & Baby Girls Cotton Rabbit Booties (Rani,Red) -BT1156andBT1180",Warehouse A,167,159,2025-02-28 14:26:00,8
3654,ORD_3655,27930,Miss U Dungaree for Boys Applique Cotton,Warehouse B,349,316,2025-02-28 15:25:00,33
3655,ORD_3656,27116,United Colors of Benetton Baby-Girl's Bermuda Shorts Cotton Casual,Warehouse B,525,483,2025-02-28 22:39:00,42
3656,ORD_3657,5543,"Neska Moda 12 To 18 Months Baby Girls Cotton Butterfly Booties (Red,Orange) -BT1145andBT1156",Warehouse A,330,302,2025-02-28 00:57:00,28
3657,ORD_3658,27138,ARDAKI Baby Proofing Edge & Corner Guards Corner Protector Child Safety Edge Guards Pre-Taped Self Adhesive for Furniture ...,Warehouse B,163,152,2025-02-28 03:37:00,11
3658,ORD_3659,27142,Mothercare Unisex Baby YC191,Warehouse C,361,326,2025-02-28 19:11:00,35
3659,ORD_3660,5539,heartbury Baby's Anti Slip Cotton Socks,Warehouse A,60,29,2025-02-28 10:16:00,31
3660,ORD_3661,27148,KETKAR Baby Gloves Winter Warm Lovely Knitted Gloves Kid Mittens_Pack Of 12(Multicolour),Warehouse B,321,285,2025-02-28 04:48:00,36
3661,ORD_3662,27149,"LuvLap Super Soft Baby Toothbrush, Ultra Soft baby toothbrush with High Density unique 10,000+ Floss Bristles for ultimate...",Warehouse C,212,167,2025-02-28 08:06:00,45
3662,ORD_3663,27158,adidas Originals Unisex-Child Superstar Crib Crib Shoe,Warehouse B,372,327,2025-02-28 22:06:00,45
3663,ORD_3664,28140,Aarushi Premium Powder Puff with Container for Baby Pack of 1 Content: 1 Powder Puff With Case ( color May Very ),Warehouse B,126,110,2025-02-28 15:17:00,16
3664,ORD_3665,27921,SYGA Newborn Infant Baby Girls Soft Nylon Bowknot Tie Headbands Hairbands Fashion Hair Accessories Knotted Headband Toddle...,Warehouse B,104,60,2025-02-28 02:20:00,44
3665,ORD_3666,27922,"Mamaearth Coco Soft Body Lotion with Coconut Milk & Turmeric, for babies, for 24-Hour Moisturization - 400 ml",Warehouse B,458,409,2025-02-28 21:15:00,49
3666,ORD_3667,27923,"HARISTAR Potty Trainer Seat Baby Potty Seat with Lid for Child Baby For-1,2,3,4 Year Babies, Suitable for Boy/Girl",Warehouse A,477,430,2025-02-28 11:12:00,47
3667,ORD_3668,27602,"Neska Moda Unisex Set Of 3 Pair Booties for 6 to 9 Months (Blue,Orange,Yellow)",Warehouse A,382,351,2025-02-28 07:38:00,31
3668,ORD_3669,28003,"First Kick Baby Boys/ Baby Girl's Micro fleece Pack of Super Soft Bathrobe Wrapper Cum Bath Towel (80cm x 80cm, 0-6 Month...",Warehouse C,450,416,2025-02-28 17:59:00,34
3669,ORD_3670,28020,Sunbaby Combo of Anti-Slip Plastic Baby Bathtub with Drain Plug & Baby Bath seat for New Born Babies for Bathing,Warehouse C,127,109,2025-02-28 21:23:00,18
3670,ORD_3671,28022,"Teddyify Microfibre Cotton washcloth, Babies Extra Soft/Quick Dry/ Strong Water Absorbent/Bathing Towel for Kids, Boys and...",Warehouse B,386,368,2025-02-28 01:23:00,18
3671,ORD_3672,28077,"ZeroOneCraft® Wooden Non Toxic Colourful Rattle Toys for Newborn Baby, Musical Infant Toy, Gift Set Age 0+ (Set of 3, Mult...",Warehouse C,351,318,2025-02-28 04:59:00,33
3672,ORD_3673,5048,Hopscotch Girls Fabric Text Print Boots in Pink Color,Warehouse B,320,275,2025-02-28 12:57:00,45
3673,ORD_3674,5042,SHIRAZI KIDS Boy's Printed Huddy T-shirt and pant,Warehouse C,172,132,2025-02-28 16:42:00,40
3674,ORD_3675,28056,1st Step BPA Free Straw Sipper Cup with Twin Handle (Pink),Warehouse B,443,427,2025-02-28 15:23:00,16
3675,ORD_3676,28061,heartbury Organic Muslin Cotton Baby Wipes/BabyTowel/Baby washclothes for New Born Baby (Size100*100 CM) (100 * 100 (Pack ...,Warehouse B,462,443,2025-02-28 00:07:00,19
3676,ORD_3677,28062,"Neska Moda 12 To 18 Months Baby Boys & Baby Girls Cotton Lace Shoes/Booties (Yellow,Orange) -BT1188andBT1191",Warehouse B,434,388,2025-02-28 22:45:00,46
3677,ORD_3678,28070,"Sebamed Baby Lotion, 400ml & Baby Cleansing Bar - 100 g & Childrens' Shampoo, 500ml Combo",Warehouse B,182,159,2025-02-28 19:51:00,23
3678,ORD_3679,28075,"FabSeasons Baby Boy's and Baby Girl's Acrylic Woollen Winter Gloves, fits for 1-3 years. Pack of 2 | Brown::Purple",Warehouse C,98,67,2025-02-28 19:49:00,31
3679,ORD_3680,28033,Simply Girls Cotton Panties - Bloomers Set,Warehouse B,169,138,2025-02-28 19:25:00,31
3680,ORD_3681,27827,"Neska Moda 6 To 12 Months Baby Boys & Baby Girls Cotton Lace Shoes/Booties (Rani,Orange) -SK136andSK134",Warehouse B,104,95,2025-02-28 21:06:00,9
3681,ORD_3682,27824,Donuts Cotton Skirt Yellow,Warehouse C,335,319,2025-02-28 16:59:00,16
3682,ORD_3683,27599,BUMZEE Navy & Grey Front Open Half Sleeves Jablas for Baby Boy Pack of 3 Age - 0-3 Months,Warehouse A,322,279,2025-02-28 06:32:00,43
3683,ORD_3684,5302,"Hiniry® Baby Nail Trimmer Electric Safe Baby Nail Clippers Baby Nail File Kit Manicure Set, Trim Polish Grooming kit for N...",Warehouse A,217,202,2025-02-28 21:07:00,15
3684,ORD_3685,28076,Toyshine Stunt Scooter Toy Lights and Sound Electric Car Model Toy Vehicles Toys for Toddlers Baby Kids Children Birthday-...,Warehouse B,88,63,2025-02-28 00:21:00,25
3685,ORD_3686,5130,SHOP FRENZY barbie/Princess Baby Shoes CUM socks booties FOR KIDS TODDLERS INFANT (3 PairS) age 0-12 months | 0-1 year Blu...,Warehouse A,169,161,2025-02-28 03:54:00,8
3686,ORD_3687,27830,"Pigeon Peristaltic Baby Nursing/ Feeding Bottle KPP Nipple L,For 9+ Month Babies,BPA Free,BPS Free,Pink,240 ml",Warehouse B,195,172,2025-02-28 20:35:00,23
3687,ORD_3688,27985,LILTOES Baby Safety Helmet Baby Pink,Warehouse C,242,199,2025-02-28 22:45:00,43
3688,ORD_3689,5074,Piku Store Kids Full Sleeves T-Shirt & Lower Set,Warehouse B,126,104,2025-02-28 22:49:00,22
3689,ORD_3690,5019,HUG 'n' FEEL SOFT TOYS Soft Toys Long Soft Lovable Huggable Cute Giant Life Size Teddy Child Safe Best for Birthday Gift V...,Warehouse C,130,109,2025-02-28 23:43:00,21
3690,ORD_3691,28101,Little Fingers 4-in-1 Baby Grooming Kit/Nailcare kit for Newborn- Healthcare Daily Hygiene Set- Pack of 1 (Different Color...,Warehouse B,278,268,2025-02-28 20:31:00,10
3691,ORD_3692,28104,"Jordan Step BPA-free Plastic Gentle Baby Toothbrush with Extra Soft Bristles (Random Colour, 0-2 Years)",Warehouse A,366,330,2025-02-28 13:24:00,36
3692,ORD_3693,5007,socho samjo Baby Girl's Midi Fit And Flare Dress,Warehouse A,252,206,2025-02-28 08:21:00,46
3693,ORD_3694,5006,WorldCare® 3mm Water Sports Diving Socks Swim Surfing Beach Boots Shoes Camo M (54032254JEL),Warehouse B,493,479,2025-02-28 22:34:00,14
3694,ORD_3695,5005,"Neska Moda 0 To 6 Months Baby Girls Cotton Butterfly Booties (Black,Rani) -BT384andBT1115",Warehouse C,419,401,2025-02-28 11:31:00,18
3695,ORD_3696,28120,Lillypupp Unisex Red Velcro Strap Low-Ankle Chu-Chu Sound Making New Born Baby Shoes- Size Range : 6 to 24 Months,Warehouse B,487,456,2025-02-28 06:52:00,31
3696,ORD_3697,5001,little PANDA Unisex Baby Dungaree Dress Half Sleeve Hosiery Cotton T-Shirt and Dungaree Set for Baby Boys and Baby Girls,Warehouse A,334,296,2025-02-28 19:37:00,38
3697,ORD_3698,28136,"Superbottoms BASIC Quick Dry Pads | Insert | Diaper liner for Adjustable Cloth Diaper,Washable & Reusable Cloth Diapers(Co...",Warehouse A,50,19,2025-02-28 21:14:00,31
3698,ORD_3699,30598,Manan Shopee Unisex Regular Vest,Warehouse C,189,147,2025-02-28 06:54:00,42
3699,ORD_3700,30602,baby wish Baby Hooded Towels for New Born Bath Towel for Boys and Girls Kids Towels Set Ultra Absorbent Mushroom Print Bab...,Warehouse C,444,425,2025-02-28 02:03:00,19
3700,ORD_3701,31234,Sathiyas Akash 100% Cotton Embroidered Baby Towels - Pack of 2 (Blue || Cream),Warehouse B,379,342,2025-02-28 12:19:00,37
3701,ORD_3702,31242,Nyamah Sales Baby Boys and Baby Girls Cotton Low Cut No Show Socks Loafer Kids 3-7 Years Multicolor 6 PAIR,Warehouse C,459,430,2025-02-28 14:45:00,29
3702,ORD_3703,3345,PROMISE KID Girls Kid dresses,Warehouse C,423,374,2025-02-28 08:38:00,49
3703,ORD_3704,31249,Manan Shopee Newborn Baby Cotton Polyester Blend Suit for Winter Wear Dress Suit Set 5 Pcs Pack 0-3 Months (Pink),Warehouse B,495,453,2025-02-28 10:46:00,42
3704,ORD_3705,31254,BM Jewellers 925 Pure Hallmarked Silver Kada With Certificate Of Purity For Baby Boy And Baby Girl (11.5 GM),Warehouse A,536,493,2025-02-28 08:04:00,43
3705,ORD_3706,31260,ALPHASTAR Girls Slip on Walking Shoes-19A,Warehouse B,216,198,2025-02-28 07:26:00,18
3706,ORD_3707,31248,Crawl'in Boys Cotton Panties (Pack of 6) (Panty.Cr16_Multicolour_Children One Size),Warehouse A,391,356,2025-02-28 21:44:00,35
3707,ORD_3708,31288,Lify Water Shoes Barefoot Aqua Yoga Socks Quick-Dry Beach Swim Surf Shoes for Women Men – 1 Pair,Warehouse A,102,73,2025-02-28 14:45:00,29
3708,ORD_3709,31141,Silverwala 92.5-925 Sterling Silver Baby Bracelets kada Bangle Nazariya With Black Beads/crystal for baby boy and BABY girl,Warehouse C,107,102,2025-02-28 14:29:00,5
3709,ORD_3710,3385,Silver Stone Studded Bangles For Baby Girls 0-3 Months[PACK OF 4 pieces],Warehouse B,489,444,2025-02-28 02:50:00,45
3710,ORD_3711,3380,"Yellow Bee Anti-Skid Rubber Sock Shoes for Boys, Beige",Warehouse A,218,171,2025-02-28 03:41:00,47
3711,ORD_3712,31162,Mee Mee Anti-Bacterial Baby Liquid Cleanser (Cleanser - 500 Ml - Bottle)&Mee Mee Anti-Bacterial Baby Liquid Cleanser (1.5 ...,Warehouse A,97,53,2025-02-28 13:47:00,44
3712,ORD_3713,31227,"GION Antiskid Soft Sole Socks Shoes for Kids/Outdoor, Running, Walking, Casual Wear Shoes for Baby Boys and Girls/Antislip...",Warehouse A,100,83,2025-02-28 08:38:00,17
3713,ORD_3714,31215,ambitieux RABIT Cap for Baby boy 0-6 Months Age Baby Girl Cap,Warehouse B,503,472,2025-02-28 01:39:00,31
3714,ORD_3715,3351,MTR Cute Crab Silicone Suction Plate for Babies Toddlers|Premium Cartoon Baby Feeding Set|Baby-Led Self Feeding Training D...,Warehouse A,91,56,2025-02-28 22:16:00,35
3715,ORD_3716,30494,YouBella Jewellery Adjustable Head Bands for Kids (Pink 1),Warehouse A,89,40,2025-02-28 03:02:00,49
3716,ORD_3717,30492,Nestlé CERELAC Baby Cereal with Milk - Wheat Orange (From 8 Months) - BIB Pack 300g,Warehouse C,413,395,2025-02-28 07:29:00,18
3717,ORD_3718,3765,Philips Avent Natural 2. 0 Pink Feeding Bottle 260ml SCF034/10,Warehouse B,456,429,2025-02-28 20:15:00,27
3718,ORD_3719,3764,babeezworld Girl's Fit And Flare Knee Length Dress,Warehouse B,233,227,2025-02-28 04:34:00,6
3719,ORD_3720,30432,Hygear Girls Premium Comfy Fashionable Slip-on Shoes,Warehouse A,284,253,2025-02-28 09:27:00,31
3720,ORD_3721,3762,Chidakash 4 Pcs Squeeze Animal Bath Toys Soft Rubber Non-Toxic Chu Chu Squeeze Toys for Babies Kids Toddlers,Warehouse C,303,282,2025-02-28 18:11:00,21
3721,ORD_3722,3750,Baby Boy Clothing Set | Stylist Yellow Tshirt and Blue Jeans (5-6 Years),Warehouse C,167,123,2025-02-28 11:28:00,44
3722,ORD_3723,3749,BABY VIBES Unisex Baby Cotton Night Suit / Sleep wear Pajamas Sets with Ribs (Pack of 2)(Same Color Will be Send). .,Warehouse B,120,95,2025-02-28 02:28:00,25
3723,ORD_3724,30471,OYO BABY New Born Combo Baby No Tears Baby Shampoo for Newborn Babies and Extra Virgin Coconut oil for baby massage skin a...,Warehouse C,48,35,2025-02-28 02:54:00,13
3724,ORD_3725,30479,Shrungarika Silver golden Ghungroo Heart Charms Kada/Bracelet For Baby Girls & Baby Boys Alloy Anklet,Warehouse B,189,172,2025-02-28 05:02:00,17
3725,ORD_3726,30482,Unisex Woolen Caps for Babies (Set of 2) | Soft Muffler Cum Scarf Sets | Light Weighted Cap for Infants,Warehouse C,291,257,2025-02-28 07:25:00,34
3726,ORD_3727,30485,Adore Pop Kid's Toothbrush With Cover (Panda Black),Warehouse C,446,421,2025-02-28 06:24:00,25
3727,ORD_3728,30844,MINI KLUB Baby-Boy's Regular Fit,Warehouse B,321,312,2025-02-28 09:55:00,9
3728,ORD_3729,31167,"Baby Cream, 50g",Warehouse C,216,189,2025-02-28 21:28:00,27
3729,ORD_3730,3370,Hopscotch Unisex EVA Solid Infant Booties in Multi Color,Warehouse B,412,400,2025-02-28 14:27:00,12
3730,ORD_3731,30537,INFANTSO Baby Rocker Portable with Mosquito & U- Shape Baby Pillow with Calming Vibrations with Music & Musical Toy Blue,Warehouse B,501,463,2025-02-28 09:01:00,38
3731,ORD_3732,3203,Moozo Baby Grooming Kit for New Born Baby Comb & Hair Brush for Kids Set (Pink),Warehouse A,340,332,2025-02-28 13:53:00,8
3732,ORD_3733,3251,"Philips Avent Natural Baby Bottle Nipple, Medium Flow Nipple 3M+, 4pk, SCF653/43",Warehouse A,474,432,2025-02-28 15:39:00,42
3733,ORD_3734,31309,"Baybee Amdia Baby Bath Tub for Baby, Mini Swimming Pool for Kids with Recline Position & Drainer | Baby Bather Bath Chair...",Warehouse A,46,13,2025-02-28 11:09:00,33
3734,ORD_3735,31316,"Boniry Baby Nail Trimmer,Baby Nail Clippers Safe for Newborn Toddler Adult Toes Fingernails Care Trim Kit 6 Grinding Head...",Warehouse A,536,493,2025-02-28 13:17:00,43
3735,ORD_3736,31373,KRONADO Presents Boys Vests Multi Pack in Multicoloured,Warehouse A,476,463,2025-02-28 13:19:00,13
3736,ORD_3737,3266,Kidbee Baby Supersoft Cotton Hosiery Boys & Baby Girls Printed Hosiery Shorts Multicolor (Pack of 3) (3-4 Years),Warehouse B,440,428,2025-02-28 02:29:00,12
3737,ORD_3738,31331,Meena Fancy - Baby Set - Vasambu - Bangle - New Born Baby Set for Unisex Baby - Pack of 1,Warehouse C,180,155,2025-02-28 09:35:00,25
3738,ORD_3739,31336,"Little Peaches Pure Cotton Terry Burp Cloths for New Born Baby, Baby Napkins/Hand Towel/Wash Cloth (Girl, Pack of Any 9)",Warehouse C,94,83,2025-02-28 04:29:00,11
3739,ORD_3740,3263,Dr. Brown's Milk Powder Dispenser (Blue)(Pack of 1),Warehouse B,462,430,2025-02-28 15:56:00,32
3740,ORD_3741,3261,Bold N Elegant Corduroy Winter Fleece Bonded Full Sleeve Footless Baby Romper Onesie Front Button Bodysuit Jumper for Newb...,Warehouse B,132,108,2025-02-28 16:57:00,24
3741,ORD_3742,31353,"Toy Factory Baby Nasal Aspirator, Nose Cleaner, Vacuum Suction Tool, Immediate Relief from Blocked Baby Nose Pack of 1 (Pink)",Warehouse A,210,169,2025-02-28 12:12:00,41
3742,ORD_3743,31329,"Baby Needs New Born Baby Multi-Color Long Sleeve Cotton Sleep Suit Romper for Boys and Girls Set of 3 (Newborn, Dark Blue)",Warehouse A,322,305,2025-02-28 00:49:00,17
3743,ORD_3744,28651,Mothercare Baby Boy's Regular fit Cotton Shorts,Warehouse A,196,163,2025-02-28 22:00:00,33
3744,ORD_3745,3210,R for Rabbit Large L Size Premium Feather Diaper for Baby 9 to 14 kgs (92 Combo Pack Offer),Warehouse A,372,353,2025-02-28 07:22:00,19
3745,ORD_3746,3365,Dermadew Baby Cream(240 g)-Pack of 3,Warehouse A,333,298,2025-02-28 07:16:00,35
3746,ORD_3747,31185,"DISNEY BY Jagannath Gangaram Pednekar Since 1965 18KT Yellow Gold, BRACELET BABY BRACELET",Warehouse C,505,462,2025-02-28 08:56:00,43
3747,ORD_3748,3363,Mee Mee Unique Finger Brush (Green),Warehouse B,305,275,2025-02-28 10:20:00,30
3748,ORD_3749,31187,Bouncy Toonz New Born Baby Clothes - Boys & Girls - Rompers 0-3-6-9-12 Months - Ideal for Summer & Winter (Pack of 2) (bod...,Warehouse B,329,324,2025-02-28 17:23:00,5
3749,ORD_3750,31139,MOMS LOVE Baby-Girls Baby and Toddlers Sleepwear,Warehouse A,434,416,2025-02-28 18:40:00,18
3750,ORD_3751,3290,Kidbee Soft Cotton New Born Baby Booties Mittens Tie Knot with Earflaps Cap Set,Warehouse B,371,345,2025-02-28 03:11:00,26
3751,ORD_3752,3242,"POLKA TOTS Reusable & Washable Swim Diaper, Leak proof & Adjustable Summer Swimsuit Costume for Toddlers Baby Kids (Bird, ...",Warehouse B,347,338,2025-02-28 16:07:00,9
3752,ORD_3753,31416,Himalaya Anti-Dandruff Hair Cream | Removes & Prevents Dandruff | Non Sticky Oil Replacement Hair Cream | Soothes Scalp | ...,Warehouse C,313,307,2025-02-28 11:25:00,6
3753,ORD_3754,3231,"Neska Moda 12 To 18 Months Baby Boys & Baby Girls Cotton Rabbit Booties (Black,Blue) -BT1142andBT1175",Warehouse A,38,32,2025-02-28 02:28:00,6
3754,ORD_3755,31421,Himalaya Baby Care Bathing Kit (Gentle Baby Soap 125g*3 and Shampoo 200ml),Warehouse B,142,93,2025-02-28 03:05:00,49
3755,ORD_3756,3227,"Neska Moda 6 To 12 Months Baby Boys & Baby Girls Pack Of 2 Pair Cotton Butterfly Booties (Maroon,Black) -BT85andBT6",Warehouse C,247,232,2025-02-28 04:44:00,15
3756,ORD_3757,3225,Dianna sales Baby Girls Soft Velvet Headbands 6Inch Big Bows Elastic Nylon Hairbands Hair Accessories for Newborns Infants...,Warehouse B,199,177,2025-02-28 03:13:00,22
3757,ORD_3758,31430,"LOVEY DOVEY Kangaroo Soft Toy, Baby Toys, Kids Toy, Soft Toy, Toy for Girl, Birthday Gift for Girl/Boys, Toy Gift for Girl...",Warehouse B,205,164,2025-02-28 15:18:00,41
3758,ORD_3759,31390,Hopscotch Boys Cotton Solid T-Shirt in Red Color,Warehouse A,479,455,2025-02-28 01:04:00,24
3759,ORD_3760,31431,"Foot Injury Cast Shoe, Walking Cast Shoe Wear Resistant Shock Absorption Canvas Fabric Flat Sole Adjustable for Post Op (YTH)",Warehouse C,514,489,2025-02-28 11:43:00,25
3760,ORD_3761,31440,"Neska Moda 6 To 12 Months Baby Girls Cotton Butterfly Booties (Black,Red) -SK172andSK126",Warehouse C,446,413,2025-02-28 06:32:00,33
3761,ORD_3762,31444,KazarMax Anti-Skid Breathable Soft & Comfortable Animal Train Multicolor Moccasin Baby-Girls Booties - TOOTSIES/Shoes,Warehouse B,83,59,2025-02-28 14:29:00,24
3762,ORD_3763,3697,CATCUB Ultra Soft Cotton Baby Hooded Towel Combo - Pack of 2 (Green & Cream),Warehouse B,199,155,2025-02-28 05:49:00,44
3763,ORD_3764,30605,"Menarini Olemessa Baby Massage Oil, Children One Size, Pink, 200 ml (Pack of 3)",Warehouse A,516,482,2025-02-28 14:18:00,34
3764,ORD_3765,30800,"Luster Baby-Khan Frock (Age 0 to 5) N.blue, Pink Blended Hand Made Cotton (pure) khan/Khun/ilkal fabric frock. Soft and Co...",Warehouse B,298,285,2025-02-28 00:16:00,13
3765,ORD_3766,30754,"ayushicreationa Cotton Winter Loafer Printed 6 to 9 Years Kids Socks for Boys and Girls (Free_Size,Pack of 6)",Warehouse B,249,233,2025-02-28 00:10:00,16
3766,ORD_3767,30746,"Mamaearth Soothing Baby Massage Oil, with Sesame, Almond & Jojoba Oil - 200ml & Milky Soft Diaper Rash Cream for Babies – 50g",Warehouse A,437,416,2025-02-28 02:10:00,21
3767,ORD_3768,30686,"MY NEWBORN Baby Towel Cotton Printed Mix Cartoon Designs- Set of 3 Pcs (Pink, Sky, Cream)",Warehouse C,171,151,2025-02-28 07:11:00,20
3768,ORD_3769,30699,Chicco Massage Oil 200 ml & Body Lotion (500 ml),Warehouse B,371,346,2025-02-28 06:21:00,25
3769,ORD_3770,3612,Netra Creation Baby Girls Pink Sleeveless Printed Knee Lenght Net Frock Clothes Set,Warehouse C,406,376,2025-02-28 16:21:00,30
3770,ORD_3771,30711,XML Baby Safety Electric Switch Board Dummy Socket Plug Cover Guards Kids Protection Proofing White (Dummy-Plug-6),Warehouse A,306,301,2025-02-28 03:03:00,5
3771,ORD_3772,30718,"SYGA Baby Girls Boys Cute Cap Hats and Scarf Set, 6-24 Month Knit Warm Baby Winter Cap Hat Beanie Cap Hat",Warehouse A,478,441,2025-02-28 20:07:00,37
3772,ORD_3773,3585,"LuvLap Adore Double Electric Breast Pump with Dual Mode & LuvLap Baby Laundry Liquid Detergent, Food Grade,1000ml",Warehouse C,463,417,2025-02-28 12:43:00,46
3773,ORD_3774,3605,Zero Baby Cotton Clothing Pair | Unisex T-Shirt Short Pant Set Printed Set | Multi - Color | Size New Born Baby - 3 Months...,Warehouse C,453,439,2025-02-28 07:34:00,14
3774,ORD_3775,30726,"Sebamed Baby Gentle Wash, 400ml & Clear Face Cleansing Bar, 100g",Warehouse C,394,350,2025-02-28 03:52:00,44
3775,ORD_3776,3599,PUMA Toddler Boys St Runner V3 Sneakers Shoes Casual - Red,Warehouse A,348,310,2025-02-28 16:59:00,38
3776,ORD_3777,30723,MOOLYAVAAN Products New Cassic Water Put Put Steam Toy Metal Boat Indian Festival Janmashtami Dussehra Boat Nau (Pack of 3),Warehouse B,244,201,2025-02-28 06:27:00,43
3777,ORD_3778,30562,"SkinCo Infant Dress 5 PCS, 100% Bio Washed Combed Cotton (White)",Warehouse C,171,144,2025-02-28 01:38:00,27
3778,ORD_3779,3800,JAAMSO ROYALS Multicolor Zoo Animal Kid Tree Vinyl Self Adhesive Home Decor Wall Sticker (70 CM X 45 CM),Warehouse A,489,442,2025-02-28 23:22:00,47
3779,ORD_3780,3627,"The Moms Co. Natural Sensitive Skin Wash - Very Dry, Sensitive or Itchy Skin Wash with Daily Moisturizing for Very Dry, Re...",Warehouse B,296,270,2025-02-28 09:24:00,26
3780,ORD_3781,3536,"BRANDONN Baby's Cotton Fashion Shower Towel, 73.66x66.20cm (Pink, Mango and Blue) - Pack of 3",Warehouse B,336,294,2025-02-28 19:29:00,42
3781,ORD_3782,30365,baby wish Baby Boy's and Baby Girl’s Bodysuits Mittens Booties and caps Combo Cotton Full Sleeve Rompers Gift Set Full Sle...,Warehouse C,346,307,2025-02-28 23:26:00,39
3782,ORD_3783,30607,Silver Shoppee Gold Silver Plated Kadaa for Boys,Warehouse B,315,283,2025-02-28 10:24:00,32
3783,ORD_3784,30608,"Pampers Premium Care Pants, Medium size baby Diapers, (M) 38 Count Softest ever Pampers Pants,",Warehouse B,69,28,2025-02-28 04:02:00,41
3784,ORD_3785,30614,im baby Kids Baby Shoes with Chu Chu Musical Sound for Boys and Girls,Warehouse C,475,430,2025-02-28 22:39:00,45
3785,ORD_3786,3621,"AdiChai Tritan Plastic Water Bottles with Straw, BPA Free SSipper Bottle, Anti-Leak With Cap Lock Design Kids Water Bottle...",Warehouse B,162,131,2025-02-28 16:52:00,31
3786,ORD_3787,30761,PATPAT® 3 PCS Suction Cup Toys for Baby 6 - 24 Months Cartoon Pop It Top Toy Bath Toys Suction Cup Design for Baby Dining ...,Warehouse C,206,172,2025-02-28 17:59:00,34
3787,ORD_3788,30773,KATS GAMEON Kids Baby Boy and Girls Walking Sandal,Warehouse C,125,118,2025-02-28 05:39:00,7
3788,ORD_3789,3547,"Neska Moda 6 To 12 Months Baby Girls Cotton Butterfly Booties (Red,Yellow) -SK127andBT5",Warehouse A,62,15,2025-02-28 01:47:00,47
3789,ORD_3790,3544,SMARTOTS Kids Unisex Baby Casual Shoes for Baby Boys/Girls Age 12 Months to 3.5 Years Combo-Pack of 2 Pairs Blade-6 & Blad...,Warehouse B,246,204,2025-02-28 19:12:00,42
3790,ORD_3791,30809,"Baby Walk NC Girl Boat Zip & Hair Shoes Age from 10 Month to 7 Year, Special & Comfort Zip Hairy Shoes for Baby Girls Ange...",Warehouse C,368,354,2025-02-28 17:48:00,14
3791,ORD_3792,30814,United Colors of Benetton Baby-Girl's Regular T-Shirt,Warehouse C,61,13,2025-02-28 19:36:00,48
3792,ORD_3793,30369,Fabnest Kids Unisex Winter Acrylic Yellow Cable Self Design HGH Neck Sweater,Warehouse B,322,298,2025-02-28 10:18:00,24
3793,ORD_3794,30332,Johnson's Cottontouch Newborn Baby Lotion 100ml (Pack of 2),Warehouse A,285,238,2025-02-28 12:28:00,47
3794,ORD_3795,3813,NOTTY BABY the perfect pair of baby shoes/buties/sandals,Warehouse B,253,219,2025-02-28 02:06:00,34
3795,ORD_3796,30335,Mamaearth Easy Tummy Roll On for Digestion & Colic Relief with Hing & Fennel 40Ml & Natural Insect Repellent for babies (1...,Warehouse A,352,336,2025-02-28 03:40:00,16
3796,ORD_3797,3823,"Pigeon Anti-Bacterial Liquid Cleanser Combo (Yuzu 700ml Bottle + 650ml Refill) for Fruits, Bottles, Accessories and Toys B...",Warehouse A,129,104,2025-02-28 05:50:00,25
3797,ORD_3798,30418,Fareto®️ New Born Baby Clothing Combo Pack Of 9 Daily Essential Items In A Single Packet/6 Vest/3 Pillows/1 Baby Suit/4 Sh...,Warehouse A,98,53,2025-02-28 12:54:00,45
3798,ORD_3799,3770,"Chicco Natural Feeling Baby Milk Feeding Bottle with Wide Neck, Anti-Colic for Easy Milk Flow, For Babies & Toddlers 6m+, ...",Warehouse A,292,256,2025-02-28 05:08:00,36
3799,ORD_3800,30506,Shishu Natural Milky Soft Bubble Bath Baby Body Wash | Natural Cleanser with Milky Soft Foaming Texture | Tear-free & Gent...,Warehouse A,260,246,2025-02-28 16:14:00,14
3800,ORD_3801,30522,Toddylon Baby Bedding for New Born Mosquito Net Bed Sleeping Bag & Reversible Baby Nest Tub Bed (0-6 Months) (Pink),Warehouse B,477,455,2025-02-28 09:42:00,22
3801,ORD_3802,3716,"BRATS N BEAUTY -Kids Soft & Cozy Panda Style Knitted Woolen Cap,Warm Winter Woolen Cap for Girl's fit for 5 to 8 Year Kids...",Warehouse B,48,16,2025-02-28 16:30:00,32
3802,ORD_3803,30504,"Boniry Push Pop it Bubble Fidget Toy, Stress Relief and Anti-Anxiety Tools Sensory Toy for Autism to Relieve Stress for Ki...",Warehouse C,265,224,2025-02-28 12:35:00,41
3803,ORD_3804,30541,LEVOT Toffee Velcro Sneakers for Boys & Girls,Warehouse C,126,79,2025-02-28 14:04:00,47
3804,ORD_3805,30543,Nike unisex-child Sunray Adjust 5 V2 (Gs/Ps) Sandal,Warehouse B,58,37,2025-02-28 08:51:00,21
3805,ORD_3806,3700,Tilismi Moti For Teething Babies By REBUY,Warehouse B,388,368,2025-02-28 20:53:00,20
3806,ORD_3807,30548,Ghelonadi 8-12 Years Boys and Girls Cotton Ankle Socks Winter Warm Colorful Multi-Printed Random Color Free Size 5 PAIR,Warehouse A,252,204,2025-02-28 18:02:00,48
3807,ORD_3808,30549,"CURATIO Tedibar Baby Bathing Bar, 75 g",Warehouse C,194,161,2025-02-28 23:31:00,33
3808,ORD_3809,3832,"CLUZE Microfiber Coral Fleece Baby Face Towels, Soft and Absorbent Wash Clothes for Newborns, Infants and Toddlers, Gentle...",Warehouse A,154,142,2025-02-28 00:06:00,12
3809,ORD_3810,30371,"SaleOn Pack of 12 Pcs Mix Cute Animals Swimming Water Toys Non-Toxic,BPA Free Colorful Soft Rubber Float Squeeze Sound Squ...",Warehouse A,84,41,2025-02-28 11:58:00,43
3810,ORD_3811,3793,Bodycare 73 Girls Cycling Shorts (Pack of 3),Warehouse A,193,149,2025-02-28 04:20:00,44
3811,ORD_3812,30356,"little PANDA Kids Unisex Soft Hosiery Cotton Panties, Multi-Colored (Pack of 6)(2-3 Years) Multicolour",Warehouse C,523,483,2025-02-28 11:22:00,40
3812,ORD_3813,3789,"MY NEWBORN Baby Cup Bibs | Feeding Infants and Toddlers | 6-36 Months | Waterproof, Spill Resistant Bibs | Baby Shower Gif...",Warehouse A,259,239,2025-02-28 11:35:00,20
3813,ORD_3814,3784,"Little Peaches Baby Caps, Caps for New Born, Caps/Hat/Topi for New Born, 100% Cotton Hosiery, Feather Soft, Edgy Designs, ...",Warehouse A,93,70,2025-02-28 23:01:00,23
3814,ORD_3815,3782,Mummamia 10pc Baby Grooming & Healthcare kit in Gift Pack (Pink),Warehouse B,458,433,2025-02-28 22:19:00,25
3815,ORD_3816,30397,"Dreambaby 2 Up Step Stool, Grey",Warehouse B,91,73,2025-02-28 04:49:00,18
3816,ORD_3817,30403,Mee Mee Gentle Baby Body wash / Bubble Bath (With Cherry Extracts- 500 ml),Warehouse B,445,398,2025-02-28 13:56:00,47
3817,ORD_3818,30404,"Mamaearth Mineral Based Sunscreen Baby Lotion SPF 20+,Hypoallergenic,100ml,(0-10 Years)",Warehouse B,144,125,2025-02-28 20:49:00,19
3818,ORD_3819,30405,"Pigeon Stainless Steel Infant Baby Feeding Bottle, BPA Free, Anti-Colic, Plastic-Free, Medium-Flow Nipple Slim Neck Steel ...",Warehouse A,419,411,2025-02-28 11:24:00,8
3819,ORD_3820,3790,AVANI METROBUZZ Baby Mosquito Net Jhula Swing with Mosquito Net for New Born Baby 1-2 Years Babies-Newborn Baby Cotton Bab...,Warehouse C,48,20,2025-02-28 00:58:00,28
3820,ORD_3821,3802,wear your mind Kids Unisex Cotton Poly Full Length Joggers - Black (KJ004.2),Warehouse A,486,479,2025-02-28 16:27:00,7
3821,ORD_3822,30340,Mom's Love Baby-Girl's Leggings,Warehouse B,431,424,2025-02-28 09:04:00,7
3822,ORD_3823,30287,Mee Mee Infant to Toddler Toothbrush (Pink_Purple),Warehouse B,155,150,2025-02-28 01:15:00,5
3823,ORD_3824,3839,"Chicco Baby Liquid Laundry Detergent, 5X Stain & Germ Fighter, Delicate FLowers (1 L) & Baby Fabric Softener, Keeps Clothe...",Warehouse A,163,157,2025-02-28 17:51:00,6
3824,ORD_3825,30302,"VinsonKids Girls|Boy's Cotton Socks Cute Animal Cartoon Socks Dog Cat Pattern Socks (Multicolour, Pack of 02)",Warehouse B,417,386,2025-02-28 15:33:00,31
3825,ORD_3826,30351,"SYGA Foldable Baby Bottle Drying Racks Feeding Cup Nipple Storage Shelf Stand Holder (Pink), 1 Piece",Warehouse C,420,415,2025-02-28 19:19:00,5
3826,ORD_3827,5554,Sai Creations fancy hairbands for baby girls for 3 months to 2 years,Warehouse C,165,148,2025-02-28 21:58:00,17
3827,ORD_3828,29071,Mother Sparsh 99% Pure Water (Unscented) baby wipes I Natural Plant made cloth - Super thick I 72 pcs/pack - Pack of 2 (Su...,Warehouse B,204,164,2025-02-28 06:31:00,40
3828,ORD_3829,4472,Bath Toys Cute Swimming Tortoise Toys for Toddlers Floating on Water Wind Up pandal Hand and Swim Toys for 1 2 3 Year Old ...,Warehouse B,357,322,2025-02-28 12:46:00,35
3829,ORD_3830,4470,"TinyLane - Curated for you! Newborn Baby Gift Set, 0-36 Months, Multi Color, Baby Shower Gift Set, Skin Friendly, Breathab...",Warehouse A,228,218,2025-02-28 14:39:00,10
3830,ORD_3831,29091,Momisy Knitted Winter Twist Woolen Warm Headband | Cold Weather Hair Accessories Head Wrap | Winter Designer Headbands for...,Warehouse B,71,47,2025-02-28 02:58:00,24
3831,ORD_3832,29035,xldreams Imported Flower design White Lace Hairband/Head band for kids/infants for party/baptism/birthday naming ceremony,Warehouse C,379,355,2025-02-28 00:35:00,24
3832,ORD_3833,28654,Himalaya Combo Pack of 6 Gentle Baby soap (6 x 20.83 g),Warehouse B,304,298,2025-02-28 18:15:00,6
3833,ORD_3834,28973,Promise Kid Baby Girl's Dress Midi/Knee Length Dress for Casual and Ethinic wear,Warehouse C,296,286,2025-02-28 13:48:00,10
3834,ORD_3835,4529,Women's Cotton Maternity Feeding Kurtis by Paritika Fashion,Warehouse C,497,482,2025-02-28 17:35:00,15
3835,ORD_3836,28987,"LuvLap Pearly Food & Fruit Nibbler & LuvLap Baby Silicone Finger Toothbrush with case for Easy Cleaning, Massaging, and So...",Warehouse A,396,354,2025-02-28 01:43:00,42
3836,ORD_3837,4524,Myfam thorthu Towel for Babies- Pure Soft Cotton - White - 4 nos,Warehouse A,225,213,2025-02-28 05:23:00,12
3837,ORD_3838,4517,DOGTOWN Non-Toxic Playing Chewing Fetching Rubber Bouncing Egg Ball Toy for Puppies (Set of 2),Warehouse C,451,430,2025-02-28 20:41:00,21
3838,ORD_3839,28990,Levi's Baby-Boy's Regular Fit T-Shirt,Warehouse A,64,27,2025-02-28 15:40:00,37
3839,ORD_3840,4486,"Safe-O-Kid BPA Free Silicone Liquid Medicine FeederDropper with Box for Baby, Pink, Pack of 1",Warehouse A,127,113,2025-02-28 02:20:00,14
3840,ORD_3841,28330,R Cube Baby Girl Ruffle Lace Backless Pageant Dress Toddler Tutu Gown Flower Tulle Party Dresses,Warehouse C,178,146,2025-02-28 02:39:00,32
3841,ORD_3842,4879,"Neska Moda Unisex Booties For 6 To 12 Months (Pink,Yellow) -BT3and-BT7",Warehouse A,79,63,2025-02-28 13:37:00,16
3842,ORD_3843,28341,Little Fingers 2 in1 Nut & Bolts / Logical Links Combo Puzzle Sets Beads for Kids Early Learning || Montessori Educational...,Warehouse C,380,374,2025-02-28 05:00:00,6
3843,ORD_3844,28344,"Neska Moda 6 To 12 Months Baby Boys & Baby Girls Cotton Rabbit Booties (Orange,Black) -SK126andSK131",Warehouse A,224,215,2025-02-28 00:22:00,9
3844,ORD_3845,28345,HomeFast Comfortable Squat Stool for Western Toilet Portable Sturdy Foot Step Stool for Potty Training Kids Adults - Made ...,Warehouse A,509,465,2025-02-28 06:46:00,44
3845,ORD_3846,4876,ambitieux Combo Mouse & Lazy Bear Cap for Baby boy 1-2 Years Age Baby Girl Cap Kids Cap (Pack of 2),Warehouse C,395,370,2025-02-28 13:44:00,25
3846,ORD_3847,4675,VParents Bitsy New Born Baby Gift Set (Pack of 10) (Yellow),Warehouse C,475,470,2025-02-28 22:38:00,5
3847,ORD_3848,4996,Afflatus Ayurvedic AD Vitamin Baby Massage Oil 100ml for Healthy Babies & Infants || Healthy Skin & Rich Moisturizer for A...,Warehouse C,467,435,2025-02-28 22:57:00,32
3848,ORD_3849,4673,"NIRVA WITH DEVICE OF WOMEN PICTURE New Baby Nail File Electric,Baby Nail Trimmer with 6 Grinding Heads Safe for Newborn Ba...",Warehouse B,437,391,2025-02-28 17:55:00,46
3849,ORD_3850,4503,"RCMB Creations Baby Plastic Evil Eye Protection Nazariya Beads Bracelet, 0-3 Years - Black and White Beads Combo - 3",Warehouse B,162,142,2025-02-28 01:21:00,20
3850,ORD_3851,29042,Max Boys Graphic Print Crew Neck T-Shirt,Warehouse B,211,184,2025-02-28 06:15:00,27
3851,ORD_3852,29043,Baby Moo Rainbow Chu-Chu Sound Breathable Anti-Skid Sandals - Blue (2Y-2.5Y),Warehouse A,438,398,2025-02-28 03:10:00,40
3852,ORD_3853,4502,"ANCHOR Calf Length Cotton Socks for Baby Boy And Baby Girl, Pack of 5 Pairs, Multicoloured",Warehouse B,370,332,2025-02-28 00:09:00,38
3853,ORD_3854,4501,Nestos Unisex Cotton Briefs for Kids or Baby Boys or Baby Girls (Pack of 6) (3 Months - 7 Years),Warehouse A,441,403,2025-02-28 06:59:00,38
3854,ORD_3855,4500,"Melissa & Doug On the Go Water Wow! On the Farm (Reusable Water-Reveal Activity Pad, Chunky-Size Water Pen)",Warehouse A,209,161,2025-02-28 06:20:00,48
3855,ORD_3856,4494,ANNACREATIONS Hair Bow Clips Set Hair Pins Toddlers Barrettes Hair Accessories for Baby Girls (Pack of 5) (STYLE 7),Warehouse C,97,68,2025-02-28 18:42:00,29
3856,ORD_3857,29038,SOUTH SAILOR Baby Girls Cotton a-line Girls Dress (Multicolor_3 Months to 6 Years) Pack of 3,Warehouse A,493,449,2025-02-28 12:04:00,44
3857,ORD_3858,29059,Mothercare Kids Round Neck Printed Tee (Yellow_3-6 Months),Warehouse A,334,321,2025-02-28 08:12:00,13
3858,ORD_3859,4487,Jay Gopal Fashion Use and Throw Disposable Panties Healthy Maternity Pregnancy Printed Panties for Girl's (White) (Pack of...,Warehouse C,78,46,2025-02-28 01:03:00,32
3859,ORD_3860,29019,Bold N Elegant Cotton Half Sleeve Teddy Bear Patch Tunic Pinafore Pinny Midi Dress Frock for Infant Toddler Baby Girls,Warehouse C,137,101,2025-02-28 18:25:00,36
3860,ORD_3861,28954,"Neska Moda 6 To 12 Months Baby Boys & Baby Girls Pack Of 2 Pair Cotton Butterfly Frill Booties (Light Green,Maroon) -BT16a...",Warehouse C,327,313,2025-02-28 07:35:00,14
3861,ORD_3862,28317,Dilan Jewels Happiness Collection Blue and Black Colour Elegant Nazariye Bracelets for Babies,Warehouse A,145,98,2025-02-28 11:50:00,47
3862,ORD_3863,29129,"Cotonex 100% Cotton Organic Muslin Swaddle for New Born Babies Blankets at Dinosaur Design 100x100cm (Pack of 3) (Blue), B...",Warehouse B,366,361,2025-02-28 06:58:00,5
3863,ORD_3864,29170,"Hey Baby Unisex Mittens (Multi-Colored, Set of 6, 0-6 Months)",Warehouse A,169,155,2025-02-28 21:06:00,14
3864,ORD_3865,4432,"Esquire Spotty Baby Dining Chair with Footrest, Red Colour",Warehouse C,383,355,2025-02-28 05:41:00,28
3865,ORD_3866,29154,RSINC Taslim/Tilasmi/TLISMI Moti for Baby New Teeth Solution Pack of 2 pcs,Warehouse B,149,107,2025-02-28 18:42:00,42
3866,ORD_3867,29161,"Neska Moda 0 To 6 Months Baby Girls Cotton Butterfly Booties (Rani,Orange) -BT386andBT377",Warehouse A,75,31,2025-02-28 10:08:00,44
3867,ORD_3868,29162,New born infant baby clothes suit for both baby girl and boy for winter and summer - Imported fabric set of two combo - up...,Warehouse B,189,175,2025-02-28 11:26:00,14
3868,ORD_3869,4422,LC WAIKIKI Girls Knitted Pant,Warehouse A,335,296,2025-02-28 15:35:00,39
3869,ORD_3870,4543,"Organo Veda Zeromos Natural Mosquito Repellent Spray | Developed by CSIR-CIMAP, Govt of India",Warehouse B,339,302,2025-02-28 12:56:00,37
3870,ORD_3871,28949,MINI KLUB Baby Girl's Pink Romper,Warehouse C,491,461,2025-02-28 15:21:00,30
3871,ORD_3872,28782,Mee Trend Outdoor Adjestable Baseball Cap for Boy & Girl (Age 4 to 14 yrs),Warehouse A,477,452,2025-02-28 07:38:00,25
3872,ORD_3873,28784,Lillypupp Soft Velvet Baby Booties for Winter and Beautiful Design for New Born Baby/Infant boy and Girl/Kids Unisex`Baby ...,Warehouse B,66,33,2025-02-28 01:14:00,33
3873,ORD_3874,28787,Baby Swing/ Jhula for Kids/ Swing for Kids/Jhula for Baby Swing Hanging Indoor & Outdoor/ Ideal for 1-5 Years with Safety ...,Warehouse A,164,119,2025-02-28 05:44:00,45
3874,ORD_3875,4624,"Pigeon Baby Conditioning Shampoo, For Newborns, Strengthens and Nourishes Hair, Enriched with Chamomile, Rosehip and Olive...",Warehouse C,244,235,2025-02-28 01:32:00,9
3875,ORD_3876,28780,"Knitroot Family Special Unisex Baby Romper Half Sleeve Envelope Neck ""Happy Birthday Dada""(KMCBR72-1,0-3 Months,White)",Warehouse C,423,379,2025-02-28 00:36:00,44
3876,ORD_3877,4452,"Mamaearth Onion Hair Serum For Silky & Smooth Hair, Tames Frizzy Hair, with Onion & Biotin for Strong, Tangle Free & Friz...",Warehouse A,158,132,2025-02-28 05:54:00,26
3877,ORD_3878,4458,"OLWICK® 1 Pcs Extra Thick Furniture Edge Protectors High Dense Foam Cushion Baby Safety Corner Strip Guards, 6.5 Ft Furnit...",Warehouse C,387,364,2025-02-28 03:01:00,23
3878,ORD_3879,29105,Mee Mee Mild Baby Shampoo with Fruit Extracts 500ml (Pack of 2 Pcs),Warehouse B,229,198,2025-02-28 14:14:00,31
3879,ORD_3880,4416,Baby Collection Printed Baby Vest for Kids Cotton Sleeveless Sando Baniyan Toddler Innerwear Baby Cloth for Boys & Girls P...,Warehouse A,141,117,2025-02-28 08:19:00,24
3880,ORD_3881,29176,UJEAVETTE 3Mm Neoprene Anti-Slip Scuba Diving Spearfishing Snorkeling Socks M(39-41),Warehouse A,175,126,2025-02-28 14:05:00,49
3881,ORD_3882,29178,"R for Rabbit 200 ml Pure & Beyond Baby Body Wash,Mild & Gentle with No Tears or Soap Free, Ph 5.5 Skin Friendly, With Natu...",Warehouse C,295,259,2025-02-28 21:44:00,36
3882,ORD_3883,29191,Puma Unisex-Baby Aquacat Inf Sport Sandal,Warehouse B,243,230,2025-02-28 10:32:00,13
3883,ORD_3884,29198,"Philips Avent Advance Bottle sterilizer SCF291/00|| 10 mins Cycle, Natural steam Sterilization, Capacity Of 6 Baby Bottles",Warehouse C,129,122,2025-02-28 20:29:00,7
3884,ORD_3885,29200,"Similac Advance Stage 3 Infant Formula - 400g, after 12 months",Warehouse B,67,52,2025-02-28 17:47:00,15
3885,ORD_3886,29173,Woonie Handmade Cream and Red Frock for Girls (3-6 Months),Warehouse B,178,164,2025-02-28 14:28:00,14
3886,ORD_3887,29205,MINIKLUB Girls T-Shirt-Red,Warehouse C,320,282,2025-02-28 16:10:00,38
3887,ORD_3888,29223,Hopscotch Boys Mesh Lace Tie-Up Athletic Shoes in White Color,Warehouse A,443,420,2025-02-28 11:40:00,23
3888,ORD_3889,4389,BRANDONN Unisex Baby Flannel Jumpsuit Panda Style Cosplay Clothes Bunting Outfits Snowsuit Hooded Romper Outwear (Grey Sca...,Warehouse A,347,320,2025-02-28 21:07:00,27
3889,ORD_3890,29238,"Knitroot Family Special Unisex Baby Romper Half Sleeve Envelope Neck""My mamu Loves me""(KMCBR47-7,6-9 Months,Lime Yellow)",Warehouse B,100,89,2025-02-28 10:36:00,11
3890,ORD_3891,4382,Ghelonadi Baby-girls Lace Socks for 4-8 Years Newborn Toddler Baby Girls Princess Multicolor Pack of 5,Warehouse C,241,194,2025-02-28 07:25:00,47
3891,ORD_3892,29245,ANGAAKAR CLOTHINGS Baby Boys & Girls Regular Fit Cotton Track Pants for Kids Lowers Sports Trousers for Boys Pajama Pants ...,Warehouse C,209,165,2025-02-28 18:40:00,44
3892,ORD_3893,29099,"Neska Moda 12 To 18 Months Baby Girls Cotton Butterfly Frill Booties (Mint,Blue) -BT1142andBT1170",Warehouse C,358,351,2025-02-28 00:33:00,7
3893,ORD_3894,4418,"Krystle Baby Winter Warm Pilot Beanie Cap for Kids Girl's & Boy's (Blue, 01yrs-03Yrs)",Warehouse A,95,72,2025-02-28 08:16:00,23
3894,ORD_3895,4419,"Neska Moda 0 To 6 Months Baby Boys & Baby Girls Pack Of 2 Pair Cotton Butterfly Booties (Maroon,Rani Pink) -BT376andBT1120",Warehouse A,257,211,2025-02-28 16:13:00,46
3895,ORD_3896,28315,"Colgate Kids Batman Manual Toothbrush for 5+ years, Pack of 3, Extra Soft Bristles with Tongue Cleaner,Multicolor",Warehouse B,355,349,2025-02-28 14:38:00,6
3896,ORD_3897,4619,Anoma Reusable Maternity Breast Pads | Washable Nursing Pads | Super Absorbent Comfort Fit Breast Pads +Laundary Bag (Pack...,Warehouse C,59,20,2025-02-28 23:29:00,39
3897,ORD_3898,28631,"Neska Moda 12 To 18 Months Baby Boys & Baby Girls Cotton Lace Shoes/Booties (Baby Pink,Red) -BT1147andBT1183",Warehouse B,261,219,2025-02-28 17:05:00,42
3898,ORD_3899,4722,"The Sandbox Clothing Co. Woollen Half Sweater - Regular Fit, Sleeveless, Round Neck, Winter Wear Solid Knitted Unisex Swea...",Warehouse A,350,316,2025-02-28 08:45:00,34
3899,ORD_3900,28608,"Dr. Zach's MOSTIGO 100% Natural Mosquito Repellent, Herbal DEET Free Pest Repellent Lotion For Adults & Kids, 100ml, Natur...",Warehouse A,506,472,2025-02-28 15:33:00,34
3900,ORD_3901,28627,R for Rabbit i Bot Sterilizer with Dryer 2-in-1 Sterilizer Turns Dryer Electric Baby Milk Bottles Water Heater (White),Warehouse A,460,434,2025-02-28 08:31:00,26
3901,ORD_3902,28597,Babyhug Super dry diaper pants (M),Warehouse A,59,16,2025-02-28 16:22:00,43
3902,ORD_3903,28401,D ETERNAL Chu Chu Baby Bath Toys Colorful Animal Shape Toy Non Toxic for Babies Kids Floats in Water(Set of 12 Pieces)(Mul...,Warehouse C,163,137,2025-02-28 11:44:00,26
3903,ORD_3904,28400,"Mee Mee Reusable Water Proof Cotton Bed Protector Sheet /Extra Absorbent Mat/Dry Sheets/Urine Sheet/Dry Mat(Medium, Maroon)",Warehouse A,472,445,2025-02-28 13:11:00,27
3904,ORD_3905,28399,JBRD Umbrella Style Full Cover up for 0 to 3 Year Baby Green Mosquito Net for Baby_New Born_Infants,Warehouse C,346,318,2025-02-28 20:06:00,28
3905,ORD_3906,28215,"Wearville New Born Baby Boy's & Baby Girls jabla Clothing Top Set(Multicolored),Combo Pack of 5",Warehouse C,469,431,2025-02-28 03:25:00,38
3906,ORD_3907,4951,"TEDDYIFY Non Slip Kids Toddler Socks with Grip, Anti Skid Socks, Crew Socks for Babies to Toddlers | Non Slip Anti Skid Cr...",Warehouse B,269,249,2025-02-28 08:39:00,20
3907,ORD_3908,4941,ARVESA baby Romper Theme Unisex Baby White Romper Onesie dress for boy and Girls Half Sleeve Envelope Neck,Warehouse A,433,389,2025-02-28 13:00:00,44
3908,ORD_3909,4939,Neska Moda 6 To 12 Months Baby Boys & Girls Cotton Anti Slip Indoor Slippers Booties (Green)-BT1565,Warehouse B,132,109,2025-02-28 01:31:00,23
3909,ORD_3910,4956,"SNOWIE SOFT® Baby Cloth Book, Cartoon Elephant Cloth Books for Babies Newborn Baby Toys 3D Touch Feel Soft Books for Babie...",Warehouse A,67,35,2025-02-28 21:21:00,32
3910,ORD_3911,4934,Johnson's Baby Hair Oil 200ml and Baby Cream 100gm,Warehouse C,290,245,2025-02-28 22:28:00,45
3911,ORD_3912,28595,Hopscotch Boys and Girls Printed Slip Ons in Blue Color,Warehouse A,330,288,2025-02-28 23:12:00,42
3912,ORD_3913,4731,"Nuby Grooming Nail Care Set - Nail Clipper, Scissor, Emery Board (Pink)",Warehouse A,412,395,2025-02-28 07:03:00,17
3913,ORD_3914,28584,RC. ROYAL CLASS Baby Boys and Girls Cotton Terry Soft Cushion Socks (Pack of 5 Pairs)(0-5 Years),Warehouse B,389,377,2025-02-28 20:50:00,12
3914,ORD_3915,5526,"Chicco Baby Moments Gentle Body Wash and Shampoo for Tear-Free Bath time, Suitable for Baby’s Gentle Skin and Soft Hair, N...",Warehouse C,479,434,2025-02-28 06:52:00,45
3915,ORD_3916,4703,Krishn Cotton T-Shirt and Shorts Set | Kids Printed Dress | Black,Warehouse C,514,487,2025-02-28 03:36:00,27
3916,ORD_3917,4686,"The Little Lookers Kids Hair Brush, Compatible for Wet and Dry Hair, Best for detangling Hair | Stylish Comb for Babies/Ch...",Warehouse A,461,455,2025-02-28 00:45:00,6
3917,ORD_3918,28685,Shnuggle Folding Bath Stand,Warehouse C,364,344,2025-02-28 00:33:00,20
3918,ORD_3919,28687,"Pearldew Baby Massage Oil 100 ml|With Almond Oil, Aloe Vera, Calendula Oil, Macadamia Oil, Olive Oil, Til Oil, Vitamin E, ...",Warehouse A,187,148,2025-02-28 21:45:00,39
3919,ORD_3920,28690,"Jinie Baby Boy's Silk Cotton Blend Dhoti Kurta Pyjama Dress (Multicolour, 6-12 Months)",Warehouse C,85,46,2025-02-28 03:51:00,39
3920,ORD_3921,28695,Original Tilismi Moti by S. Abdur Rasheed for Teething Babies (Pack of 10) with Free Nazar Manka 2 Piece,Warehouse C,55,20,2025-02-28 05:02:00,35
3921,ORD_3922,4746,YUV Infant Boys & Girls Multi-Color Pack of 3 100% Soft Cotton Printed Tshirts & Shorts with Shoulder Poppers,Warehouse C,97,76,2025-02-28 21:35:00,21
3922,ORD_3923,28314,"MOM CARE Cotton face Hankey Napkin for Newborn,Babies, Extra Soft Reusable Double Layer Ideal for Infants, Toddlers White(...",Warehouse A,442,434,2025-02-28 02:19:00,8
3923,ORD_3924,28369,baby wish Birthday gifted to Baby Bodysuits Newborn birthday Romper Half Sleeve Envelope Neck Cute Outfit First Birthday P...,Warehouse B,72,43,2025-02-28 04:43:00,29
3924,ORD_3925,28374,Baby Headbands Baby Bows Toddler Hair Accessories Flower Headband For Infants Toddlers and Kids (PACK OF 12)(Multicolor),Warehouse A,462,453,2025-02-28 19:51:00,9
3925,ORD_3926,4855,"Luv Lap Baby Grooming Scissors & Nail Clipper Set/Kit, Manicure Set, 4pcs, Blue, 0m+",Warehouse C,479,436,2025-02-28 21:04:00,43
3926,ORD_3927,4852,Nawani Black 10 Pic nazariya for Baby Girl Baby boy. 12 inch to 15 inch,Warehouse A,110,65,2025-02-28 07:50:00,45
3927,ORD_3928,4850,DARSHRAJ 925 Sterling Silver kada for Baby Boys & Baby Girls (7.270gm Approx.) Adjustable Size-Best for 0-6 Month Old Babies,Warehouse B,109,60,2025-02-28 12:14:00,49
3928,ORD_3929,28392,EIO New Born Baby Gift Set -13 Piecess (Pinkk),Warehouse A,515,487,2025-02-28 22:38:00,28
3929,ORD_3930,4848,Vrindam 925 Sterling Silver Nazariya Kada For baby Boys and Girls child Specially for 1 Year Baby to 3Years kids | Traditi...,Warehouse A,269,264,2025-02-28 17:11:00,5
3930,ORD_3931,28351,RunBugz Mosquito Repellent Patches (Printed)(Star)(Pack of 2 ),Warehouse B,374,337,2025-02-28 13:40:00,37
3931,ORD_3932,28292,"Jordan* | Step 2 Kids Toothbrush | Infant Toothbrush for Age 3-5 Years Old | Kid Toothbrush with Soft Bristles, Dual Ergon...",Warehouse B,445,403,2025-02-28 22:37:00,42
3932,ORD_3933,28294,"Maate Baby Hair Care Ritual Box | Baby Hair Oil, Baby Shampoo & Baby Wooden Hair Brush | Baby Hair Care Kit | Natural & Vegan",Warehouse A,268,241,2025-02-28 06:19:00,27
3933,ORD_3934,4897,"Baby Monkey Cap Pack of 03 (Pink,Blue and Red, 6-12 Months)",Warehouse A,50,36,2025-02-28 08:08:00,14
3934,ORD_3935,4892,TotzTouch baby-girls Shorts,Warehouse C,365,342,2025-02-28 10:51:00,23
3935,ORD_3936,28311,"REFFER Women’s hat Latest Reversible 100% Cotton Butterfly Embroidered Foldable Bucket hat for Women Summer hat, Vacation ...",Warehouse A,58,41,2025-02-28 00:54:00,17
3936,ORD_3937,28363,"Hopscotch Baby Girls Cotton, Polyester All-Over Print Onesie in Blue Color",Warehouse C,328,302,2025-02-28 10:35:00,26
3937,ORD_3938,4919,"Mamaearth Moisturizing Baby Bathing Soap Bar pH 5.5 with Goat Milk and Oatmeal, 75g (Pack of 2) & Gentle Cleansing Shampoo...",Warehouse B,446,436,2025-02-28 14:05:00,10
3938,ORD_3939,4907,Mee Mee Mild Baby Shampoo With Fruit Extracts | 200ml - Pack Of 2,Warehouse C,414,388,2025-02-28 18:18:00,26
3939,ORD_3940,4916,My Milestones Casual Cotton Shorts for Kids/Baby Boys - Pack of 2,Warehouse C,148,101,2025-02-28 04:00:00,47
3940,ORD_3941,4936,HAPPU COLLECTION printed kids boot (black) 03,Warehouse A,50,30,2025-02-28 14:07:00,20
3941,ORD_3942,28282,"LuvLap Adaptable 2 in 1 Potty Training Seat for 1 + Year child, potty trainer with Detachable Potty Bowl, Suitable for pot...",Warehouse A,54,12,2025-02-28 17:47:00,42
3942,ORD_3943,28194,Hopscotch Boys and Girls PVC Mesh LED Slip-Ons in Gray Color,Warehouse C,387,349,2025-02-28 01:33:00,38
3943,ORD_3944,28144,Mamaearth dusting Powder with Organic Oatmeal & Arrowroot Powder 150g & After Bite Roll On for Rashes & Mosquito Bites wit...,Warehouse A,487,439,2025-02-28 13:37:00,48
3944,ORD_3945,28148,Mamaearth Tea Tree Natural Face Wash for Acne & Pimples Wash 100 ml - For Normal & Dry Skin,Warehouse C,42,17,2025-02-28 03:32:00,25
3945,ORD_3946,28157,"Mamaearth Nourishing Hair Oil for Babies 100ml (0-10 Years) & Gentle Cleansing Shampoo for Babies (200 ml, 0-5 Yrs) & dust...",Warehouse A,342,296,2025-02-28 02:41:00,46
3946,ORD_3947,28158,UUSUPSO Usupso Kid's Shoes,Warehouse C,59,26,2025-02-28 20:51:00,33
3947,ORD_3948,4977,Runbugz Safe Natural Mosquito Repellent Patches for Kids|30 Patches-WHIK1,Warehouse C,327,285,2025-02-28 15:53:00,42
3948,ORD_3949,4974,New Jain Traders - Woolen Winter Gloves for Girls & Boys - Pack of 2,Warehouse C,460,455,2025-02-28 01:11:00,5
3949,ORD_3950,4966,DYOMNIZY Wind Up Swimming Tortoise Bath Toy / Toddlers Swimming Floating Playing Toy in Bathroom Beach Pool / Colorful Wat...,Warehouse A,270,231,2025-02-28 02:37:00,39
3950,ORD_3951,28166,"Jordan Kids Toothbrush Step 2 -3-5 Years Kids Tooth brush Soft Bristles, BPA Free with a Sand Timer Holder (3-5Years-Sand ...",Warehouse A,245,239,2025-02-28 09:57:00,6
3951,ORD_3952,29130,DULCI® Gold Tone Handmade Ghungroo Bells Expandable Free Size Nazariya Kids Kada Anklet Jewellery for New Born Babys -Set ...,Warehouse B,88,75,2025-02-28 13:28:00,13
3952,ORD_3953,5420,Brand Conquer 3D Astronaut Cartoon Character Printed Little Cap for Kids and Baby Girls 3-12 Years Multicolour,Warehouse A,444,418,2025-02-28 11:14:00,26
3953,ORD_3954,27395,Himalaya Herbals Baby Lotion (400ml) and Gentle Wipes (72 Napkins of 2 Packs) Combo,Warehouse C,360,320,2025-02-28 19:32:00,40
3954,ORD_3955,5417,Babloo New Born Baby Gift Combo Pack of Bedding and Clothing Set Daily Essential Items for 0-6 Months Baby Boy's & Baby Gi...,Warehouse A,61,35,2025-02-28 13:19:00,26
3955,ORD_3956,27408,HAPPU COLLECTION printed kids boots (pink) 1c,Warehouse A,478,437,2025-02-28 07:08:00,41
3956,ORD_3957,5403,"Sunbaby Baby Anti Slip Big Plastic Bathtub with Bath Toddler Seat Sling Non Slip Suction for Bathing,Baby Shower,Bubble Ba...",Warehouse C,461,414,2025-02-28 21:09:00,47
3957,ORD_3958,5402,Bumchums Baby-Girl's Cotton A-Line Knee-Length Dress,Warehouse C,190,176,2025-02-28 16:24:00,14
3958,ORD_3959,27428,"Pampers Premium Care Pants,New Born Extra Small size baby Diapers,(NB/XS)70 count,Upto 5 kg Softest ever Pampers",Warehouse A,322,283,2025-02-28 22:49:00,39
3959,ORD_3960,27434,"KNITROOT Monthly Birthday Teddy Special Unisex Baby Romper Half Sleeve Envelope Neck ""12 Month Old""(KMTBR12-1,9-12 Months,...",Warehouse A,305,267,2025-02-28 06:29:00,38
3960,ORD_3961,27439,Cable World® Dancing Dog Toy with Music Flashing Lights(Multi Color),Warehouse A,320,295,2025-02-28 07:07:00,25
3961,ORD_3962,27440,"Neska Moda 0 To 6 Months Baby Girls Cotton Butterfly Booties (Black,Yellow) -BT1113andBT1115",Warehouse C,349,330,2025-02-28 07:02:00,19
3962,ORD_3963,27427,VENJA (LABEL) Baby Toddler Sock Shoes | Non-Skid Slipper with Soft Sole Breathable Cotton Walking Shoes for Infant Girls B...,Warehouse A,246,207,2025-02-28 23:13:00,39
3963,ORD_3964,27244,"JD Fresh Electric Baby Nail Trimmer New Born, Baby Nail Cutter, Nail Polish Grooming Kit Safe for Infant Toddler Kids or W...",Warehouse C,471,458,2025-02-28 23:44:00,13
3964,ORD_3965,27017,"A to Z Hub Baby Cradle N Swing Ghodiyu with Indian Style Hammock Having Mosquito Net for New Born Infants,Blue",Warehouse C,407,368,2025-02-28 04:41:00,39
3965,ORD_3966,5592,Pink Rabbit Newborn Baby Girls Printed Cotton Full Sleeves Front Open Frock for Casual Wear Kids Girls Middi Dress Jhabla ...,Warehouse C,302,256,2025-02-28 19:02:00,46
3966,ORD_3967,27046,"RYLAN Baby Electric Drill Nail Trimmer, Filer Cum Manicure Set, Ergonomic Design, Safe for Baby/Kid, Nail Filer and Grinde...",Warehouse B,253,221,2025-02-28 12:47:00,32
3967,ORD_3968,27391,Runbugz Safe Natural Mosquito Repellent Patches for Kids|30 Patches-BOOK2,Warehouse B,207,190,2025-02-28 02:02:00,17
3968,ORD_3969,27273,CIBZ U Shaped Toothbrush for Kids Manual Whitening Toothbrush Silicone Brush Head for Kids Children Infant Toothbrush For ...,Warehouse B,287,260,2025-02-28 14:44:00,27
3969,ORD_3970,5484,Funwood Games CosmicKolors Baby Boys Cotton Spandex Solid Full Sleeves Shirt and Pant Set in Blue Color,Warehouse A,167,159,2025-02-28 16:42:00,8
3970,ORD_3971,27385,"Meditive Reversible Baby Play Mat, BPA Free Learning & Crawling Foldable Foam Mat for Kids, Toddlers…",Warehouse B,248,226,2025-02-28 20:49:00,22
3971,ORD_3972,5371,"Luv Lap Baby Diaper Pants S Size (Small) , with Aloe Vera Lotion for rash protection, Pack of 234 Count (78x3), with upto ...",Warehouse B,58,18,2025-02-28 02:58:00,40
3972,ORD_3973,27467,Pristine POUSHTIK Cereal Based Baby Food 300g (6-24 Months) 100% Organic Whole Grains | Infant Food - Pack of 5,Warehouse A,415,394,2025-02-28 22:37:00,21
3973,ORD_3974,27473,iDream® Baby Safety Door Handle Cushion Cover Spiral Protector (Pack of 2),Warehouse A,191,176,2025-02-28 23:44:00,15
3974,ORD_3975,5362,Sharyl Baby Nail Cutter/Clipper,Warehouse A,308,291,2025-02-28 18:02:00,17
3975,ORD_3976,27488,"DoxBox Baby Monthly Milestone Cards, Months Growth Milestones Cards, Baby Shower Gift Scrapbook Photo Keepsake Monthly Age...",Warehouse B,358,313,2025-02-28 07:32:00,45
3976,ORD_3977,27489,"Neska Moda 6 To 12 Months Baby Boys & Baby Girls Pack Of 2 Pair Cotton Butterfly Booties (Light Green,Black) -BT88andBT6",Warehouse C,390,367,2025-02-28 00:33:00,23
3977,ORD_3978,27494,Dazzlia cotton socks/Anti slip grip socks for boy and girl,Warehouse B,111,64,2025-02-28 09:43:00,47
3978,ORD_3979,5355,"Lifree Medium Size Diaper Pants EXTRA ABSORB EASY SELF WEAR HIGH ABSORBING - For Men and Women,10 Count",Warehouse B,448,428,2025-02-28 11:02:00,20
3979,ORD_3980,5353,"SKINhub Sofidew Baby Massage Oil, 100ml",Warehouse B,24,13,2025-02-28 21:32:00,11
3980,ORD_3981,27501,Ancient Living Baby Bath Powder enriched with Organic Ingredients - 200 gm,Warehouse B,453,433,2025-02-28 11:51:00,20
3981,ORD_3982,28808,Hopscotch Girls Cotton All-Over Print Causal Dress in Blue Color,Warehouse B,102,86,2025-02-28 07:10:00,16
3982,ORD_3983,5423,Morisons Baby Dreams Classic Powder Puff - Peach & Blue (Pack of 2),Warehouse B,347,327,2025-02-28 18:05:00,20
3983,ORD_3984,5590,"Shyamcollections Baby Boy and Baby Girl's Fabulous Collection of Printed Full Sleeves Soft Hosiery Cotton Vests,Jhabla T-S...",Warehouse B,123,94,2025-02-28 00:17:00,29
3984,ORD_3985,27016,Hopscotch Baby Girls Cotton Short Sleeves Solid Casual Dresses in Dark Blue Color,Warehouse B,130,82,2025-02-28 22:42:00,48
3985,ORD_3986,26993,EXCLUZO Baby PU Leather Rubber Soles Warm Snow Boots Grey (for 18-21Months),Warehouse B,404,363,2025-02-28 08:50:00,41
3986,ORD_3987,26972,LALEY Baby Grooming Nail Cutter Kit for new born with Scissors/Baby Nail Clipper Safety Cutter & Manicure Pedicure Care Ki...,Warehouse B,458,439,2025-02-28 09:21:00,19
3987,ORD_3988,27094,"Mamaearth Hydragel Indian Sunscreen Spf 50, With Aloe Vera & Raspberry, For Sun Protection - 50G",Warehouse A,352,323,2025-02-28 05:02:00,29
3988,ORD_3989,27095,"SS Acc0409 Camo 9000 Shoes, 8 (Black/White)",Warehouse B,284,239,2025-02-28 21:14:00,45
3989,ORD_3990,5524,The Root And Craft Kids Birthday Photoshoot Dress Outfit Sky Blue & White-12 month,Warehouse C,153,147,2025-02-28 03:28:00,6
3990,ORD_3991,5518,JIG'sMART Baby Electric Nail Trimmer for Baby Nail Cutter for New Born Baby with 6 Grinding Heads Automatic Kids Nail Grin...,Warehouse A,149,132,2025-02-28 22:57:00,17
3991,ORD_3992,27180,The Comfort Closet - Baby's Handmade Sweater with Cap and Booties (6-12 Months) (Blue and White),Warehouse B,189,183,2025-02-28 11:35:00,6
3992,ORD_3993,5508,HAPPU COLLECTION printed kids boots (black) 1c,Warehouse B,152,119,2025-02-28 21:54:00,33
3993,ORD_3994,5506,ETHNOS Fashion baby girl's Printed Sleeveless Cotton Top with Designer Dhoti Set,Warehouse A,295,259,2025-02-28 08:10:00,36
3994,ORD_3995,27208,"Baby Nail Trimmer YTWM Electric Baby Nail File Safe Nail Clipper kit with Led Light, Newborn Infant Toddler Kids Toes and ...",Warehouse B,423,389,2025-02-28 04:46:00,34
3995,ORD_3996,5496,Olebest Baby Bathing Bar : 75 grams - Pack of 1,Warehouse B,366,337,2025-02-28 04:32:00,29
3996,ORD_3997,27229,Dexolac Follow Up Infant Formula Milk Powder for Babies - Stage 4 (18 to 24 months) - with 36 Vital Nutrients - 400gms - B...,Warehouse C,141,116,2025-02-28 03:52:00,25
3997,ORD_3998,27237,"Summer Stories Visual Stimulation Cards for Newborns and Infants, High Contrast Flash Cards for Babies 0-6 Months 6-12 Mon...",Warehouse B,64,38,2025-02-28 06:44:00,26
3998,ORD_3999,27240,ONICORN Baby Proofing Edge and Corner Guard Protection Extra Thick & Wide Kindergarten DIY Child Safety Foam Cushion Furni...,Warehouse A,490,467,2025-02-28 00:38:00,23
3999,ORD_4000,5497,Hopscotch Girl's Empire Knee Length Dress,Warehouse C,151,112,2025-02-28 00:56:00,39
4000,ORD_4001,5628,Baby Moo Rainbow Chu-Chu Sound Anti-Skid Breathable Denim Sandals - Navy Blue (8-12M),Warehouse A,225,217,2025-02-28 00:31:00,8
4001,ORD_4002,27063,"SYGA Bathing Shower Cap, Kids Bath Cap, Adjustable Baby Shower Caps - Frog Style",Warehouse A,437,396,2025-02-28 00:18:00,41
4002,ORD_4003,26987,babeezworld Dungaree for Boys & Girls Casual Printed Pure Cotton-Pack of 2 (Multicolour),Warehouse C,77,61,2025-02-28 16:21:00,16
4003,ORD_4004,27071,"Mee Mee Comb and Brush Set (Premium, Blue)",Warehouse C,444,433,2025-02-28 16:16:00,11
4004,ORD_4005,27072,Mothercare Unisex Slub Shorts Pack of 2,Warehouse B,61,45,2025-02-28 10:35:00,16
4005,ORD_4006,5575,Amraz Food-Grade Silicone Plastic Easy Squeeze Baby Food Feeder Medicine Dropper Pipette - 8029 - Pink - 5ML - Pack of 2 |...,Warehouse C,367,355,2025-02-28 18:50:00,12
4006,ORD_4007,27080,Girls Printed Cotton A-Line Dress/Frock (DN-1081),Warehouse A,192,164,2025-02-28 03:57:00,28
4007,ORD_4008,27089,Mothercare Girls Embroidery Pink Hat,Warehouse B,64,55,2025-02-28 07:56:00,9
4008,ORD_4009,5566,Mamaearth Daily Moisturizing Natural Baby Lotion (400 ml),Warehouse C,217,194,2025-02-28 05:17:00,23
4009,ORD_4010,5565,Hopscotch Girls Floral Print Onesie and Shorts Set with Headband Cotton and Polyester in Pink Color,Warehouse A,392,382,2025-02-28 07:13:00,10
4010,ORD_4011,27067,"Chicco Bath Foam, 200ml",Warehouse A,451,419,2025-02-28 22:05:00,32
4011,ORD_4012,27093,CMMCHAAH 0-6 Years Baby Girls Pageant Lace Embroidery Dresses Toddler Formal Dress with Headwear,Warehouse A,501,496,2025-02-28 18:54:00,5
4012,ORD_4013,5613,"100% Muslin Cotton 4 Layer Baby Quilt for Newborn to 5 Years, Soft Dream Blanket, Muslin Baby Blankets for Girls & Boys, L...",Warehouse C,374,334,2025-02-28 15:34:00,40
4013,ORD_4014,26935,BODYSTYLE Baby Boys & Baby Girls Soft Cotton Bloomers (Pack of 6)- Made in India,Warehouse A,416,385,2025-02-28 05:52:00,31
4014,ORD_4015,26939,A P Boutique Baby Girl Clothing Set Sunflower Print Dress Photo Shoot Outfit,Warehouse A,317,302,2025-02-28 03:25:00,15
4015,ORD_4016,5649,"Littloo Diaper Nappy Cream for Baby's Soft Skin with Natural Calendula Extract, Shea Butter for Newborns, Babies- 50 GM",Warehouse B,210,178,2025-02-28 07:20:00,32
4016,ORD_4017,5645,United Colors of Benetton Girls' T-Shirt,Warehouse C,98,82,2025-02-28 04:16:00,16
4017,ORD_4018,26955,Mom's Darling Pack of 4 | Newborn Baby Cotton Cap with Mittens and Booties Set | Baby Cap Set | Baby Gloves Set | Baby Soc...,Warehouse C,192,177,2025-02-28 13:34:00,15
4018,ORD_4019,5639,"Decals Design 'Walking in The Garden Flower' Wall Sticker (PVC Vinyl, 70 cm x 25 cm), Multicolour",Warehouse A,40,17,2025-02-28 20:08:00,23
4019,ORD_4020,27005,"LuvLap Muslin Cotton Cloth Premium Baby Washcloth for New Born, Washable, Reusable, Absorbent, Extra Soft Face Towels/Wash...",Warehouse B,345,322,2025-02-28 10:50:00,23
4020,ORD_4021,5636,Hopscotch Unisex Synthetic/PU Applique Sneakers in White Color,Warehouse A,436,429,2025-02-28 15:42:00,7
4021,ORD_4022,5631,GIVA 925 Sterling Silver Minimal Kids Nazariya Bracelet | Birthday Gifts for Kids | With Certificate of Authenticity and 9...,Warehouse B,361,348,2025-02-28 15:54:00,13
4022,ORD_4023,27294,"First Kick New Born Super Soft Baby Blanket Wrapper Sheet Cum Baby Blanket for Baby Boys, Baby Girls, Babies (100cm x 80c...",Warehouse B,66,58,2025-02-28 04:30:00,8
4023,ORD_4024,5360,"KASSY POP Baby Muslin Strips Towels, 10 x 10 Inches, Pack of 5 (0-18 Months)",Warehouse B,184,139,2025-02-28 06:55:00,45
4024,ORD_4025,27289,"Baby Girls Dress, Frock Lycra in Polka Dot Dress (12-24 Months & 1-2 Years) in Black Color",Warehouse B,389,346,2025-02-28 11:34:00,43
4025,ORD_4026,28897,SBM Ayur Baby Oil 100 ml,Warehouse B,397,359,2025-02-28 13:20:00,38
4026,ORD_4027,4571,x2o Kids Cotton Pajama Pants with All Over Print and Bright Colors (Multicolor) (Pack of 5),Warehouse A,459,425,2025-02-28 14:24:00,34
4027,ORD_4028,4570,"Knitroot Unisex Baby Romper Half Sleeve Envelope Neck ""Drinking Buddies""(KTSBR09-2,3-6 Months,White)",Warehouse B,499,476,2025-02-28 02:06:00,23
4028,ORD_4029,28905,"Mothercare All We Know Baby Lotion E 0M+ (300ml, Pack of 2)",Warehouse C,498,451,2025-02-28 20:19:00,47
4029,ORD_4030,4566,"Neska Moda 0 To 6 Months Baby Boys & Baby Girls Cotton Lace Shoes/Booties (Yellow,Red) -BT380andBT1139",Warehouse C,236,220,2025-02-28 22:21:00,16
4030,ORD_4031,4565,Hopscotch Boys Polo T-Shirt,Warehouse B,125,106,2025-02-28 03:19:00,19
4031,ORD_4032,4562,JUGULAR Baby Boys T-Shirt Multicolour (Pack of 5),Warehouse C,234,208,2025-02-28 07:00:00,26
4032,ORD_4033,28926,Aashiya Trades Yellow Turban Knot Bow Cap for Baby Girls & Baby Boys Turban Bow Cap Infant Head Cap,Warehouse A,353,311,2025-02-28 03:45:00,42
4033,ORD_4034,28929,"Neska Moda 6 To 12 Months Baby Girls Cotton Butterfly Frill Booties (Rani,Orange) -SK143andBT43",Warehouse B,396,348,2025-02-28 10:08:00,48
4034,ORD_4035,4552,Barbie Girl's BBPGBO1329 Beige Booties,Warehouse B,183,139,2025-02-28 18:17:00,44
4035,ORD_4036,28940,QIUYI Toddler House Shoes Autumn And Winter Children Slippers Girls Boys Flat Non Slip Short Warm Comfortable Cute Shoes,Warehouse C,434,420,2025-02-28 18:36:00,14
4036,ORD_4037,4549,Vaseline Blue Seal Original Baby Gentle Protective Jelly 100ml,Warehouse A,489,461,2025-02-28 21:29:00,28
4037,ORD_4038,28914,VK creation Rabbit Frock Baby Frock Kids Frock Girl Kids Frocks Cotton Kids Frock Baby Girl Fancy Frock Frocks & Dresses F...,Warehouse A,82,43,2025-02-28 15:33:00,39
4038,ORD_4039,28892,Mars Infiniti Stylish t shirt and jeans set for boys and girl (combo),Warehouse A,167,146,2025-02-28 02:37:00,21
4039,ORD_4040,28891,"Pigeon Baby Skincare Wipes,PH Balance,Paraben Free,Alcohol Free,Sulphate Free,Non-Irritant,Enriched with Glycerin,72 Sheet...",Warehouse C,53,19,2025-02-28 10:00:00,34
4040,ORD_4041,28890,92.5 Sterling Silver Kids Nazaria cum Bracelet for baby boy & baby girls with Om Charms,Warehouse A,444,403,2025-02-28 03:21:00,41
4041,ORD_4042,28836,jivo®100% Pure Cotton Traditional Dress Dhoti Kurta for Kids,Warehouse B,307,279,2025-02-28 13:51:00,28
4042,ORD_4043,4602,A toddler thing Baby Half Sleeve Cotton Button Top And Shorts,Warehouse B,48,41,2025-02-28 00:31:00,7
4043,ORD_4044,4636,StapX Baby Nail Trimmer with LED Light Filer Cum Manicure Set Suitable for New Born Kid (Multicolor),Warehouse C,179,130,2025-02-28 16:13:00,49
4044,ORD_4045,4616,Honey Enterprise Baby Mittens hand gloves Set-Multi Color (pack of 4 pair),Warehouse C,438,394,2025-02-28 01:48:00,44
4045,ORD_4046,4621,EIO� New Born Baby Romper Body Suits Jump Suit for Boys and Girls Set of 3,Warehouse C,189,147,2025-02-28 21:40:00,42
4046,ORD_4047,28828,"Moon Nasal Aspirator, Filter-Free Nasal Aspirator, 0M+",Warehouse B,205,160,2025-02-28 19:03:00,45
4047,ORD_4048,28777,"Little Angel Extra Dry Baby Pants Diaper, Small (S) Size, 120 Count, Super Absorbent Core Up to 12 Hrs. Protection, Soft E...",Warehouse B,319,273,2025-02-28 11:59:00,46
4048,ORD_4049,28712,GRAZIA portable mini U Shaped Toothbrush For Kids With Cover | 2-6 Years Aged Boys & Girls | Manual U Type 360 Degree Soft...,Warehouse A,536,498,2025-02-28 02:06:00,38
4049,ORD_4050,28714,"Neska Moda 0 To 6 Months Baby Girls Cotton Butterfly Booties (Maroon,Orange) -BT386andBT1117",Warehouse B,428,410,2025-02-28 03:52:00,18
4050,ORD_4051,4665,SuperBottoms Dry Feel Langot - Pack of 12- Cotton Padded Langot / Nappy with Gentle Elastics & a SuperDryFeel Layer on top...,Warehouse C,413,373,2025-02-28 06:18:00,40
4051,ORD_4052,28718,ANKIMA New Born Baby Printed Caps Pack 4 (Multicolor) (3-6 Months),Warehouse A,256,214,2025-02-28 19:53:00,42
4052,ORD_4053,28724,Huggies Nature Care Baby Wipes - Plant Based with Aloe Vera & Calendula (72 x 1 Count),Warehouse B,386,373,2025-02-28 10:07:00,13
4053,ORD_4054,28727,Mee Mee Baby Gentle Nail Clipper Safe for Newborn Toddler Adults Toes Fingernails Care | Baby Nail Clipper with Magnifier...,Warehouse A,53,20,2025-02-28 02:34:00,33
4054,ORD_4055,28732,KOCHIKAME Kids Sleeveless Multicolor Vest(baniyan) for Boys/Unisex(Pack of 6),Warehouse B,534,495,2025-02-28 11:52:00,39
4055,ORD_4056,28774,"Runbugz Mosquito Repellent Patches, Anti Mosquito Patch - Blue, 48 Patches",Warehouse C,391,356,2025-02-28 22:52:00,35
4056,ORD_4057,28739,ATORSE Soft Water Shoes Stretchy Aqua Socks Yoga Swim Shoe Dive Sock Pink L,Warehouse C,445,427,2025-02-28 03:19:00,18
4057,ORD_4058,4647,"Pigeon Glass Feeding 120m Bottle with 2 Nipples, Small, Pink",Warehouse B,132,119,2025-02-28 09:58:00,13
4058,ORD_4059,28751,NEW NOW Baby Frock Multicolor Fit and Flare Angel Fancy Trendy Girls Frock and Dress Modern Classy Frock,Warehouse C,463,431,2025-02-28 22:24:00,32
4059,ORD_4060,28760,"MAXI Lollipop Tongue Cleaner for kids, extra soft, 6+ months, watermelon, candy, multicolor (Pack of 4)",Warehouse C,429,415,2025-02-28 04:40:00,14
4060,ORD_4061,4641,"VAVSU U Shaped Toothbrush, Silicone Soft bristled Baby Infant Toothbrush U-Shaped Cleaning Toothbrush 360° Oral Cleaning D...",Warehouse B,21,10,2025-02-28 03:52:00,11
4061,ORD_4062,4637,Mamaearth dusting Powder with Organic Oatmeal & Arrowroot Powder 150g & Mamaearth's Plant Based Baby Laundry Liquid Deterg...,Warehouse C,86,55,2025-02-28 02:41:00,31
4062,ORD_4063,28843,"Pampers Premium Care Pants, Large size baby diapers (L), 176 Count, Softest ever Pampers pants",Warehouse C,416,407,2025-02-28 18:21:00,9
4063,ORD_4064,28848,"Neska Moda Baby Boys and Girls Pack of 4 Cotton Caps for 0 to 12 Months (Blue,Pink,Green,Orange)",Warehouse A,414,365,2025-02-28 06:36:00,49
4064,ORD_4065,27347,"NewSpace™ Electric Baby Nail Trimmer New Born, Baby Nail Cutter, Nail Polish Grooming Kit Safe for Infant Toddler Kids or ...",Warehouse A,222,199,2025-02-28 08:35:00,23
4065,ORD_4066,27360,VBaby Unisex-Baby's Sky Blue Walking Shoes -12-15 Months,Warehouse B,455,429,2025-02-28 00:15:00,26
4066,ORD_4067,5427,Sahiba Gems Light Weight Comfortable Traditional Plain Hollow Trishul Design Baby Kada/Bangles in Solid Silver for Kids ~ ...,Warehouse C,464,456,2025-02-28 22:34:00,8
4067,ORD_4068,27369,Jo's 21 PCS PEPPA PIG Shoe Charms Decoration for Croc Shoes Bracelets - shoe charms make your shoes more interesting fun a...,Warehouse A,179,142,2025-02-28 11:25:00,37
4068,ORD_4069,27376,Younique Mosquito Net for Baby Cradle Swing/Mosquito Net for Baby Jhula with Side Zip Opening (0-3 yrs) (Blu n Wht),Warehouse A,122,117,2025-02-28 02:17:00,5
4069,ORD_4070,27381,"TNW-The Natural Wash Baby Care Combo with Lip Balm, Face Cream, Body Lotion, Powder, Shampoo & Body Wash | Care for Lips, ...",Warehouse B,501,486,2025-02-28 20:40:00,15
4070,ORD_4071,27259,"Himalaya Baby Prickly Heat Powder, Pack of 200g",Warehouse A,102,71,2025-02-28 10:51:00,31
4071,ORD_4072,5474,Fully Girl's Cotton Caps for Sun Protection Beach Hat (Multicolour),Warehouse A,282,263,2025-02-28 12:22:00,19
4072,ORD_4073,5473,Njels 925 HALLMARKED Sterling Silver Plain Kada cum Bangle for Baby Boys & Baby Girls (Unisex),Warehouse A,456,446,2025-02-28 16:59:00,10
4073,ORD_4074,27271,Jordan Step Plastic Soft Bristles Toothbrush (6-9 Years),Warehouse B,330,302,2025-02-28 03:23:00,28
4074,ORD_4075,5472,"Mamaearth Milky Soft Natural Baby Face Cream for Babies 60mL & Soothing Massage Oil 100% Natural Oils for Babies and Kids,...",Warehouse A,300,272,2025-02-28 02:05:00,28
4075,ORD_4076,28850,"Giggles - Stack N Nest Toy , Multicolour 3 in 1 Gift Set, Develops Motor Skills , 6 Months & Above, Infant and Preschool Toys",Warehouse B,479,433,2025-02-28 06:26:00,46
4076,ORD_4077,27307,Infantbond 56 in 1 New Born Baby Complete Daily Items Combo(0-6 Months)(Circle) (Polka Orange),Warehouse B,217,173,2025-02-28 02:05:00,44
4077,ORD_4078,27344,Magnet NARI Farishta Fashion Baby Girls Casual Dress Shorts ((FFBG-001RE_-),Warehouse A,245,199,2025-02-28 14:07:00,46
4078,ORD_4079,28860,Infantbond Combo of Baby Mattress with Net | Sleeping Bag | 4 Pcs Bedding Set | 4 Waterproof Sheets(0-6 Months) (Moon Pink),Warehouse A,210,182,2025-02-28 12:29:00,28
4079,ORD_4080,4591,H&H Dermadew Diaper Cream - 50 g (Pack of 2),Warehouse B,437,401,2025-02-28 17:10:00,36
4080,ORD_4081,28866,Mamaearth Fruit Based Nourishing Clear Bathing Bar Baby Soap & Milky Soft Body Wash – 400 ml & Milky Soft Shampoo with Oat...,Warehouse C,366,317,2025-02-28 00:51:00,49
4081,ORD_4082,28869,Tippy Toes Baby Girls Red Synthetic Shoe,Warehouse C,450,435,2025-02-28 13:03:00,15
4082,ORD_4083,28872,"Softsens Baby Nourishing Lotion with Milk Cream & Shea Butter (200ml x Pack of 2, Green)",Warehouse B,403,394,2025-02-28 11:33:00,9
4083,ORD_4084,28875,WorldCare® 5mm Neoprene Anti-skid Scuba Diving Surfing Swim Wetsuit Boots US Size 7 (66003287JEL),Warehouse B,90,82,2025-02-28 23:25:00,8
4084,ORD_4085,28854,Neska Moda Baby Boys Synthetic Leather Slip On Loafer Booties/Shoes For 6 To 12 Months (Gold) -BT917,Warehouse A,109,68,2025-02-28 09:55:00,41
4085,ORD_4086,28701,"vOnline New Born Baby Sweater Set for Boys & Girls (Unisex)(Age: 0-6 Months) Woollen Winterwear Set of Sweater, Cap & Sock...",Warehouse B,535,493,2025-02-28 14:17:00,42
4086,ORD_4087,29248,Trokopoka Powder Puff for Babies (Pack of 3),Warehouse C,473,462,2025-02-28 23:03:00,11
4087,ORD_4088,5455,Sukha Jhari Baby Oil | Baby Massage Oil | Sukha Jhari Lal Tel (Pack Of 1),Warehouse B,115,106,2025-02-28 06:00:00,9
4088,ORD_4089,27343,OYO BABY Waterproof Baby Bed Protector Dry Sheets for New Born Babies | Reusable Mats | Cot & Bassinet Gift Pack (Dark Blu...,Warehouse B,139,91,2025-02-28 21:44:00,48
4089,ORD_4090,5459,"HUG 'n' FEEL SOFT TOYS Teddy Bear 6 feet, Soft Toy, Teddy Bear 6 feet for Girls, Teddy Bear 6 feet for Girls, Soft Toys fo...",Warehouse B,221,176,2025-02-28 12:51:00,45
4090,ORD_4091,27313,"SebaMed Clear Face Cleansing Foam, 150ml & Sebamed Baby Cream, Extra Soft, 200ml & Sebamed Everyday Shampoo, 200ml",Warehouse A,459,453,2025-02-28 09:45:00,6
4091,ORD_4092,4998,RSE Baby boy & Baby Girl Teddy Bear Dungaree Set with Tshirt 0-6 Months || Baby Boy Dresses for 0-6 Months || Clothes for ...,Warehouse C,414,408,2025-02-28 14:56:00,6
4092,ORD_4093,4997,Morisons Baby Dreams Bottle & Accessories Cleaner 500ml & Morisons Baby Dreams Baby Laundry Detergent - 1 Lt,Warehouse B,118,91,2025-02-28 13:48:00,27
4093,ORD_4094,22668,Sathiyas Baby Girl's Knee Length Dress,Warehouse C,274,247,2025-02-28 18:27:00,27
4094,ORD_4095,26136,"Little Hub New Born Unisex Baby 6pcs Gift Set (Pink, 0-3 months)",Warehouse B,137,113,2025-02-28 14:37:00,24
4095,ORD_4096,19740,Neska Moda 6 To 12 Months Baby Girls Synthetic Leather/Rexine Polka Dot Baby Sandal Booties (White)-BT1205,Warehouse C,465,442,2025-02-28 03:13:00,23
4096,ORD_4097,31779,Nike Boys Team Hustle D 10 Lil (Td) Platform,Warehouse C,89,71,2025-02-28 21:18:00,18
4097,ORD_4098,3574,Baby Girls Dungaree Solid Festive Wedding Cotton Frocks and Dresses,Warehouse A,289,251,2025-02-28 16:46:00,38
4098,ORD_4099,35231,Mozzo Baby boy & Girls Shoes,Warehouse C,335,309,2025-02-28 15:21:00,26
4099,ORD_4100,23016,Nemichand Jewels Sterling Silver 925 Hallmarked Baby/Kids Bangle Kada Bracelet for below 1 year,Warehouse A,484,463,2025-02-28 14:27:00,21
4100,ORD_4101,30609,SMARNN Silver Plated Bangle Set Nazariya for New born baby boy girl kid Adjustable (0-9 months),Warehouse B,74,37,2025-02-28 11:41:00,37
4101,ORD_4102,22493,"ANZAILALA 4pcs Flower Headbands Elastic Floral Hair Band, Bows Wrap Headband for Baby Girls, Infants and Newborns - Multic...",Warehouse B,104,76,2025-02-28 07:37:00,28
4102,ORD_4103,33261,Zacharias Girl's Cotton Pink Smile Cap Free Size (Pack of 1),Warehouse B,259,225,2025-02-28 22:24:00,34
4103,ORD_4104,34504,"Wearville New Born Baby Boy's & Baby Girls jabla Clothing Top Set(Multicolored),Pack of 10",Warehouse A,415,386,2025-02-28 16:28:00,29
4104,ORD_4105,31576,Babymoon Baby Flower Headbands and Barefoot Sandals Set Hair Accessories Foot Bands Nylon Headband for Baby Girls,Warehouse B,164,141,2025-02-28 01:02:00,23
4105,ORD_4106,3745,MOM CARE Baby Vest for 0-6 Months Cotton Sleeveless for Boys and Girls Sando Baniyan Combo (Pack of 6) White,Warehouse B,154,134,2025-02-28 20:56:00,20
4106,ORD_4107,26890,Kiddeo Infants Bodysuits (Pack of 5),Warehouse C,362,357,2025-02-28 01:11:00,5
4107,ORD_4108,30326,"MagicPop Colourful Socks for kids/Boys, Crew length, Cotton, 1 to 9 Years, Pack of 5, Designer socks, Gift Option",Warehouse B,366,328,2025-02-28 18:39:00,38
4108,ORD_4109,31098,Khillayox New Born Baby Socks Set 0 to 6 months Woolen Socks For kids baby boys and baby girls Warm thick terry socks for ...,Warehouse A,159,120,2025-02-28 14:24:00,39
4109,ORD_4110,24285,"LuvLap 100% Cotton Baby Caps, Mittens and Booties Combo Set for 0-6 Months - Pack of 2 (Assorted)",Warehouse B,527,494,2025-02-28 22:32:00,33
4110,ORD_4111,33916,GoodLuck Baybee New Born Baby Cap with Knot Boys and Girls Soft Cotton Cap Set Babies - Multicolour (0-3 Months),Warehouse B,251,206,2025-02-28 03:30:00,45
4111,ORD_4112,5060,Kike Baby Products Born Baby's Combed Cotton Regular Fit Half Sleeve Cartoon Printed Undershirt Hosiery Vest Top Underwear...,Warehouse B,309,286,2025-02-28 05:59:00,23
4112,ORD_4113,9158,DHRUVS COLLECTION 92.5 Pure Silver Black Beads Crystal Nazariya Bracelet for Baby Boys & Girls - Set of 2,Warehouse B,171,148,2025-02-28 07:01:00,23
4113,ORD_4114,27748,Disney Kids' W000227 Mickey Mouse Stainless Steel Time Teacher Watch with Black Nylon Band,Warehouse C,305,277,2025-02-28 09:05:00,28
4114,ORD_4115,20255,CHIU Chu-Chu Black Shoes with Double Strap for Baby Boys & Baby Girls,Warehouse B,193,187,2025-02-28 00:37:00,6
4115,ORD_4116,5346,Butterthief Unisex Infant Soft New Born Baby Sandal 3-7 Months Feet Size 11cm (Pack of 2pair) Multi,Warehouse C,344,303,2025-02-28 21:56:00,41
4116,ORD_4117,11964,Tinchuk Baby Girl's A-Line Mini Dress(Pack of 6),Warehouse C,80,64,2025-02-28 09:53:00,16
4117,ORD_4118,11991,"INSTABUYZ Baby Boys & Baby Girls Shoes for Boys & Girls, Infant Shoes for Newborn, First Walking Baby Shoe (6-9 Months) Blue",Warehouse A,126,107,2025-02-28 23:38:00,19
4118,ORD_4119,22769,Sathiyas Baby Girls Dresses (Pack of 5) (Printed Button),Warehouse A,456,426,2025-02-28 17:43:00,30
4119,ORD_4120,22772,"Neska Moda 0 To 6 Months Baby Boys & Girls Pack of 3 Pair Cotton Rabbit Face Slip On Baby Booties (Black,Maroon,Baby Pink)...",Warehouse C,121,111,2025-02-28 15:02:00,10
4120,ORD_4121,7797,LMN CHILD CARE Unisex Baby Booties For 0 To 6 Months (White -Black),Warehouse C,289,243,2025-02-28 03:54:00,46
4121,ORD_4122,11811,"Skudgear Best Chiffon Comfortable and Soft Headbands for Baby Girls (Colors Set, One Size, Pack of 6) - Multicolor",Warehouse C,442,435,2025-02-28 00:05:00,7
4122,ORD_4123,32817,Hopscotch Boys Yellow Text Print Top and Pant Set M/90(12-18 Months) LSB-1975894,Warehouse C,339,324,2025-02-28 18:33:00,15
4123,ORD_4124,14489,Batik Printed Frock Knee Length for,Warehouse C,108,69,2025-02-28 07:59:00,39
4124,ORD_4125,6258,NPRC Unisex Wool Cap (436_Multicolor_M),Warehouse B,277,267,2025-02-28 10:16:00,10
4125,ORD_4126,20708,Jewel string by Bk arts Evil Eye Baby Nazaria adjustable (1pair) Size for newborn baby to 3 year child girl boy (unisex) n...,Warehouse A,504,471,2025-02-28 08:08:00,33
4126,ORD_4127,408,SMARTOTS Kids Unisex Casual Baby Shoes Easy Pullon Strap for Baby Boys/Girls Age 15 Months to 4 Years,Warehouse B,292,282,2025-02-28 13:25:00,10
4127,ORD_4128,19834,WILDBIRDS Kids Girls Shoes for 12 Months to 10 Years l Children Footwear Flora Pattern Boots (Size Chart in Image),Warehouse C,93,86,2025-02-28 20:49:00,7
4128,ORD_4129,3615,"BabyMoon Baby Girl Rhinestone Crown Headbands Toddler Princess Acrylic Headband Hair Accessories Glittering for Girls,",Warehouse B,146,132,2025-02-28 14:11:00,14
4129,ORD_4130,9754,Li'l Cupid Regular Fit Hooded Fleece Sweatshirt for Kids Boys & Girls,Warehouse C,519,489,2025-02-28 11:40:00,30
4130,ORD_4131,4032,"CHiU Kids LED Light Shoes with Chu Chu Music Sound for Baby Girl and Baby Boys (Age Group - 9-12 Months, 12-15 Months, 15-...",Warehouse A,64,23,2025-02-28 22:45:00,41
4131,ORD_4132,9749,DHRUVS COLLECTION Exclusive BIS Hallmarked 925 Pure Silver Evil Eye Baby Nazariya Bracelets With Black Crystal & Silver Be...,Warehouse C,387,381,2025-02-28 08:07:00,6
4132,ORD_4133,5401,"Darshraj 925 Sterling Silver 10 Ball in Black Thread Handmade Baby Nazariya|Girls Bracelet (Use As Bracelet & Anklets), (...",Warehouse A,448,440,2025-02-28 11:22:00,8
4133,ORD_4134,254,DHRUVS COLLECTION Exclusive 925 Pure Silver Pair Of Adjustable Baby Plain Pipe Kada In 925 Sterling Silver For Baby Boys &...,Warehouse C,502,459,2025-02-28 07:08:00,43
4134,ORD_4135,4027,Nemichand Jewels 925 Sterling Pure Silver(Chandi) Black Bead Crystal Nazariya Bangle/Bracelet For Kids - One Pair For Chil...,Warehouse A,446,425,2025-02-28 00:21:00,21
4135,ORD_4136,20895,CUTEABLY unisex-baby Multicolored Booties - 6 Months (Set of 2 Pairs),Warehouse A,437,392,2025-02-28 09:51:00,45
4136,ORD_4137,28394,ShoppeWatch 12 Pairs Baby Toddler Socks with Grips Anti-Slip Non-Skid Bottoms For Kids Infant Babies Unisex 2T and 3T Walk...,Warehouse C,318,285,2025-02-28 04:16:00,33
4137,ORD_4138,17530,Bold N Elegant Summer Sleeveless Cotton Floral Heart Print Princess Dress Frock Tutu with Hat,Warehouse B,144,103,2025-02-28 06:24:00,41
4138,ORD_4139,31014,BABY GO 100% Pure Cotton Half Sleeves Romper/Sleepsuit for Baby Girls,Warehouse C,511,492,2025-02-28 06:56:00,19
4139,ORD_4140,6836,EIO New Born Baby Front Open Cotton Half Sleeves Jhablas Pack of 4,Warehouse C,462,429,2025-02-28 14:37:00,33
4140,ORD_4141,22468,Coolz Kids Knitted First Walking Shoes with Light Led-01 for Baby Boys and Baby Girls for 9-24 Months,Warehouse A,332,319,2025-02-28 17:10:00,13
4141,ORD_4142,15317,Kids Chu-Chu Sound Musical First Walking Cozy Sandals for Baby Boys and Baby Girls Age 9-22 Months,Warehouse A,210,198,2025-02-28 09:31:00,12
4142,ORD_4143,32307,"exciting Lives - Vintage Motorbike Pocket Watch Keychain - Gift for Birthday, Anniversary - for Brother, Boyfriend, Friend...",Warehouse B,64,49,2025-02-28 04:01:00,15
4143,ORD_4144,21802,KingSwagger Sneakers for Kids,Warehouse B,83,75,2025-02-28 01:44:00,8
4144,ORD_4145,32454,"Skudgear Comfortable Soft Chiffon Flower Headbands for Baby Girls (Colors Set, One Size, Pack of 15) - Multicolor",Warehouse C,377,352,2025-02-28 07:47:00,25
4145,ORD_4146,17151,MINI BERRY M D IMPEX BANGALORE 13 Piece Unisex Baby's Gift Set (Pink),Warehouse C,320,289,2025-02-28 18:43:00,31
4146,ORD_4147,2044,Neska Moda Months Baby Boys Synthetic Leather Baby Loafer Booties (Brown) -BT1305-BT1307,Warehouse C,317,285,2025-02-28 09:36:00,32
4147,ORD_4148,701,ShoppeWatch 12 Pairs Baby Toddler Socks with Grips Anti-Slip Non-Skid Bottoms For Kids Infant Babies Boys 2T and 3T Walker...,Warehouse A,137,96,2025-02-28 10:08:00,41
4148,ORD_4149,28870,Superminis Unisex-baby's Bootie,Warehouse C,353,348,2025-02-28 05:46:00,5
4149,ORD_4150,14740,"Kids Fitness Tracker Watch for Girls Boys, Digital Watch with Alarm Clock, Stopwatch, Sleep Monitor, No App Sport Watches ...",Warehouse B,476,441,2025-02-28 18:16:00,35
4150,ORD_4151,24081,EIO� 100% Cotton Rompers/Sleepsuit for Newborn Baby Boys & Girls Pack of 3,Warehouse B,482,449,2025-02-28 08:16:00,33
4151,ORD_4152,33600,"Superminis Baby Girls and Boys Dual Color Shoes/Booties with Wooden Button - Soft Base, Ankle Length, Breathable for Newbo...",Warehouse A,150,103,2025-02-28 10:50:00,47
4152,ORD_4153,19422,Bold N Elegant Full Sleeve Cotton Fun Cute Cartoon Jungle Animal Tshirt & Pajama PJ Pant Clothing Set for Infant Toddler B...,Warehouse B,415,385,2025-02-28 22:18:00,30
4153,ORD_4154,278,"LuvLap Newborn Baby Gift Set of 5 Items, Open Half Sleeves Jhabla Vest- Tshirt, Pajama Pants, Cap, Mittens and Socks, Cott...",Warehouse B,441,403,2025-02-28 11:43:00,38
4154,ORD_4155,34631,ARIEL Baby Boys & Baby girls Cotton Printed Round Neck Half Sleeve T-shirt & Short Latest Summer Clothing Sets,Warehouse A,143,126,2025-02-28 13:22:00,17
4155,ORD_4156,25462,DARSHRAJ JEWELLERS 925 Sterling Silver kada for Baby Boys & Baby Girls (10 Approx.) Adjustable Size-Best for 1-3 Years Old...,Warehouse A,271,234,2025-02-28 01:51:00,37
4156,ORD_4157,225,Kids Choice Baby Boy's and Girl's Canvas Shoes with Anti-Slip Sole (3-12 Months) Blue,Warehouse A,100,82,2025-02-28 10:01:00,18
4157,ORD_4158,10958,EIO New Born Baby Gift Set -13 Piecess (Pink),Warehouse B,314,291,2025-02-28 18:01:00,23
4158,ORD_4159,10913,"Pooja Baby 100% Cotton Rompers/Sleepsuits/Jumpsuit/Night Suits for Baby Boys & Girls, Infants, New Borns",Warehouse A,492,443,2025-02-28 22:05:00,49
4159,ORD_4160,5624,"Baby Bow Cap -Turban Bow Cap Baby Bow Cap -Turban Bow Cap,Baby Cap, Turban Cap, Baby Headwear Suitable for 0 to 12 Months ...",Warehouse B,322,282,2025-02-28 02:13:00,40
4160,ORD_4161,23874,WHP Jewellers 22KT(916) Gold Kadli for new born baby/Kids black beads bracelet (Pack of 2),Warehouse C,312,306,2025-02-28 18:57:00,6
4161,ORD_4162,30526,Cute and Easy Crocheted Baby Clothes: 35 adorable projects for 0–3 year-olds,Warehouse C,430,414,2025-02-28 00:33:00,16
4162,ORD_4163,13525,ARTIFICIAL TREE evil eye nazaria bracelet(2piece) black beads adjustable for newborn baby to 4 year child girl boy (unise...,Warehouse B,475,427,2025-02-28 12:12:00,48
4163,ORD_4164,13257,PW PLATYPUS WORLD Baby Girl's Cotton Silk Frock,Warehouse B,208,166,2025-02-28 05:13:00,42
4164,ORD_4165,29415,superbottoms Top & Shorts Set | Evrydaywear| Comfort Wear | Lounge Wear | Top and Shorts set for Kids | Kids Combo Dress |...,Warehouse C,306,259,2025-02-28 06:46:00,47
4165,ORD_4166,1960,Mom's Darling Newborn Baby Cotton Mittens Set/Gloves Set/Multicolor (Pack of 12 Pair),Warehouse B,248,236,2025-02-28 15:13:00,12
4166,ORD_4167,32538,SooWoo® Boy’s Anti-Skid Grip Cotton Socks,Warehouse C,428,397,2025-02-28 17:24:00,31
4167,ORD_4168,24445,SSKR Black and White Beads Thread based Nazar Baby Bracelet Nazariya - Pack of 2 Pairs Inside,Warehouse B,160,119,2025-02-28 11:36:00,41
4168,ORD_4169,29442,HOPE QUAY Baby Sleep Wear Bottom Pant |Cartoon Printed Cotton Pajami Lower Trackpant Pyjama Nightwear for Kids Set of 5 Pcs,Warehouse C,236,207,2025-02-28 23:05:00,29
4169,ORD_4170,8633,Butterthief Soft Unisex Baby Shoe for New Born Baby Infant Booties (6-9 Months),Warehouse B,152,106,2025-02-28 08:08:00,46
4170,ORD_4171,5958,NEOBABY Casual Shoes for 2 Years to 4.5 Years Kids Boys & Girls,Warehouse B,358,311,2025-02-28 10:22:00,47
4171,ORD_4172,12469,Silverwala 92.5-925 Sterling Silver Baby Bracelets kada Bangle Nazariya With Black Beads/crystal for baby boy and girl,Warehouse B,399,390,2025-02-28 03:03:00,9
4172,ORD_4173,21683,Traditional Silver & Black Nazariya Beads For Baby Boys & Baby Girls Nazariya in Silver Plating - One Pair (Black & White),Warehouse A,407,395,2025-02-28 01:15:00,12
4173,ORD_4174,24070,Sathiyas Baby Girl's Dress (Pack of 6) (asvinf77_Multicolored_0-3 Months),Warehouse B,479,467,2025-02-28 03:46:00,12
4174,ORD_4175,1636,TuddyBuddy 100% Cotton Multi Color Romper/Bodysuit/Onesies for Baby Boy & Baby Girl,Warehouse A,239,200,2025-02-28 10:30:00,39
4175,ORD_4176,36051,CHIU Kids LED Light Shoes with Musical Sound for Baby Boy and Girl,Warehouse C,42,32,2025-02-28 05:12:00,10
4176,ORD_4177,34718,DARSHRAJ JEWELLERS 925 Sterling Silver Blue Evil Eye Nazariya Bracelet|Nara Battu|New Born Baby 4 Silver Ball Crystal for ...,Warehouse A,119,108,2025-02-28 07:00:00,11
4177,ORD_4178,12392,Arokast L 5mg/10mg Tablet,Warehouse C,30,13,2025-02-28 10:08:00,17
4178,ORD_4179,12391,"Bath Brush - Large Mesh, Dark Cyan",Warehouse A,97,78,2025-02-28 06:52:00,19
4179,ORD_4180,245,Nutriment Apricot Mask All Skin Type 300 gm,Warehouse C,26,18,2025-02-28 06:05:00,8
4180,ORD_4181,30411,"Classmate Soft Cover 6 Subject Spiral Binding Notebook, Single Line, 300 Pages",Warehouse B,18,13,2025-02-28 07:15:00,5
4181,ORD_4182,12396,"Fashion Colour Terra Cotta Blusher, Shade 06 8 gm",Warehouse B,40,28,2025-02-28 01:42:00,12
4182,ORD_4183,12384,Mirah Belle Organic Tomato Grapeseed Complexion Soap 125 gm,Warehouse B,45,29,2025-02-28 13:45:00,16
4183,ORD_4184,16996,Lametec 100 OD Tablet SR,Warehouse C,114,98,2025-02-28 12:59:00,16
4184,ORD_4185,15003,Omron NE C28 Compressor Nebulizer For Child and Adult With Virtual Valve Technology Ensuring Optimum Medicine Delivery to ...,Warehouse A,45,36,2025-02-28 07:21:00,9
4185,ORD_4186,30422,Lipitag 20mg Tablet,Warehouse B,99,87,2025-02-28 20:23:00,12
4186,ORD_4187,3776,Vitanova-D3 6L Injection,Warehouse C,68,55,2025-02-28 12:11:00,13
4187,ORD_4188,17043,Floink OZ 200mg/500mg Tablet,Warehouse A,91,79,2025-02-28 03:39:00,12
4188,ORD_4189,15002,Streetwear Fruity Balm Spf 15 - Strawberry Delight 4.2 Gm,Warehouse B,82,70,2025-02-28 20:03:00,12
4189,ORD_4190,32153,LAPSTER Wireless Bluetooth in Ear Replacement Earpads (Black),Warehouse B,64,54,2025-02-28 02:15:00,10
4190,ORD_4191,15009,"realme narzo 50 5G (Hyper Blue, 4GB RAM+128GB Storage) Dimensity 810 5G Processor | 48MP Ultra HD Camera",Warehouse A,106,88,2025-02-28 04:14:00,18
4191,ORD_4192,29357,Amazon Brand - Solimo Silicone Soft & Shockproof Back Cover with inbuilt Cushioned Edges Mobile Cover for Samsung Galaxy M...,Warehouse B,61,52,2025-02-28 02:35:00,9
4192,ORD_4193,12364,Lotevail Eye Drop,Warehouse C,61,54,2025-02-28 16:27:00,7
4193,ORD_4194,15182,Glador 4 Tablet,Warehouse A,103,85,2025-02-28 14:04:00,18
4194,ORD_4195,30364,Tombow Mono Zero Eraser with Extra Refill,Warehouse A,27,15,2025-02-28 06:55:00,12
4195,ORD_4196,11341,Moisturising Face & Body Wash With Shea Butter - For Dry Skin,Warehouse A,114,99,2025-02-28 01:34:00,15
4196,ORD_4197,29348,AE M.A.C Premium Makeup Brush for Professional Makeup and Lite Makeup - Set Of 12 Pieces,Warehouse B,99,92,2025-02-28 02:51:00,7
4197,ORD_4198,29347,Tomato Firming Facial Kit,Warehouse A,60,52,2025-02-28 15:36:00,8
4198,ORD_4199,30425,"Trussardi New Fem Eau De Perfum, 90 ML",Warehouse A,111,98,2025-02-28 21:06:00,13
4199,ORD_4200,12403,Adipin 10mg Tablet,Warehouse B,17,11,2025-02-28 22:54:00,6
4200,ORD_4201,4329,Latvitor 200 Tablet,Warehouse C,102,92,2025-02-28 00:31:00,10
4201,ORD_4202,12404,Senoflox 400mg Tablet,Warehouse A,100,85,2025-02-28 11:08:00,15
4202,ORD_4203,12421,Traxol O 200mg Tablet,Warehouse B,60,42,2025-02-28 10:03:00,18
4203,ORD_4204,30441,Azafran Organics Dfend Spf 30+ Creme 100 gm,Warehouse A,28,18,2025-02-28 12:01:00,10
4204,ORD_4205,3061,Superdrug Fruity Tea Tree & Mint Shower Gel 250 ml,Warehouse C,47,31,2025-02-28 23:36:00,16
4205,ORD_4206,17115,Ceff CF 250mg Tablet,Warehouse B,49,42,2025-02-28 16:30:00,7
4206,ORD_4207,3055,Neem Plus Ras,Warehouse A,19,11,2025-02-28 00:42:00,8
4207,ORD_4208,3669,7 O Clock - Ready Ii Disposable Razor,Warehouse C,20,4,2025-02-28 16:24:00,16
4208,ORD_4209,12477,"boAt Newly Launched Aavante Bar 3200D Soundbar with Dolby Audio,350W RMS Signature Sound,5.1 Channel,3D Surround Sound,Dua...",Warehouse B,25,19,2025-02-28 17:46:00,6
4209,ORD_4210,14912,"ASUS Vivobook Pro 14 OLED, 14-inch (35.56 cms) 2.8K OLED 16:10 90Hz, AMD Ryzen 5 5600H, Thin and Light Laptop (16GB/512GB ...",Warehouse B,25,17,2025-02-28 05:13:00,8
4210,ORD_4211,30582,"ZEBRONICS Juke BAR 100A Compact Soundbar with Subwoofer, 60W RMS Output, Powerful Bass, Glossy Design, HDMI ARC, Coaxial, ...",Warehouse B,39,22,2025-02-28 20:29:00,17
4211,ORD_4212,12527,A-Od 500mg Tablet,Warehouse C,37,31,2025-02-28 13:06:00,6
4212,ORD_4213,36671,Superdrug Calm Skin Soothing Facial Wash 150 ml,Warehouse B,56,50,2025-02-28 14:03:00,6
4213,ORD_4214,15045,Spigen EZ Fit Tempered Glass Screen Guard for iPhone 11 / Xr - 2 Pack,Warehouse B,79,63,2025-02-28 22:39:00,16
4214,ORD_4215,29295,Robustrion Smart Trifold Hard Back Flip Stand Case Cover for iPad 10th Generation Cover iPad Cover 10.9 inch - Navy,Warehouse C,106,97,2025-02-28 04:20:00,9
4215,ORD_4216,30556,"VLCC Cocoa Butter De-tan Glow SPF 30 | PA+++, 400 ml",Warehouse C,94,83,2025-02-28 03:28:00,11
4216,ORD_4217,31743,Nil Rich 100mg Tablet,Warehouse C,41,30,2025-02-28 08:39:00,11
4217,ORD_4218,36679,Adbeni Complete 3 in 1 Fashion Make-Up Kit,Warehouse A,106,87,2025-02-28 18:53:00,19
4218,ORD_4219,11278,Betadine First Aid Solution,Warehouse B,56,51,2025-02-28 08:42:00,5
4219,ORD_4220,14963,MC SID Razz Harry Potter Pack of 6 New Magnetic Bookmarks | Gift for Readers and Book Lovers| Girlfriends/Boyfriends Gift...,Warehouse A,32,20,2025-02-28 01:16:00,12
4220,ORD_4221,36645,Renata Cr 2430 Lithium Battery (1Pc Blister Pack),Warehouse A,95,90,2025-02-28 11:58:00,5
4221,ORD_4222,36009,The Natural Wash Handmade Activated Charcoal Soap With Anti-Pollution Effect 100 Gm,Warehouse B,87,76,2025-02-28 03:46:00,11
4222,ORD_4223,3664,Cedobact CV 200mg/125mg Tablet DT,Warehouse C,72,62,2025-02-28 12:47:00,10
4223,ORD_4224,3676,"Fusion T500 Smartwatch with Heart Rate and Blood Pressure Monitor for Men & Women, Bluetooth Calling, Sleep Monitor, Oxyge...",Warehouse A,24,19,2025-02-28 10:09:00,5
4224,ORD_4225,36681,Tygot Gorilla Tripod/Mini 33 CM (13 Inch) Tripod for Mobile Phone with Phone Mount | Flexible Gorilla Stand for DSLR & Act...,Warehouse B,66,59,2025-02-28 01:26:00,7
4225,ORD_4226,2793,"Revlon ColorStay Liquid Eye Pen, Classic, Blackest Black",Warehouse C,41,32,2025-02-28 02:48:00,9
4226,ORD_4227,12576,D'Addario EJ13 11-52 Bronze Custom Light Acoustic Guitar Strings,Warehouse B,28,16,2025-02-28 19:47:00,12
4227,ORD_4228,17138,"Fogg Amber Extreme Perfume, Long-Lasting Perfume, Eau De Parfum For Men, 100ml",Warehouse A,52,46,2025-02-28 00:34:00,6
4228,ORD_4229,227,"KB BB Cream Foundation of Green Tea Moisture, Shade-03 | 30g Each (Pk of 02), 60g",Warehouse B,83,76,2025-02-28 11:56:00,7
4229,ORD_4230,17135,Robustrion Deer Flip Stand Case Cover [Auto Sleep Wake] with S Pen Holder for Samsung Galaxy Tab S6 Lite Tablet Cover 10.4...,Warehouse C,31,24,2025-02-28 01:23:00,7
4230,ORD_4231,30639,Vega Foundation Brush (MBP - 04) 28 gm,Warehouse A,108,97,2025-02-28 19:06:00,11
4231,ORD_4232,3658,"Lightning to 3.5 mm Headphone Jack Adapter, [Apple MFi Certified] Phone 3.5mm Headphones/Earphones Jack Aux Audio Dongle A...",Warehouse A,80,65,2025-02-28 07:42:00,15
4232,ORD_4233,17118,Oskrit OZ 200mg/500mg Tablet,Warehouse C,32,19,2025-02-28 13:32:00,13
4233,ORD_4234,30599,Lignorain 2% Injection,Warehouse C,72,67,2025-02-28 20:09:00,5
4234,ORD_4235,12567,Maitridrox KID 125mg Tablet,Warehouse C,24,12,2025-02-28 09:04:00,12
4235,ORD_4236,11307,Medimade Coffee Fixing Hair Gel (Pack of 2) 1's,Warehouse C,62,48,2025-02-28 12:41:00,14
4236,ORD_4237,3640,HA&F29 Enterprises Organic Orange Peel Powder (250 Gram) For Hair & Skin Care.,Warehouse B,106,92,2025-02-28 09:23:00,14
4237,ORD_4238,36630,Boult Audio BassBuds X1 in-Ear Wired Earphones with 10mm Extra Bass Driver and HD Sound with mic(Black),Warehouse A,90,82,2025-02-28 06:33:00,8
4238,ORD_4239,3609,Clobenex gm Cream,Warehouse A,54,38,2025-02-28 01:04:00,16
4239,ORD_4240,36881,"HTY Educational English Learner Laptop with 20 Activity Games for Kids,color Blue",Warehouse A,75,57,2025-02-28 16:54:00,18
4240,ORD_4241,12819,Revlon Colorstay Brow Fiber Filler Gel - Warm Brown 6.8 ml,Warehouse A,22,7,2025-02-28 21:08:00,15
4241,ORD_4242,3471,"Logitech C270 Digital HD Webcam with Widescreen HD Video Calling, HD Light Correction, Noise-Reducing Mic, for Skype, Face...",Warehouse B,30,12,2025-02-28 15:57:00,18
4242,ORD_4243,3477,Luliba 1% Lotion,Warehouse A,42,31,2025-02-28 09:37:00,11
4243,ORD_4244,3120,Biotic Red Sandalwood Powder - Lal Chandan Powder - Rakta Chandan Powder - 100g,Warehouse B,55,46,2025-02-28 07:16:00,9
4244,ORD_4245,31618,"Nivea Men Body Wash, Vitality Fresh With Ocean Minerals, Shower Gel For Body, Face & Hair, 250 ml",Warehouse C,38,24,2025-02-28 06:41:00,14
4245,ORD_4246,36864,"TP-Link TL-SG108S 8-Port Desktop Gigabit Ethernet Switch/Hub, Ethernet Splitter, Plug & Play, no Configuration Required, S...",Warehouse B,22,3,2025-02-28 01:22:00,19
4246,ORD_4247,4430,"FLiX (Beetel USB to Type C PVC Data Sync & 2A Smartphone Fast Charging Cable, Made in India, 480Mbps Data Sync, Tough Cabl...",Warehouse C,49,44,2025-02-28 13:48:00,5
4247,ORD_4248,31652,"Maybelline New York Colossal Kajal, Black, 0.35g And Maybelline New York The Blushed Nudes Palette Eyeshadow, 9g",Warehouse A,79,66,2025-02-28 16:17:00,13
4248,ORD_4249,3534,MANCODE Intimate Wash 100 ml,Warehouse C,50,32,2025-02-28 22:04:00,18
4249,ORD_4250,32194,Teatree Essential Oil,Warehouse A,36,22,2025-02-28 11:35:00,14
4250,ORD_4251,30704,Livotec Plus 75mg/5mg/10mg Tablet SR,Warehouse C,39,25,2025-02-28 23:44:00,14
4251,ORD_4252,14649,Vomiover 4mg Tablet MD,Warehouse B,10,3,2025-02-28 22:05:00,7
4252,ORD_4253,30712,Rosuless 10 Tablet,Warehouse C,113,99,2025-02-28 20:08:00,14
4253,ORD_4254,30975,HP Z3700 Wireless Optical Mouse with USB Receiver and 2.4GHz Wireless Connection/ 1200DPI / 16 Months Long Battery Life/Am...,Warehouse B,41,25,2025-02-28 10:18:00,16
4254,ORD_4255,31686,Acifame P Oral Suspension,Warehouse C,96,91,2025-02-28 22:12:00,5
4255,ORD_4256,32186,"Samsung Soundbar {HW-B550/XL}, 2.1 Channel, Wireless Subwoofer, Dolby 2ch & DTS Virtual X Experience Sound, AI Adaptive So...",Warehouse B,97,83,2025-02-28 22:08:00,14
4256,ORD_4257,17178,Nimopride 100mg/325mg Tablet,Warehouse A,59,49,2025-02-28 08:41:00,10
4257,ORD_4258,36746,Dalsix D 200mg/500mg Tablet,Warehouse A,92,73,2025-02-28 06:37:00,19
4258,ORD_4259,12744,Gemblue Biocare Rose Petal Cream 500 ml,Warehouse B,59,48,2025-02-28 19:53:00,11
4259,ORD_4260,17171,"Fiama Gel Bathing Bar Fresh Celebration pack, with 3 unique gel bars, with skin conditioners for moisturized skin, 125g so...",Warehouse A,98,83,2025-02-28 01:37:00,15
4260,ORD_4261,12627,Natural Fairness Natural Ayurvedic Saffron Face Cream,Warehouse C,102,85,2025-02-28 09:44:00,17
4261,ORD_4262,35967,Amitar 500mg Injection,Warehouse C,59,53,2025-02-28 23:54:00,6
4262,ORD_4263,17160,Ozone D Tan Extension Range Combo (Face Wash + Face Pack Cream + Face Scrub) - For Sun Tan Removal - 300 G,Warehouse C,69,64,2025-02-28 02:32:00,5
4263,ORD_4264,11243,Livocit 5 Tablet,Warehouse C,32,13,2025-02-28 02:54:00,19
4264,ORD_4265,30719,"B077RCVT1R Giordani Gold Original Perfumed Roll-On Deodorant for Women, 50ml",Warehouse A,64,45,2025-02-28 15:48:00,19
4265,ORD_4266,36756,Insta Beauty 72 Shades ColorBook Color Book Multicolor Matte Shimmer Glittery Metallic Highly Pigmented WaterProof Eyeshad...,Warehouse A,61,47,2025-02-28 09:47:00,14
4266,ORD_4267,14232,Uniball Eye Ub-150 Blue [Pack Of 3] Micro 0.5mm Tip Rollerball Pen,Warehouse B,16,6,2025-02-28 12:27:00,10
4267,ORD_4268,3465,Bajaj 220V 4-Way Spike and Surge Guard with 2m Wire (White),Warehouse C,70,51,2025-02-28 16:31:00,19
4268,ORD_4269,15039,"Digiway 240 volts 8 + 2 Mini Power Strip Extension Cord/Board with 2 Switch, Indicator, Safety Fuse & 8 International sock...",Warehouse C,110,92,2025-02-28 10:12:00,18
4269,ORD_4270,36834,M.G.R.J® Tempered Glass Screen Protector Compatible with iPad 10.2 9th Gen (2021) / 8th Gen (2020) / 7th Gen (2019) (with ...,Warehouse C,54,36,2025-02-28 05:10:00,18
4270,ORD_4271,30476,"Uniball Eye UB157 Roller Pen (Blue, Green, Pink, Violet, Wine Red Pack Of 5)",Warehouse C,33,18,2025-02-28 01:35:00,15
4271,ORD_4272,12466,Dec ND 50mg Injection,Warehouse A,19,12,2025-02-28 09:29:00,7
4272,ORD_4273,30493,"STRIFF Multi Angle Mobile Tabletop Stand. Phone Holder for iPhone, Android, Samsung, OnePlus, Xiaomi. Portable,Foldable Ce...",Warehouse B,79,68,2025-02-28 19:48:00,11
4273,ORD_4274,15011,I AM EYECONIC FINE GLITTER FIREBALL 4 gm,Warehouse C,70,62,2025-02-28 09:37:00,8
4274,ORD_4275,14771,Plantas Purifying & Acne Control Organic Cleansing Milk 100 ml,Warehouse B,26,20,2025-02-28 07:46:00,6
4275,ORD_4276,29257,Voltanec 100mg Tablet,Warehouse C,64,46,2025-02-28 10:05:00,18
4276,ORD_4277,15218,"Ant Esports H1100 Pro RGB Wired Over Ear Gaming Headphones with Mic for PC / PS4 / PS5 / Xbox One / Switch1, Carbon Black",Warehouse C,22,14,2025-02-28 20:52:00,8
4277,ORD_4278,14376,Prazopol 2.5 Tablet,Warehouse A,89,72,2025-02-28 21:08:00,17
4278,ORD_4279,31635,D'Addario EJ11 12-53 Bronze Light Acoustic Guitar Strings,Warehouse C,66,60,2025-02-28 07:18:00,6
4279,ORD_4280,17310,Wellgas L 75mg/40mg Capsule SR,Warehouse A,103,91,2025-02-28 09:37:00,12
4280,ORD_4281,14358,Herbal Moisturising Lotion With Rose & Honey,Warehouse B,17,12,2025-02-28 19:47:00,5
4281,ORD_4282,29169,Canon Pixma MG 3070S All-in-One Wireless Inkjet Colour Printer (Black) with 1 Colour Cartridge,Warehouse A,39,29,2025-02-28 16:41:00,10
4282,ORD_4283,17290,"Pro Ultra Girl HD Pro Concealer 3pc Liquid Cream Powder (ORANGE CORRECTOR, Yellow Corrector, Green Corrector) Concealer (2...",Warehouse C,61,52,2025-02-28 12:27:00,9
4283,ORD_4284,30864,Faces Canada Belle De Luxe Nail Enamel Le Rouge 67 9 Ml,Warehouse A,92,79,2025-02-28 17:49:00,13
4284,ORD_4285,17359,Deodorant Body Spray - Relation,Warehouse A,22,17,2025-02-28 14:32:00,5
4285,ORD_4286,3505,Sunpen DM 10mg/20mg Tablet,Warehouse B,76,66,2025-02-28 21:41:00,10
4286,ORD_4287,12788,TheGiftKart Shockproof Crystal Clear OnePlus 7 / 6T Back Cover Case | 360 Degree Protection | Protective Design | Transpar...,Warehouse C,38,24,2025-02-28 03:55:00,14
4287,ORD_4288,30848,Miss Claire Nature Essence Face Mask - Sandalwood & Rose 25 Ml,Warehouse A,53,43,2025-02-28 05:36:00,10
4288,ORD_4289,14418,Spigen Ultra Hybrid Back Cover Case Compatible with iPhone 14 (TPU + Poly Carbonate | Frost Black),Warehouse B,40,26,2025-02-28 11:21:00,14
4289,ORD_4290,3527,"Gifferes Solah Shringar Kit for Women ( Basic Cosmetics, 16 Pcs Set) | Sixteen Embellishments | Solah Shringar Set | Bride...",Warehouse A,25,14,2025-02-28 19:57:00,11
4290,ORD_4291,3530,Paradise® Hair Streak Colored Extension Highlighter For Women And Girls (Set Of 4 pc) (Maroon),Warehouse A,61,52,2025-02-28 17:27:00,9
4291,ORD_4292,3112,"Amazon Basics New Release Nylon USB-A to Lightning Cable Cord, MFi Certified Charger for Apple iPhone, iPad, Silver, 6-Ft",Warehouse A,51,45,2025-02-28 04:37:00,6
4292,ORD_4293,10070,Disinfectant Foam Hand Wash,Warehouse B,89,76,2025-02-28 10:49:00,13
4293,ORD_4294,12881,Winface MR 100mg/325mg/250mg Tablet,Warehouse B,36,26,2025-02-28 05:08:00,10
4294,ORD_4295,2777,Lolita Lempicka Lolitaland Women Eau De Parfum 40ml,Warehouse B,91,86,2025-02-28 03:14:00,5
4295,ORD_4296,131,Fmx D 250mg/250mg Capsule,Warehouse C,78,70,2025-02-28 18:34:00,8
4296,ORD_4297,2038,Incolor Meets Story 8 Colour Eyeshadow 04 15 Gm,Warehouse B,28,15,2025-02-28 06:22:00,13
4297,ORD_4298,23870,"Oaky Keyboard Protector Compatible with MacBook Air M1 13 inch 2020 Release Model A2179, A2337 Ultra Thin Keyboard Cover W...",Warehouse C,89,82,2025-02-28 19:30:00,7
4298,ORD_4299,22757,Zapcase Carbon Fibre Rugged Armour Back Cover Case Compatible for Xiaomi Redmi Note 5 Pro Cases & Covers (Black),Warehouse B,73,55,2025-02-28 18:19:00,18
4299,ORD_4300,22575,Casmont-LC Tablet,Warehouse B,63,46,2025-02-28 12:35:00,17
4300,ORD_4301,6623,PJ Masks Gekko Night Light for Boys 5+ & Above,Warehouse C,29,20,2025-02-28 17:49:00,9
4301,ORD_4302,33271,"Noise Newly Launched Bravo Bluetooth in Ear Neckband with Upto 35 Hours of Playtime, Instacharge (10-min Charge=10-hrs Pla...",Warehouse B,53,39,2025-02-28 10:32:00,14
4302,ORD_4303,23996,Brightening Serum,Warehouse B,83,72,2025-02-28 11:30:00,11
4303,ORD_4304,1151,Rainbath Refreshing Shower & Bath Gel,Warehouse B,39,27,2025-02-28 16:49:00,12
4304,ORD_4305,9616,Miss Rose High Blendable Blusher 7004 - 070 01 12 gm,Warehouse C,50,33,2025-02-28 14:43:00,17
4305,ORD_4306,23077,"boAt Rockerz 330ANC Bluetooth in Ear Neckband with mic, Crystal Bionic Sound Powered by Dirac Opteo, Active Noise Cancella...",Warehouse A,27,16,2025-02-28 22:54:00,11
4306,ORD_4307,6311,L.A Girl HD PRO Conceal Classic Ivory 8 gm,Warehouse B,62,49,2025-02-28 20:35:00,13
4307,ORD_4308,7279,Raxcef TZ 250mg/31.25mg Injection,Warehouse A,19,10,2025-02-28 22:19:00,9
4308,ORD_4309,26742,Neflox OZ 200mg/500mg Tablet,Warehouse C,34,20,2025-02-28 17:56:00,14
4309,ORD_4310,34635,DENVER Black Code Perfume (EDP) - 60ML | Eau de Parfum - For Men | Long Lasting Luxury Scent Fragrance,Warehouse C,83,65,2025-02-28 20:20:00,18
4310,ORD_4311,18593,Soulflower Essential Oil Bergamot 15 ml,Warehouse A,31,25,2025-02-28 08:38:00,6
4311,ORD_4312,18814,TheGiftKart Ultra-Hybrid Crystal Clear Back Case Cover for Samsung Galaxy A23 4G / A23 5G | Shockproof Design | Camera Pro...,Warehouse C,77,67,2025-02-28 12:25:00,10
4312,ORD_4313,21214,Rose Absolute Essential Oil - 100% Pure & Natural,Warehouse C,25,9,2025-02-28 15:14:00,16
4313,ORD_4314,2272,"AmazonBasics New Release ABS USB-A to Lightning Cable Cord, Fast Charging MFi Certified Charger for Apple iPhone, iPad Tab...",Warehouse A,65,54,2025-02-28 23:04:00,11
4314,ORD_4315,27573,Hello Zone Exclusive Matte Finish Soft Back Case Cover for Samsung Galaxy S9 Plus - Black,Warehouse B,75,68,2025-02-28 03:33:00,7
4315,ORD_4316,8224,Kum Kumadi Tailam Oil For Blemishes & Scars For Radiant Skin 25 ml (Pack of 1),Warehouse C,69,62,2025-02-28 06:37:00,7
4316,ORD_4317,25317,Nutriment Ubtan Gel All Skin Type 250 gm,Warehouse A,88,82,2025-02-28 23:30:00,6
4317,ORD_4318,28135,L'Amante Aqua Eau De Parfum - Perfume For Men,Warehouse C,24,8,2025-02-28 13:03:00,16
4318,ORD_4319,19765,Vozwa 12 Color EyeShadow Chunky Glitter,Warehouse A,90,74,2025-02-28 00:26:00,16
4319,ORD_4320,8923,Ajmal Desert Rose EDP Floral Oriental Perfume And Raindrops Femme Deodorant Floral Chypre Fragrance 300 ml,Warehouse B,34,27,2025-02-28 09:03:00,7
4320,ORD_4321,23790,Glimmer Ne Fes Maroon 5Ml Btl M 12 ml,Warehouse B,16,11,2025-02-28 06:42:00,5
4321,ORD_4322,33289,Rofaclo P 100 mg/500 mg Tablet,Warehouse C,29,17,2025-02-28 18:18:00,12
4322,ORD_4323,22337,Wella Professionals Invigo Color Brilliance Shampoo 250Ml And Conditioner 200Ml Duo For Fine/Normal Hair,Warehouse B,22,6,2025-02-28 00:28:00,16
4323,ORD_4324,18966,Upfe 100mg Injection,Warehouse C,63,47,2025-02-28 23:54:00,16
4324,ORD_4325,28162,Levon-AZ Tablet,Warehouse A,92,79,2025-02-28 08:02:00,13
4325,ORD_4326,4978,Mytederm-B Lotion,Warehouse A,42,30,2025-02-28 17:47:00,12
4326,ORD_4327,21132,"Fast Charger for All Vivo Mobile Y21L Y51L V7 Y6 VIVO V11 PRO V11 PRO Vivo V5 Vivo V15 Pro, V7 Plus, Y81, Y93, Z1 Pro, S1,...",Warehouse A,63,44,2025-02-28 00:14:00,19
4327,ORD_4328,22126,After-Sun Recovery - Chamomile & White Tea Body Gel,Warehouse B,25,7,2025-02-28 08:55:00,18
4328,ORD_4329,4883,Nandika Beauty Facial Gel - Wine 500 gm,Warehouse B,70,55,2025-02-28 14:19:00,15
4329,ORD_4330,27645,Amazon Brand - Solimo Thermoplastic Polyurethane Soft & Flexible Back Cover for Apple iPhone 12 (Transparent),Warehouse C,19,9,2025-02-28 04:48:00,10
4330,ORD_4331,6639,Letzy M 5mg/10mg Tablet,Warehouse C,18,1,2025-02-28 12:28:00,17
4331,ORD_4332,32492,D'Addario EJ27N Nylon Classical Normal Tension Guitar Strings,Warehouse C,62,50,2025-02-28 07:54:00,12
4332,ORD_4333,7320,Lepromine 100mg Capsule,Warehouse A,51,37,2025-02-28 23:51:00,14
4333,ORD_4334,8333,Tricute MH Cream,Warehouse A,37,23,2025-02-28 14:46:00,14
4334,ORD_4335,2634,Samsung EVO Plus 512GB microSDXC UHS-I U3 130MB/s Full HD & 4K UHD Memory Card with Adapter (MB-MC512KA),Warehouse A,68,53,2025-02-28 22:59:00,15
4335,ORD_4336,33832,Kiss Pretty Fantasy 2 Glitter Eye Shadow Palette | Makeup Palette - High Pigmented Professional Eye Shadow with 9 Differen...,Warehouse A,81,64,2025-02-28 04:32:00,17
4336,ORD_4337,23078,D'Addario EJ26 Acoustic 11-52 Custom Light Guitar Strings,Warehouse A,79,60,2025-02-28 15:51:00,19
4337,ORD_4338,34096,EGOTUDE Shockproof Transparent Hard Back Scratch Resistant Cover Case for iPhone 14 / iPhone 13 (Clear),Warehouse A,80,69,2025-02-28 05:35:00,11
4338,ORD_4339,7824,Abturbi Cream,Warehouse B,20,15,2025-02-28 15:32:00,5
4339,ORD_4340,21359,Spigen EZ Fit Tempered Glass Screen Protector for iPhone 14 Plus / 13 Pro Max - 2 Pack (Sensor Protection),Warehouse C,93,86,2025-02-28 12:40:00,7
4340,ORD_4341,18588,"HIKVISION DS-U02 1080p Webcam, Wide Angle Without Distortion, Noise Reduction, Plug, Play, Digital, Zoom/WebEx/Skype/Team...",Warehouse A,69,55,2025-02-28 02:32:00,14
4341,ORD_4342,22097,Ajmal 2 Sacrifice II For Him And 2 Distraction Deodorants Pack of 4 200 ml,Warehouse C,99,82,2025-02-28 07:54:00,17
4342,ORD_4343,8383,Amazon Brand - Solimo Soft & Flexible Shockproof Thermoplastic Polyurethane Back Cover for OnePlus 7 (Transparent),Warehouse C,47,41,2025-02-28 10:31:00,6
4343,ORD_4344,23055,Vigini VPlus Women Capsule 30's,Warehouse A,29,18,2025-02-28 16:47:00,11
4344,ORD_4345,18658,Z Plus Tablet,Warehouse A,72,58,2025-02-28 19:17:00,14
4345,ORD_4346,18585,Trytin Plus 50mg/325mg Tablet,Warehouse C,63,48,2025-02-28 02:29:00,15
4346,ORD_4347,23042,Oxedep 20mg Capsule,Warehouse A,30,24,2025-02-28 08:43:00,6
4347,ORD_4348,7606,POPIO Tempered Glass Screen Protector Compatible for OnePlus Nord with Edge to Edge Coverage and Easy Installation Kit,Warehouse A,67,57,2025-02-28 08:09:00,10
4348,ORD_4349,28388,"RETRIX Make Up Combo Kit For Girls & Women, 1Makeup Fixer, 1 Primer, 2 In 1 Concealer And Highlighter Stick, 1 High Defini...",Warehouse B,91,85,2025-02-28 09:30:00,6
4349,ORD_4350,32950,Oxlaw USB C to USB A Adapter (Pack of 2) USB C Male to USB3 Female Adapter Compatible with MacBook Pro 2021 iMac iPad Mini...,Warehouse C,80,61,2025-02-28 01:35:00,19
4350,ORD_4351,21383,Dppin S 500mg/250mg Injection,Warehouse C,48,40,2025-02-28 20:08:00,8
4351,ORD_4352,21385,Optimox 500mg Tablet,Warehouse B,61,51,2025-02-28 13:22:00,10
4352,ORD_4353,1594,"Swan® 37 Key Melodica with Case, (Black)",Warehouse C,59,45,2025-02-28 11:59:00,14
4353,ORD_4354,18591,Onamox 250mg Tablet,Warehouse B,77,70,2025-02-28 16:55:00,7
4354,ORD_4355,27562,Astypod CV Dry Syrup,Warehouse B,20,2,2025-02-28 22:48:00,18
4355,ORD_4356,5319,Odeon Coffee & Coconut Face And Body Scrub 100 ml,Warehouse B,40,28,2025-02-28 01:10:00,12
4356,ORD_4357,25172,Adofys HOT-L-Type Quick Release Camera Vertical Plate Dual Camera Bracket Plate Universal SLR Stabilizer,Warehouse A,53,42,2025-02-28 10:13:00,11
4357,ORD_4358,32695,ZOUL Type C to Type C 65W Nylon Braided Fast Charging Cable Compatible with Macbook Oneplus9 10R Samsung Galaxy S22 S21 Ul...,Warehouse C,80,70,2025-02-28 19:01:00,10
4358,ORD_4359,35402,"OCTRIX WARP/Dash Charging Cable, Type C Cable 3FT 5V 4A Fast Charge Data Cable for OnePlus 8/8T, OnePlus 7, OnePlus 6T/ 6,...",Warehouse A,58,42,2025-02-28 15:03:00,16
4359,ORD_4360,18941,Vlcc Ultimo Blends Charcoal Face Wash 100 Gm,Warehouse C,91,86,2025-02-28 19:46:00,5
4360,ORD_4361,26813,"3M Post-it Sticky Note Cube, 200 Sheets (4 Colors x 50 Sheets) | 3"" x 3"" Size | For notes, reminders, study, school and or...",Warehouse B,95,77,2025-02-28 13:49:00,18
4361,ORD_4362,23806,Spigen Ultra Hybrid S Back Cover Case for Galaxy S23 Ultra (Poly Carbonate + TPU + Kickstand | Crystal Clear),Warehouse C,99,84,2025-02-28 08:11:00,15
4362,ORD_4363,6042,Full Body Massager - Colour May Vary,Warehouse A,63,49,2025-02-28 15:53:00,14
4363,ORD_4364,7374,Atenolix 50mg Tablet,Warehouse B,101,83,2025-02-28 11:14:00,18
4364,ORD_4365,21195,Periflox 500mg Tablet,Warehouse A,106,88,2025-02-28 16:06:00,18
4365,ORD_4366,7770,Criss Cross Toothbrush With Neem Extract - Medium,Warehouse B,89,72,2025-02-28 04:41:00,17
4366,ORD_4367,14606,"proffisy 303 Toner for Canon 303 CRG 303 Toner Cartridge for Canon LBP 2900, LBP 2900B,LBP 3000 (1 pcs)",Warehouse C,77,61,2025-02-28 07:48:00,16
4367,ORD_4368,9645,Vertibar 24mg Tablet,Warehouse C,59,42,2025-02-28 12:29:00,17
4368,ORD_4369,22248,Ajmal Nightingale And Distraction For Men & Women And Silver Shade Deodorants Pack of 3 200 ml,Warehouse B,96,88,2025-02-28 23:10:00,8
4369,ORD_4370,2614,Acigo-SP Tablet,Warehouse B,64,48,2025-02-28 15:51:00,16
4370,ORD_4371,1873,Mcaffeine Naked & Raw Cappuccino Coffee Scalp Lotion 100 ml,Warehouse B,16,10,2025-02-28 13:34:00,6
4371,ORD_4372,26810,Myglamm K.Play Flavoured Blush - Frozen Raspberry 9 Gm,Warehouse C,26,7,2025-02-28 19:13:00,19
4372,ORD_4373,20584,MME 80MMx50Mtr.(3Inch) Cash Register Machine Thermal Paper Roll Set of 10 Rolls,Warehouse B,16,6,2025-02-28 19:12:00,10
4373,ORD_4374,21161,Cherry Lip Balm,Warehouse A,22,7,2025-02-28 04:29:00,15
4374,ORD_4375,28201,Malirid-DS Tablet,Warehouse A,94,86,2025-02-28 01:24:00,8
4375,ORD_4376,5276,Femol 500mg Tablet,Warehouse C,42,24,2025-02-28 07:25:00,18
4376,ORD_4377,26207,Strohax 250mg Injection,Warehouse A,99,90,2025-02-28 11:53:00,9
4377,ORD_4378,21149,Bestine 16mg Tablet,Warehouse C,106,92,2025-02-28 08:36:00,14
4378,ORD_4379,10125,Weight Balance Capsules,Warehouse C,68,52,2025-02-28 00:51:00,16
4379,ORD_4380,7402,"Stbotanica Activated Charcoal Hair Conditioner, Deeply Purifies And Removes Impurities, Refreshing Menthol 300 ml",Warehouse B,89,73,2025-02-28 09:40:00,16
4380,ORD_4381,21157,"Original 18W Adapter Quick Fast Charging for iQOO Z6 5G, iQOO Z6 Lite 5G, iQOO Z6 Lite - White",Warehouse B,28,13,2025-02-28 08:38:00,15
4381,ORD_4382,7385,Beauty People Matte Lucious Liquid Lip Colornude - L16 ,Warehouse C,76,61,2025-02-28 06:33:00,15
4382,ORD_4383,25672,TheGiftKart Back Cover for OnePlus 9R (Poly Carbonate | Black),Warehouse C,37,31,2025-02-28 07:02:00,6
4383,ORD_4384,10133,Nilnate SP 100mg/325mg/10mg Tablet,Warehouse A,21,13,2025-02-28 21:03:00,8
4384,ORD_4385,25285,"Fashion Colour Terra Cotta Blusher, Shade 16 16 gm",Warehouse A,9,1,2025-02-28 07:49:00,8
4385,ORD_4386,33407,Sixfire® Cleaner 5 in 1 Keyboard & Earphone Cleaner Keyboard Cleaning Brush Laptop Cleaning Kit Cleaning Pen for Airpods C...,Warehouse C,52,42,2025-02-28 05:41:00,10
4386,ORD_4387,28210,Sounce Replacement Band Strap for Xiaomi Mi Band 2 / Xiaomi MI Band HRX Edition/Xiaomi Mi Band HRX Version (Device not Inc...,Warehouse A,47,28,2025-02-28 14:59:00,19
4387,ORD_4388,1287,Telmibert 40 Tablet,Warehouse C,76,70,2025-02-28 12:14:00,6
4388,ORD_4389,7379,"Fashion Colour Pro Hd Contour & Highlighter Palette, Shade 02 12 gm",Warehouse A,25,7,2025-02-28 13:20:00,18
4389,ORD_4390,35436,Ant Esports VS600L 600 Watt Non-Modular Continuous Power Gaming Power Supply/PSU for PC,Warehouse C,25,8,2025-02-28 13:44:00,17
4390,ORD_4391,7409,"Camlin 7270002 Kokuyo Permanent Marker - Pack of 4 Assorted Colors (Black, Blue, Red, Green)",Warehouse B,41,22,2025-02-28 09:47:00,19
4391,ORD_4392,28109,Doms Plastic Crayon 28 Shades Round Tin,Warehouse B,66,60,2025-02-28 23:12:00,6
4392,ORD_4393,19763,Meba Plus Injection,Warehouse A,40,28,2025-02-28 03:38:00,12
4393,ORD_4394,5540,"2022 Upgrade Bluetooth Adapter Transmitter Receiver, Oxlaw 2 in1 Music Audio 5.0 Bluetooth USB Wireless for PC TV Car Hand...",Warehouse A,59,44,2025-02-28 06:06:00,15
4394,ORD_4395,32546,Encenil 200mg Oral Suspension,Warehouse A,93,78,2025-02-28 07:44:00,15
4395,ORD_4396,19057,Vivo T1x Gravity Black (4+64GB),Warehouse C,70,65,2025-02-28 03:45:00,5
4396,ORD_4397,32662,Cloguard-S Ointment,Warehouse B,88,77,2025-02-28 21:21:00,11
4397,ORD_4398,22358,Hair Naturals - Scalp Detoxifying Tonic,Warehouse A,26,13,2025-02-28 13:27:00,13
4398,ORD_4399,6530,BIOPRIM 40MG TABLET SR,Warehouse A,96,91,2025-02-28 23:25:00,5
4399,ORD_4400,1228,"LG Ultragear 69 cm IPS FHD, G-Sync Compatible, HDR 10, Gaming LCD Monitor, Display Port, HDMI x 2, Height Adjust & Pivot S...",Warehouse C,76,61,2025-02-28 19:23:00,15
4400,ORD_4401,25327,"RPM Euro Games USB Wireless Gaming Mouse Rechargeable 500 mAh Battery DPI Upto 3200 6 Color RGB Lights Rubber Coated Mice,...",Warehouse C,37,27,2025-02-28 04:51:00,10
4401,ORD_4402,20619,"Redmi 9A Sport (Carbon Black, 3GB RAM, 32GB Storage) | 2GHz Octa-core Helio G25 Processor | 5000 mAh Battery",Warehouse C,27,13,2025-02-28 04:16:00,14
4402,ORD_4403,33394,Swiss Beauty Real MakeUp Base Hightlighting Primer| Skin-hydrating Poreless Primer with Natural Glow finish for Face makeu...,Warehouse C,28,17,2025-02-28 15:40:00,11
4403,ORD_4404,23771,Aldactone F Tablet,Warehouse B,59,42,2025-02-28 13:54:00,17
4404,ORD_4405,35434,MyProg 200 Soft Gelatin Capsule,Warehouse B,68,62,2025-02-28 20:12:00,6
4405,ORD_4406,19747,"Color Diva Eye Liner, Long-Lasting, Water Resistant, 6ml (Pink)",Warehouse B,60,51,2025-02-28 04:43:00,9
4406,ORD_4407,7421,Ajmal Aurum Avid Wisal Deodorant Spray (Pack of 3) 200 ml,Warehouse C,49,43,2025-02-28 09:54:00,6
4407,ORD_4408,22587,Amantex Tablet,Warehouse B,77,65,2025-02-28 18:13:00,12
4408,ORD_4409,2115,Lenphor Smudge Me Eye Pencil Groovy Grey 02 1.2 Gm,Warehouse B,90,82,2025-02-28 21:49:00,8
4409,ORD_4410,25657,"【2 Pack】 Replacement Tips Compatible with Apple Pencil 1st & 2nd Gen iPad Pro Pencil, High Sensitivity Apple Pencil Nibs f...",Warehouse A,16,1,2025-02-28 06:48:00,15
4410,ORD_4411,22330,Pmw - Natural Surma Stone - Kohl - Stibnite - For Pooja & Cooling Of Eyes - 100 Grams,Warehouse A,50,37,2025-02-28 03:07:00,13
4411,ORD_4412,7407,Miss Claire Gel Effect Nail Polish - G01 5 Ml,Warehouse B,58,45,2025-02-28 08:22:00,13
4412,ORD_4413,35151,"i GEAR KeyBee Retro Typewriter Inspired 2.4GHz Wireless Keyboard and Mouse Set with USB Support, Single Nano Receiver, Rou...",Warehouse B,22,15,2025-02-28 14:01:00,7
4413,ORD_4414,19767,Ajmal Cd 99 Mukhallat Concentrated Perfume Oil Floral Oriental And Wisal Deodorant Floral Musky Fragrance 214 ml,Warehouse A,71,53,2025-02-28 23:34:00,18
4414,ORD_4415,35154,Cufrio-DX Syrup,Warehouse C,95,87,2025-02-28 18:49:00,8
4415,ORD_4416,23165,Glucolive M Forte 1mg/1000mg Tablet,Warehouse B,83,67,2025-02-28 05:46:00,16
4416,ORD_4417,22252,CEDO Back Cover Samsung M51 | Matte Soft Silicon Flexible | Camera Bump Protection | All Side Shock Proof Rubberised Back ...,Warehouse C,10,5,2025-02-28 03:00:00,5
4417,ORD_4418,36369,"Logitech MK295 Wireless USB Keyboard and Mouse Set, SilentTouch Technology, Full Number Keyboard, Shortcut Buttons, Nano U...",Warehouse C,98,81,2025-02-28 13:22:00,17
4418,ORD_4419,14602,"Handwash - Sea Minerals Liquid Refill 750 ml + Naturals, Sea Mineral 250 ml",Warehouse B,38,26,2025-02-28 22:13:00,12
4419,ORD_4420,35856,"Apple 2021 10.2-inch (25.91 cm) iPad with A13 Bionic chip (Wi-Fi, 256GB) - Space Grey (9th Generation)",Warehouse C,19,5,2025-02-28 11:18:00,14
4420,ORD_4421,13345,Ginkgovert Tablet,Warehouse B,115,98,2025-02-28 22:42:00,17
4421,ORD_4422,13542,L.A Girl HD PRO Conceal Creamy Beige 8 gm,Warehouse C,57,48,2025-02-28 07:29:00,9
4422,ORD_4423,748,"Maybelline New York Liquid Foundation, Matte & Poreless, Fit Me, 115 Ivory & Maybelline New York Compact Powder, 115 Ivor...",Warehouse A,107,99,2025-02-28 17:34:00,8
4423,ORD_4424,31108,Nozee Tablet,Warehouse A,92,80,2025-02-28 21:42:00,12
4424,ORD_4425,31480,Apsara Scholars Kit,Warehouse B,40,31,2025-02-28 13:57:00,9
4425,ORD_4426,29030,Bonjour Paris Just Matte Lip Crayon - Nude Brown 3.2 gm,Warehouse B,68,54,2025-02-28 13:35:00,14
4426,ORD_4427,14002,Cefitrix 100 Tablet DT,Warehouse A,11,3,2025-02-28 11:07:00,8
4427,ORD_4428,13478,"Forest Essentials Hair Cleanser, Amla, Honey and Mulethi, 200ml (Shampoo & Conditioner Combo)",Warehouse C,87,71,2025-02-28 14:14:00,16
4428,ORD_4429,31346,ACP Plus 100mg/500mg Tablet,Warehouse A,10,2,2025-02-28 00:55:00,8
4429,ORD_4430,17566,MeRaYo 3 Compartment Metal Mesh Desk Organizer Stationery Pen Stand for Office Study Table (Black Color),Warehouse C,29,24,2025-02-28 07:49:00,5
4430,ORD_4431,13848,"POPIO Flexible PET Screen Guard Protector Compatible for Apple Watch Series 7 (Black), Pack of 1, 45mm",Warehouse C,61,43,2025-02-28 12:23:00,18
4431,ORD_4432,37034,NHT 1080 Corded & Cordless Trimmer For Men,Warehouse C,62,44,2025-02-28 17:19:00,18
4432,ORD_4433,13597,Dasamoolarishtam,Warehouse B,43,34,2025-02-28 22:05:00,9
4433,ORD_4434,12977,"anthi: Anti-Hair Thinning Shampoo, Hair Thickening and Volume boosting, Sulphate and Paraben Free, Plant-origins shampoo, ...",Warehouse A,53,48,2025-02-28 12:18:00,5
4434,ORD_4435,3206,Salbutamol Resp Solution,Warehouse C,32,22,2025-02-28 12:50:00,10
4435,ORD_4436,32223,Ajmal Yearn EDP & Primitive Forest EDT Pack of 2 350 ml,Warehouse A,71,55,2025-02-28 16:53:00,16
4436,ORD_4437,14095,URBN 10000 mAh 15W Li-Polymer Premium Black Edition Wireless Power Bank | 22.5W Fast Charging | Type C Power Delivery (1 I...,Warehouse A,96,78,2025-02-28 12:24:00,18
4437,ORD_4438,17615,Dns  Infusion,Warehouse A,13,1,2025-02-28 14:39:00,12
4438,ORD_4439,31166,boAt Bassheads 220 Wired in Ear Earphones with Inline Mic(Blue),Warehouse A,21,12,2025-02-28 07:14:00,9
4439,ORD_4440,13588,Amazon Brand - Solimo Basic Case for Apple iPhone Xs (Silicone_Transparent),Warehouse A,101,95,2025-02-28 02:27:00,6
4440,ORD_4441,17546,Mopid 5mg Tablet,Warehouse C,15,7,2025-02-28 13:09:00,8
4441,ORD_4442,14126,"Cosmic Byte Stardust Headset with Flexible Mic for PS4, Xbox One, Laptop, PC, iPhone and Android Phones (Black)",Warehouse A,43,35,2025-02-28 14:51:00,8
4442,ORD_4443,13513,Bath & Body Works Butterfly Fine Fragrance Mist 236 ml,Warehouse A,43,28,2025-02-28 02:27:00,15
4443,ORD_4444,31432,D'Addario Electric Regular {Light Gauge10/46 BRIGHT TONE ROUND WOUND} Guitar Strings (Bronze),Warehouse C,91,76,2025-02-28 14:30:00,15
4444,ORD_4445,14033,ONE ASSIST Live Uninterrupted 1 Year Extended Warranty Plan for Electric Iron (Price Range: 2501 to 5000) - Email Delivery...,Warehouse B,88,78,2025-02-28 08:23:00,10
4445,ORD_4446,10948,Madhushoonya Tablet,Warehouse B,76,71,2025-02-28 20:54:00,5
4446,ORD_4447,17601,Fusitop B Cream,Warehouse A,71,57,2025-02-28 04:27:00,14
4447,ORD_4448,14021,Pel 200mg Tablet DT,Warehouse C,17,1,2025-02-28 02:13:00,16
4448,ORD_4449,15601,Mixdose 500mg Capsule,Warehouse C,21,3,2025-02-28 18:47:00,18
4449,ORD_4450,15667,Casio CTX700 61-Key Touch Sensitive Portable Keyboard with Piano tones,Warehouse A,104,91,2025-02-28 09:15:00,13
4450,ORD_4451,30064,T Hexy 2mg Tablet,Warehouse A,45,38,2025-02-28 12:52:00,7
4451,ORD_4452,30182,Ball Tip Roll on - Formiula 1 With 2 cc,Warehouse B,71,54,2025-02-28 03:09:00,17
4452,ORD_4453,16775,"Zebronics Jet PRO Premium Wired Gaming On Ear Headphone with LED for Headband + earcups, 40mm Neodymium Drivers, 2 Meter B...",Warehouse B,43,25,2025-02-28 21:49:00,18
4453,ORD_4454,15720,Ondilex 4mg Tablet MD,Warehouse A,101,88,2025-02-28 10:49:00,13
4454,ORD_4455,16759,Amonit Plus Dry Syrup,Warehouse B,63,56,2025-02-28 10:08:00,7
4455,ORD_4456,598,Sadhev - Brightening Nalpamaradi Tailam 150 Ml,Warehouse A,61,48,2025-02-28 09:39:00,13
4456,ORD_4457,31907,boAt Bassheads 220 Wired in Ear Earphones(Indi Blue),Warehouse C,28,17,2025-02-28 16:10:00,11
4457,ORD_4458,4242,Ketoreno 2% Shampoo,Warehouse A,80,67,2025-02-28 12:21:00,13
4458,ORD_4459,16818,LIDDU Watch Strap Belt for Boat Xtend Smart Watch,Warehouse A,63,57,2025-02-28 22:05:00,6
4459,ORD_4460,31886,5V / 4A VOOC 20W Power Adapter Fast Charging Compatible with RealMe 5 Pro/ 7 Pro/ X2 Pro/ 6/7/ 8/ X3/ 7i/ X/XT & All Other...,Warehouse C,82,69,2025-02-28 06:53:00,13
4460,ORD_4461,15603,"USB C to HDMI Adapter, Aluminum Portable USB C Adapter, Supports 1080p 60Hz, 4K 30Hz, for MacBook Pro, MacBook Air, Pixelb...",Warehouse B,109,93,2025-02-28 01:50:00,16
4461,ORD_4462,16830,"IRONFIX® (Pack of 4) Multipurpose Mobile Holder for Home Wall Charging, Wall Mount Phone Holder, Wall Mobile Charging Hold...",Warehouse C,74,67,2025-02-28 17:19:00,7
4462,ORD_4463,15588,"Ubluker 10k 8k 4k HDMI Cable,Certified 48Gbps 1ms Ultra High Speed HDMI 2.1 Cable 120Hz 144Hz 2k 165Hz 8k 60Hz Dynamic HDR...",Warehouse A,27,20,2025-02-28 05:56:00,7
4463,ORD_4464,17457,Eltram Plus Tablet,Warehouse C,95,81,2025-02-28 16:31:00,14
4464,ORD_4465,12132,Herbal Amla & Reetha Hair Cleanser,Warehouse A,23,9,2025-02-28 17:29:00,14
4465,ORD_4466,16841,"tizum HDMI to VGA Adapter/ Connector/ Converter Cable 1080P (Male to Female) for Media Players, Xbox, Projector, Computer,...",Warehouse C,115,96,2025-02-28 18:23:00,19
4466,ORD_4467,30140,Oilcure Niger Seed Oil,Warehouse A,104,96,2025-02-28 01:51:00,8
4467,ORD_4468,16845,TheGiftKart Back Cover for Samsung M31 / F41 / M31 Prime (Poly Carbonate Polymer | Greyish Blue),Warehouse A,70,56,2025-02-28 16:45:00,14
4468,ORD_4469,12135,Mecodryl M Syrup,Warehouse C,45,33,2025-02-28 21:01:00,12
4469,ORD_4470,15576,Faces Canada Longstay Liquid Matte Lipstick Oh So Berry 05 6 Ml,Warehouse A,27,11,2025-02-28 16:55:00,16
4470,ORD_4471,3900,Mamaearth Retinol Face Serum 30 gm,Warehouse B,16,8,2025-02-28 22:14:00,8
4471,ORD_4472,15545,"Happee Natural UTI Management - Cranberry, Ursolia, D-Mannose, Strawberry Flavour",Warehouse A,32,20,2025-02-28 05:53:00,12
4472,ORD_4473,15536,Nimsco-P 100mg/325mg Tablet,Warehouse B,36,17,2025-02-28 20:13:00,19
4473,ORD_4474,2971,Pegcob M Capsule,Warehouse C,72,62,2025-02-28 16:20:00,10
4474,ORD_4475,36064,Huion H430P OSU Graphics Drawing Tablet with Battery-Free Stylus 4.8x3 inch Working Area 4 Press Keys Support Work from Ho...,Warehouse A,11,2,2025-02-28 16:03:00,9
4475,ORD_4476,2774,Ajmal Vibrant Ether Edt Of 2 & Magnetize Deodorant Pack of 2 450 ml,Warehouse B,76,68,2025-02-28 01:05:00,8
4476,ORD_4477,32060,Blue Heaven Bling Nailpaint 717 (Urban Grey) 8 ml,Warehouse C,96,84,2025-02-28 18:07:00,12
4477,ORD_4478,17472,"GiftMax® Photography LED Video Soft Light Panel, for Studio Photography | Video Recording | Conference | YouTube,2700K-570...",Warehouse C,16,5,2025-02-28 16:45:00,11
4478,ORD_4479,31581,Fruit Face Wash,Warehouse C,60,49,2025-02-28 09:12:00,11
4479,ORD_4480,30751,"Skypearll Universal Wireless Motorcycle Helmet Bluetooth Headset, Speakers Hands-Free, Music Call Control, Mic Earphones, ...",Warehouse C,87,82,2025-02-28 05:18:00,5
4480,ORD_4481,10954,"Fashion Colour Vivid Matte Lipstick, 20 Tomato 3.8 gm",Warehouse B,51,32,2025-02-28 04:31:00,19
4481,ORD_4482,28968,Grosafe O 200mg Tablet,Warehouse C,54,35,2025-02-28 17:02:00,19
4482,ORD_4483,28967,Flormar Kiss Me More Lip Tattoo 02 Creamy 3.8 gm,Warehouse C,98,86,2025-02-28 14:52:00,12
4483,ORD_4484,31360,"L'Oréal Paris Lipstick, Liquid Format with Matte Finish, Oil-In-Water Formula, Breathable and Lightweight Feel, Non-Flakin...",Warehouse B,18,12,2025-02-28 16:07:00,6
4484,ORD_4485,13237,AmazonBasics Stapler with 1000 Staples - Black,Warehouse B,36,27,2025-02-28 00:36:00,9
4485,ORD_4486,31,"Fashion Colour Jersy Girl Kiss Proof No Transfer Lipstick, 17 Iced Amethyst 2 gm",Warehouse C,92,76,2025-02-28 17:57:00,16
4486,ORD_4487,11050,Verymiss 8 To 8 Premium Kajal - 0.30g,Warehouse C,44,39,2025-02-28 11:04:00,5
4487,ORD_4488,13711,Amazon Brand - Solimo Polycarbonate Back Cover for Redmi 9A (Black),Warehouse A,35,28,2025-02-28 19:06:00,7
4488,ORD_4489,14205,Total Repair 5 Serum,Warehouse A,29,13,2025-02-28 17:33:00,16
4489,ORD_4490,3258,Advanced  Hair Fall Control Conditioner,Warehouse C,62,54,2025-02-28 12:32:00,8
4490,ORD_4491,31269,"M.G.R.J® Pro HD+ Tempered Glass Screen Protector Compatible for iPad(6th Gen) Tablet (9.7"" inch) Compatible with iPad 5th ...",Warehouse C,18,13,2025-02-28 22:21:00,5
4491,ORD_4492,120,Infanim Plus 50 mg/125 mg Suspension,Warehouse B,25,10,2025-02-28 07:22:00,15
4492,ORD_4493,31279,ZOUK Jet Blue Printed Handmade Ikkat and Vegan Leather Women's Office Bag for 15.6 inch Laptop with Double Handles - Ikat ...,Warehouse A,82,74,2025-02-28 17:20:00,8
4493,ORD_4494,36967,"boAt Micro USB 550 Stress Resistant, Tangle-Free, Sturdy Cable with 3A Fast Charging & 480mbps Data Transmission, 10000+ B...",Warehouse B,9,1,2025-02-28 20:22:00,8
4494,ORD_4495,31178,"JBL Flip 5 Wireless Portable Bluetooth Speaker, Signature Sound with Powerful Bass Radiator, Vibrant Colors with Rugged Fa...",Warehouse A,32,17,2025-02-28 13:03:00,15
4495,ORD_4496,31565,Abvida M 850mg/50mg Tablet,Warehouse A,75,65,2025-02-28 21:34:00,10
4496,ORD_4497,37036,Panego Plus Tablet,Warehouse C,86,71,2025-02-28 03:56:00,15
4497,ORD_4498,12937,Stbotanica Moroccan Argan Oil Firming & Illuminating Under Eye Serum 25 ml,Warehouse A,22,10,2025-02-28 00:10:00,12
4498,ORD_4499,13683,Herbal Chocolate Lip Balm,Warehouse B,90,84,2025-02-28 21:03:00,6
4499,ORD_4500,13415,SUGAR Cosmetics Smudge Me Not Liquid Lipstick - 11 Greige Rage (Greige Rose) 4.5 ml,Warehouse C,79,63,2025-02-28 19:53:00,16
4500,ORD_4501,11041,Faces Canada Weightless Creme Finish Lipstick Pretty Pink 07 4 Gm,Warehouse A,25,12,2025-02-28 16:34:00,13
4501,ORD_4502,13898,Dolop Plus 325mg/37.5mg Tablet,Warehouse C,34,20,2025-02-28 18:43:00,14
4502,ORD_4503,31399,Glomet 400mg Tablet,Warehouse A,45,27,2025-02-28 02:55:00,18
4503,ORD_4504,13176,Omeus 20mg Capsule,Warehouse B,29,10,2025-02-28 21:57:00,19
4504,ORD_4505,29001,Smart Watch for Men Women ID116 Plus Smart Bracelet Fitness Tracker Color Screen Smartwatch Heart Rate Blood Pressure Pedo...,Warehouse B,97,79,2025-02-28 02:11:00,18
4505,ORD_4506,13400,Fujifilm Instax Mini 11 Instant Camera (Lilac Purple),Warehouse A,12,1,2025-02-28 02:08:00,11
4506,ORD_4507,13500,"VNQ Remote Compatible with Samsung ac, Your Old Remote Must be Same",Warehouse B,26,7,2025-02-28 10:04:00,19
4507,ORD_4508,37069,Sensitex 25mg Tablet,Warehouse C,39,24,2025-02-28 17:51:00,15
4508,ORD_4509,14192,TCL 126 cm (50 inches) 4K Ultra HD Certified Android Smart LED TV 50P615 (Black),Warehouse C,90,76,2025-02-28 22:17:00,14
4509,ORD_4510,13706,POPIO Tempered Glass Screen Protector Compatible for iPhone 12 / iPhone 12 Pro with Case Friendly Edge to Edge Coverage an...,Warehouse A,69,51,2025-02-28 06:42:00,18
4510,ORD_4511,31397,Depot 105 Invigorating Shampoo 50 ml,Warehouse C,111,97,2025-02-28 12:50:00,14
4511,ORD_4512,47,Oxalic 200mg Tablet,Warehouse C,52,35,2025-02-28 22:29:00,17
4512,ORD_4513,13006,"Portronics Auto 18 Car Bluetooth Transmitter/Receiver with Display, Handsfree Calling, Aux in/Out, HD Sound Quality, for C...",Warehouse C,87,71,2025-02-28 05:24:00,16
4513,ORD_4514,17605,Adcef 125mg Tablet DT,Warehouse A,63,54,2025-02-28 09:55:00,9
4514,ORD_4515,107,Mflox O 200mg/500mg Tablet,Warehouse A,85,78,2025-02-28 12:03:00,7
4515,ORD_4516,14013,Cetrafit-M Tablet,Warehouse B,66,48,2025-02-28 15:02:00,18
4516,ORD_4517,35898,Glilar 1mg Tablet,Warehouse B,32,20,2025-02-28 10:27:00,12
4517,ORD_4518,13582,"AGARO 3.5mm Aux Male to Female Extension Cable, Audio Cable with Microphone Gold Plated Jack Nylon Braided for Car, Media ...",Warehouse C,37,23,2025-02-28 23:08:00,14
4518,ORD_4519,11080,Cepotuf 100mg Tablet DT,Warehouse B,26,18,2025-02-28 15:34:00,8
4519,ORD_4520,3285,Dexacort N Eye/Ear Drops,Warehouse B,46,32,2025-02-28 09:30:00,14
4520,ORD_4521,4493,"Tough Lee Tempered Glass Full Screen Guard Protector Coverage for Samsung Galaxy M21 2021 Edition, M21, M31 Prime Edition,...",Warehouse C,103,97,2025-02-28 08:20:00,6
4521,ORD_4522,29054,BP AT 5mg/50mg Tablet,Warehouse B,43,35,2025-02-28 12:15:00,8
4522,ORD_4523,31389,Cedonex 500 mg/500 mg Injection,Warehouse C,72,64,2025-02-28 14:42:00,8
4523,ORD_4524,31315,"Wings Phantom 500 Godlike Wireless Gaming Earbuds,TWS Headphones with LED Battery Indicator, 40ms Low Latency, Bluetooth ...",Warehouse A,66,61,2025-02-28 16:04:00,5
4524,ORD_4525,31219,"ZEB-SD26 256 GB Solid State Drive, TLC, SATA II & SATA III Interface",Warehouse B,97,90,2025-02-28 21:02:00,7
4525,ORD_4526,17495,"Fresh Fruit Massage Cream - With Apple, Orange, Papaya & Kokum Butter",Warehouse B,34,28,2025-02-28 18:40:00,6
4526,ORD_4527,12980,Lorniz 8mg Tablet,Warehouse C,96,82,2025-02-28 04:54:00,14
4527,ORD_4528,14065,Doubledicestore Tempered Glass Screen Protector Compatible for Samsung Galaxy M31 /M21 /M30/ A50S / A50 /A30S /A30/F41 wit...,Warehouse C,56,39,2025-02-28 21:43:00,17
4528,ORD_4529,35861,Dethro 250mg Tablet,Warehouse B,59,40,2025-02-28 15:00:00,19
4529,ORD_4530,36938,Mokcan CV 200mg/28.5mg Tablet DT,Warehouse B,27,20,2025-02-28 22:33:00,7
4530,ORD_4531,29,"Xiaomi Mi Smart Router 4C, 300 Mbps with 4 high-Performance Antenna & App Control, Single_Band, Wi-Fi, White",Warehouse C,20,12,2025-02-28 05:41:00,8
4531,ORD_4532,2746,Ajmal Aurum Raindrops Wisal Deodorant Spray (Pack of 3) 200 ml,Warehouse C,24,17,2025-02-28 23:33:00,7
4532,ORD_4533,29007,Ciaxone S 250mg/125mg Injection,Warehouse B,87,81,2025-02-28 01:30:00,6
4533,ORD_4534,17363,Carbasafe 300mg Tablet,Warehouse B,88,76,2025-02-28 00:54:00,12
4534,ORD_4535,12930,"Wings Phantom 550, Gaming TWS Earbuds, with 45 Hours Playtime, Bluetooth 5.3, Environmental Noise Cancellation, Touch Cont...",Warehouse C,21,7,2025-02-28 23:33:00,14
4535,ORD_4536,30091,Beau Monde Eternal For Women,Warehouse A,31,19,2025-02-28 11:08:00,12
4536,ORD_4537,15651,"Hair Color 87.5 g + 72 ml, 500 Medium Brown + Color Protect Shampoo 175 ml",Warehouse C,86,69,2025-02-28 22:13:00,17
4537,ORD_4538,15645,Leafmet-G2 Tablet SR,Warehouse C,55,42,2025-02-28 18:31:00,13
4538,ORD_4539,15883,Kleral Cream Ai Semi Di Lino 250 ml,Warehouse B,73,60,2025-02-28 21:34:00,13
4539,ORD_4540,15820,"Rousrie NFC Stickers, Rewritable, 144 Bytes Memory, 13.56 MHz ISO 14443A : NFC Type 2 NTAG213 HF RFID NFC Tags Sticker, Pa...",Warehouse B,13,4,2025-02-28 18:29:00,9
4540,ORD_4541,32104,Ventirex-Plus Syrup,Warehouse A,64,51,2025-02-28 22:55:00,13
4541,ORD_4542,15781,Glow Vanilla Lavender Body Polisher,Warehouse A,45,31,2025-02-28 10:44:00,14
4542,ORD_4543,29505,"ClubComfort� Combo of Eyelash Curler, Eyelash Glue and False Eyelashes - Pack of 2) (Set of 3)",Warehouse C,15,7,2025-02-28 02:54:00,8
4543,ORD_4544,590,Anneal 60mg/800mg/5mg Tablet,Warehouse B,76,63,2025-02-28 04:41:00,13
4544,ORD_4545,36395,Etoco 90mg Tablet,Warehouse C,102,92,2025-02-28 05:55:00,10
4545,ORD_4546,15818,"Lenovo Tab M8 (2nd Gen) FHD 20.32 cm (8 inch,3 GB, 32 GB, wi-fi+4G LTE, Voice Calling), Grey",Warehouse A,70,61,2025-02-28 11:09:00,9
4546,ORD_4547,15835,"Veet Pure Hair Removal Cream for Women with No Ammonia Smell, Sensitive Skin - 100 g (Buy 2 Get 1 Free) | Suitable for Leg...",Warehouse A,13,3,2025-02-28 11:25:00,10
4547,ORD_4548,15885,Kadence Wanderer Series ukulele + (Free online learning Course) Brown Mahogany wood Ukulele With Bag,Warehouse C,17,3,2025-02-28 11:12:00,14
4548,ORD_4549,11980,Etoridex MR 60mg/4mg Tablet,Warehouse A,72,59,2025-02-28 17:38:00,13
4549,ORD_4550,31935,Ajmal Avid & Blu Deo & Aretha EDP Pack of 3 20 ml,Warehouse A,29,21,2025-02-28 00:08:00,8
4550,ORD_4551,15876,"(Renewed) Redmi Smart Band Pro SportsWatch- 1.47 Large AMOLED Display, Always On Display, Continuous Sleep, HR, Stress and...",Warehouse C,64,48,2025-02-28 23:48:00,16
4551,ORD_4552,11958,Trutil 250mg Tablet,Warehouse B,78,60,2025-02-28 00:42:00,18
4552,ORD_4553,11954,Rastinon 500mg Tablet,Warehouse A,33,26,2025-02-28 12:39:00,7
4553,ORD_4554,4014,HP 802 2-Pack Small Black/Tri-Color Original Ink Cartridges,Warehouse C,100,84,2025-02-28 17:32:00,16
4554,ORD_4555,16044,Tukzer Universal Replacement Disc Tips Precision Round Shape Replaceable Stylus Pen Disc Tips for Touch Screen Devices – (...,Warehouse B,109,90,2025-02-28 20:34:00,19
4555,ORD_4556,16607,Natural Damaged Repair Hair Mask,Warehouse C,73,58,2025-02-28 05:38:00,15
4556,ORD_4557,11681,Night Repair Cream,Warehouse B,64,51,2025-02-28 05:01:00,13
4557,ORD_4558,29725,"Portronics Ruffpad 8.5E Re-Writable LCD Writing Pad with Screen 21.5cm (8.5-inch) for Drawing, Playing, Handwriting Gifts ...",Warehouse A,77,58,2025-02-28 13:32:00,19
4558,ORD_4559,16295,Movibon 500mg Tablet,Warehouse A,77,72,2025-02-28 17:05:00,5
4559,ORD_4560,32067,Makeup Revolution Power Fix Mist 50 ml,Warehouse C,63,49,2025-02-28 19:18:00,14
4560,ORD_4561,16345,"Amazon Basics LED Ring Light (14-inch) with Tripod Stand & Mini Tripod, and Dual Temperature Modes",Warehouse C,86,80,2025-02-28 03:58:00,6
4561,ORD_4562,16347,Rabevib L Capsule SR,Warehouse A,103,86,2025-02-28 08:43:00,17
4562,ORD_4563,32065,LINQS® Original NXP Chip | Waterproof NFC Tag Sticker (Set of 5) | Smartrac Circus NTAG213 chip | for All NFC Phones | Vin...,Warehouse A,30,13,2025-02-28 11:37:00,17
4563,ORD_4564,29619,Venirate AR 60mg Injection,Warehouse C,21,7,2025-02-28 13:55:00,14
4564,ORD_4565,449,"ZEBRONICS Zeb-Sound Bomb N1 True Wireless In Ear Earbuds with ENC, Gaming Mode (up to 50ms), up to 18H Playback, Bluetooth...",Warehouse C,108,91,2025-02-28 05:44:00,17
4565,ORD_4566,36226,Cold Processed Sandalwood Geranium Hair Cleansing Bar,Warehouse B,22,10,2025-02-28 04:36:00,12
4566,ORD_4567,12029,Epodox 50mg Dry Syrup,Warehouse B,40,25,2025-02-28 03:52:00,15
4567,ORD_4568,4224,Metoprax 25mg Tablet,Warehouse C,67,50,2025-02-28 17:30:00,17
4568,ORD_4569,15632,"Blue Heaven Matte Bb Cream, Honey - Medium, 301, 30 Gm",Warehouse A,26,14,2025-02-28 14:50:00,12
4569,ORD_4570,11208,Cazin-MD 2 Tablet,Warehouse A,8,1,2025-02-28 04:07:00,7
4570,ORD_4571,183,U Rab DSR 30mg/20mg Capsule,Warehouse A,34,29,2025-02-28 21:16:00,5
4571,ORD_4572,14544,Sunkizzrs® Hook & Loop Tape Roll Strips with Adhesive Back Mounting Tape for Picture and Tools Hanging Pedal Board Fasteni...,Warehouse B,107,99,2025-02-28 19:51:00,8
4572,ORD_4573,11200,Lullimend Cream,Warehouse C,10,4,2025-02-28 07:39:00,6
4573,ORD_4574,36794,JXL 1690 High Performance 3 Way 6 Inch Coaxial Car Speaker with Inbuilt PEI Car Tweeter and HOP Woofer 600W MAX Pair (Black),Warehouse C,16,5,2025-02-28 01:37:00,11
4574,ORD_4575,5527,CO Symoxyl 250mg/125mg Tablet,Warehouse A,87,74,2025-02-28 13:04:00,13
4575,ORD_4576,14521,Ajmal Aristocrat EDP Citrus Woody Perfume 75ml for Men and Cento EDP Citrus Aromatic Perfume 100ml for Men +1 Perfume Test...,Warehouse C,54,46,2025-02-28 23:06:00,8
4576,ORD_4577,30787,Three Secondz Combo of 5 Teeka Stamp Spiritual Forehead Teeka Tilak Applicator/Stamp Tool Puja for Daily Usage and Occasio...,Warehouse C,97,86,2025-02-28 12:39:00,11
4577,ORD_4578,30789,Eriof OZ Oral Suspension,Warehouse C,43,38,2025-02-28 23:57:00,5
4578,ORD_4579,14514,"Globus Naturals Crack Cream for Dry Cracked Heels & Feet Enriched with Aloevera, Neem, Anantmool 50g",Warehouse A,79,62,2025-02-28 07:04:00,17
4579,ORD_4580,14510,CEDO Samsung F62 Back Cover | Matte Soft Silicon Flexible | Camera Bump Protection | All Side Shock Proof Rubberised Back ...,Warehouse B,53,46,2025-02-28 22:41:00,7
4580,ORD_4581,12720,Flormar Compact Powder 102 Almond 11 gm,Warehouse C,94,80,2025-02-28 18:32:00,14
4581,ORD_4582,31802,UrbanBotanics® Oil Free Moisturizer For Face - Mattifying Moisturiser Face Cream for Oily/Acne Prone/Normal Skin - with Ne...,Warehouse A,37,24,2025-02-28 03:11:00,13
4582,ORD_4583,14208,Sri Sri Tattva Sudanta Tooth Tablet 60's,Warehouse B,102,89,2025-02-28 15:57:00,13
4583,ORD_4584,16621,Medfloxa 200mg Tablet,Warehouse B,20,1,2025-02-28 08:31:00,19
4584,ORD_4585,15961,BabyChakra Tummy Relief Roll on 40 gm,Warehouse A,90,77,2025-02-28 22:06:00,13
4585,ORD_4586,31945,"Pentonic Linc Ball Point Pen Blister Pack | 0.7 mm | Smooth Writing, Ultra- Low Viscosity Ink | Sleek Matte Finish | Black...",Warehouse B,59,53,2025-02-28 08:52:00,6
4586,ORD_4587,4022,Sassoon BIS Approved N95 Face Masks (Multi colored)- Anti Pollution Cotton Reusable & Washable Mask with 6 Layer Protectio...,Warehouse A,23,9,2025-02-28 15:28:00,14
4587,ORD_4588,16646,"Motorola G32 (4GB, 64GB) (Mineral Gray)",Warehouse B,94,82,2025-02-28 23:10:00,12
4588,ORD_4589,4034,"Doodle Initial S Premium Soft Bound Notebook Diary for Girls and Women (B6,192 Theme Based Ruled Pages, 80 GSM) Floral Design",Warehouse B,20,14,2025-02-28 09:53:00,6
4589,ORD_4590,11911,Khadi Essentials Phuhaar Body Cleanser - Mixed Herbs & Spices 200 ml,Warehouse B,30,24,2025-02-28 08:52:00,6
4590,ORD_4591,11898,Tazoter 4000 mg/500 mg Injection,Warehouse A,36,29,2025-02-28 14:27:00,7
4591,ORD_4592,15982,"iTronix Charger Cable for Amazfit GTS 4 Mini, GTS 2, GTS 2 Mini, GTS 2e, GTR 2, GTR 2e, Bip U, Bip 3, Bip 3 Pro, T-Rex Pr...",Warehouse B,107,90,2025-02-28 14:22:00,17
4592,ORD_4593,32074,Ajmal Aurum Blu Sacrifice II Deodorant Spray (Pack of 3) 200 ml,Warehouse C,52,43,2025-02-28 15:37:00,9
4593,ORD_4594,36345,"boAt Rockerz 335 Bluetooth Wireless in Ear Earphones with Qualcomm Aptx & CVC, Upto 30 Hours Playback, ASAP Charge, Signat...",Warehouse B,10,4,2025-02-28 20:55:00,6
4594,ORD_4595,11875,Romithrax 50mg Tablet,Warehouse B,47,28,2025-02-28 02:22:00,19
4595,ORD_4596,16403,Sindoor Powder,Warehouse A,9,2,2025-02-28 14:05:00,7
4596,ORD_4597,29656,Stazol 50 Injection,Warehouse C,114,96,2025-02-28 13:45:00,18
4597,ORD_4598,4185,Chemoliv T 100000AU Tablet,Warehouse B,52,38,2025-02-28 07:28:00,14
4598,ORD_4599,306,Prosto-8 Ras,Warehouse A,28,21,2025-02-28 17:09:00,7
4599,ORD_4600,30204,"Belkin Apple Certified Lightning to Type C Cable, Tough Unbreakable Braided Fast Charging for iPhone, iPad, Air Pods, 3.3 ...",Warehouse B,97,86,2025-02-28 13:51:00,11
4600,ORD_4601,3876,"DIGITEK® (DLS-006FT) Lightweight & Portable Aluminum Alloy Light Stand for Ring Light, Reflector, Flash Units, Diffuser, P...",Warehouse C,40,33,2025-02-28 10:04:00,7
4601,ORD_4602,31854,"ZEBRONICS SD13 128GB SSD,Ultra Low Power Consumption, S.M.A.R.T. Thermal Management and Silent Operation.",Warehouse A,19,5,2025-02-28 20:51:00,14
4602,ORD_4603,15482,AGARO 5.4 A USB Dual Port Quick Car Charger (Qualcomm Certified) for All Smartphones & Tablets - Grey,Warehouse C,79,68,2025-02-28 21:38:00,11
4603,ORD_4604,4295,SoloWIT Professional Headphones Ear Pads Cushions Replacement - Earpads Compatible with Bose Quietcomfort 15 Qc15 Qc25 Qc2...,Warehouse A,51,36,2025-02-28 00:11:00,15
4604,ORD_4605,11378,Electomania® Set of 4Pcs Eyeshadow Blending Pencil Brush For Cosmetic Foundation Powder Blush Eyeshadow Kabuki Blending Ma...,Warehouse B,33,23,2025-02-28 07:54:00,10
4605,ORD_4606,12040,Revlon Matte Balm - Striking 2.7 Gm,Warehouse C,22,15,2025-02-28 20:03:00,7
4606,ORD_4607,32140,Tough Lee Tempered Glass Screen Guard Protector for Redmi Note 11SE / 11 SE/Mi Redmi Note 11 / Redmi Note 11s / Redmi Note...,Warehouse A,61,53,2025-02-28 22:49:00,8
4607,ORD_4608,31807,"The Body Shop Moringa Body Mist, 100ml",Warehouse A,93,79,2025-02-28 22:01:00,14
4608,ORD_4609,300,Topovate NM Cream,Warehouse B,24,11,2025-02-28 09:54:00,13
4609,ORD_4610,3815,Allure Small Powder Brush - (101) 1's,Warehouse B,107,97,2025-02-28 22:29:00,10
4610,ORD_4611,29376,Esgerd IV 40mg Injection,Warehouse C,19,13,2025-02-28 21:36:00,6
4611,ORD_4612,3835,Sanitary Pads - Choice Wings,Warehouse B,24,5,2025-02-28 17:48:00,19
4612,ORD_4613,29647,Fire TV Stick with Alexa Voice Remote (includes TV and app controls) | HD streaming device,Warehouse A,74,64,2025-02-28 01:55:00,10
4613,ORD_4614,30294,Gentleman - Urbane Compact Perfume,Warehouse C,58,43,2025-02-28 15:02:00,15
4614,ORD_4615,2994,Winbp CT 40/12.5 Tablet,Warehouse B,56,48,2025-02-28 20:23:00,8
4615,ORD_4616,310,"Swiss Beauty Clay Mask Brush for Face with Wooden Handle, Pack of 1",Warehouse B,77,66,2025-02-28 11:02:00,11
4616,ORD_4617,12284,Gemblue Biocare Apple Cider Gel 500 ml,Warehouse C,108,91,2025-02-28 21:09:00,17
4617,ORD_4618,30278,Azilcad 40mg Tablet,Warehouse B,79,65,2025-02-28 18:33:00,14
4618,ORD_4619,36538,Excellence Creme Hair Color 172 gm + Color Protect Shampoo 175 ml,Warehouse A,45,38,2025-02-28 06:52:00,7
4619,ORD_4620,16915,Bhringraj Multi-Vitaliser Hair Oil,Warehouse B,47,38,2025-02-28 12:11:00,9
4620,ORD_4621,36534,Esotric LS 75mg/40mg Capsule SR,Warehouse C,12,2,2025-02-28 19:46:00,10
4621,ORD_4622,338,Quench Botanics Mama Cica Rejuvenating Face Mist 100 ml,Warehouse B,70,55,2025-02-28 18:40:00,15
4622,ORD_4623,30191,Medibal 500mcg Injection,Warehouse B,99,80,2025-02-28 04:04:00,19
4623,ORD_4624,36485,Lxvor 5 Tablet,Warehouse C,29,13,2025-02-28 14:25:00,16
4624,ORD_4625,11452,Amozo Back Case Cover for iPhone 12 Mini 5.4 (Polycarbonate | Transparent),Warehouse A,74,63,2025-02-28 12:25:00,11
4625,ORD_4626,3927,Panther 40mg Tablet,Warehouse A,67,49,2025-02-28 09:50:00,18
4626,ORD_4627,15461,"Pears Pure & Gentle Original Body Wash With Glycerin,Dermatogically Tested, 100% Soap Free Shower gel,Imported,750 ml (Fre...",Warehouse C,42,37,2025-02-28 19:02:00,5
4627,ORD_4628,16896,PureSense Macadamia Reviving Face Serum 30ml,Warehouse A,47,36,2025-02-28 16:33:00,11
4628,ORD_4629,2983,Dobicin 10mg Injection,Warehouse B,28,13,2025-02-28 08:27:00,15
4629,ORD_4630,11618,Natural Protein Hair Serum,Warehouse C,26,9,2025-02-28 10:46:00,17
4630,ORD_4631,4131,LRIPL Mi Remote Control with Netflix & Prime Video Button Compatible for Mi 4X LED Android Smart TV 4A Remote Control (3...,Warehouse B,66,56,2025-02-28 05:41:00,10
4631,ORD_4632,2868,Cocoryl 2mg/10mg Tablet,Warehouse B,61,51,2025-02-28 01:26:00,10
4632,ORD_4633,29744,Flunif 10mg Tablet,Warehouse A,56,48,2025-02-28 14:04:00,8
4633,ORD_4634,11740,Urbanmade Mouse Pad Large Office Table Accessories Desk Mat Large Gaming Mouse Pad Desk Accessories Extended Mouse Pad Gam...,Warehouse A,18,7,2025-02-28 19:37:00,11
4634,ORD_4635,16237,Melgain Decapeptide Stimulates Pigmentation Lotion 10 ml,Warehouse B,17,7,2025-02-28 18:23:00,10
4635,ORD_4636,4105,ACM Watch Strap Stainless Steel Metal 22mm compatible with Fire Boltt Invincible Smartwatch Belt Luxury Band,Warehouse A,37,23,2025-02-28 02:11:00,14
4636,ORD_4637,2882,Portronics Adapto ONE POR-1103 3A Fast Charging Adapter with 1M Type-C Cable (Black),Warehouse A,82,72,2025-02-28 18:29:00,10
4637,ORD_4638,29780,"Face Mask - Pro Tech 95, 6 layered, Large, MK18004",Warehouse C,106,89,2025-02-28 15:04:00,17
4638,ORD_4639,4094,Ostigard 200mg/50mg Capsule,Warehouse A,10,5,2025-02-28 02:58:00,5
4639,ORD_4640,458,Caseology Vault Case Compatible with Samsung Galaxy Buds 2 - Matte Black,Warehouse A,9,1,2025-02-28 23:47:00,8
4640,ORD_4641,457,Amazon Brand - Solimo Silicone Basic Case for Samsung Galaxy Note 10 Lite (Transparent),Warehouse C,16,9,2025-02-28 19:11:00,7
4641,ORD_4642,29583,Lenphor I Craze Eye Liner Sculpting Black 1.7 Ml,Warehouse A,25,9,2025-02-28 17:59:00,16
4642,ORD_4643,455,FAMEZA Face Cleansing Sponge Puff Makeup Washing Pad Deep Cleansing & Exfoliating Facial Sponge - Assorted Color Pack of 2,Warehouse B,39,28,2025-02-28 14:19:00,11
4643,ORD_4644,11803,"Regal toy's,Charger.12V Kid's Powered Universal Charger with Charging Indicator Light-for a Variety of Electric Kid's Batt...",Warehouse C,46,30,2025-02-28 06:43:00,16
4644,ORD_4645,4082,"ACESHLEY 19mm Soft Silicone Smartwatch Strap/Band with Black Metal Buckle Strap for Noise ColorFit Pulse, Noise ColorFit P...",Warehouse C,68,63,2025-02-28 19:42:00,5
4645,ORD_4646,2901,Gatil 200mg Tablet,Warehouse B,55,41,2025-02-28 13:46:00,14
4646,ORD_4647,29829,Gxdium 0.65% Nasal Drops,Warehouse B,92,86,2025-02-28 21:45:00,6
4647,ORD_4648,15776,Flormar Full Color Nail Enamel FC19 Gotta Get Tanned 8 ml,Warehouse B,110,92,2025-02-28 05:09:00,18
4648,ORD_4649,15743,TheGiftKart Sleek Back Cover Case for iPhone XR | Slim Fit Protective Design | Ultra Matte Finish | Camera Protection Bump...,Warehouse A,41,26,2025-02-28 08:58:00,15
4649,ORD_4650,29406,OnePlus Type C to 3.5 mm Jack Audio Connector Noise Cancelling Headphones Jack Converter Splitter Audio Adapter for One Pl...,Warehouse A,50,43,2025-02-28 18:07:00,7
4650,ORD_4651,12259,Nozof 0.1% Nasal Drops,Warehouse A,20,13,2025-02-28 15:04:00,7
4651,ORD_4652,31841,Vega Luxury Flower Sponge (BA - 3/5) 76 gm,Warehouse C,107,92,2025-02-28 00:32:00,15
4652,ORD_4653,12231,TheGiftKart Back Cover Soft Case for Samsung Galaxy S22 5G | Best Camera Protection | Inbuilt Dust Plugs & Anti-Slip Grip...,Warehouse C,24,16,2025-02-28 21:41:00,8
4653,ORD_4654,29416,Citograph 5mg Tablet,Warehouse A,96,78,2025-02-28 09:02:00,18
4654,ORD_4655,10669,Ra HQ 400mg Tablet,Warehouse C,88,72,2025-02-28 12:48:00,16
4655,ORD_4656,23942,Stalia 500 Tablet,Warehouse B,75,56,2025-02-28 02:11:00,19
4656,ORD_4657,6933,Olanz 5mg Tablet,Warehouse B,27,15,2025-02-28 20:45:00,12
4657,ORD_4658,25925,"ABOUTTHEFIT Keyboard Case for Samsung Galaxy Tab S6 Lite 10.4'' 2020 Model Sm-P610 (Wi-Fi) Sm-P615 (LTE), Slim Stand Cover...",Warehouse B,71,63,2025-02-28 11:22:00,8
4658,ORD_4659,10826,Trimtee 10 Tablet,Warehouse C,41,22,2025-02-28 21:54:00,19
4659,ORD_4660,9405,"Beauty Tool Sendhuram Paste Orange sindoor Paste - 100% Chemical Free, All Natural, No Lead, No Mercury, No Parabens, Wate...",Warehouse C,100,95,2025-02-28 10:48:00,5
4660,ORD_4661,6923,Vega Flat Brush (R8 - FB) 87 gm,Warehouse B,107,93,2025-02-28 02:58:00,14
4661,ORD_4662,26492,Sanfe Back & Bum Acne Clearing Lotion with Shea Butter & Peach extracts for healing Bum acne & crusty skin - 100ml | Deepl...,Warehouse B,77,70,2025-02-28 02:51:00,7
4662,ORD_4663,8571,Rabenox 20mg Tablet,Warehouse B,33,27,2025-02-28 07:51:00,6
4663,ORD_4664,28852,Spigen Ultra Hybrid Magfit Back Cover Case Compatible with MagSafe Designed for iPhone 14 Pro (TPU + Poly Carbonate | White),Warehouse C,97,78,2025-02-28 00:38:00,19
4664,ORD_4665,6829,Robustrion Smart Trifold Hard Back Flip Stand Case Cover for Samsung Galaxy Tab A8 10.5 inch(265m) [SM-X200/X205/X207] 202...,Warehouse A,14,9,2025-02-28 02:35:00,5
4665,ORD_4666,5896,Astapod 200mg Tablet,Warehouse A,80,69,2025-02-28 05:53:00,11
4666,ORD_4667,10808,SUPER TOY 8.5 Inch LCD Writing Tablet E-Notepad Ruff Pad (Multicolor),Warehouse C,79,64,2025-02-28 21:12:00,15
4667,ORD_4668,27380,Matra Pure & Natural Oil - Castor 200 ml,Warehouse C,47,35,2025-02-28 21:01:00,12
4668,ORD_4669,27378,Fogg Fresh Fougere Deo 120 Ml,Warehouse C,64,48,2025-02-28 00:04:00,16
4669,ORD_4670,17852,Migace-PR Capsule SR,Warehouse C,34,29,2025-02-28 18:27:00,5
4670,ORD_4671,20341,Stbotanica Bulgarian Rose Otto Glow Cleansing Milk Soothes & Cleanses No Paraben & Sls 150 ml,Warehouse C,29,17,2025-02-28 10:35:00,12
4671,ORD_4672,26507,Winble Silicone Back Cover for OnePlus Nord CE 2 5G Back Cover Camera Protection Soft Silicon Protective Back Cover Design...,Warehouse C,24,8,2025-02-28 19:59:00,16
4672,ORD_4673,17834,Justdor 25mg Injection,Warehouse B,27,16,2025-02-28 03:44:00,11
4673,ORD_4674,2005,DeBelle Gel Nail Lacquer Yellow Topaz Mustard Yellow Nail Polish 8 ml,Warehouse A,29,13,2025-02-28 17:16:00,16
4674,ORD_4675,24585,Detan + Whiteglow Moisturising Body Lotion SPF 30 PA+++,Warehouse C,86,78,2025-02-28 03:49:00,8
4675,ORD_4676,7951,"WishCare Brow & Lash Growth Serum - EyeBrow & Eyelash Growth Oil Serum With Castor Oil, Almond Oil & Vitamin E - 30ml",Warehouse B,64,49,2025-02-28 12:58:00,15
4676,ORD_4677,17818,Neutolen P 500mg/800mg Tablet,Warehouse A,79,68,2025-02-28 13:11:00,11
4677,ORD_4678,34448,Apple Cider Vinegar Shaving Foam,Warehouse C,82,64,2025-02-28 12:23:00,18
4678,ORD_4679,22731,Day 5 500mg Tablet,Warehouse B,68,53,2025-02-28 07:28:00,15
4679,ORD_4680,2708,Azcort Oral Suspension,Warehouse C,88,80,2025-02-28 15:59:00,8
4680,ORD_4681,4603,"Swiss Beauty The Tropics I 10-Color Shadows Palette, Eye Makeup, Multicolor-1, 10G",Warehouse C,77,69,2025-02-28 04:19:00,8
4681,ORD_4682,1238,Revlon ColorSilk Hair Color with Keratin - 4N Medium BrowN 91.8 ML,Warehouse A,113,95,2025-02-28 19:32:00,18
4682,ORD_4683,33607,Haldotram 50mg Injection,Warehouse B,71,64,2025-02-28 14:19:00,7
4683,ORD_4684,32299,"AmazonBasics Laptop Sleeve Case Cover Pouch for 13-inches, 13.3-inches Laptop for Men and Women | Slim Profile Neoprene, S...",Warehouse B,66,53,2025-02-28 14:20:00,13
4684,ORD_4685,25889,Saco Silicone Skin Keyboard Cover Compatible for HP Pavilion Power 15-cb518TX 15.6-inch Full HD Gaming Laptop - Black,Warehouse C,69,53,2025-02-28 15:33:00,16
4685,ORD_4686,2718,Cucid ES 40mg Injection,Warehouse C,90,83,2025-02-28 06:25:00,7
4686,ORD_4687,33472,"AmazonBasics USB A to Lightning PVC Molded Nylon MFi Certified Charging Cable for Tablet, Personal Computer, Smartphone (B...",Warehouse B,39,34,2025-02-28 07:18:00,5
4687,ORD_4688,24169,Chambor Silver Shadow - Ocher Rr10 32 gm,Warehouse A,81,72,2025-02-28 18:53:00,9
4688,ORD_4689,7200,Ajmal Distraction And Magnetize For Men & Women And Avid Deodorants Pack of 3 200 ml,Warehouse B,79,64,2025-02-28 23:21:00,15
4689,ORD_4690,19972,"SaleOn™ Portable Storage Organizer Bag for Earphone USB Cable Power Bank Mobile Charger Digital Gadget Hard Disk, Water Re...",Warehouse C,22,11,2025-02-28 21:02:00,11
4690,ORD_4691,9556,Serflam FC Tablet,Warehouse A,79,63,2025-02-28 07:55:00,16
4691,ORD_4692,948,"ESR HaloLock Vegan Leather Wallet Stand, MagSafe Wallet and Adjustable Stand, Compatible with iPhone 14/14 Plus/14 Pro/14 ...",Warehouse A,13,4,2025-02-28 20:21:00,9
4692,ORD_4693,32422,Flupiz 100mg Capsule,Warehouse C,98,86,2025-02-28 22:06:00,12
4693,ORD_4694,10461,Full Coverage Natural Concealer Makeup for Women Eye Dark Circles,Warehouse A,66,58,2025-02-28 17:06:00,8
4694,ORD_4695,34395,Ocurax 200mg Tablet,Warehouse C,12,2,2025-02-28 21:06:00,10
4695,ORD_4696,6670,Cesef S 1000mg/500mg Injection,Warehouse C,44,30,2025-02-28 16:26:00,14
4696,ORD_4697,19952,L.A Girl HD PRO Conceal Mahogany 8 gm,Warehouse C,60,53,2025-02-28 09:47:00,7
4697,ORD_4698,10474,"FABify 10 Pair False Eyelash, 2 Eyelash Glue + 1 Eyelash Curler(Eye Combo)",Warehouse C,23,7,2025-02-28 17:21:00,16
4698,ORD_4699,24828,TheGiftKart Ultra-Hybrid Crystal Clear Back Cover Case for iPhone 14 PRO | Slim Fit Shockproof Design | Camera Protection ...,Warehouse A,61,52,2025-02-28 21:47:00,9
4699,ORD_4700,9547,"ZURATO 10X Handheld Reading Magnifier Loupe Glasses 10X with Rosewood Handle for Book and Newspaper Reading, Insect and Ho...",Warehouse A,55,37,2025-02-28 00:04:00,18
4700,ORD_4701,33755,Curexime 200mg Tablet,Warehouse C,90,79,2025-02-28 18:00:00,11
4701,ORD_4702,21450,Viscowell MR 250mg/50mg/325mg Tablet,Warehouse A,40,30,2025-02-28 20:23:00,10
4702,ORD_4703,26589,"Mi Robot Vacuum-Mop P, Best-in-class Laser Navigation in 10-20K INR price band, Intelligent mapping, Robotic Floor Cleaner...",Warehouse C,98,87,2025-02-28 07:52:00,11
4703,ORD_4704,24408,Clomfert 50mg Tablet,Warehouse A,91,78,2025-02-28 21:09:00,13
4704,ORD_4705,35647,Vibez by Lifelong Haile Smartwatch For Men with HD Display|24x7 Heart Rate & Blood Oxygen Tracking|24 Sports Mode|Sleep Mo...,Warehouse A,91,76,2025-02-28 23:36:00,15
4705,ORD_4706,2001,"Brother DCP-T525W - Wi-Fi Color Ink Tank Multifunction (Print, Scan & Copy) All in One Printer for Home & Office",Warehouse C,55,45,2025-02-28 22:13:00,10
4706,ORD_4707,17803,M.G.R.J® Tempered Glass Screen Protector for Fossil Gen 5E (42mm / 44mm) (Men & Women) (Pack of 2),Warehouse A,34,17,2025-02-28 21:10:00,17
4707,ORD_4708,8016,Pre-Waxing Gel - Lemon,Warehouse C,109,90,2025-02-28 05:17:00,19
4708,ORD_4709,1697,Syga Focus F-1 Anti-Slip Quick Rapid Shoulder Sling Belt Neck Strap for Camera SLR DSLR Black,Warehouse B,42,33,2025-02-28 04:43:00,9
4709,ORD_4710,9416,Foot Spray,Warehouse B,22,6,2025-02-28 11:36:00,16
4710,ORD_4711,24631,Fast Charger Compatible for Mi Xiaomi Redmi Mi 9/9A/9i/4/4A/5/5A/6A/6 Pro/7 | Smartphone Mobile | Wall | Travel | Adapter/...,Warehouse C,71,55,2025-02-28 14:20:00,16
4711,ORD_4712,805,"Sapthamruth Lauha - Eye Care, 300mg",Warehouse C,100,85,2025-02-28 12:05:00,15
4712,ORD_4713,21800,Spigen Liquid Air Back Cover Case for iPhone Xs | iPhone X (TPU | Matte Black),Warehouse B,48,34,2025-02-28 04:24:00,14
4713,ORD_4714,26428,L'Oreal Paris 6 Oil Nourish Conditioner 192.5 ml,Warehouse A,48,29,2025-02-28 06:50:00,19
4714,ORD_4715,28669,"RE' EQUIL Oil Control Anti Acne Face Wash for Oily, Sensitive and Acne Prone Skin - 200ml, Sulphate Free, Soap Free",Warehouse C,102,95,2025-02-28 03:53:00,7
4715,ORD_4716,34948,Atulya Aloe Vera Soap 125 gm,Warehouse C,79,70,2025-02-28 23:56:00,9
4716,ORD_4717,33558,Montevit-LC Tablet,Warehouse B,94,88,2025-02-28 04:01:00,6
4717,ORD_4718,6893,"Lenovo 15.6"" Professional Backpack, Made in India, Water-resistant,Uncompromised storage, Travel friendly:Fleece-lined PC ...",Warehouse C,99,89,2025-02-28 03:39:00,10
4718,ORD_4719,17707,"Parker Vector GT Fountain Pen, Matte Black",Warehouse C,101,91,2025-02-28 07:18:00,10
4719,ORD_4720,34446,"Blue Heaven Hypergel Nailpaint -Rocking Raisin, 724 11 ml",Warehouse B,102,90,2025-02-28 13:53:00,12
4720,ORD_4721,17883,Lenovo Casual Laptop Briefcase T210 (Toploader) 39.62 cm (15.6-inch) Water Repellent Grey,Warehouse A,28,9,2025-02-28 10:09:00,19
4721,ORD_4722,9303,AmazonBasics D Cell Everyday Alkaline Batteries (12-Pack),Warehouse C,106,92,2025-02-28 18:53:00,14
4722,ORD_4723,22720,Flormar Full Color Nail Enamel FC12 Love is Blushing 8 ml,Warehouse C,58,42,2025-02-28 07:55:00,16
4723,ORD_4724,20438,Nik case Silicon Cover for Realme Buds Air Pro/Air 2 (Soft|Silicon|Black),Warehouse B,52,38,2025-02-28 20:19:00,14
4724,ORD_4725,5490,Smashtronics - Spiral Cable Protector Wire Protector for All Charging able Cover Set of 3 (12 Pieces),Warehouse A,19,13,2025-02-28 04:06:00,6
4725,ORD_4726,20084,"Kids Toothpaste - 6+ Years, Strawberry Flavour, Barbie",Warehouse B,20,11,2025-02-28 16:40:00,9
4726,ORD_4727,24456,Zacrol TP 4mg/100mg/325mg Tablet,Warehouse B,80,75,2025-02-28 14:53:00,5
4727,ORD_4728,20086,TABLE MAGIC Multipurpose Laptop Table Mat Finish Top PP Steel Metal 52.5 * 40 * 73cm 6 Heights 3 Angles Adjustable Foldabl...,Warehouse B,87,70,2025-02-28 07:15:00,17
4728,ORD_4729,22701,Nutriment Chocolate Cream All skin Type 250 gm,Warehouse C,82,73,2025-02-28 14:43:00,9
4729,ORD_4730,7919,Onsitego 1 Year Extended Warranty for Small Household Appliances from Rs. 1-500 (Email Delivery - No Physical Kit),Warehouse B,29,15,2025-02-28 15:41:00,14
4730,ORD_4731,17736,Clopigal 75 Tablet,Warehouse C,17,7,2025-02-28 14:43:00,10
4731,ORD_4732,10657,iPhone Original 20W C Type Fast PD Charger Compatible with I-Phone13/13 mini/13pro/13 pro Max I-Phone 12/12 Pro/12mini/12 ...,Warehouse C,88,77,2025-02-28 07:04:00,11
4732,ORD_4733,18075,Miss Rose Matte Smudge Proof LipGloss 7701 - 002M 10,Warehouse C,87,71,2025-02-28 18:16:00,16
4733,ORD_4734,1188,Rabilast Capsule,Warehouse C,53,39,2025-02-28 09:52:00,14
4734,ORD_4735,6245,Galoxin OZ 50mg/5ml/125mg/5ml Suspension,Warehouse A,14,7,2025-02-28 06:37:00,7
4735,ORD_4736,2685,Rabikon 20mg Tablet,Warehouse A,84,66,2025-02-28 07:47:00,18
4736,ORD_4737,18067,EVM 8GB DDR3 1333MHz Long-DIMM Desktop Memory Ram (EVMT8G1333U86P),Warehouse C,38,22,2025-02-28 00:15:00,16
4737,ORD_4738,18064,"Kimirica Pharmacopia Travel Care Luxury Bath and Body Care Gift Pouch - Shower Gel, Shampoo, Conditioner, Body Lotion and ...",Warehouse A,27,11,2025-02-28 10:47:00,16
4738,ORD_4739,26549,Omkair 20mg Capsule,Warehouse B,91,80,2025-02-28 16:13:00,11
4739,ORD_4740,26365,Kilake Plus 100mg/325mg Tablet,Warehouse B,24,11,2025-02-28 11:08:00,13
4740,ORD_4741,22699,Lacryl Forte Eye Drop,Warehouse C,92,86,2025-02-28 21:52:00,6
4741,ORD_4742,24418,"Cosluxe Professional 8 in 1 Makeup Sponge Multicolour , Cotton Pad Applicator Foundation Makeup Blender Powder Buff Sponge...",Warehouse B,53,40,2025-02-28 21:38:00,13
4742,ORD_4743,18123,"Ajanta Abstract Metal Quartz Wall Clock (32 cm x 32 cm x 3.5 cm, White)",Warehouse A,75,64,2025-02-28 04:10:00,11
4743,ORD_4744,24382,"Pond's White Beauty BB+ Fairness Cream 01 Original, 18 g And Lakme Absolute Perfect Radiance Skin Brightening Day Creme, L...",Warehouse A,68,55,2025-02-28 08:00:00,13
4744,ORD_4745,24687,"Saregama Carvaan Premium Hindi - Portable Music Player with 5000 Preloaded Songs, FM/BT/AUX  (Royal Blue)",Warehouse C,47,31,2025-02-28 14:16:00,16
4745,ORD_4746,34453,"Fashion Colour 4 - In - 1 Perfect Match, Shade 01 7 gm",Warehouse C,84,70,2025-02-28 17:15:00,14
4746,ORD_4747,24729,Entirety Salisia KT Anti-Dandruff Shampoo (75 ml) - Pack of 2,Warehouse C,97,86,2025-02-28 00:30:00,11
4747,ORD_4748,10921,"CASEOLOGY by Spigen Parallax TPU, PC Back Cover Compatible for Samsung Galaxy S22 Ultra (Burgundy)",Warehouse B,30,13,2025-02-28 01:38:00,17
4748,ORD_4749,24734,Cefipal O 200mg/200mg Tablet,Warehouse A,99,93,2025-02-28 17:36:00,6
4749,ORD_4750,34473,Ceticare Plus-DS Oral Suspension,Warehouse C,23,13,2025-02-28 22:20:00,10
4750,ORD_4751,33571,"Insight Non Transfer Lip Color, 4ml (19 Dive) & Insight Non Transfer Lip Color, 4ml (22 Autumn)",Warehouse C,42,32,2025-02-28 20:15:00,10
4751,ORD_4752,24741,"La Shield IR SPF 30+ & Pa+++ Sunscreen Gel, 60 g",Warehouse A,26,11,2025-02-28 19:50:00,15
4752,ORD_4753,10905,Beardo Wakeup Shot Vitamin C Power Foam Facewash 130 ml,Warehouse C,57,49,2025-02-28 08:16:00,8
4753,ORD_4754,27321,Equinox Hot Water Bottle with Cover EQ-HT-01 C,Warehouse B,68,56,2025-02-28 18:34:00,12
4754,ORD_4755,27315,Bio Margosa Neem Shampoo & Conditioner 340 Ml,Warehouse A,94,88,2025-02-28 03:25:00,6
4755,ORD_4756,6891,"Sakura 57454 Gelly Roll Classic Ass't (05/08/10) 3pk Pen, White",Warehouse B,97,89,2025-02-28 16:45:00,8
4756,ORD_4757,21842,Zipradep 80mg Tablet,Warehouse C,69,60,2025-02-28 17:22:00,9
4757,ORD_4758,22768,"Extension Board with Cable Management Box, Hoteon Power Strip Plus Cord Organizer Box with Reset, 2500W/10A 5nos Universal...",Warehouse A,44,34,2025-02-28 19:25:00,10
4758,ORD_4759,24747,Meganano Gel,Warehouse B,16,11,2025-02-28 21:01:00,5
4759,ORD_4760,32777,Betaron 16mg Tablet,Warehouse A,16,9,2025-02-28 03:27:00,7
4760,ORD_4761,20308,"Lenovo IdeaPad Flex 5 AMD Ryzen 5 5500U 14""(35.56cm)WUXGA IPS 2-in-1 Convertible Touchscreen Laptop(16GB/512GB SDD/Win11/M...",Warehouse C,59,53,2025-02-28 17:02:00,6
4761,ORD_4762,34462,Zayn & Myza Glint & Glow Glam Blush + Highlighter Duo 8 gm,Warehouse B,38,20,2025-02-28 12:00:00,18
4762,ORD_4763,34452,Maxina 500mg Injection,Warehouse B,46,41,2025-02-28 12:08:00,5
4763,ORD_4764,5457,"AURINKO Hair Headband, Synthetic Knot Hair Band For Women And Girls, Pack of 5 - Multicolor",Warehouse C,84,73,2025-02-28 06:50:00,11
4764,ORD_4765,24709,"Kalpana Bindi Maroon Half Moon Shape with Black Border Marathi Style Traditional Bindi Maroon Chand Bindi Sticker Bindi, S...",Warehouse C,50,39,2025-02-28 15:01:00,11
4765,ORD_4766,21887,Flicka Sketch to Amaze-Waterproof Eyeliner Long Lasting Smudge Proof Sketch Pen Eyeliner for Girl and Women Black,Warehouse C,72,66,2025-02-28 23:48:00,6
4766,ORD_4767,24803,Shot Body Spray - Royal Jade,Warehouse B,100,93,2025-02-28 16:00:00,7
4767,ORD_4768,22785,Gatidar 200mg Tablet,Warehouse B,38,19,2025-02-28 02:57:00,19
4768,ORD_4769,32780,MANCODE De-Tan Face Sheet Mask 25 ml,Warehouse A,38,29,2025-02-28 03:10:00,9
4769,ORD_4770,24672,NoWorries No Worries - MAP Laptop Skin Bubble-Free Vinyl Laptop Sticker for 14 & 15.6 inches laptops It Keeps Your Laptop ...,Warehouse B,60,53,2025-02-28 16:41:00,7
4770,ORD_4771,5456,Luxor UNIFLO Ball Pen Blue (20's Box),Warehouse A,102,87,2025-02-28 15:19:00,15
4771,ORD_4772,35792,Vedic Pure Ayurvedic Herbal Adivasi Hair Oil,Warehouse A,65,46,2025-02-28 16:41:00,19
4772,ORD_4773,10863,"Camel Artists Fixative Spray, 200ml",Warehouse A,77,67,2025-02-28 02:01:00,10
4773,ORD_4774,27306,Tulsi Powder,Warehouse B,31,13,2025-02-28 12:01:00,18
4774,ORD_4775,4559,Amick 100mg Injection,Warehouse A,95,84,2025-02-28 20:11:00,11
4775,ORD_4776,24178,Avlinctus Syrup,Warehouse B,99,82,2025-02-28 16:35:00,17
4776,ORD_4777,33736,Generic Lipstick Multicolore (Matte),Warehouse A,77,59,2025-02-28 08:43:00,18
4777,ORD_4778,28535,"Teal & Terra Shampoo With Argan Oil, Olive Oil 200 ml",Warehouse A,109,97,2025-02-28 22:34:00,12
4778,ORD_4779,8647,FaceToner With Vitamin C &Cucumber200ml +Vitamin C Sleeping Mask Night Cream100g,Warehouse C,15,6,2025-02-28 08:23:00,9
4779,ORD_4780,20011,Oxigat 0.3% Eye Drop,Warehouse B,42,23,2025-02-28 03:17:00,19
4780,ORD_4781,4708,"Yamaha F280 Acoustic Rosewood Guitar (Natural, Beige)",Warehouse C,52,38,2025-02-28 23:09:00,14
4781,ORD_4782,22930,"Parker Vector Standard Fountain Pen (Body - Black, Ink - Black with free 1 cartridge)",Warehouse C,81,75,2025-02-28 08:04:00,6
4782,ORD_4783,7085,TULIPS Magnolia Refreshing Wet Wipes with Magnolia Bark Extract (Pack of 3),Warehouse C,53,47,2025-02-28 10:52:00,6
4783,ORD_4784,10591,Fastac MR 250mg/50mg/325mg Tablet,Warehouse B,22,8,2025-02-28 01:58:00,14
4784,ORD_4785,5368,Sety 50 Tablet,Warehouse C,86,74,2025-02-28 17:14:00,12
4785,ORD_4786,18276,Deodorant Spray - Women Romance,Warehouse A,36,23,2025-02-28 00:42:00,13
4786,ORD_4787,8042,Kufrant-D Syrup,Warehouse A,79,67,2025-02-28 02:49:00,12
4787,ORD_4788,6265,Phenergan 25 Tablet,Warehouse A,54,41,2025-02-28 09:04:00,13
4788,ORD_4789,20041,Ajmal Sacrificell Him Sacredlove Deodorant Spray (Pack of 2) 200 ml,Warehouse A,31,18,2025-02-28 04:05:00,13
4789,ORD_4790,20048,STRIFF Adjustable Laptop Tabletop Stand Patented Riser Ventilated Portable Foldable Compatible with MacBook Notebook Table...,Warehouse C,35,18,2025-02-28 17:53:00,17
4790,ORD_4791,21615,GreatDio® Transparent Envelope Folder | Poly-Plastic A4 Documents File Storage Bag with Snap Button | Document Folder for ...,Warehouse B,89,73,2025-02-28 11:40:00,16
4791,ORD_4792,28655,"L.A GIRL Pro. Liquid Concealer Conceal - Tawny, Dark Circles Treatment, Light And Creamy Formula, Long Lasting, 8gm",Warehouse A,7,2,2025-02-28 08:49:00,5
4792,ORD_4793,7090,Moisturizing Aloe Vera Face Wash,Warehouse C,97,82,2025-02-28 04:42:00,15
4793,ORD_4794,20462,Cello Technotip Ball Pen - Pack of 10 (Red),Warehouse B,84,77,2025-02-28 00:00:00,7
4794,ORD_4795,24315,Cerona 0.5mg Tablet,Warehouse A,92,78,2025-02-28 14:52:00,14
4795,ORD_4796,7097,Terbiriv 250mg Tablet,Warehouse B,55,49,2025-02-28 17:03:00,6
4796,ORD_4797,32809,"Forest Essentials Luscious Sugared Rose Petal Lip Balm, 4g & Forest Essentials Mashobra Honey, Lemon and Rosewater Facial ...",Warehouse A,58,47,2025-02-28 15:24:00,11
4797,ORD_4798,20493,"SAISAN Adhesive Carton Packing High Strength Tape (Brown, 2inch/48mm x 65m) - Pack of 6",Warehouse A,81,70,2025-02-28 19:22:00,11
4798,ORD_4799,7102,Voizgesic P 100mg/325mg Tablet,Warehouse B,60,51,2025-02-28 19:29:00,9
4799,ORD_4800,26660,Brahmi Oil,Warehouse B,107,91,2025-02-28 08:50:00,16
4800,ORD_4801,25963,Fast&Up Reload Hydration & Energy Drink With Electrolytes - Effervescent Tablets - Berry,Warehouse B,26,14,2025-02-28 19:00:00,12
4801,ORD_4802,35617,Ajmal Raindropss & Blu & Aurum & Wisal Deo & Neea EDP Pack of 5 20 ml,Warehouse A,35,29,2025-02-28 15:57:00,6
4802,ORD_4803,28604,Loeva 100mg Tablet,Warehouse A,109,97,2025-02-28 19:16:00,12
4803,ORD_4804,35620,"MI Xiao Usb Type C Hypercharge Cable 6A 100Cm Sturdy And Durable Black Supports 120W Hypercharging, Compatible With Smartp...",Warehouse B,15,9,2025-02-28 22:48:00,6
4804,ORD_4805,25803,Exermet GM 502 Tablet PR,Warehouse A,59,51,2025-02-28 14:36:00,8
4805,ORD_4806,8426,"VJTI Envelope Folder,Transparent Poly-Plastic A4 Documents File Storage Bag with Snap Button Set of 5/Certificate File Hol...",Warehouse C,19,13,2025-02-28 07:05:00,6
4806,ORD_4807,28534,Gloket 2% Shampoo,Warehouse C,49,31,2025-02-28 02:44:00,18
4807,ORD_4808,4737,Bella Vita Organic Strawberry 3 In 1 Tinty For Lips 8 gm,Warehouse B,71,55,2025-02-28 02:45:00,16
4808,ORD_4809,7324,FreshDcart Portable Magnifying Lens 3X High-Powered Magnification Hand-Held Folding Magnifier Glass with LED Lights Stand ...,Warehouse B,41,22,2025-02-28 20:35:00,19
4809,ORD_4810,33074,"COSMUS Madison waterproof Multipurpose Backpack With laptop compartment , 33L",Warehouse C,14,4,2025-02-28 23:57:00,10
4810,ORD_4811,34408,Lecasa 5mg Tablet,Warehouse C,73,68,2025-02-28 23:27:00,5
4811,ORD_4812,21560,"Lakmé Perfect Radiance Fairness Day Creme 50 g & Pond's White Beauty BB+ Fairness Cream 01 Original, 18 g",Warehouse A,111,93,2025-02-28 13:35:00,18
4812,ORD_4813,9542,"Swiss Beauty Eyebrow Definer Pencil with Spoolie | Smudge proof, Waterproof and Pigmented Eyebrow pencil |Shade - Coco Bro...",Warehouse A,78,62,2025-02-28 23:42:00,16
4813,ORD_4814,32394,GoPro AFTTM-001 Shorty Mini Extension Pole with Tripod (Black),Warehouse B,74,59,2025-02-28 19:10:00,15
4814,ORD_4815,2296,"Fedus Cat6 Ethernet Cable, 1 Meter High Speed 550Mhz 10 Gigabit Speed Utp Lan Cable, Network Cable Internet Cable Rj45 Cab...",Warehouse C,12,1,2025-02-28 22:27:00,11
4815,ORD_4816,9541,Urinaloc 1.38gm Syrup,Warehouse C,102,88,2025-02-28 01:22:00,14
4816,ORD_4817,22976,boAt Bass Heads 225 in-Ear Wired Headphones with Mic (Frosty White),Warehouse C,37,19,2025-02-28 05:25:00,18
4817,ORD_4818,35599,Qcort 6mg Tablet,Warehouse C,23,18,2025-02-28 20:10:00,5
4818,ORD_4819,2301,Advansed Ayurvedic Hot Oil,Warehouse C,62,57,2025-02-28 21:11:00,5
4819,ORD_4820,34567,Flormar Nail Enamel 075 Baroque Bordeaux 11 ml,Warehouse A,86,71,2025-02-28 07:27:00,15
4820,ORD_4821,18291,Domcer 15mg/20mg Tablet,Warehouse A,57,48,2025-02-28 03:09:00,9
4821,ORD_4822,4754,"Redmi Smart Band Pro SportsWatch- 3.73 cm (1.47) Large AMOLED Display, Always On Display, Continuous Sleep, HR, Stress and...",Warehouse A,102,87,2025-02-28 15:04:00,15
4822,ORD_4823,1494,Dependal M 100 mg/300 mg Tablet,Warehouse C,79,69,2025-02-28 04:33:00,10
4823,ORD_4824,22961,Corz 6mg Tablet,Warehouse A,113,99,2025-02-28 03:43:00,14
4824,ORD_4825,27203,Amlorace AT 5mg/50mg Tablet,Warehouse A,45,29,2025-02-28 00:40:00,16
4825,ORD_4826,28571,"keskriva Foldable Wooden Mini Laptop Table for Bed, Study Table with Drawer, Tablet/Mobile Holder for Kids And Adults",Warehouse C,26,9,2025-02-28 03:05:00,17
4826,ORD_4827,18319,Herbal Burgundy Mehandi,Warehouse A,24,15,2025-02-28 19:05:00,9
4827,ORD_4828,25783,Recefix 200mg Tablet,Warehouse A,33,23,2025-02-28 03:46:00,10
4828,ORD_4829,32720,Picsul 10mg Tablet,Warehouse A,88,80,2025-02-28 22:08:00,8
4829,ORD_4830,32402,Ajmal 3 Wisal Dahab Deo & Ascend EDP Pack of 4 20 ml,Warehouse A,15,3,2025-02-28 16:04:00,12
4830,ORD_4831,2067,Pantodac DSR Capsule,Warehouse C,85,75,2025-02-28 17:59:00,10
4831,ORD_4832,25967,"WOW IMAGINE Shock Proof Clear Protective TPU, PC Back Cover Case for Nothing Phone 1 5G - AirEDGE Technology 360 Degree Ca...",Warehouse B,111,93,2025-02-28 17:40:00,18
4832,ORD_4833,33719,"DIGITEK® (LP E8) Lithium-ion Rechargeable Battery for DSLR Camera, Compatibility - Power EOS 55D, 600D, D650, 700D, EOS KI...",Warehouse B,85,75,2025-02-28 04:24:00,10
4833,ORD_4834,18325,"Wottagirl! Perfume Spray - Fantasy, Classic",Warehouse A,82,66,2025-02-28 23:28:00,16
4834,ORD_4835,28602,Esocool 20mg Tablet,Warehouse B,60,45,2025-02-28 02:18:00,15
4835,ORD_4836,1692,Blue Heaven Flawless Liquid Concealer - Caramel 17 ml,Warehouse C,87,74,2025-02-28 08:42:00,13
4836,ORD_4837,6273,Code Chrome Body Perfume,Warehouse A,84,67,2025-02-28 17:01:00,17
4837,ORD_4838,18238,Silmox Capsule,Warehouse C,54,36,2025-02-28 06:42:00,18
4838,ORD_4839,28469,House of Aroma Frankincense Essential Oil 10 ml,Warehouse C,66,58,2025-02-28 08:05:00,8
4839,ORD_4840,7260,Cognix 500mg/5ml Syrup,Warehouse A,101,88,2025-02-28 08:51:00,13
4840,ORD_4841,22082,Sadhev Nourishing & Moisturising Bathing Bar - Vetiver and Chocolate 125 gm,Warehouse A,99,93,2025-02-28 20:39:00,6
4841,ORD_4842,5776,Lemak 250mg Injection,Warehouse B,57,48,2025-02-28 13:05:00,9
4842,ORD_4843,6656,Sounce Flash/Super VOOC Micro USB 7 Pin Data Sync Fast Charging Cable Compatible for Oppo Reno/Oppo F9 PRo/ F11 pro Upto 4...,Warehouse B,75,67,2025-02-28 13:36:00,8
4843,ORD_4844,24053,Betarich 16 Tablet,Warehouse B,73,60,2025-02-28 05:35:00,13
4844,ORD_4845,18545,"Success Stationery Hero Pen Original Fountain Ink Pen Iridium Nib Model 329 Silver Cap, Black Green Maroon - Pack of 3",Warehouse A,87,68,2025-02-28 07:49:00,19
4845,ORD_4846,27185,"TRITON Professional Makeup Kajal Eyeliner Eyebrow Pencil Dual Sharpener, Twin Hole Cosmetic Cutter for Beauty Salon, Parlo...",Warehouse A,46,38,2025-02-28 16:48:00,8
4846,ORD_4847,34604,Vega 2 In 1 Brow Groomer And Tweezer (TWE - 01) 15 gm,Warehouse B,89,75,2025-02-28 21:08:00,14
4847,ORD_4848,35535,Swift 500mg Capsule,Warehouse B,46,38,2025-02-28 23:12:00,8
4848,ORD_4849,18539,Spigen AlignMaster Tempered Glass Screen Protector Guard for Nothing Phone (1) - 2 Pack,Warehouse B,62,51,2025-02-28 02:57:00,11
4849,ORD_4850,28468,Mirah Belle Organic Sea Buckthorn Healing Soap 125 gm,Warehouse C,77,66,2025-02-28 00:12:00,11
4850,ORD_4851,35627,"Safari Seek 32 Ltrs Overnighter Travel Laptop Backpack (Black), Water Resistant Spacious Bag for Travelling and Camping, A...",Warehouse A,61,48,2025-02-28 21:37:00,13
4851,ORD_4852,25067,DavaIndia Amitriptyline 10mg Tablet,Warehouse B,63,47,2025-02-28 13:10:00,16
4852,ORD_4853,24187,Glimmer Premium Nail Enamel Darkest Hour 10 ml,Warehouse A,109,99,2025-02-28 10:12:00,10
4853,ORD_4854,7169,DavaIndia Rosuvastatin 10mg Tablet,Warehouse B,58,43,2025-02-28 09:16:00,15
4854,ORD_4855,5996,Vega Round Brush (E1 - RB) 81 gm,Warehouse A,76,63,2025-02-28 11:48:00,13
4855,ORD_4856,28517,"TOYPORIUM Style My Home LCD Writing Tablet 8.5 inches Electronic e-Writers Graphics Tablets, Erasable Portable Drawing Doo...",Warehouse C,35,19,2025-02-28 14:26:00,16
4856,ORD_4857,22045,St.Botanica Body Wash - Rich Mysore Sandal 250 ml,Warehouse B,73,55,2025-02-28 12:48:00,18
4857,ORD_4858,4778,ZOBAK 3-in-1 Multifunctional Extendable Bluetooth Selfie Stick Tripod with Detachable Wireless Remote Compatible with iPho...,Warehouse C,24,15,2025-02-28 07:18:00,9
4858,ORD_4859,4775,Ciprocir Eye Drop,Warehouse B,99,86,2025-02-28 11:27:00,13
4859,ORD_4860,1954,New Ventisol Expectorant,Warehouse C,62,57,2025-02-28 18:15:00,5
4860,ORD_4861,5995,"AKAI SB-20 20W Bluetooth Stereo Soundbar with Multicolour LED Lights, Aux in 3.5mm, Micro SD Slot, USB Supported(Black)",Warehouse C,52,43,2025-02-28 11:25:00,9
4861,ORD_4862,1579,Manish Malhotra Glitter Eyeliner - Galaxy Blue 1.2 Gm,Warehouse C,13,5,2025-02-28 15:56:00,8
4862,ORD_4863,2663,Tosif O 200mg/200mg Tablet,Warehouse B,23,7,2025-02-28 11:49:00,16
4863,ORD_4864,4770,Zoryl MP LD 2mg/500mg/7.5mg Tablet,Warehouse B,80,69,2025-02-28 21:44:00,11
4864,ORD_4865,1450,Maa Paa with Ganesh Ji Combo Tattoo Men and Women Waterproof Temporary Body Tattoo,Warehouse B,76,64,2025-02-28 13:13:00,12
4865,ORD_4866,7263,"Duracell Specialty 1620 Lithium Coin Battery 3V, Pack of 5 (DL1620/CR1620) Designed for use in keyfobs, Scales, wearables ...",Warehouse A,74,59,2025-02-28 02:26:00,15
4866,ORD_4867,28397,AJM 360 Protection Shockproof Design Soft Rubberised Case with Keychain for Oppo Enco Air 2 Pro (Navy Blue),Warehouse B,106,87,2025-02-28 14:50:00,19
4867,ORD_4868,19906,Datrone 4mg Tablet,Warehouse C,83,76,2025-02-28 06:40:00,7
4868,ORD_4869,20005,Gear Classic 20L Faux Leather Water Resistant Anti Theft Laptop Bag/Backpack for Men/Women-Black,Warehouse B,26,16,2025-02-28 11:58:00,10
4869,ORD_4870,26619,Moxytab 250mg Tablet,Warehouse A,13,2,2025-02-28 14:16:00,11
4870,ORD_4871,4714,Weltelmi MT 40mg/50mg Tablet,Warehouse B,68,60,2025-02-28 22:44:00,8
4871,ORD_4872,34131,"Belkin 18W USB Type C Adapter (iPhone Fast Charger for All iPhone 14, iPhone 13, Iphone12 Models, Ipad Pro and Type-C Andr...",Warehouse C,50,42,2025-02-28 17:06:00,8
4872,ORD_4873,26653,Astofen-P Tablet,Warehouse A,74,57,2025-02-28 16:31:00,17
4873,ORD_4874,5171,Mettoboss 25mg Tablet,Warehouse A,25,14,2025-02-28 18:59:00,11
4874,ORD_4875,1690,"Amkette EvoFox Falcon X85 Extended Mouse Pad/Desk Pad for Laptop, PC Gaming and Desk with Extra Large Speed Surface, Non-S...",Warehouse B,62,44,2025-02-28 16:03:00,18
4875,ORD_4876,28456,BAE BEAUTE Imagic Professional Makeup Cosmetic Sponge (04),Warehouse C,70,64,2025-02-28 02:53:00,6
4876,ORD_4877,25120,Olimelt 10 Tablet MD,Warehouse A,48,34,2025-02-28 01:37:00,14
4877,ORD_4878,19912,Temabact LB Tablet,Warehouse C,74,59,2025-02-28 23:24:00,15
4878,ORD_4879,27192,Escytop 20mg Tablet,Warehouse B,67,62,2025-02-28 01:51:00,5
4879,ORD_4880,34915,Cnoxt 100mg Tablet,Warehouse A,42,35,2025-02-28 15:56:00,7
4880,ORD_4881,6665,Brown Dressing Comb For Fine/Medium Length Straight Hair - 2,Warehouse A,81,71,2025-02-28 16:27:00,10
4881,ORD_4882,24111,Maxx Cold and Flu Oral Suspension,Warehouse A,102,91,2025-02-28 18:21:00,11
4882,ORD_4883,35555,"GOVO GOBASS 400 in Ear Wired Earphones with Microphone High Definition, Passive Noise Cancellation for Music, 3.5mm Jack (...",Warehouse A,11,2,2025-02-28 04:31:00,9
4883,ORD_4884,18475,Street Wear Playfull Matte Lip Crayon - Dude Red 2.9 gm,Warehouse C,9,4,2025-02-28 06:32:00,5
4884,ORD_4885,21491,Azipax 500mg Tablet,Warehouse C,78,71,2025-02-28 03:03:00,7
4885,ORD_4886,24121,Nykaa All Day Matte Long Wear Liquid Foundation With Pump - Ivory 01,Warehouse C,76,62,2025-02-28 15:47:00,14
4886,ORD_4887,10414,Perinol 650mg Tablet,Warehouse C,66,48,2025-02-28 21:59:00,18
4887,ORD_4888,10416,"POSH Male to Male VGA Cable 1.5 Meter, Support PC/Monitor/LCD/LED, Plasma, Projector, TFT. VGA to VGA Converter Adapter Cable",Warehouse B,40,26,2025-02-28 19:53:00,14
4888,ORD_4889,25768,"Denver Deodorant Body Spray For Men, Caliber Hamilton, 200ml, Pack Of 1",Warehouse B,83,64,2025-02-28 13:48:00,19
4889,ORD_4890,22056,"EXO Cyclozan - Round, 500g Box with free scrubber",Warehouse B,48,39,2025-02-28 01:10:00,9
4890,ORD_4891,9558,Wipeout Germ Killing Hand Cream,Warehouse C,44,37,2025-02-28 21:01:00,7
4891,ORD_4892,10425,Hair Care Kit - Anti Hair Fall,Warehouse A,61,44,2025-02-28 07:10:00,17
4892,ORD_4893,9582,Mecostay-G Tablet,Warehouse B,46,37,2025-02-28 22:20:00,9
4893,ORD_4894,35542,"Aroma® NB119 Care Bluetooth Wireless In Ear Neckband with Long Lasting Playtime 48 Hrs, Smart Voice Assistant, In-line Con...",Warehouse A,43,27,2025-02-28 06:58:00,16
4894,ORD_4895,23026,"Dyazo Telescopic Multi Angle Adjustable and Foldable Mobile Phone Tabletop Stand, Anti Slip and Scratch Resistant, Compati...",Warehouse C,75,61,2025-02-28 21:21:00,14
4895,ORD_4896,8644,"TP-Link RE205 AC750 Universal Wireless Dual Band Range Extender, Broadband/Wi-Fi Extender, WiFi Booster/Hotspot with Ether...",Warehouse A,60,42,2025-02-28 14:59:00,18
4896,ORD_4897,28551,Miss Rose Professional Make-up Professional Make Up 18-Color Glitter 7001-083M02,Warehouse A,50,35,2025-02-28 10:33:00,15
4897,ORD_4898,33973,Nexocid 40mg Tablet,Warehouse A,72,55,2025-02-28 01:36:00,17
4898,ORD_4899,6404,GadgetBite Anti-Lost Magnetic Strap Silicone Cable String for Apple Wireless Earphones 1 | Apple Wireless Earphones 2 | Ap...,Warehouse B,113,94,2025-02-28 15:38:00,19
4899,ORD_4900,27043,"Samsung Galaxy M32 Prime Edition (Light Blue, 6GB RAM, 128GB)",Warehouse B,40,25,2025-02-28 09:54:00,15
4900,ORD_4901,6408,"BESTOR ® 8K HDMI 2.1 Cable 48Gbps 9.80FT/ Ultra High Speed HDMI Braided Cord-4K@120Hz 8K@60Hz, DTS:X, HDCP 2.2 & 2.3, HDR ...",Warehouse A,77,58,2025-02-28 13:26:00,19
4901,ORD_4902,9119,LUX Soft Glow|Buy 4 Get 1 Offer|Rose & Vitamin E Bathing Soap|For Glowing Skin| Beauty Soaps|150 g,Warehouse C,46,31,2025-02-28 04:23:00,15
4902,ORD_4903,19484,Ozimentin CV Dry Syrup,Warehouse C,118,99,2025-02-28 14:48:00,19
4903,ORD_4904,27838,Spigen Ultra Hybrid Back Cover Case for iPhone 13 (TPU + Poly Carbonate | Rose Crystal),Warehouse C,30,17,2025-02-28 01:11:00,13
4904,ORD_4905,26068,Stelbid Tablet,Warehouse B,104,93,2025-02-28 15:20:00,11
4905,ORD_4906,6409,Firming Gel,Warehouse B,63,47,2025-02-28 14:23:00,16
4906,ORD_4907,35241,New Revlon One-Stroke Defining Eyeliner Kajal - Smoke 1.2 Gm,Warehouse A,24,8,2025-02-28 19:47:00,16
4907,ORD_4908,9111,Scotfix-O Tablet,Warehouse C,92,81,2025-02-28 04:53:00,11
4908,ORD_4909,19475,Original Eau De Toilette - For Men,Warehouse A,90,73,2025-02-28 11:44:00,17
4909,ORD_4910,19467,Hair & Skin Vitamin Gummies With Biotin & Folic Acid,Warehouse B,73,66,2025-02-28 04:34:00,7
4910,ORD_4911,8160,Walpodox CV 200mg/125mg Tablet,Warehouse C,25,14,2025-02-28 19:22:00,11
4911,ORD_4912,23465,Eurosar 50mg Tablet,Warehouse B,86,76,2025-02-28 10:03:00,10
4912,ORD_4913,35242,"MAONO AU-100 Auxiliary Omnidirectional Lavalier Clip On Collar Microphone for Mobile Phone, Camera with 6M Audio Cable, 3....",Warehouse C,27,11,2025-02-28 02:25:00,16
4913,ORD_4914,23468,"Ellics Enterprise Presents Foldable Laptop Table with Cup Holder, Study Table, Foldable & Portable/Ergonomic & Rounded Edg...",Warehouse C,85,77,2025-02-28 01:57:00,8
4914,ORD_4915,20790,Fixderma Cosmetic Laboratories (FCL) B Prox 10 Face Wash 100 ml,Warehouse A,7,1,2025-02-28 12:32:00,6
4915,ORD_4916,25483,Pierre Cardin Paris - Metallic Nails 127,Warehouse B,19,2,2025-02-28 08:52:00,17
4916,ORD_4917,9030,aaRF Laptop Table for Home Adjustable Foldable Bed/Multi-Function Portable Laptop Table & Study (Brown),Warehouse C,75,66,2025-02-28 23:14:00,9
4917,ORD_4918,5607,Bio Soya Protein Fresh Nourishing Shampoo 340 Ml,Warehouse A,99,88,2025-02-28 04:11:00,11
4918,ORD_4919,27960,Serum Vegital Perfecting Toning Lotion - For All Skin Types,Warehouse A,114,99,2025-02-28 20:27:00,15
4919,ORD_4920,9907,DC DERMACOL Make Up Cover Foundation (221),Warehouse A,65,46,2025-02-28 00:02:00,19
4920,ORD_4921,34008,Nipril H 2.5mg/12.5mg Tablet,Warehouse B,98,83,2025-02-28 09:29:00,15
4921,ORD_4922,32847,Lozec 10gm Syrup,Warehouse C,29,18,2025-02-28 11:32:00,11
4922,ORD_4923,23335,"Fashion Colour Non - Transfer Matt Waterproof Lipstick, 34 Agate Purple 2.6 gm",Warehouse B,105,89,2025-02-28 14:03:00,16
4923,ORD_4924,33151,Hihit P 500mg/4mg Tablet,Warehouse C,60,46,2025-02-28 10:15:00,14
4924,ORD_4925,23536,FENOCOR 67MG TABLET,Warehouse C,53,48,2025-02-28 21:58:00,5
4925,ORD_4926,5160,"ENVOUS Smart Watch Charger Magnetic, Charging Cable for Boat Xtend, Noise ColorFit Pulse, Colorfit Ultra/Ultra 2, Color Fi...",Warehouse A,67,51,2025-02-28 19:36:00,16
4926,ORD_4927,19497,Extract Capsules - Garcinia Cambogia,Warehouse C,96,80,2025-02-28 21:39:00,16
4927,ORD_4928,23277,Ajmal Blu Dreams EDP Citurs Fruity Perfume And Sacrifice II For Him Deodorant Fruity Aromatic Fragrance 300 ml,Warehouse B,30,11,2025-02-28 23:07:00,19
4928,ORD_4929,23275,R Zole L 75mg/20mg Capsule,Warehouse C,62,55,2025-02-28 23:02:00,7
4929,ORD_4930,2398,Gainac-S Tablet,Warehouse C,52,41,2025-02-28 00:15:00,11
4930,ORD_4931,19681,Rsold 30mg/20mg Capsule SR,Warehouse B,103,86,2025-02-28 08:16:00,17
4931,ORD_4932,35350,Coldcare Syrup,Warehouse A,72,66,2025-02-28 12:12:00,6
4932,ORD_4933,1301,Body Wash & shower Gel - Energize,Warehouse B,56,38,2025-02-28 11:10:00,18
4933,ORD_4934,19115,"ZORBES® Mini Printer, Small Pocket Printer Black and White Printing Bluetooth Thermal Printer Compatible with iOS, Androi...",Warehouse B,17,12,2025-02-28 13:35:00,5
4934,ORD_4935,25432,Neemli Naturals Natural SPF 30 Mattifying Sunscreen 50 ml,Warehouse A,102,83,2025-02-28 04:19:00,19
4935,ORD_4936,33358,"Apple 2021 10.2-inch (25.91 cm) iPad with A13 Bionic chip (Wi-Fi, 64GB) - Silver (9th Generation)",Warehouse B,75,69,2025-02-28 02:52:00,6
4936,ORD_4937,27910,Micromax X818 Maroon,Warehouse B,55,49,2025-02-28 00:28:00,6
4937,ORD_4938,22508,Anti Dullness Shampoo With Coffee Bean & Patchouli,Warehouse B,94,78,2025-02-28 07:49:00,16
4938,ORD_4939,22481,Mecofine PG 750mcg/75mg Capsule,Warehouse A,46,38,2025-02-28 22:32:00,8
4939,ORD_4940,6415,Zuldine AT 5mg/50mg Tablet,Warehouse A,60,53,2025-02-28 13:34:00,7
4940,ORD_4941,22499,Oxyglow Hair Serum - Keratin 50 ml,Warehouse C,30,23,2025-02-28 02:12:00,7
4941,ORD_4942,19432,GURUJI COSMETICS Get Bright Fairness and Foundation BB Cream Shade Cream SPF15 PA +++ (30 mL),Warehouse B,78,62,2025-02-28 19:18:00,16
4942,ORD_4943,19425,"Arata Natural Refreshing Toothpaste With Peppermint, Cinnamon Fights Bacteria & Tooth Decay 100 ml",Warehouse B,70,61,2025-02-28 04:02:00,9
4943,ORD_4944,27819,Onsetrin 2mg Injection,Warehouse A,56,43,2025-02-28 17:56:00,13
4944,ORD_4945,8163,Zyra-DSR Capsule,Warehouse C,48,38,2025-02-28 09:14:00,10
4945,ORD_4946,32608,White Botanical Exceptional Cleansing Mousse,Warehouse C,23,10,2025-02-28 05:33:00,13
4946,ORD_4947,20784,Modicare Urban Color Expert Firm And Lift Compact 9g- Soft Shell 03 + Hairpin Free,Warehouse C,59,52,2025-02-28 13:27:00,7
4947,ORD_4948,27061,BIGWIG GLOSS 2 IN 1 (DARK PEACH),Warehouse C,108,94,2025-02-28 13:40:00,14
4948,ORD_4949,1664,Iscept L 1.25 mg/250 mg Tablet,Warehouse B,39,32,2025-02-28 06:49:00,7
4949,ORD_4950,7584,Panci D Tablet,Warehouse C,57,44,2025-02-28 16:55:00,13
4950,ORD_4951,7583,SupCares Edge to Edge Tempered Glass for Redmi K50i (6.6 Inch) with Easy Self Installation Kit | Black,Warehouse C,51,46,2025-02-28 19:34:00,5
4951,ORD_4952,19404,Zitel Case with Screen Protector Compatible with Apple Watch Series 8/7 45mm Hard PC Cover with Built-in 9H Tempered Glass...,Warehouse B,43,31,2025-02-28 15:54:00,12
4952,ORD_4953,25590,Men Charcoal Face Scrub,Warehouse B,85,71,2025-02-28 11:32:00,14
4953,ORD_4954,25449,Orticid 10mg Tablet,Warehouse C,41,30,2025-02-28 10:56:00,11
4954,ORD_4955,7563,Penix-P 37.5mg/325mg Tablet,Warehouse B,25,12,2025-02-28 19:48:00,13
4955,ORD_4956,5749,"MaxFresh Toothpaste Gel - Anticavity, Spicy Fresh, Saver Pack",Warehouse C,20,5,2025-02-28 23:17:00,15
4956,ORD_4957,18714,"APC Easy UPS BVX1200LI-IN 1200VA / 650W, 230V, UPS System, an Ideal Power Backup & Protection for Home Office, Desktop PC...",Warehouse C,80,61,2025-02-28 14:19:00,19
4957,ORD_4958,33274,Ramidil 1.25mg Capsule,Warehouse A,78,72,2025-02-28 21:22:00,6
4958,ORD_4959,4896,Sirona Premium Applicator Tampons - (Mix pack) 8's,Warehouse A,83,70,2025-02-28 08:03:00,13
4959,ORD_4960,18702,Match LB-Link 4G Router | 4G LTE 2 in One Wi-Fi Router (WAN Ports +Sim Card Slot) with Smart Switch (WAN < = > Sim Card) |...,Warehouse B,76,61,2025-02-28 21:07:00,15
4960,ORD_4961,6322,Energizer CR1620 3V Lithium Coin Battery,Warehouse B,17,6,2025-02-28 19:54:00,11
4961,ORD_4962,18691,Inkacin 500mg Injection,Warehouse B,19,12,2025-02-28 19:33:00,7
4962,ORD_4963,10267,Terbister 250mg Tablet,Warehouse A,102,96,2025-02-28 00:35:00,6
4963,ORD_4964,10268,"iBELL FM700BT Portable FM Radio with Bluetooth Speaker, USB, SD Slot, MP3 Player & Dynamic Speaker 3 Band (Brown)",Warehouse C,95,84,2025-02-28 07:45:00,11
4964,ORD_4965,22175,CROSSVOLT 4-in-1 Portable Type C Hub [Type-C to 4 USB-A Port] with Fast Data Transfer.,Warehouse B,23,16,2025-02-28 03:04:00,7
4965,ORD_4966,8837,"ABOUTTHEFIT TPU Case for Samsung Galaxy TAB S6 Lite 10.4 2020 WiFi SM-P610 / LTE SM-P615, Slim Flexible Soft TPU Back Foli...",Warehouse A,24,19,2025-02-28 08:29:00,5
4966,ORD_4967,23080,"Oppo A78 5G (Glowing Blue, 8GB RAM, 128 Storage) | 5000 mAh Battery with 33W SUPERVOOC Charger| 50MP AI Camera | 90Hz Refr...",Warehouse C,29,13,2025-02-28 11:18:00,16
4967,ORD_4968,22167,Sunaina COLORZ 288 Bindi Book For Women (SIZE-3) (Size 9mm),Warehouse B,90,84,2025-02-28 12:34:00,6
4968,ORD_4969,22633,"pTron Bassbuds Perl in-Ear TWS Earbuds with TruTalk ENC, Bluetooth 5.3 Wireless Headphone with Mic, Deep Bass, Low Latenc...",Warehouse B,98,91,2025-02-28 17:24:00,7
4969,ORD_4970,33150,Cefyhex OZ 200mg/500mg Tablet,Warehouse B,56,46,2025-02-28 20:57:00,10
4970,ORD_4971,28291,"Skin Naturals - Sakura White, Face Serum Sheet Mask, Pink",Warehouse B,87,78,2025-02-28 09:51:00,9
4971,ORD_4972,26226,Levotrix 250mg Tablet,Warehouse A,61,54,2025-02-28 19:44:00,7
4972,ORD_4973,33825,A-Phyl 100 Capsule,Warehouse B,92,75,2025-02-28 20:50:00,17
4973,ORD_4974,8285,"ZEBRONICS Zeb-Blitz USB Gaming Wired On Ear Headphones with Mic with Dolby Atmos, RGB Led, Windows Software, Simulated 7.1...",Warehouse A,74,57,2025-02-28 10:08:00,17
4974,ORD_4975,25234,"Rene Furterer Okara Color Enhancing Spray, 150 ml",Warehouse B,91,85,2025-02-28 04:13:00,6
4975,ORD_4976,20570,"elus Fair Glow Gel Saffron & Turmeric | The Age-old Secret Of Saffron And Turmeric That Let’s You Be Naturally You, 25g",Warehouse C,20,13,2025-02-28 14:50:00,7
4976,ORD_4977,7773,BB+ Cream Light,Warehouse B,47,28,2025-02-28 00:25:00,19
4977,ORD_4978,994,Essential Souls Facewash - Grapefruit Splash 200 ml,Warehouse A,109,91,2025-02-28 00:51:00,18
4978,ORD_4979,23136,Corant Expectorant,Warehouse A,75,66,2025-02-28 00:08:00,9
4979,ORD_4980,32827,TECHONTO 360° Degree Cell Phone Holder with Adjustable Clamp Phone Tripod Mount Adapter Compatible with Smartphones & All ...,Warehouse C,40,27,2025-02-28 16:51:00,13
4980,ORD_4981,23930,Thalizide 12.5mg Tablet,Warehouse B,107,98,2025-02-28 12:19:00,9
4981,ORD_4982,25209,Jovees Himalayan Cherry Cold Cream 60 gm,Warehouse C,55,40,2025-02-28 13:15:00,15
4982,ORD_4983,1411,Isoelite Remote Compatible for Samsung LED/LCD Remote Control Works with All Samsung LED/LCD TV Model No :- BN59-607A (Ple...,Warehouse C,48,37,2025-02-28 05:47:00,11
4983,ORD_4984,20555,"Priefy Trail Loop Band Compatible for Apple Watch Ultra Band 49mm 45mm 44mm 42mm, Nylon Sport Loop Men Women Adjustable Pu...",Warehouse C,39,29,2025-02-28 05:49:00,10
4984,ORD_4985,32822,Gentle Enamel Ultra Soft Toothbrush,Warehouse C,102,84,2025-02-28 12:33:00,18
4985,ORD_4986,10249,Baby Happy Round Cotton Pads,Warehouse B,58,51,2025-02-28 10:03:00,7
4986,ORD_4987,1602,Dolsan-SP Tablet,Warehouse A,19,7,2025-02-28 13:41:00,12
4987,ORD_4988,19609,"Kingsway Dustproof Car Body Cover, Suitable for Maruti Suzuki Alto, Model Year : 2000-2012, Color : Silver Matty, 2#2 2X2 ...",Warehouse C,89,75,2025-02-28 10:16:00,14
4988,ORD_4989,22436,Cefiquik 200mg Tablet,Warehouse B,54,44,2025-02-28 00:52:00,10
4989,ORD_4990,19610,Abel 80 Tablet,Warehouse A,13,8,2025-02-28 20:20:00,5
4990,ORD_4991,5219,"GOVO GOSURROUND 900 | 200W Soundbar, 2.1 Channel Home Theatre, 6.5” Wired Subwoofer, HDMI, AUX, Opt, USB & Bluetooth, 4 Eq...",Warehouse A,61,52,2025-02-28 12:08:00,9
4991,ORD_4992,23524,Lakme True Wear Nail Color Reds & Maroons D417 9 Ml,Warehouse B,61,53,2025-02-28 11:52:00,8
4992,ORD_4993,6134,Trumeb C 135mg/5mg Tablet,Warehouse C,108,90,2025-02-28 04:11:00,18
4993,ORD_4994,1796,Narizine 10mg Tablet,Warehouse B,52,39,2025-02-28 05:50:00,13
4994,ORD_4995,22463,Abzith 500 Tablet,Warehouse B,16,5,2025-02-28 00:51:00,11
4995,ORD_4996,32601,Crucial RAM 8GB DDR4 2666 MHz CL19 Laptop Memory CT8G4SFRA266,Warehouse C,101,85,2025-02-28 19:13:00,16
4996,ORD_4997,2535,Cefdac AZ 200mg/250mg Tablet,Warehouse C,81,65,2025-02-28 20:09:00,16
4997,ORD_4998,19535,Amazon Brand - Solimo Acrylic Transparent Case (Hard Back & Soft Bumper Cover with Cushioned Edges) for Apple iPhone 7,Warehouse C,60,43,2025-02-28 03:24:00,17
4998,ORD_4999,19549,Macbery LS Expectorant,Warehouse A,24,12,2025-02-28 23:00:00,12
4999,ORD_5000,34846,"Western Digital WD 4TB My Book Desktop External Hard Disk Drive,Compatible with Windows&Mac, Portable HDD",Warehouse C,29,24,2025-02-28 13:29:00,5
5000,ORD_5001,20827,Pure Aloe Vera Hydrating Gel,Warehouse A,57,46,2025-02-28 17:10:00,11
5001,ORD_5002,20828,Drotalac 80mg/250mg Tablet,Warehouse C,79,71,2025-02-28 03:40:00,8
5002,ORD_5003,9877,TheGiftKart Sleek Back Cover Case for iPhone SE 2020 / iPhone SE 2022 | Protective & Slim Fit | Ultra Matte Finish | Camer...,Warehouse B,106,87,2025-02-28 02:27:00,19
5003,ORD_5004,25567,Panna-DSR Capsule,Warehouse C,86,77,2025-02-28 15:29:00,9
5004,ORD_5005,5191,Kefsurge 500 mg/500 mg Injection,Warehouse C,31,20,2025-02-28 08:58:00,11
5005,ORD_5006,19367,Cintyp D 15mg/20mg Tablet,Warehouse A,85,77,2025-02-28 07:43:00,8
5006,ORD_5007,19360,Aqua-Jole Injection,Warehouse C,74,64,2025-02-28 22:17:00,10
5007,ORD_5008,33317,Nax Gel,Warehouse B,53,46,2025-02-28 04:01:00,7
5008,ORD_5009,1797,Altrom 1mg Tablet,Warehouse B,75,57,2025-02-28 07:43:00,18
5009,ORD_5010,9888,Bose Quietcomfort 45 Bluetooth Wireless Over Ear Headphones with Mic Noise Cancelling - Triple Black,Warehouse A,60,50,2025-02-28 10:04:00,10
5010,ORD_5011,9890,Omiprex D 10 mg/20 mg Capsule,Warehouse B,77,69,2025-02-28 20:57:00,8
5011,ORD_5012,26152,"Arata Natural Mini Face & Oral Care Gift Box with Facewash(50 Ml), Face Serum Cream (50 Ml), Toothpaste (50 Ml) 150 ml",Warehouse A,86,68,2025-02-28 18:57:00,18
5012,ORD_5013,21060,"CRUST CS30 Car Bluetooth Device with Call Receiver, FM Transmitter for Music System & Dual USB + Type C Fast Charger; 7 Co...",Warehouse C,59,53,2025-02-28 03:42:00,6
5013,ORD_5014,8217,Vega Set Of 6 Brushes (MBS - 06) 53 gm,Warehouse B,20,4,2025-02-28 14:33:00,16
5014,ORD_5015,19685,WOW Imagine Shockproof Crystal Clear 1+ OnePlus Nord CE 2 5G Back Cover Case | 360 Degree Protection | Transparent Mobile ...,Warehouse A,49,38,2025-02-28 21:06:00,11
5015,ORD_5016,19275,Metoliz G 2mg/500mg Tablet SR,Warehouse B,28,20,2025-02-28 19:48:00,8
5016,ORD_5017,2522,Spigen Ultra Hybrid Back Cover Case Compatible with iPhone 14 Pro max (TPU + Poly Carbonate | Matte Black),Warehouse B,61,49,2025-02-28 11:21:00,12
5017,ORD_5018,33525,Etoril H 5mg/12.5mg Tablet,Warehouse B,76,69,2025-02-28 10:29:00,7
5018,ORD_5019,1984,"Lenovo 15.6"" (39.62cm) Slim Everyday Backpack, Made in India, Compact, Water-resistant, Organized storage:Laptop sleeve,ta...",Warehouse C,90,74,2025-02-28 06:36:00,16
5019,ORD_5020,18040,Femrone 100mg Capsule,Warehouse B,49,41,2025-02-28 10:22:00,8
5020,ORD_5021,24915,Mist - Rose,Warehouse B,108,91,2025-02-28 06:27:00,17
5021,ORD_5022,10697,"7X Beard Oil - Musk, 7 Premium Oils Supports Beard Growth & Nourishment",Warehouse C,77,70,2025-02-28 16:00:00,7
5022,ORD_5023,32999,Flormar Glitter Nail Enamel GL12 White Pearl 11 ml,Warehouse C,37,21,2025-02-28 20:08:00,16
5023,ORD_5024,33000,boAt Bassheads 105 Wired in Ear Earphones with Mic (Black),Warehouse B,62,44,2025-02-28 08:17:00,18
5024,ORD_5025,20127,"BigPassport USB Wired Over Ear Headphones with Mic with Noise-Cancelling for Pc, Laptop, Computer, Model- Pro-Tech 134 (Bl...",Warehouse A,66,47,2025-02-28 11:45:00,19
5025,ORD_5026,24923,Nokia 110 Dual SIM (Blue),Warehouse A,101,90,2025-02-28 20:44:00,11
5026,ORD_5027,1516,Repsol SP 50mg/325mg/15mg Tablet,Warehouse B,63,52,2025-02-28 04:14:00,11
5027,ORD_5028,5874,Activated Charcoal Bright Glow Face Wash,Warehouse C,86,80,2025-02-28 04:35:00,6
5028,ORD_5029,24502,"boAt Laptop, Smartphone Type-c A400 Male Data Cable (Carbon Black)",Warehouse C,98,87,2025-02-28 10:09:00,11
5029,ORD_5030,20400,Fildox T 5mg/400mg Tablet,Warehouse B,42,31,2025-02-28 02:37:00,11
5030,ORD_5031,840,Classic Sandalwood & Tulsi Hand Wash,Warehouse A,63,44,2025-02-28 17:33:00,19
5031,ORD_5032,22861,Hand Sanitiser - Green Apple,Warehouse A,89,70,2025-02-28 19:38:00,19
5032,ORD_5033,33050,"Paco Rabanne Black XS for Her Eau De Parfum, 30ml",Warehouse B,97,92,2025-02-28 16:39:00,5
5033,ORD_5034,20149,"3M Scotch Magic Tape Roll | 1.9cm x 32.9 meter | Invisible, writable and hand tearable | For school projects, home and off...",Warehouse B,21,13,2025-02-28 08:57:00,8
5034,ORD_5035,10738,"Sery Color Flirt Nail Paint Glitter, Gold Sheen, Gold Glitter 10 ml",Warehouse B,82,71,2025-02-28 12:20:00,11
5035,ORD_5036,5407,Cold Pressed Castor Oil - Hexane Free,Warehouse A,40,22,2025-02-28 07:37:00,18
5036,ORD_5037,33230,Selaglob 800mg Tablet,Warehouse C,42,31,2025-02-28 12:39:00,11
5037,ORD_5038,20532,ZEBRONICS Zeb-Duke1 Bluetooth Wireless Over Ear Headphones with Mic (Blue),Warehouse A,10,1,2025-02-28 09:39:00,9
5038,ORD_5039,8780,Atneace MR 100mg/325mg/250mg Tablet,Warehouse A,9,1,2025-02-28 02:29:00,8
5039,ORD_5040,10348,Zebronics Zeb-Transformer-k USB Gaming Keyboard with Multicolor LED Effect,Warehouse C,50,38,2025-02-28 21:11:00,12
5040,ORD_5041,32650,Madurai Jasmine & Mogra Handmade Luxury Soap,Warehouse C,34,29,2025-02-28 22:30:00,5
5041,ORD_5042,7533,"ZEBRONICS ZEB-FIT7220CH Bluetooth Smart Watch,4.4cm (1.75"") Full Touch Curved Screen, Metal Body & Metal Strap,7 Days Data...",Warehouse B,36,30,2025-02-28 05:16:00,6
5042,ORD_5043,33930,Panprez 40mg Tablet,Warehouse A,103,89,2025-02-28 14:51:00,14
5043,ORD_5044,1673,Himrox 150mg Tablet,Warehouse B,66,59,2025-02-28 22:38:00,7
5044,ORD_5045,33141,"Tecno Spark 9 (Sky Mirror, 4GB RAM,64GB Storage) | 7GB Expandable RAM | Helio G37 Gaming Processor",Warehouse A,60,44,2025-02-28 12:32:00,16
5045,ORD_5046,22406,Fadox 100mg Tablet DT,Warehouse B,43,28,2025-02-28 13:10:00,15
5046,ORD_5047,27411,Betox 8mg Tablet,Warehouse C,34,28,2025-02-28 07:42:00,6
5047,ORD_5048,27389,"DIGITEK® (DRL 12C) Professional (12 inch) LED Ring Light with Tripod Stand for Mobile Phones & Camera, 3 Temperature Mode ...",Warehouse A,64,48,2025-02-28 08:50:00,16
5048,ORD_5049,9984,"Introducing Kindle Paperwhite Signature Edition (32 GB) – With a 6.8"" display, wireless charging, and auto-adjusting front...",Warehouse A,20,4,2025-02-28 01:33:00,16
5049,ORD_5050,6242,QOCXRRIN 360 Degree Rotation Mini Tripod Support Stand for DSLR and Smartphones - Foldable Shockproof Lightweight Bracket ...,Warehouse A,50,39,2025-02-28 06:52:00,11
5050,ORD_5051,26127,Sandal Fairness Face Wash,Warehouse B,114,96,2025-02-28 18:15:00,18
5051,ORD_5052,25960,Oxy-Infusion Face Wash,Warehouse C,112,94,2025-02-28 07:26:00,18
5052,ORD_5053,32986,Ajmal Wisal & Silver Shade & Sacrificeiihim & Raindropss Deo & Ascend EDP Pack of 5 20 ml,Warehouse A,30,19,2025-02-28 12:19:00,11
5053,ORD_5054,24416,Facial Kit - Party Glow,Warehouse C,10,1,2025-02-28 13:00:00,9
5054,ORD_5055,1157,"TUSA USB C Car Charger, Dual USB Fast Charger PD 30W + QC 30W (Max 30W) Compatible with iPhone 14/13/12/11 Pro Max Plus, P...",Warehouse A,103,87,2025-02-28 08:10:00,16
5055,ORD_5056,5851,Cilovas 5mg Tablet,Warehouse A,101,90,2025-02-28 21:41:00,11
5056,ORD_5057,10648,"Dyazo Water Resistant Laptop Sleeve /Case Cover for 15 Inches,15.6 Inch Laptops & Notebook (Black)",Warehouse B,54,48,2025-02-28 06:46:00,6
5057,ORD_5058,35674,mars by GHC Alpha Arbutin Serum for Pigmentation & Dark Spots Removal | Anti-pigmentation Face Serum For Men with Hyaluron...,Warehouse A,20,10,2025-02-28 09:11:00,10
5058,ORD_5059,35062,"Bodywash - 3-In-1, Plum Blossom",Warehouse C,32,16,2025-02-28 21:42:00,16
5059,ORD_5060,20073,Heparen 5000IU Injection,Warehouse C,61,54,2025-02-28 04:56:00,7
5060,ORD_5061,8612,EGOTUDE Shockproof Hard Transparent Back Cover Case for iPhone 14 Pro 6.1 inch (Clear),Warehouse C,26,18,2025-02-28 16:30:00,8
5061,ORD_5062,18047,TheGiftKart Ultra-Hybrid Clear Back Case Cover for iPhone 12/12 PRO | Shockproof Design | Camera Protection Bump | Hard Ba...,Warehouse A,59,41,2025-02-28 05:52:00,18
5062,ORD_5063,10755,Quench Botanics Mon Cherry Overnight Peeling Mask 50 ml,Warehouse C,42,23,2025-02-28 05:36:00,19
5063,ORD_5064,35737,TheGiftKart Tough Armor Bumper Back Cover Ring Holder and Kickstand in-Built 360 Degree Protection Back Cover for Samsung ...,Warehouse A,84,71,2025-02-28 20:32:00,13
5064,ORD_5065,5875,Protoin 100mg Tablet,Warehouse C,46,41,2025-02-28 21:43:00,5
5065,ORD_5066,22714,HP USB 3.2 Flash Drive 64GB x718w,Warehouse B,29,18,2025-02-28 01:30:00,11
5066,ORD_5067,33006,Mahabhringraj Tel - Hairfall Reduction & Dandruff Control,Warehouse A,41,26,2025-02-28 23:50:00,15
5067,ORD_5068,21914,"Fashion Colour Satin Smooth Lip Definer, 14 Absolute Copper 1.41 gm",Warehouse A,48,43,2025-02-28 03:05:00,5
5068,ORD_5069,20169,Auromide 1% Eye Drop,Warehouse B,109,94,2025-02-28 07:56:00,15
5069,ORD_5070,24529,Sun Expert Ultramatte Lotion - SPF 50,Warehouse A,29,21,2025-02-28 06:22:00,8
5070,ORD_5071,5414,Doubledicestore Tempered Glass Screen Protector Compatible for Samsung Galaxy M52 5G/M51/F62/M62/A71 with Edge to Edge Cov...,Warehouse C,92,73,2025-02-28 06:40:00,19
5071,ORD_5072,10757,Miss Rose Matte Smudge Proof LipGloss 7701 - 002M 04,Warehouse B,64,51,2025-02-28 05:02:00,13
5072,ORD_5073,17935,"Fashion Colour Vivid Matte Lipstick, 4 Red Bean 3.8 gm",Warehouse A,102,92,2025-02-28 17:05:00,10
5073,ORD_5074,9450,"Lenovo Ideapad 3 AMD Ryzen 5 5500U 15.6""(39.62cm) FHD T&L Laptop (8GB/512GB SSD/Win 11/MSO 2021/Backlit Keyboard/2Yr Warra...",Warehouse C,15,4,2025-02-28 16:40:00,11
5074,ORD_5075,21725,AND MystE EDP & ChicC Mist Pack of 2 250 ml,Warehouse B,97,88,2025-02-28 04:13:00,9
5075,ORD_5076,24883,F Cold 5mg/500mg/5mg Tablet,Warehouse B,57,43,2025-02-28 05:23:00,14
5076,ORD_5077,1201,Cello Butterflow Simply Ball Pen | Pack of 20 Blue and 5 Black pens | Best Ball Pens for Smooth Writing | Writing Pens for...,Warehouse A,73,60,2025-02-28 16:59:00,13
5077,ORD_5078,23635,ENVIE® (ECR-20 MC) Cooper Rechargeable Battery Charger for AA & AAA Ni-mh Batteries with LED Indicator,Warehouse A,12,3,2025-02-28 10:00:00,9
5078,ORD_5079,21621,D-Chlorex Eye/Ear Drops,Warehouse C,94,88,2025-02-28 15:57:00,6
5079,ORD_5080,26122,Memake Women's Waterproof Glitter shine lipstick for Women's & Girls,Warehouse B,94,80,2025-02-28 12:24:00,14
5080,ORD_5081,19719,Saumox CV 500mg/125mg Tablet,Warehouse C,12,6,2025-02-28 14:29:00,6
5081,ORD_5082,1046,Ichiban CCNJTG21G001 Dual SIM GSM Fixed Wireless Corded Landline Phone (Grey),Warehouse C,68,54,2025-02-28 16:07:00,14
5082,ORD_5083,5242,"Toothbrush - Complete Expert, Medium",Warehouse B,60,53,2025-02-28 13:18:00,7
5083,ORD_5084,9693,Jaa DSR Capsule,Warehouse B,97,88,2025-02-28 19:33:00,9
5084,ORD_5085,19698,Flavozest 200mg Tablet,Warehouse C,59,50,2025-02-28 17:34:00,9
5085,ORD_5086,28087,Ajmal Shine EDP Floral Powdery Perfume 75ml for Women and Zeal EDP Aquatic Woody Perfume 100ml for Men +1 Perfume Tester FREE,Warehouse A,14,8,2025-02-28 09:52:00,6
5086,ORD_5087,23720,Kingston SSDNow A400 240GB Internal Solid State Drive (SA400S37/240GIN),Warehouse B,69,63,2025-02-28 09:32:00,6
5087,ORD_5088,7707,Pomegranate Face Scrub,Warehouse B,35,21,2025-02-28 06:33:00,14
5088,ORD_5089,7713,Sperexen Duo 500mg/50mg Tablet,Warehouse B,7,1,2025-02-28 02:18:00,6
5089,ORD_5090,7447,Cyclogesic 20mg/500mg Tablet,Warehouse A,80,68,2025-02-28 14:41:00,12
5090,ORD_5091,6515,Wizact-S Tablet,Warehouse A,100,84,2025-02-28 05:05:00,16
5091,ORD_5092,19701,"ETI Duct Tape 48mm x 25 Mtr, Grey",Warehouse A,78,70,2025-02-28 22:44:00,8
5092,ORD_5093,27119,Isolone 10mg Tablet,Warehouse C,54,43,2025-02-28 21:28:00,11
5093,ORD_5094,26029,"TIED RIBBONS Cute Dog Decorative Pen Stand for Gift Office Desk Kids Study Table ( 11 cm X 9 cm X 11 cm, Multicolor)",Warehouse B,47,35,2025-02-28 02:15:00,12
5094,ORD_5095,23231,"TheGiftKart Crystal Clear Back Cover Case for Samsung Galaxy S20 FE / S20 FE 5G | Shockproof 360 Degree Protection | PC, T...",Warehouse A,115,97,2025-02-28 17:24:00,18
5095,ORD_5096,2132,"Axmon® Extension Cord with USB Port [FIRE Proof] [Shock Proof] Safest , Space Saver [6 Socket 2 USB Ports] 10 Amp [1.9 Met...",Warehouse B,13,7,2025-02-28 05:17:00,6
5096,ORD_5097,32906,Enoxel 20 Injection,Warehouse A,106,90,2025-02-28 03:54:00,16
5097,ORD_5098,34728,Esmol 40mg Injection,Warehouse C,104,86,2025-02-28 05:08:00,18
5098,ORD_5099,27120,Boxclav Syrup,Warehouse C,89,84,2025-02-28 14:08:00,5
5099,ORD_5100,19108,Canon EOS 200D II 24.1MP Digital SLR Camera + EF-S 18-55mm f4 is STM Lens (Black),Warehouse A,74,57,2025-02-28 13:55:00,17
5100,ORD_5101,25627,Conditioner - Organic Now,Warehouse C,93,77,2025-02-28 04:10:00,16
5101,ORD_5102,20647,Cadbury Original Drinking Chocolate - 250g,Warehouse C,109,90,2025-02-28 13:34:00,19
5102,ORD_5103,32901,LOHAYA Remote Compatible for Sony Bravia LCD LED HD TV Remote Control Works with All Sony LED LCD HD Tv's [ Compatible for...,Warehouse A,30,12,2025-02-28 12:47:00,18
5103,ORD_5104,5033,Hello Sun Sunblock & Anti-tTan Lotion - SPF30,Warehouse C,32,13,2025-02-28 08:47:00,19
5104,ORD_5105,20986,Aminak Injection,Warehouse C,94,87,2025-02-28 16:21:00,7
5105,ORD_5106,20994,Makeup Revolution Rehab Overnight Lip Serum 4.6 ml,Warehouse A,69,58,2025-02-28 06:15:00,11
5106,ORD_5107,19161,Ajmal Selfie And Aura Of CP & Neea EDP Of Pack of 3 20 ml,Warehouse A,21,6,2025-02-28 11:43:00,15
5107,ORD_5108,27109,Soft Clean Vegetable & Fruit Wash 1 litre,Warehouse B,11,2,2025-02-28 21:46:00,9
5108,ORD_5109,9704,Omniset 4mg Tablet,Warehouse B,90,77,2025-02-28 20:17:00,13
5109,ORD_5110,10628,Wormburn Plus 6mg/400mg Tablet,Warehouse B,18,1,2025-02-28 22:47:00,17
5110,ORD_5111,20938,Lemon & Oil Shower Gel - Pampering Care With Refreshing Scent Of Lemon,Warehouse C,69,51,2025-02-28 12:59:00,18
5111,ORD_5112,19227,Regrowth Hair Oil,Warehouse C,91,77,2025-02-28 18:25:00,14
5112,ORD_5113,6096,Yubico - YubiKey 5 NFC - USB-A - Two Factor Authentication Security Key,Warehouse C,62,48,2025-02-28 03:37:00,14
5113,ORD_5114,20983,Bacocef-S Injection,Warehouse A,73,61,2025-02-28 19:12:00,12
5114,ORD_5115,6482,Mexa Acoustic Guitar Bag Compatible With 38; 39; 40; 41; Inches Guitar Like - Fender; Yamaha; Cort; Ibanez; Xtag; Ashton; ...,Warehouse B,21,8,2025-02-28 14:53:00,13
5115,ORD_5116,9996,Fevicol MR 1 kg Craft Glue Ultimate Adhesive for Student’s Project Work - Craft Glue & Office Glue Refill Pack,Warehouse A,12,2,2025-02-28 23:02:00,10
5116,ORD_5117,7697,Myglamm Wandurlust Matt Chrome Nail Paint Miami 11 Ml,Warehouse C,80,71,2025-02-28 12:17:00,9
5117,ORD_5118,19666,"POPIO Tempered Glass Screen Protector for Samsung Galaxy Watch 4, Samsung Galaxy Watch 5 (44mm) (1.4"" inch), Pack of 2",Warehouse C,31,23,2025-02-28 21:48:00,8
5118,ORD_5119,10005,"Sanitary Pads - XL Wings, Ultra Clean",Warehouse A,97,91,2025-02-28 21:34:00,6
5119,ORD_5120,19165,Dothcin 75mg Tablet,Warehouse C,88,70,2025-02-28 15:17:00,18
5120,ORD_5121,27724,Sorest 50mg Tablet,Warehouse B,33,17,2025-02-28 08:51:00,16
5121,ORD_5122,19880,Mostred 100mg Injection,Warehouse A,98,82,2025-02-28 23:06:00,16
5122,ORD_5123,27732,"Miss rose Hot and Soft Matte Lipstick, Maroon, 3.4 g",Warehouse A,77,62,2025-02-28 15:05:00,15
5123,ORD_5124,9159,MI 360° Home Security Camera 1080P l Full HD Picture l AI Powered Motion Detection l Infrared Night Vision | 360° Panorama...,Warehouse C,93,86,2025-02-28 05:55:00,7
5124,ORD_5125,23649,Onsitego 2 Year Extended Warranty for Small Household Appliances from Rs. 2501-3000 (Email Delivery - No Physical Kit),Warehouse A,46,30,2025-02-28 03:45:00,16
5125,ORD_5126,20903,Soulflower Aroma Oil - Walk in the Wood 30 ml,Warehouse C,34,25,2025-02-28 20:20:00,9
5126,ORD_5127,9969,Collagen Nutrition Cream,Warehouse C,89,72,2025-02-28 14:49:00,17
5127,ORD_5128,7540,"LS LAPSTER Quality Assured HDMI to VGA Adapter Cable 1080P for Projector, Computer, Laptop, TV, Projectors & TV",Warehouse A,26,15,2025-02-28 02:09:00,11
5128,ORD_5129,34770,Lamolet 100mg Tablet,Warehouse C,73,68,2025-02-28 09:41:00,5
5129,ORD_5130,6463,Glimmer Ne Mojitogreen 5Ml Btl M 7 ml,Warehouse B,79,65,2025-02-28 06:14:00,14
5130,ORD_5131,9027,Nourishing Face Moisturizing Lotion,Warehouse A,58,53,2025-02-28 21:01:00,5
5131,ORD_5132,32884,Nurial Plus Injection,Warehouse A,28,16,2025-02-28 00:33:00,12
5132,ORD_5133,34860,Amhace 500mg Injection,Warehouse A,88,74,2025-02-28 17:23:00,14
5133,ORD_5134,26963,Ajmal Nightingale & Distraction & Magnetize & Persuade Deo & Yearn EDP Pack of 3 20 ml,Warehouse C,52,42,2025-02-28 02:15:00,10
5134,ORD_5135,23577,Pramtina 0.5mg Tablet,Warehouse A,69,55,2025-02-28 00:23:00,14
5135,ORD_5136,1115,Decorax 50mg Injection,Warehouse B,69,54,2025-02-28 17:56:00,15
5136,ORD_5137,1821,"VEGA Men T1 Beard Trimmer For Men With 40 Mins Run Time, Usb Charging & 23 Length Settings (VHTH-18 Black) 1 gm",Warehouse B,44,27,2025-02-28 03:01:00,17
5137,ORD_5138,6026,Fogg Adventure 1000 Sprays 150 Ml,Warehouse A,27,12,2025-02-27 20:59:00,15
5138,ORD_5139,33864,"Biotique Advanced Organics Clear Improvement Vitamin C Illuminating Body Wash, 200ml",Warehouse A,32,15,2025-02-27 14:15:00,17
5139,ORD_5140,26158,"HIFFIN® Green Screen Backdrop with Stand, 8FT X 12FT Wide Green Screen Backdrop with 9 FT x 12 FT Wide Photo Backdrop Stan...",Warehouse C,62,55,2025-02-27 08:10:00,7
5140,ORD_5141,3746,CASENED Camera Lens Protector For iPhone 14 Pro/ 14 Pro Max 9H Premium Tempered Glass Aviation Aluminum Camera Protection...,Warehouse B,81,67,2025-02-27 01:10:00,14
5141,ORD_5142,2267,Face Scrub - Enriched With Kiwi Extract & Natural Exfoilant,Warehouse C,77,60,2025-02-27 11:58:00,17
5142,ORD_5143,22336,Mecovia P 750mcg/75mg Capsule,Warehouse B,99,84,2025-02-27 01:55:00,15
5143,ORD_5144,8317,Gliden 30mg Tablet MR,Warehouse B,73,68,2025-02-27 13:50:00,5
5144,ORD_5145,8324,"Matlek 2.4G Small Wireless Keyboard - Ergonomic and Comfortable Keyboard for - Desktop, Laptop, Tabs, Mobile Phones, Smart...",Warehouse A,79,67,2025-02-27 05:24:00,12
5145,ORD_5146,1606,Verocet 1000mg Tablet,Warehouse C,99,87,2025-02-27 23:24:00,12
5146,ORD_5147,31142,Lozipam 1mg Tablet,Warehouse A,65,59,2025-02-27 23:04:00,6
5147,ORD_5148,22204,Raface 2.5mg Tablet,Warehouse B,105,89,2025-02-27 23:43:00,16
5148,ORD_5149,22207,"SKYTONE Large Capacity Cosmetic Travel Bag, Women's Makeup Travel Bag Portable Leather Cosmetics Bag, Makeup Storage Bags ...",Warehouse C,86,74,2025-02-27 18:13:00,12
5149,ORD_5150,22227,Maryaj Cosmo Girl EDP Floral Powdery Perfume And Maryaj Lilas EDP Citrus Floral Perfume 200 ml,Warehouse C,17,10,2025-02-27 10:12:00,7
5150,ORD_5151,13064,Epodox 100mg Tablet DT,Warehouse C,105,99,2025-02-27 19:34:00,6
5151,ORD_5152,33139,Carvodil 6.25mg Tablet,Warehouse A,52,44,2025-02-27 07:56:00,8
5152,ORD_5153,31145,Pre Shave Cream - Musk,Warehouse C,40,26,2025-02-27 21:17:00,14
5153,ORD_5154,14797,ME-ON Ultra HD Foundation (Shade 01 - Ivory),Warehouse B,41,25,2025-02-27 07:04:00,16
5154,ORD_5155,3660,Levo Anawin 0.25% Injection,Warehouse A,91,74,2025-02-27 02:44:00,17
5155,ORD_5156,6557,Depilox 50mg Tablet,Warehouse A,71,52,2025-02-27 03:26:00,19
5156,ORD_5157,12573,Rabescope D 30mg/20mg Tablet SR,Warehouse A,18,5,2025-02-27 18:25:00,13
5157,ORD_5158,26130,"TVARA LCD Writing Tablet, 8.5"" Inch Colorful Toddler Doodle Board Drawing Tablet, Erasable Reusable Electronic Drawing Pad...",Warehouse B,102,92,2025-02-27 20:19:00,10
5158,ORD_5159,26131,Depapod CV Dry Syrup,Warehouse A,99,86,2025-02-27 05:54:00,13
5159,ORD_5160,22393,Zecoryl Tablet,Warehouse A,63,47,2025-02-27 04:59:00,16
5160,ORD_5161,23826,Checkered Flag Eau De Toilette For Men,Warehouse C,33,22,2025-02-27 12:24:00,11
5161,ORD_5162,30624,"Synqe Type C to Type C Short Fast Charging 60W Cable Compatible with Samsung Galaxy Z Fold3 5G, Z Flip3 5G, S22 5G, S22 Ul...",Warehouse B,15,5,2025-02-27 07:23:00,10
5162,ORD_5163,14818,Forest Essentials Body Mist Parijat|Hydrates & Scents the Skin|Body Spray For Men And Women|50ml,Warehouse C,20,11,2025-02-27 12:07:00,9
5163,ORD_5164,8283,Megthro 125mg Dry Syrup,Warehouse A,42,32,2025-02-27 04:14:00,10
5164,ORD_5165,23844,Acival 200mg Tablet SR,Warehouse B,50,41,2025-02-27 00:21:00,9
5165,ORD_5166,26201,Wet N Wild Color Icon Eyeshadow Single - Sugar 1.7 gm,Warehouse A,77,67,2025-02-27 12:45:00,10
5166,ORD_5167,12320,Dumcef T 1000mg/125mg Injection,Warehouse C,39,26,2025-02-27 02:48:00,13
5167,ORD_5168,34532,"MATT LOOK BIG EYES Long Lasting Super Waterproof Mascara & Defined Volume with No Clump, Gives Lashes Intense Volumising ,...",Warehouse A,43,35,2025-02-27 04:04:00,8
5168,ORD_5169,24038,TheGiftKart Ultra-Hybrid Crystal Clear Back Case Cover for iPhone 13 Back Cover Case | Slim Fit Shockproof Design | Camera...,Warehouse C,57,44,2025-02-27 01:06:00,13
5169,ORD_5170,26585,Lxfen Tablet,Warehouse A,79,71,2025-02-27 14:22:00,8
5170,ORD_5171,26592,"Ambrane Wired in Ear Earphones with in-line Mic for Clear Calling, 14mm Dynamic Drivers for BoostedBass, 3.5mm Jack, Mult...",Warehouse C,74,62,2025-02-27 16:48:00,12
5171,ORD_5172,3322,Repliv 100mg Tablet,Warehouse C,15,4,2025-02-27 19:31:00,11
5172,ORD_5173,15233,Wet N Wild Color Icon Eyeshadow Quads - Hooked On Vinyl 4.5 gm,Warehouse C,112,99,2025-02-27 14:30:00,13
5173,ORD_5174,26602,CEDO Realme Pad Mini (8.7 Inch) Tempered Glass | Screen Protector Tempered Glass for Realme Pad Mini (8.7 Inch),Warehouse A,92,80,2025-02-27 15:29:00,12
5174,ORD_5175,299,"Body Spray - Basic Purple, Fission, Up or Down",Warehouse A,76,61,2025-02-27 06:16:00,15
5175,ORD_5176,25141,SUGAR Cosmetics Time To Shine Lip Gloss - 02 Velma Pinkley 4.5 ML,Warehouse C,18,6,2025-02-27 22:29:00,12
5176,ORD_5177,8677,USM i8 Pro Max Touch Screen Bluetooth Smartwatch with Activity Tracker Compatible with All 3G/4G/5G Android & iOS Smartpho...,Warehouse B,98,83,2025-02-27 10:36:00,15
5177,ORD_5178,2082,Shower Gel - Oceanus,Warehouse B,98,80,2025-02-27 00:49:00,18
5178,ORD_5179,33113,7 Day Surface Disinfectant Shield,Warehouse C,32,23,2025-02-27 07:42:00,9
5179,ORD_5180,26397,"Yantralay 40 in 1 Action Camera Mount Kit Compatible with gopro Hero 11/10/9/8/7/6/5, SJCAM,Osmo Action,Insta 360 & Other ...",Warehouse A,46,40,2025-02-27 13:38:00,6
5180,ORD_5181,22367,Bio Renew Argan Oil Of Morocco Shampoo 400 ml + Conditioner 400 ml,Warehouse B,78,66,2025-02-27 05:23:00,12
5181,ORD_5182,36629,Ranicef 100mg Tablet,Warehouse B,44,28,2025-02-27 16:18:00,16
5182,ORD_5183,6567,"Redgear A-17 Gaming Mouse with Upto 6400 DPI, RGB Lighting and Braided Cable(Black)",Warehouse A,97,82,2025-02-27 21:58:00,15
5183,ORD_5184,22332,BhringAmla Hair Oil With Bhringraj & Amla For Intense Hair Treatment,Warehouse A,110,93,2025-02-27 20:37:00,17
5184,ORD_5185,22324,Roparil 2mg Tablet,Warehouse A,28,15,2025-02-27 19:14:00,13
5185,ORD_5186,31555,Amazon Basics RJ45 Cat-6 Ethernet Patch/LAN Cable for Personal Computer - 10 Feet/3 Meters (Black),Warehouse A,52,39,2025-02-27 18:11:00,13
5186,ORD_5187,26182,INSIGHT COSMETICS NON TRANSFER LIQUID LIPSTICK (LG-39) - DEEP RUST 6 ml,Warehouse B,71,56,2025-02-27 23:06:00,15
5187,ORD_5188,12539,"Simply Inked New Mini Anchor Temporary Tattoo, Designer Tattoo for Girls Boys Men Women waterproof Sticker Size: 2 X 2 inc...",Warehouse C,54,35,2025-02-27 11:10:00,19
5188,ORD_5189,30595,"Shot Body Spray - Gold, Dynamic",Warehouse B,106,94,2025-02-27 03:16:00,12
5189,ORD_5190,25273,Thyronic 50mcg Tablet,Warehouse A,91,82,2025-02-27 03:40:00,9
5190,ORD_5191,8215,"Portronics Ruffpad 8.5M Multicolor LCD Writing Pad with Screen 21.5cm (8.5-inch) for Drawing, Playing, Handwriting Gifts f...",Warehouse C,99,80,2025-02-27 04:04:00,19
5191,ORD_5192,7354,Herbal Sensitive pH Balanced Liquid Handwash - Refill Pouch,Warehouse A,101,91,2025-02-27 11:12:00,10
5192,ORD_5193,14829,Ayracef LB 200mg Tablet,Warehouse B,106,96,2025-02-27 05:01:00,10
5193,ORD_5194,12487,"Samsung 3 Speakers Wireless Subwoofer, Dolby Digital and DTS Virtual X Bluetooth Soundbar (HW-B45E/XL, Black, 2.1 Channel)",Warehouse C,95,88,2025-02-27 01:14:00,7
5194,ORD_5195,22116,Anti Acne Serum,Warehouse A,30,14,2025-02-27 07:44:00,16
5195,ORD_5196,3373,"MI Smart LED Bulb with Adjustable Brightness, B22 Base Compatible with Amazon Alexa and Google Assistant (White)",Warehouse A,51,40,2025-02-27 18:53:00,11
5196,ORD_5197,12518,Alkreen 1.4gm Syrup,Warehouse C,23,8,2025-02-27 06:18:00,15
5197,ORD_5198,14922,"AFPIN oneplus Smart Watch Charger, Fast Charger - oneplus Smart Watch Charger 2 pin, Power Sharing Cable for oneplus smart...",Warehouse B,75,61,2025-02-27 17:07:00,14
5198,ORD_5199,8415,Geszon L 75mg/40mg Capsule SR,Warehouse C,103,97,2025-02-27 05:55:00,6
5199,ORD_5200,22074,Daily Life Forever52 Glitz Waterproof Eyeliner Eyeshadow Glt008 0.6 gm,Warehouse B,77,65,2025-02-27 23:30:00,12
5200,ORD_5201,13852,CEDO Samsung S21 FE (5G) Shockproof Bumper Crystal Clear Back Cover | 360 Degree Protection TPU+PC | Camera Protection | A...,Warehouse C,31,22,2025-02-27 21:06:00,9
5201,ORD_5202,6001,HP Laserjet Pro M126nw Multi-Function Monochrome Laser Printer,Warehouse C,88,81,2025-02-27 17:53:00,7
5202,ORD_5203,36664,Ustraa Hair Cream for Men 100 gm,Warehouse C,52,46,2025-02-27 23:18:00,6
5203,ORD_5204,14949,L.A. Colors Eyeliner Pencil- Black 1 gm,Warehouse B,37,21,2025-02-27 23:38:00,16
5204,ORD_5205,8412,"Sery Colorflirt Nail Paint Petal Pink, Pink 10 ml",Warehouse B,26,11,2025-02-27 02:51:00,15
5205,ORD_5206,22363,Pkem 40 Tablet,Warehouse C,56,39,2025-02-27 19:35:00,17
5206,ORD_5207,31754,Beauty People Matte Lucious Liquid Lip Colorparty - Glam - L23 ,Warehouse C,104,99,2025-02-27 18:17:00,5
5207,ORD_5208,26315,Sanitize - Antiseptic Liquid,Warehouse B,94,88,2025-02-27 12:10:00,6
5208,ORD_5209,12530,SUGAR Cosmetics Eye Lit You So! Vivid Eyeliner - 06 White Heat - Bright White 1.7 ml,Warehouse B,86,72,2025-02-27 01:19:00,14
5209,ORD_5210,17629,Pent AV D Tablet,Warehouse A,58,51,2025-02-27 03:38:00,7
5210,ORD_5211,11279,The ultimate Detox Mask,Warehouse B,75,63,2025-02-27 05:21:00,12
5211,ORD_5212,28145,Artistry Tattoo Needle Cartridge-1203-RLT,Warehouse C,21,6,2025-02-27 17:50:00,15
5212,ORD_5213,10127,Tiox 0.25mg Tablet,Warehouse A,33,26,2025-02-27 18:39:00,7
5213,ORD_5214,16885,MaxFresh Toothpaste Gel Anticavity 300 g + Plax Mouthwash Peppermint Fresh 250ml,Warehouse A,54,35,2025-02-27 20:45:00,19
5214,ORD_5215,18907,Nutin-NT Tablet,Warehouse B,32,18,2025-02-27 01:31:00,14
5215,ORD_5216,35419,Hosol-S6 Lotion,Warehouse A,93,86,2025-02-27 09:48:00,7
5216,ORD_5217,32515,Eloxib 90mg Tablet,Warehouse A,56,49,2025-02-27 12:53:00,7
5217,ORD_5218,10120,Coldvue Tablet,Warehouse B,30,16,2025-02-27 23:11:00,14
5218,ORD_5219,30559,L'Oreal Paris White Perfect Night Cream 50 Gm,Warehouse A,110,96,2025-02-27 23:50:00,14
5219,ORD_5220,30563,OneAssist 3Yrs Total Protection Plan for TV (Price Range 5000-15000)-Digital Delivery in 2 Hours,Warehouse A,71,60,2025-02-27 06:34:00,11
5220,ORD_5221,8354,"boAt Stone 1200 14W Bluetooth Speaker with Upto 9 Hours Battery, RGB LEDs, IPX7 and TWS Feature(Blue)",Warehouse B,69,58,2025-02-27 07:23:00,11
5221,ORD_5222,34531,Brustro Professional Pigment Based Fineliner - Set of 6 (Black),Warehouse B,65,47,2025-02-27 14:16:00,18
5222,ORD_5223,23829,Acelive CZ 100mg/325mg/250mg Tablet,Warehouse A,44,30,2025-02-27 14:08:00,14
5223,ORD_5224,22171,"S.A.V.I 9 Pairs Natural Brown Eyebrow Tattoos, Long Lasting Up to 4 Days, Waterproof Eyebrow Temporary Tattoo Sticker - 1 ...",Warehouse A,53,45,2025-02-27 06:55:00,8
5224,ORD_5225,2543,Atecard-AM Tablet,Warehouse C,61,47,2025-02-27 02:50:00,14
5225,ORD_5226,13078,Fosolin 150mg Injection,Warehouse C,103,96,2025-02-27 18:33:00,7
5226,ORD_5227,23849,Flormar Color Up Lip Crayon 02 Salmon 3.2 gm,Warehouse A,97,78,2025-02-27 20:56:00,19
5227,ORD_5228,22016,"Classmate 2100117 Soft Cover 6 Subject Spiral Binding Notebook, Single Line, 300 Pages",Warehouse A,48,31,2025-02-27 10:13:00,17
5228,ORD_5229,1576,Surgizole DM 10mg/20mg Tablet,Warehouse A,100,82,2025-02-27 21:11:00,18
5229,ORD_5230,6589,Chocolate & Raw Sugar Face Mask,Warehouse A,98,80,2025-02-27 07:07:00,18
5230,ORD_5231,7357,100% Organic Cotton Biodegradable Sanitary Pads - Regular,Warehouse B,39,31,2025-02-27 00:44:00,8
5231,ORD_5232,21999,Staxcef 250mg Tablet,Warehouse A,99,90,2025-02-27 17:17:00,9
5232,ORD_5233,14986,"M.G.R.J® Tempered Glass Screen Protector for Lenovo Tab M10 (TB-X605LC / TB-X605FC / M10 FHD Rel) (10.1"" inch)",Warehouse B,29,20,2025-02-27 01:32:00,9
5233,ORD_5234,21991,Fevorit LB Dry Syrup,Warehouse C,59,48,2025-02-27 09:06:00,11
5234,ORD_5235,8435,"Chekko Cold Pressed Virgin Castor Oil | 100% Natural, Pure & Wood Pressed (200ML) for Baby Massage, Constipation, Healthy ...",Warehouse C,60,42,2025-02-27 12:02:00,18
5235,ORD_5236,33065,Huff N Kuff Syrup,Warehouse B,105,97,2025-02-27 23:22:00,8
5236,ORD_5237,13843,Smeto Cream,Warehouse A,106,96,2025-02-27 07:11:00,10
5237,ORD_5238,7346,"Nokia 215 4G Dual SIM 4G Keypad Phone with Long Battery Life, Multiplayer Games, Wireless FM Radio and Durable Ergonomic D...",Warehouse B,22,5,2025-02-27 03:24:00,17
5238,ORD_5239,30495,Retisphere 0.05% Cream,Warehouse C,89,80,2025-02-27 04:35:00,9
5239,ORD_5240,13842,Rolonate 25mg Injection,Warehouse A,53,37,2025-02-27 22:03:00,16
5240,ORD_5241,3737,Mexafix O 200mg/200mg Tablet,Warehouse B,54,47,2025-02-27 12:52:00,7
5241,ORD_5242,2094,I M Safe 200mg Tablet DT,Warehouse C,54,40,2025-02-27 01:26:00,14
5242,ORD_5243,37002,Almond Body Wash Soap,Warehouse C,107,90,2025-02-27 12:21:00,17
5243,ORD_5244,23936,Ajmal Blu & Aurum & Evoke silver Edition Homme & Shadow Homme Deo & Neea EDP Pack of 4 20 ml,Warehouse C,111,95,2025-02-27 09:00:00,16
5244,ORD_5245,1552,Pregsafe 200mg Injection,Warehouse A,96,83,2025-02-27 08:42:00,13
5245,ORD_5246,21913,"Hoteon Power Strip plus cord Organizer Extension Board with Cable Management Box with Reset, 2500W/10A 5nos Universal Sock...",Warehouse A,15,9,2025-02-27 02:24:00,6
5246,ORD_5247,36999,Amazon Brand - Solimo Silicone Mobile Case for Apple iPhone 13 (Clear),Warehouse C,41,26,2025-02-27 17:47:00,15
5247,ORD_5248,251,Apple Watch Series 8 [GPS + Cellular 45 mm] Smart Watch w/Midnight Aluminium Case with Midnight Sport Band. Fitness Tracke...,Warehouse A,108,93,2025-02-27 17:04:00,15
5248,ORD_5249,14955,Ambrodal LS Syrup,Warehouse B,82,67,2025-02-27 19:13:00,15
5249,ORD_5250,12783,"realme 10 Pro 5G (Dark Matter, 128 GB) (8 GB RAM)",Warehouse B,72,62,2025-02-27 07:32:00,10
5250,ORD_5251,3323,Lakme True Wear Nail Color Reds & Maroons 401 9 Ml,Warehouse A,19,4,2025-02-27 12:53:00,15
5251,ORD_5252,7317,Golden Dew Intense For Women,Warehouse C,56,47,2025-02-27 13:25:00,9
5252,ORD_5253,36841,Tabopan 40mg Tablet,Warehouse A,61,43,2025-02-27 01:24:00,18
5253,ORD_5254,34098,"OnePlus 11R 5G (Galactic Silver, 16GB RAM, 256GB Storage)",Warehouse C,32,27,2025-02-27 00:40:00,5
5254,ORD_5255,7820,Azithrox 250mg Tablet,Warehouse A,89,76,2025-02-27 10:52:00,13
5255,ORD_5256,23056,Vinofen SP Tablet,Warehouse B,39,26,2025-02-27 06:55:00,13
5256,ORD_5257,34101,"Fashion Colour Jersy Girl 2 In 1 Concealer Stick, Shade 02 2.2 gm",Warehouse A,50,31,2025-02-27 03:41:00,19
5257,ORD_5258,14368,Lonazep 1mg Tablet,Warehouse A,109,92,2025-02-27 14:18:00,17
5258,ORD_5259,33268,"Motorola 15 W Single Port Wall Charger For Smartphones, Tablets, Digital Cameras With Usb Type C Cable - Black",Warehouse B,16,7,2025-02-27 06:43:00,9
5259,ORD_5260,23037,"Infinity (JBL Glide 510, 72 Hrs Playtime with Quick Charge, Wireless On Ear Headphone with Mic, Deep Bass, Dual Equalizer,...",Warehouse A,33,18,2025-02-27 01:21:00,15
5260,ORD_5261,6440,"Amazfit GTS2 Mini Smart Watch with 1.55"" (3.8cm)AMOLED Display, SpO2 Level Measurement, 14 Days' Battery Life, 70+ Sports ...",Warehouse A,104,97,2025-02-27 21:23:00,7
5261,ORD_5262,23029,Voximin 50mg Tablet CR,Warehouse A,34,15,2025-02-27 00:12:00,19
5262,ORD_5263,26101,Cipla Prolyte with Vital Electrolytes Energy Drink,Warehouse A,55,50,2025-02-27 20:12:00,5
5263,ORD_5264,33866,Emsulide 100mg Tablet,Warehouse C,98,80,2025-02-27 00:15:00,18
5264,ORD_5265,7417,realme Narzo 50 Pro 5G (Hyper Black 6GB RAM+128GB Storage) Super AMOLED | Advanced Dimensity 920 5G Gaming Processor | 50%...,Warehouse B,81,70,2025-02-27 03:24:00,11
5265,ORD_5266,15109,Tough Lee Tempered Glass Screen Guard for Samsung Galaxy Tab A8 10.5 inch (2022) (SM-X200NZSEINU) (Pack of 1) (WILL NOT FI...,Warehouse C,89,83,2025-02-27 18:08:00,6
5266,ORD_5267,6314,Spigen Air Skin Back Cover Case for Samsung Galaxy Z Fold 3 (Poly Carbonate | Black),Warehouse B,86,67,2025-02-27 21:35:00,19
5267,ORD_5268,12400,Doubledicestore Back Camera Lens Protector Premium Tempered Glass Compatible for iPhone 11 with Slim 9H Hard 2.5D and Easy...,Warehouse B,98,89,2025-02-27 19:59:00,9
5268,ORD_5269,37012,Metorest 25mg Tablet ER,Warehouse A,16,11,2025-02-27 11:05:00,5
5269,ORD_5270,33436,Aeromax 5mg/10mg Tablet,Warehouse A,63,52,2025-02-27 14:54:00,11
5270,ORD_5271,31213,Flormar Color Up Lip Crayon 09 Mauve 3.2 gm,Warehouse C,61,43,2025-02-27 07:34:00,18
5271,ORD_5272,5911,Adilo P Oral Suspension,Warehouse B,60,54,2025-02-27 19:34:00,6
5272,ORD_5273,5910,Neurofast Capsule,Warehouse C,38,33,2025-02-27 20:16:00,5
5273,ORD_5274,25189,Beats Studio Buds Bluetooth Truly Wireless in Ear Earbuds with Mic (White),Warehouse A,16,1,2025-02-27 13:05:00,15
5274,ORD_5275,8561,Vatican's Trick-Dmr Tablet,Warehouse C,57,40,2025-02-27 10:51:00,17
5275,ORD_5276,8563,Kufwaq-BR Syrup,Warehouse C,105,97,2025-02-27 20:56:00,8
5276,ORD_5277,25184,Spigen Rugged Armor Pro Case & Strap for Apple Watch Series 8 / 7 (45mm) | SE2 / 6 / SE / 5 / 4 (44mm) - Chacoal Gray (Wat...,Warehouse B,66,50,2025-02-27 17:15:00,16
5277,ORD_5278,8577,"Makeup Practice Face,Makeup Practice Board Mask Mannequin Face to practice eyes makeup",Warehouse C,59,41,2025-02-27 19:28:00,18
5278,ORD_5279,25174,OMOTON Advanced 9H Tempered Glass Screen Protector Compatible for Google Pixel 4a Edge to Edge with Easy Installation Kit,Warehouse B,68,56,2025-02-27 21:44:00,12
5279,ORD_5280,3108,Skin Oil - Acne,Warehouse C,20,7,2025-02-27 11:10:00,13
5280,ORD_5281,30884,Belkin Pocket Power Bank Charges 3 Device up to 15W (for iPhone/Samsung Galaxy/Pixel 4/Apple Watch/Apple AirPods and More)...,Warehouse A,18,8,2025-02-27 03:32:00,10
5281,ORD_5282,21752,Itch Guard Plus Cream,Warehouse A,79,72,2025-02-27 14:33:00,7
5282,ORD_5283,25435,Rider 250mg Injection,Warehouse C,102,88,2025-02-27 11:42:00,14
5283,ORD_5284,16880,Bonjour Paris Photo Match Crayon Concealer - Natural Fair 3.2 gm,Warehouse A,86,75,2025-02-27 23:29:00,11
5284,ORD_5285,7863,PINK LINE Smudge Proof and Waterproof Matte Eye Liner and Lip Liner/Smudge Free Metallic Pigmented Colour Pencil - Maroon,Warehouse A,110,98,2025-02-27 00:32:00,12
5285,ORD_5286,22965,Nourishing Winter Cream - Almond & Honey,Warehouse A,97,85,2025-02-27 09:19:00,12
5286,ORD_5287,14400,"Redragon Kumara K552-RGB LED Backlit USB Mechanical Gaming Keyboard Without Numlock Keys, Black",Warehouse A,70,64,2025-02-27 03:46:00,6
5287,ORD_5288,6279,"OPPO A15s (Fancy White, 4GB, 128GB Storage) AI Triple Camera | 6.52"" HD+ Screen | 2.3GHz Mediatek Helio P35 Octa Core Proc...",Warehouse B,107,90,2025-02-27 10:39:00,17
5288,ORD_5289,22955,Fastrack Analog Black Dial Men's Watch-NL3147KM01/NN3147KM01/NP3147KM01,Warehouse A,104,90,2025-02-27 06:13:00,14
5289,ORD_5290,7875,Zaipan D 30mg/40mg Capsule SR,Warehouse B,51,33,2025-02-27 23:01:00,18
5290,ORD_5291,31047,"VEGA Premium Collection Paddle Hair Brush for Men & Women, (8586)",Warehouse B,45,34,2025-02-27 06:12:00,11
5291,ORD_5292,22938,Nicka K Pop Neon Nine Color Palette - Oh Honey 8 gm,Warehouse B,106,97,2025-02-27 05:48:00,9
5292,ORD_5293,7889,EGOTUDE Ultra Hybrid Matte Frosted Translucent Back Cover Case for iPhone 14 (Frost Black),Warehouse B,34,19,2025-02-27 14:04:00,15
5293,ORD_5294,7891,"Hammonds Flycatcher Genuine Leather Laptop Bag for Men/Office Bag for Men, Brushwood | Fits Upto 16 Inch Laptop/MacBook| L...",Warehouse C,84,78,2025-02-27 04:02:00,6
5294,ORD_5295,14420,"Yantralay Adjustable Chest Strap Mount Body Belt Harness Compaible with GoPro Hero 10/9/8,SJCAM,Insta 360, DJI OSMO Action...",Warehouse C,94,78,2025-02-27 02:38:00,16
5295,ORD_5296,3531,Isabgol - Double Action (Relief from Constipation),Warehouse B,11,1,2025-02-27 04:21:00,10
5296,ORD_5297,3109,Sazodol SP 50mg/325mg/10mg Tablet,Warehouse B,78,66,2025-02-27 00:43:00,12
5297,ORD_5298,12761,Levotrix OZ 125mg/125mg Suspension,Warehouse A,44,39,2025-02-27 12:14:00,5
5298,ORD_5299,7902,"Sery Stay On Matte Liquid Lipstick Seductive Fushia, Pink (LSO - 13) 5 ml",Warehouse C,21,7,2025-02-27 14:34:00,14
5299,ORD_5300,23539,Ajmal Musk Rose CP And Aurum CP & Aretha EDP Pack of 3 20 ml,Warehouse C,70,52,2025-02-27 22:24:00,18
5300,ORD_5301,36833,Kentdol 10 DT Tablet,Warehouse B,108,89,2025-02-27 03:03:00,19
5301,ORD_5302,14348,Germox Kid 250mg Tablet,Warehouse B,104,93,2025-02-27 03:35:00,11
5302,ORD_5303,23025,Sugamet GP 1 Tablet,Warehouse B,48,36,2025-02-27 10:29:00,12
5303,ORD_5304,25722,"LIDBOX Foldable Wooden Mini Laptop Table for Bed, Study Table with Drawer, Tablet/Mobile Holder for Kids & Adults (Pink)",Warehouse C,56,41,2025-02-27 18:33:00,15
5304,ORD_5305,14356,Orzit 500mg Injection,Warehouse B,44,30,2025-02-27 15:37:00,14
5305,ORD_5306,6320,Uriox 200mg Tablet,Warehouse C,23,7,2025-02-27 22:59:00,16
5306,ORD_5307,3126,milk_shake Cold Brunette Conditioner 250 ml,Warehouse B,66,50,2025-02-27 21:03:00,16
5307,ORD_5308,33348,"junkyard Vinyl Quotes Laptop/Mobile/Bike/Luggage/Bottle/Guitar Sticker, 1.96 x 1.96 x 0.03 inches, Black",Warehouse A,69,60,2025-02-27 21:24:00,9
5308,ORD_5309,1751,"Maybelline New York Super Stay Crayon Lipstick, 35 Treat Yourself 1.2 gm",Warehouse B,55,40,2025-02-27 00:22:00,15
5309,ORD_5310,6315,"Amazon Basics 21.5-Inch (54.5cm) LCD 1920 x 1080 Pixels Monitor, Full HD (1080p),75 Hz Refresh Rate, 5ms Response Time, 8-...",Warehouse B,15,4,2025-02-27 02:04:00,11
5310,ORD_5311,36594,Dicospas Oral Drops,Warehouse B,21,12,2025-02-27 07:50:00,9
5311,ORD_5312,5893,Salista C Cream,Warehouse A,56,38,2025-02-27 11:03:00,18
5312,ORD_5313,37027,Rosuzen Gold 75mg/20mg/75mg Capsule,Warehouse C,93,86,2025-02-27 04:49:00,7
5313,ORD_5314,31818,"Lapster usb 2.0 mantra cable, mantra mfs 100 data cable (black)",Warehouse B,106,93,2025-02-27 12:28:00,13
5314,ORD_5315,34564,Pidilite Fevicryl Fabric Glue (80g),Warehouse B,83,66,2025-02-27 04:21:00,17
5315,ORD_5316,15270,Pierre Cardin Paris - Truly Matte Foundation 370-N.Beige,Warehouse A,59,51,2025-02-27 22:07:00,8
5316,ORD_5317,5811,"EVM25/256GB 256GB SSD 2.5"" INCH SATA",Warehouse A,78,71,2025-02-27 07:41:00,7
5317,ORD_5318,26648,"Portronics Konnect L 60W PD Type C to Type C Mobile Charging Cable, 1.2M, Fast Data Sync, Tangle Resistant, TPE+Nylon Brai...",Warehouse A,37,31,2025-02-27 03:57:00,6
5318,ORD_5319,21529,Avir 100mg Tablet,Warehouse A,35,19,2025-02-27 21:34:00,16
5319,ORD_5320,36553,Rinomist-FP Nasal Spray,Warehouse A,45,31,2025-02-27 16:49:00,14
5320,ORD_5321,21489,"FLiX (Beetel) USB Type C to Lightning PVC Data Sync & 18W PD Fast Charging Cable, Made in India, 480Mbps Data Sync, Solid ...",Warehouse A,17,5,2025-02-27 11:56:00,12
5321,ORD_5322,31250,Sheesham Beard Comb 0'S,Warehouse C,18,9,2025-02-27 13:45:00,9
5322,ORD_5323,15286,White Perfect - Clinical Day Cream SPF19 PA+++,Warehouse B,35,28,2025-02-27 05:17:00,7
5323,ORD_5324,1469,Germ Protection Clove & Salt Toothpaste,Warehouse C,111,97,2025-02-27 01:11:00,14
5324,ORD_5325,12304,Maryaj M For Her EDP Fruity Floral Perfume And Ajmal Aurum Femme Deodorant Fruity Floral Fragrance 290 ml,Warehouse C,45,40,2025-02-27 20:18:00,5
5325,ORD_5326,7258,Maybelline Liquid Lipstick Artist (Matte),Warehouse A,49,30,2025-02-27 04:41:00,19
5326,ORD_5327,31819,Deve Herbes Pure Golden Jojoba Oil (Simmondsia chinensis) Natural Therapeutic Grade Cold Pressed 30ml,Warehouse B,88,72,2025-02-27 16:08:00,16
5327,ORD_5328,26111,Cofstop-CDX Syrup,Warehouse A,20,9,2025-02-27 18:43:00,11
5328,ORD_5329,25132,KABEER ART Super Combo Mechanical Pencil with 5 Black Lead Refills And 12 Color Lead Refills,Warehouse B,24,18,2025-02-27 07:17:00,6
5329,ORD_5330,13187,XX Revolution bronzer demo 6.5 gm,Warehouse C,73,58,2025-02-27 21:17:00,15
5330,ORD_5331,25125,Triphala Capsules,Warehouse B,35,17,2025-02-27 03:42:00,18
5331,ORD_5332,21437,"Redmi 10000mAh Lithium Polymer Power Bank with 10 Watt Fast Charging, (White)",Warehouse C,56,42,2025-02-27 01:35:00,14
5332,ORD_5333,15319,"Spigen RFID Aluminium Blocking Wallet Slim Minimalist Credit Card Holder with Key Ring up to 12 Cards, Carabiner for Men a...",Warehouse A,101,85,2025-02-27 06:05:00,16
5333,ORD_5334,2360,Amxvio CV 500mg/125mg Tablet,Warehouse B,85,71,2025-02-27 21:23:00,14
5334,ORD_5335,3455,Zimnic CV 50 mg/31.25 mg Dry Syrup,Warehouse C,55,50,2025-02-27 19:20:00,5
5335,ORD_5336,8685,O3+ Professional D-Tan with Meladerm Brightening & Whitening Day and Night Cream - Clear & Bright Complexion Kit for All S...,Warehouse B,70,59,2025-02-27 04:46:00,11
5336,ORD_5337,15180,Camp 8mg/325mg Tablet,Warehouse B,51,36,2025-02-27 02:46:00,15
5337,ORD_5338,21688,Spa Rejuvenation Shampoo,Warehouse C,84,67,2025-02-27 07:38:00,17
5338,ORD_5339,15198,"Bonjour Paris Coat Me Nail Polish Absolute Nail Lock, Top Coat / Base Coat",Warehouse C,52,45,2025-02-27 10:18:00,7
5339,ORD_5340,32996,Bella Vita Organic Coffee 3 In 1 Tinty For Lips 8 gm,Warehouse A,67,51,2025-02-27 18:33:00,16
5340,ORD_5341,8687,Pantolis-DSR Capsule,Warehouse A,72,57,2025-02-27 11:16:00,15
5341,ORD_5342,26532,"Rhymestore Replacement USB Charger for Noise ColorFit Pro 3 / Pro 2 / Pro 2 Oxy/Pulse/Ultra/Nav, Nav+ / Brio/NoiseFit Acti...",Warehouse B,71,56,2025-02-27 12:40:00,15
5342,ORD_5343,8583,Natural Anti Chafing Rash Cream,Warehouse A,66,59,2025-02-27 03:56:00,7
5343,ORD_5344,21890,Gersulide Plus 100 mg/500 mg Tablet,Warehouse A,106,98,2025-02-27 19:38:00,8
5344,ORD_5345,21740,KANHIYA S.R.K Combo Face Makeup Kit With 7pcs Makeup Brush Set With Tya 6155 Makeup Kit + 2 Pc Beauty Blender Multicolour ...,Warehouse B,47,40,2025-02-27 16:51:00,7
5345,ORD_5346,5889,Ajmal Mukhallat Raaqi Concentrated Perfume Oil Floral Fruity And Carbon Homme Deodorant Citrus Spicy Fragrance 210 ml,Warehouse B,50,31,2025-02-27 08:50:00,19
5346,ORD_5347,30388,Emery Boards (MP-15),Warehouse B,109,92,2025-02-27 11:06:00,17
5347,ORD_5348,13814,"Samsung Galaxy M53 5G (Mystique Green, 8GB, 128GB Storage) | 108MP | sAmoled+ 120Hz | 16GB RAM with RAM Plus | Travel Adap...",Warehouse C,111,97,2025-02-27 04:44:00,14
5348,ORD_5349,25205,Welgrel A 75mg/75mg Tablet,Warehouse C,74,61,2025-02-27 20:47:00,13
5349,ORD_5350,7287,Ondapen Tablet MD,Warehouse B,71,52,2025-02-27 17:40:00,19
5350,ORD_5351,30427,Telmikaps 40mg Tablet,Warehouse B,91,84,2025-02-27 14:22:00,7
5351,ORD_5352,12449,Sectocef O Kid 100mg/100mg Tablet,Warehouse C,77,72,2025-02-27 19:10:00,5
5352,ORD_5353,8489,Mineral Rich Rejuvenating Body Wash,Warehouse C,77,61,2025-02-27 09:55:00,16
5353,ORD_5354,26401,POPIO Tempered Glass Screen Protector Compatible for OnePlus Nord with Edge to Edge Coverage and Easy Installation kit (Tr...,Warehouse B,57,41,2025-02-27 12:13:00,16
5354,ORD_5355,26403,Arata Vitamin C Morning Glow Combo With Purifying Face Wash (150 ML) & Vitamin C Day Cream (50 ML) 200 ml,Warehouse B,18,1,2025-02-27 18:36:00,17
5355,ORD_5356,3035,Belora Paris World Matte Vit C Popsicles - 003 Brick Bulgaria 4.2 gm,Warehouse B,82,73,2025-02-27 03:48:00,9
5356,ORD_5357,5943,Black Pearl Shampoo - Hair Loss & Dandruff Control,Warehouse A,52,44,2025-02-27 22:20:00,8
5357,ORD_5358,21889,Exobro 200mg Tablet SR,Warehouse B,88,78,2025-02-27 23:19:00,10
5358,ORD_5359,15156,Razer Kraken X Ultralight Gaming Headset: 7.1 Surround Sound - Lightweight Aluminum Frame - Bendable Cardioid Microphone -...,Warehouse C,70,51,2025-02-27 02:49:00,19
5359,ORD_5360,15063,Mcaffeine Coffee Hair Spa & Hair Fall Control Kit 700 ml,Warehouse A,60,47,2025-02-27 03:01:00,13
5360,ORD_5361,21883,Lsp 50mg Tablet,Warehouse A,56,40,2025-02-27 13:04:00,16
5361,ORD_5362,12423,Emergin 0.2mg Injection,Warehouse B,99,82,2025-02-27 14:35:00,17
5362,ORD_5363,33039,Canforce 2% Soap,Warehouse A,83,66,2025-02-27 09:44:00,17
5363,ORD_5364,33427,"HUMBLE Soft Silicone 19mm Smartwatch Strap Metal Button Compatible with Noise Colorfit Pro 2/Oxy/Pulse/Beat, Boat Storm Sm...",Warehouse B,72,58,2025-02-27 17:09:00,14
5364,ORD_5365,5931,"SHOPEE Branded Lens Hood, ES-68 Bayonet Mount LensHood Compatible with Canon EF 50mm F/1.8 STM Lens as L-HOODES68",Warehouse C,63,49,2025-02-27 13:50:00,14
5365,ORD_5366,15088,"GM 3207 G-On Mini 3 Pin Extension Cord 1.5 Mtr. with Indicator, Safety Shutter & 2 International Sockets",Warehouse B,61,44,2025-02-27 08:18:00,17
5366,ORD_5367,33430,Medimade Orange & Grapefruit Premium Soap 100 gm,Warehouse C,109,98,2025-02-27 19:28:00,11
5367,ORD_5368,26441,Hipower 100mg Tablet,Warehouse B,19,8,2025-02-27 11:57:00,11
5368,ORD_5369,21852,"SUGAR Cosmetics - Contour De Force - Mini Blush - 01 Peach Peak (Peach Pink Blush) - Long Lasting, Lightweight Makeup Blus...",Warehouse C,76,58,2025-02-27 19:03:00,18
5369,ORD_5370,2090,Skincare Bathing Soap Bar,Warehouse B,35,28,2025-02-27 19:51:00,7
5370,ORD_5371,26448,Berina A5 Medium Golden Brown Hair Color Cream 60 gm,Warehouse A,100,85,2025-02-27 23:09:00,15
5371,ORD_5372,21846,"Pure Tea Tree Glycerin Soap - Cold-Processed, 100% Natural & Organic",Warehouse B,65,47,2025-02-27 02:14:00,18
5372,ORD_5373,32517,SERY Mattish Lipstick Sexy Dare 3.5 gm,Warehouse C,75,65,2025-02-27 06:43:00,10
5373,ORD_5374,856,Citosys 20mg Tablet,Warehouse B,23,16,2025-02-27 19:26:00,7
5374,ORD_5375,18927,Xtrwaq 150mg Tablet,Warehouse C,99,81,2025-02-27 12:09:00,18
5375,ORD_5376,32415,Ajmal Avid Homme Wisal Deodorant Spray (Pack of 2) 200 ml,Warehouse C,45,30,2025-02-27 19:07:00,15
5376,ORD_5377,11009,"Wings Powerpods Wireless Earbuds with Powerbank Function, 150 Hours Playtime, Massive 2500mAh Digital Display Battery, Low...",Warehouse A,95,87,2025-02-27 02:42:00,8
5377,ORD_5378,17845,"Helix Timex Metalfit SPO2 smartwatch with Full Metal Body and Touch to Wake Feature, HRM, Sleep & Activity Tracker",Warehouse A,83,78,2025-02-27 19:33:00,5
5378,ORD_5379,35863,Gemblue Biocare Rose Petal Scrub 500 ml,Warehouse C,18,11,2025-02-27 06:41:00,7
5379,ORD_5380,755,"ProElite Smart Flip Case Cover for Apple iPad 10.2"" 9th Gen (2021) / 8th Gen / 7th Gen with Stylus Pen, Gold",Warehouse C,56,45,2025-02-27 11:40:00,11
5380,ORD_5381,2765,Eazythrot 500mg Tablet,Warehouse B,44,26,2025-02-27 18:18:00,18
5381,ORD_5382,35736,SupCares Edge to Edge Privacy Tempered Glass for iPhone 11 and iPhone XR (6.1 Inch) with Easy Self Installation Kit | Black,Warehouse B,56,42,2025-02-27 08:19:00,14
5382,ORD_5383,18220,"Adult Diapers Economy, Medium",Warehouse A,77,72,2025-02-27 10:08:00,5
5383,ORD_5384,10572,Pantia 40mg Tablet,Warehouse B,44,31,2025-02-27 19:02:00,13
5384,ORD_5385,32438,Mandnac-SP Tablet,Warehouse B,39,28,2025-02-27 12:15:00,11
5385,ORD_5386,18394,"Ambrane 30W USB Boosted Speed Dual Output Port Fast Charger with QC & PD Technology, Made in India, Multiple Layers of Pro...",Warehouse A,71,57,2025-02-27 19:33:00,14
5386,ORD_5387,35962,Snocef 200mg Tablet,Warehouse B,92,87,2025-02-27 17:30:00,5
5387,ORD_5388,10997,TWC Tampons With Applicator + Panty Liners Combo 360 gm,Warehouse A,80,72,2025-02-27 06:47:00,8
5388,ORD_5389,28495,Dgkryp M 50mg/750mg/250mg Tablet,Warehouse B,21,8,2025-02-27 16:22:00,13
5389,ORD_5390,32419,Flormar Quick Dry Nail Enamel QD22 Red Velvet 11 ml,Warehouse C,90,75,2025-02-27 19:51:00,15
5390,ORD_5391,10456,"Maybelline New York Fit Me Matte+Poreless Liquid Foundation Tube, 115 Ivory, 18ml and Maybelline New York Fit Me Conceale...",Warehouse B,84,69,2025-02-27 13:28:00,15
5391,ORD_5392,18430,Gemprime Trio LV 2mg/500mg/0.2mg Tablet SR,Warehouse A,40,26,2025-02-27 22:22:00,14
5392,ORD_5393,18444,Cortent Cream,Warehouse B,44,36,2025-02-27 12:01:00,8
5393,ORD_5394,28472,Bio Berberry 200 Ml Bxl Cleansing Solution 190 Ml,Warehouse A,73,54,2025-02-27 01:32:00,19
5394,ORD_5395,28462,MOSHKING Back Cover for OnePlus Nord CE 2 Lite 5G / 1+ Nord CE 2 Lite 5G with Slide Camera | Heavy Duty Military Grade Pro...,Warehouse B,65,60,2025-02-27 19:29:00,5
5395,ORD_5396,28459,"ClubComfort� Music Flower Black & Brown Gel Eyeliner,Beauty 8 Shades Concealer,Oval Makeup Brush Pack of 3",Warehouse A,81,73,2025-02-27 13:30:00,8
5396,ORD_5397,4813,"ProElite Smart Flip Case Cover for Lenovo Tab P11/P11 Plus 11 inch TB-J606F/J606X , Black",Warehouse B,112,97,2025-02-27 17:53:00,15
5397,ORD_5398,18385,NAUTICA Aqua Rush Gold Eau de Toilette - 100 ml (For Men),Warehouse C,34,15,2025-02-27 13:23:00,19
5398,ORD_5399,18518,CROSSVOLT Compatible Dash/Warp Data Sync Fast Charging Cable Supported for All C Type Devices [Cable],Warehouse B,97,91,2025-02-27 01:38:00,6
5399,ORD_5400,18519,Rowasa 500mg Pellets,Warehouse C,96,83,2025-02-27 07:18:00,13
5400,ORD_5401,10811,Lakme Enrich Matte Lipstick Shade Pm15 4.7 Gm,Warehouse B,30,23,2025-02-27 18:43:00,7
5401,ORD_5402,4586,Zoxicef 50mg Dry Syrup,Warehouse C,57,49,2025-02-27 07:27:00,8
5402,ORD_5403,4684,"Faber Castell Graded Drawing Pencil, Pack of 6 (Black)",Warehouse B,93,74,2025-02-27 09:45:00,19
5403,ORD_5404,28886,"Redmi K50i 5G (Stealth Black, 6GB RAM, 128GB Storage) | Flagship Mediatek Dimensity 8100 Processor | 144Hz Liquid FFS Disp...",Warehouse C,114,97,2025-02-27 15:36:00,17
5404,ORD_5405,724,"L'Oreal Paris 6 Oil Nourish Shampoo, 1 ltr",Warehouse C,41,36,2025-02-27 09:55:00,5
5405,ORD_5406,28662,Citapure Forte Tablet,Warehouse C,45,38,2025-02-27 14:10:00,7
5406,ORD_5407,4699,Albela 400mg Tablet,Warehouse A,57,50,2025-02-27 12:53:00,7
5407,ORD_5408,4439,Evoke Silver Edition Perfume Deodorant For Men,Warehouse B,42,32,2025-02-27 12:44:00,10
5408,ORD_5409,10598,SanDisk SDCZ48-032G-UAM46 Ultra CZ48 32GB USB 3.0 Pen Drive (Black),Warehouse B,66,48,2025-02-27 16:22:00,18
5409,ORD_5410,18203,Daily Life Forever52 Bent Eye Liner Brush Nx029 1's,Warehouse C,52,39,2025-02-27 18:37:00,13
5410,ORD_5411,29151,Nurokind-G  Tablet,Warehouse B,92,76,2025-02-27 19:34:00,16
5411,ORD_5412,28634,Cyafe 1gm Injection,Warehouse C,38,32,2025-02-27 00:23:00,6
5412,ORD_5413,4424,"Duracell USB Lightning Apple Certified (Mfi) Braided Sync & Charge Cable For Iphone, Ipad And Ipod. Fast Charging Lightnin...",Warehouse A,53,44,2025-02-27 09:53:00,9
5413,ORD_5414,11040,"mobistyle iPhone 14 Pro Cover,Luxury Electroplating TPU Logo Cut Case, Individual Camera Protection for Each Lens Back Cov...",Warehouse B,63,44,2025-02-27 12:52:00,19
5414,ORD_5415,17930,Charmacy Milano 360 Volume Mascara (Black) 8 gm,Warehouse A,50,44,2025-02-27 17:24:00,6
5415,ORD_5416,10748,"Lecherous Fit Me Compact Powder That Protects Skin From Sun, Absorbs Oil, Sweat and Helps You To Stay Fresh For Upto 12Hr...",Warehouse C,111,93,2025-02-27 21:49:00,18
5416,ORD_5417,28959,"Color Mate Herbal Based Ammonia Free Hair Colour with Ayur Product In Combo, 454g - 9.2 Natural Brown",Warehouse B,60,53,2025-02-27 02:24:00,7
5417,ORD_5418,29013,DeBelle Gel Nail Lacquer Mystique Green Pastel Green Nail Polish 8 ml,Warehouse B,14,2,2025-02-27 08:43:00,12
5418,ORD_5419,17617,Cwiz 200mg Tablet,Warehouse B,93,75,2025-02-27 14:47:00,18
5419,ORD_5420,17653,TheGiftKart Tough Armor OnePlus Nord CE 2 5G Bumper Back Case Cover | Ring Holder & Kickstand in-Built | 360 Degree Protec...,Warehouse C,58,48,2025-02-27 18:51:00,10
5420,ORD_5421,775,SanDisk SDCZ50-128G-I35 USB2.0 128 GB Pen Drive (Red and Black),Warehouse B,63,56,2025-02-27 00:28:00,7
5421,ORD_5422,28933,"Verilux® USB C Hub Multiport Adapter- 6 in 1 Portable Aluminum Type C Hub with 4K HDMI Output, USB 2.0/3.0 Ports, SD/Micro...",Warehouse B,40,29,2025-02-27 10:22:00,11
5422,ORD_5423,17585,Passion Indulge Body Lotion Papain (pack of 2) 1's,Warehouse A,90,72,2025-02-27 01:33:00,18
5423,ORD_5424,35796,Rabbi 20mg Tablet,Warehouse C,49,34,2025-02-27 17:05:00,15
5424,ORD_5425,17737,"Aroma Magic Aloe Vera Sun Screen Gel, 100ml",Warehouse B,82,73,2025-02-27 10:18:00,9
5425,ORD_5426,10864,Oflobid 200mg Tablet,Warehouse A,102,89,2025-02-27 21:34:00,13
5426,ORD_5427,17741,"Infinity (JBL Fuze Pint, Wireless Ultra Portable Mini Speaker with Mic, Deep Bass, Dual Equalizer, Bluetooth 5.0 with Voic...",Warehouse A,66,48,2025-02-27 02:48:00,18
5427,ORD_5428,17565,"Redmi Note 11 (Horizon Blue, 4GB RAM, 64GB Storage) | 90Hz FHD+ AMOLED Display | Qualcomm® Snapdragon™ 680-6nm | 33W Charg...",Warehouse A,44,35,2025-02-27 10:43:00,9
5428,ORD_5429,28882,Cipad 250mg Tablet,Warehouse A,101,94,2025-02-27 12:33:00,7
5429,ORD_5430,17465,FIFINE T669 Condenser USB Microphone Kit with Adjustable Scissor Arm Stand Shock Mount for PC and MAC Only (Does not Work ...,Warehouse B,59,44,2025-02-27 01:44:00,15
5430,ORD_5431,10374,Archies Parfum NEW BOYZ PARFUM ORIGINAL 50 ml,Warehouse B,93,86,2025-02-27 23:54:00,7
5431,ORD_5432,18543,Hello Zone Exclusive Matte Finish Soft Back Case Cover for OnePlus Nord CE 2 Lite 5G - Black,Warehouse C,74,66,2025-02-27 22:01:00,8
5432,ORD_5433,18544,Oulm Yellow Pu Women's Wallet (WA5),Warehouse A,62,52,2025-02-27 22:02:00,10
5433,ORD_5434,9841,"Rich Creme Hair Colour - Shade 1 Natrual Black, Single Use",Warehouse C,91,72,2025-02-27 05:21:00,19
5434,ORD_5435,927,Anpod 200mg Tablet,Warehouse B,66,49,2025-02-27 07:16:00,17
5435,ORD_5436,17212,Medimade Vitamin E Body Butter (Pack of 2) 1's,Warehouse A,98,83,2025-02-27 00:12:00,15
5436,ORD_5437,10499,"Apple Magic Mouse (for Bluetooth-Enabled Mac with OS X 10.11 or Later, iPad with iPadOS 13.4 or Later)",Warehouse A,113,99,2025-02-27 21:32:00,14
5437,ORD_5438,10498,Ajmal Silver Shade EDP Citrus Woody Perfume And Avid Homme Deodorant Aquatic Woody Fragrance 300 ml,Warehouse B,87,68,2025-02-27 23:40:00,19
5438,ORD_5439,17211,ROKCY Skingenious SPF 30 BB Cream (Rich Honey 03),Warehouse A,112,99,2025-02-27 06:24:00,13
5439,ORD_5440,549,Easevert 16 Tablet,Warehouse C,59,47,2025-02-27 00:19:00,12
5440,ORD_5441,3885,"doodle - THE JOY OF WRITING Initial R Lasercut Soft Bound Diary Notebook for Girls (6.69 X 4.72 X 0.5 Inch, 80 GSM, 192 Pa...",Warehouse B,105,95,2025-02-27 07:46:00,10
5441,ORD_5442,1103,"iBELL 5MPLUS Extension Cord / Board with 5 Meter Cord Length, 5 Way Multi Socket Spike Guard, 2500W, 10A, Individual Switc...",Warehouse B,31,24,2025-02-27 22:41:00,7
5442,ORD_5443,27846,Endoxan 1000mg Injection,Warehouse C,18,5,2025-02-27 09:45:00,13
5443,ORD_5444,9836,Amozo Ultra Hybrid Back Cover Case for iPhone 13 (Polycarbonate|Transparent) (Green),Warehouse B,111,99,2025-02-27 09:40:00,12
5444,ORD_5445,19481,Recharge 24x7 Long Lasting Deodorant Body Spray For Men,Warehouse B,73,61,2025-02-27 21:44:00,12
5445,ORD_5446,32612,Tenesidh 20 Tablet,Warehouse A,42,26,2025-02-27 19:08:00,16
5446,ORD_5447,32620,Cifimag 200mg Tablet DT,Warehouse B,85,66,2025-02-27 17:44:00,19
5447,ORD_5448,9843,"Rose Water Balancing Mist Spray - With Cardamom, Aloe Vera, Rose Extract",Warehouse A,35,24,2025-02-27 03:39:00,11
5448,ORD_5449,29280,Odaril Syrup,Warehouse B,110,97,2025-02-27 05:04:00,13
5449,ORD_5450,27840,Curevisor Salmon Fish Oil Omega-3 1000mg (360 EPA & 240 DHA) Softgel 60 no.s,Warehouse C,63,57,2025-02-27 10:20:00,6
5450,ORD_5451,27836,Vomizen-P 40mg/4mg Tablet,Warehouse C,55,37,2025-02-27 01:33:00,18
5451,ORD_5452,29598,Ofloxibact 200mg Tablet,Warehouse A,60,46,2025-02-27 00:52:00,14
5452,ORD_5453,36195,Comet Busters Fancy Long Golden Bindi (BIN1714),Warehouse C,77,70,2025-02-27 07:36:00,7
5453,ORD_5454,11613,Levoxy 500mg Tablet,Warehouse B,68,54,2025-02-27 15:01:00,14
5454,ORD_5455,19423,2 hour Ultra Protect Gel,Warehouse B,20,15,2025-02-27 19:59:00,5
5455,ORD_5456,27866,Ximsac-CL 200mg/125mg Tablet,Warehouse B,26,7,2025-02-27 06:09:00,19
5456,ORD_5457,19451,"POCO M3 (Power Black, 6GB RAM, 64GB Storage)",Warehouse A,41,29,2025-02-27 18:11:00,12
5457,ORD_5458,32604,Brightening Day Cream,Warehouse C,51,38,2025-02-27 00:17:00,13
5458,ORD_5459,35247,"CableCreation USB C to HDMI Cable,Type C to HDMI Cable HDR 4K@60Hz,2K@144Hz,USB Type C to Hdmi Adapter Thunderbolt 3 Compa...",Warehouse A,95,89,2025-02-27 09:57:00,6
5459,ORD_5460,1092,Rabikos-DSR 30mg/20mg Capsule,Warehouse B,19,12,2025-02-27 07:35:00,7
5460,ORD_5461,3519,"Stbotanica Argan Radiance Face Oil - Skin Brightening, Anti Aging & Anti Wrinkle Serum(Stbot499) 20 ml",Warehouse C,58,52,2025-02-27 16:38:00,6
5461,ORD_5462,17213,Lisoril 20mg Tablet,Warehouse A,25,13,2025-02-27 03:12:00,12
5462,ORD_5463,28537,Banana Kit,Warehouse B,95,84,2025-02-27 17:45:00,11
5463,ORD_5464,4766,Nature's Essence Brightening Diamond Facial Kit 60 gm,Warehouse A,58,50,2025-02-27 10:36:00,8
5464,ORD_5465,10513,Red Lemon Titan Ultrafit Plus Bange Series 15.6-inch Laptop Bags Backpacks for Men and Women 55L Outdoor and Camping 3in1 ...,Warehouse B,24,13,2025-02-27 23:47:00,11
5465,ORD_5466,28410,SAMSUNG GURU MUSIC2 (SM315) (SM-315) (Gold),Warehouse A,50,36,2025-02-27 08:00:00,14
5466,ORD_5467,18550,Duopen 250mg/250mg Tablet,Warehouse C,91,85,2025-02-27 18:15:00,6
5467,ORD_5468,28398,"HUMBLE Dynamic Lapel Collar Mic Voice Recording Filter Microphone for Singing Youtube SmartPhones, Black",Warehouse C,47,33,2025-02-27 08:39:00,14
5468,ORD_5469,10349,Jaspod CV Dry Syrup,Warehouse B,106,96,2025-02-27 10:23:00,10
5469,ORD_5470,32169,Lanzorun 15mg Tablet DT,Warehouse A,26,17,2025-02-27 23:29:00,9
5470,ORD_5471,35235,NOVA CREAM Ayurvedic Cream 27 gm (Pack of 3),Warehouse B,84,79,2025-02-27 03:13:00,5
5471,ORD_5472,28507,"boAt Airdopes 441 Pro Bluetooth Truly Wireless in Ear Earbuds with mic, Upto 150 Hours Playback, Signature Sound, IPX7, BT...",Warehouse B,32,15,2025-02-27 12:16:00,17
5472,ORD_5473,29225,"Amkette Xcite Pro USB wired Keyboard for Laptop, PC and USB Support Devices with UV coated keys, 10 instant one touch Mult...",Warehouse B,22,10,2025-02-27 07:48:00,12
5473,ORD_5474,18234,Pikkme Samsung Galaxy F23 5g Flip Case Leather Finish | Inside TPU with Card Pockets | Wallet Stand and Shock Proof | Magn...,Warehouse C,57,41,2025-02-27 22:50:00,16
5474,ORD_5475,18316,"Vivo Y22 (Starlit Blue, 6GB RAM, 128GB Storage) with No Cost EMI/Additional Exchange Offers",Warehouse C,55,44,2025-02-27 07:25:00,11
5475,ORD_5476,17303,Disney Princess - Bio Almond Princess Nourishing Soap,Warehouse C,40,34,2025-02-27 12:17:00,6
5476,ORD_5477,17297,"FEDUS 12V 1A DC Power Adapter, Powers Supply, SMPS for LCD Monitor, TV, LED Strip, CCTV, 12 Volt 1 Amp Power Adapter,AC In...",Warehouse A,49,30,2025-02-27 01:37:00,19
5477,ORD_5478,17293,Fairness Naturals Hair Removal Cream Fair & Soft Turmeric - Oily Skin,Warehouse A,73,67,2025-02-27 09:21:00,6
5478,ORD_5479,17289,Kool 20 Tablet,Warehouse B,35,19,2025-02-27 16:23:00,16
5479,ORD_5480,17286,Oppo Enco Air 2 Pro Bluetooth Truly Wireless in Ear Earbuds with Mic - White,Warehouse A,59,46,2025-02-27 11:22:00,13
5480,ORD_5481,17283,"Kabeer Art Mechanical Pencil With Clutch Mechanism For 2B, 4B, 6B, 8B Leads + 6 Lead Refills (4B/5.6mm)",Warehouse C,40,31,2025-02-27 13:15:00,9
5481,ORD_5482,10547,Nutriment Cocobutter Cream All Skin Type 250 gm,Warehouse C,22,10,2025-02-27 05:50:00,12
5482,ORD_5483,11158,Pikkme Samsung Galaxy A50 / A50s / A30s Smoke Cover Protective Shockproof Matte Hard Back Case Cover for Samsung Galaxy A5...,Warehouse B,99,81,2025-02-27 20:40:00,18
5483,ORD_5484,10539,"Cosmic Byte CB-EP-05 Wired Gaming in Ear Earphone with Microphone Detachable for PC, PS4, Mobiles, Tablets (Black)",Warehouse B,73,56,2025-02-27 13:39:00,17
5484,ORD_5485,17270,Rycol 250mg Capsule,Warehouse A,84,76,2025-02-27 11:29:00,8
5485,ORD_5486,18322,"Quantum QHM-7406 Full-Sized Keyboard with (₹) Rupee Symbol, Hotkeys and 3-pieces LED function for Desktop/Laptop/Smart TV ...",Warehouse B,105,96,2025-02-27 08:44:00,9
5486,ORD_5487,18378,Curvimox CV 500mg/125mg Tablet,Warehouse C,44,30,2025-02-27 04:44:00,14
5487,ORD_5488,18335,Hair Fruits Shining Black Conditioning Shampoo,Warehouse B,60,44,2025-02-27 23:25:00,16
5488,ORD_5489,11173,Omibook D 10mg/20mg Capsule,Warehouse C,93,87,2025-02-27 02:57:00,6
5489,ORD_5490,28667,Fashion Colour Papaya Face Scrub 130 gm,Warehouse C,98,91,2025-02-27 06:02:00,7
5490,ORD_5491,18114,Augprime Tablet,Warehouse C,95,89,2025-02-27 18:33:00,6
5491,ORD_5492,18934,Safpod 200mg Tablet,Warehouse C,92,75,2025-02-27 21:47:00,17
5492,ORD_5493,28255,Zomet SR Tablet,Warehouse A,99,86,2025-02-27 20:45:00,13
5493,ORD_5494,18728,Notear Eye Drop,Warehouse A,44,25,2025-02-27 10:24:00,19
5494,ORD_5495,2812,Maryaj Deuce Femme EDP Floral Fruity Perfume And Ajmal Aurum Femme Deodorant Fruity Floral Fragrance 300 ml,Warehouse B,94,85,2025-02-27 12:16:00,9
5495,ORD_5496,18730,Sit 10mg Tablet,Warehouse A,38,30,2025-02-27 01:12:00,8
5496,ORD_5497,10234,"DDPAI Mini Car Dash Camera, Full HD 1080p, 140° Wide Angle, F2.0 Aperture, Super-Capacitor, G-Sensor, WiFi, Parking Mode, ...",Warehouse C,89,72,2025-02-27 16:12:00,17
5497,ORD_5498,11339,Insight Cosmetics Instant Glow Liquid Illuminator - Bronze 18 ml,Warehouse C,32,15,2025-02-27 05:13:00,17
5498,ORD_5499,16972,Benefit Cosmetics Hoola Matte Bronzer - 0.14 oz / 4 g - travel size by Benefit Cosmetics,Warehouse B,66,56,2025-02-27 06:09:00,10
5499,ORD_5500,28276,"True-Ally Heavy Duty 50 Pcs 200 Micron Transparent Document Sleeves, Leaf Sheet Clear Certificates, Waterproof Sheet Prote...",Warehouse B,85,80,2025-02-27 10:59:00,5
5500,ORD_5501,18761,Spigen Lithium Polymer 10000 mAh 3 in 1 Wireless Charging Power Bank with USB-A | USB-C 20W Fast Charging - Black,Warehouse B,26,11,2025-02-27 03:13:00,15
5501,ORD_5502,10217,Marshall Willen Portable Bluetooth Speaker - Black & Brass,Warehouse A,59,41,2025-02-27 18:30:00,18
5502,ORD_5503,10209,"Cooler Master Cryofuze Violet Thermal Paste - For Processor, GPU, Console, Laptop | 12.6 W/m-K Thermal Conductivity | Exce...",Warehouse C,57,38,2025-02-27 04:11:00,19
5503,ORD_5504,16961,Psyllium Husk Powder,Warehouse C,93,86,2025-02-27 07:51:00,7
5504,ORD_5505,35456,Kodak 98 cm (40 inches) Full HD Certified Android LED TV 40FHDX7XPRO (Black),Warehouse A,15,1,2025-02-27 20:40:00,14
5505,ORD_5506,623,F 1mg Tablet,Warehouse B,89,74,2025-02-27 00:32:00,15
5506,ORD_5507,980,"ZEBRONICS Zeb-JUKEBAR 3900, 80W Multimedia soundbar with subwoofer Supporting Bluetooth, HDMI(ARC), Coaxial Input, AUX, US...",Warehouse B,89,77,2025-02-27 00:37:00,12
5507,ORD_5508,10096,Xoftad S 250mg/125mg Injection,Warehouse C,38,23,2025-02-27 09:48:00,15
5508,ORD_5509,19395,Rapsol 40mg Injection,Warehouse A,63,45,2025-02-27 11:48:00,18
5509,ORD_5510,2598,Piotrex 15mg Tablet,Warehouse B,37,21,2025-02-27 15:07:00,16
5510,ORD_5511,5058,ODDCLICK womens day greetings card womens day gift for ladies gifts for ladies (Set of 8),Warehouse C,69,60,2025-02-27 17:47:00,9
5511,ORD_5512,19221,"Paraspapermart A4 Ruled White Project Sheets (100 Sheets, Both Side Ruled)",Warehouse A,108,99,2025-02-27 09:16:00,9
5512,ORD_5513,19226,Ajmal Nightingale & Distraction & Magnetize Deo & Yearn EDP Pack of 3 20 ml,Warehouse A,38,30,2025-02-27 21:05:00,8
5513,ORD_5514,36148,Diclospeed SP 50mg/325mg/15mg Tablet,Warehouse B,31,13,2025-02-27 19:17:00,18
5514,ORD_5515,1057,Tryptinol 25 Tablet,Warehouse B,39,31,2025-02-27 15:39:00,8
5515,ORD_5516,32577,"Faces Eye Pencil - Solid Black, 1.2g Each",Warehouse B,11,3,2025-02-27 21:26:00,8
5516,ORD_5517,19248,"Ceptics Europe Travel Adapter, India to Europe (Schuko) plug - Type E/F European plug adapter, Universal adapter for Europ...",Warehouse B,99,86,2025-02-27 06:16:00,13
5517,ORD_5518,27991,Protective Case Compatible for Philips OneBlade Trimmer and Accessories - Compatible with QP2525/10 QP2630/70 Cordless One...,Warehouse A,25,16,2025-02-27 13:40:00,9
5518,ORD_5519,5077,Dalvo-M Syrup,Warehouse C,82,73,2025-02-27 04:34:00,9
5519,ORD_5520,9938,Nutrazol D 30mg/20mg Capsule SR,Warehouse B,19,3,2025-02-27 10:17:00,16
5520,ORD_5521,11331,Ajmal CD 99 Mukhallat Concentrated Perfume Oil Floral Oriental Attar And Impress Concentrated Perfume Oil Citrus Attar 24 ml,Warehouse A,39,34,2025-02-27 14:25:00,5
5521,ORD_5522,10259,Bilbil-M Tablet,Warehouse A,49,34,2025-02-27 08:26:00,15
5522,ORD_5523,32220,Nutriment Gold Mask All Skin Type 300 gm,Warehouse C,40,23,2025-02-27 21:35:00,17
5523,ORD_5524,18989,"realme Buds Wireless 2 Neo Bluetooth in Ear Earphones with Mic, Fast Charging & Up to 17Hrs Playtime (Black)",Warehouse A,39,27,2025-02-27 21:59:00,12
5524,ORD_5525,32519,"SupCares Edge to Edge Tempered Glass for Samsung Galaxy M33 5G, Galaxy M13, Galaxy M13 5G, Galaxy M23 5G, Galaxy A23, and ...",Warehouse B,78,63,2025-02-27 17:47:00,15
5525,ORD_5526,18936,Flormar Dipliner Black 3.5 ml,Warehouse B,72,66,2025-02-27 12:05:00,6
5526,ORD_5527,29423,Amazon Brand - Solimo Back Cover Case for Mi Poco F1 | Compatible for Mi Poco F1 Back Cover Case | 360 Degree Protection |...,Warehouse B,88,80,2025-02-27 02:30:00,8
5527,ORD_5528,29426,"RPM Euro Games Gaming Keyboard Wired 7 Color LED Illuminated & Spill Proof Keys, Black, Medium",Warehouse C,21,9,2025-02-27 00:09:00,12
5528,ORD_5529,10111,"DESOFICON [Apple MFi Certified] Lightning to 3.5mm AUX Stereo Audio Cable, Nylon iPhone Aux Cord Adapter for Car Compatibl...",Warehouse C,95,76,2025-02-27 05:37:00,19
5529,ORD_5530,18948,LOHAYA Bluetooth Voice Command Remote for Xiaomi Redmi Mi Smart Android Tv Remote Control Compatible With Mi 4A 4A Pro 4k ...,Warehouse A,85,71,2025-02-27 16:13:00,14
5530,ORD_5531,18949,Dicopin 50 mg/500 mg Tablet,Warehouse A,84,70,2025-02-27 11:05:00,14
5531,ORD_5532,1015,Upsilon Seize The Scent | Combo of Long-Lasting Pocket Perfumes | Eau De Parfum for Men | Exotic Perfume | Luxury Gift Set...,Warehouse C,50,40,2025-02-27 01:42:00,10
5532,ORD_5533,16863,Vega Fan Brush (EV - 11) 14 gm,Warehouse A,94,87,2025-02-27 00:59:00,7
5533,ORD_5534,32526,Densor P Tablet,Warehouse C,24,9,2025-02-27 09:21:00,15
5534,ORD_5535,28153,Trixil Syrup,Warehouse A,18,1,2025-02-27 12:34:00,17
5535,ORD_5536,18985,"boAt Airdopes 113 Bluetooth Truly Wireless in Ear Earbuds with ENx Tech, Beast Mode, ASAP Charge, 24H Playtime, Immersive ...",Warehouse B,82,68,2025-02-27 04:37:00,14
5536,ORD_5537,2604,Maktryp 90mg/48mg/100mg Tablet,Warehouse B,30,17,2025-02-27 15:19:00,13
5537,ORD_5538,2630,Allure Classic Eyeshadow and Round Eye Brush (Set of 2 C-5 & C18) 1's,Warehouse B,50,45,2025-02-27 02:48:00,5
5538,ORD_5539,10098,"7X Beard Oil - Lavender, 7 Premium Oils Supports Beard Growth & Nourishment",Warehouse B,82,77,2025-02-27 09:06:00,5
5539,ORD_5540,16909,Skippod 200mg Tablet,Warehouse B,72,65,2025-02-27 22:21:00,7
5540,ORD_5541,10157,"Fashion Colour Proffessional Makeup Kit, Fc516c 16.8 gm",Warehouse C,97,85,2025-02-27 11:16:00,12
5541,ORD_5542,11364,Urban Gabru Beard Color - Natural Black 70 gm,Warehouse C,87,70,2025-02-27 17:42:00,17
5542,ORD_5543,36034,Mecotec-Plus Injection,Warehouse C,82,72,2025-02-27 13:56:00,10
5543,ORD_5544,32470,Tricort 6mg Tablet,Warehouse B,42,25,2025-02-27 12:50:00,17
5544,ORD_5545,18629,Daily Life Forever52 Star Dust Eyeshadow Glitter Sd014 2.5 gm,Warehouse B,48,42,2025-02-27 11:20:00,6
5545,ORD_5546,32474,Tbr Tablet,Warehouse B,61,42,2025-02-27 01:07:00,19
5546,ORD_5547,35503,Vertimine 24mg Tablet,Warehouse A,96,80,2025-02-27 06:04:00,16
5547,ORD_5548,29330,Pure Talcum Powder For Men & Women - For Gentle Fragrance & Reliable Protection Against Body Odour,Warehouse A,106,94,2025-02-27 08:56:00,12
5548,ORD_5549,29331,Amazon Basics USB Type-C to USB-A Male 3.1 Gen2 Charging Adapter Charger Cable - 3 Feet (0.9 Meters) - Black,Warehouse C,6,1,2025-02-27 06:10:00,5
5549,ORD_5550,29333,"Portronics Power PRO 10K 10000mAh Power Bank with Dual Output Emergency Mobile Charger (Black, Lithium_Polymer)",Warehouse C,25,6,2025-02-27 15:11:00,19
5550,ORD_5551,18660,"Deejay Pedicure Tools for Feet - Pedicure Kit,Foot Scrubber for Dead Skin, Callus Remover, Foot Scraper, Foot File, Pitchf...",Warehouse A,54,40,2025-02-27 04:51:00,14
5551,ORD_5552,9935,Vega Detangling Comb (HMC - 28) 39 gm,Warehouse B,70,53,2025-02-27 10:43:00,17
5552,ORD_5553,559,Limgesia 100mg/325mg/15mg Tablet,Warehouse C,112,93,2025-02-27 22:01:00,19
5553,ORD_5554,19290,Odeworm 400mg Tablet,Warehouse B,78,62,2025-02-27 13:24:00,16
5554,ORD_5555,36112,RISSACHI Heavy Duty Wall & Ceiling Mounts for 14 to 42 inch LED/LCD TV (Black),Warehouse A,31,26,2025-02-27 05:20:00,5
5555,ORD_5556,35343,XX Revolution XX Shadow Palette XXtravaganza,Warehouse C,108,91,2025-02-27 18:11:00,17
5556,ORD_5557,10021,"STAMIO Amla, Reetha, Shikakai, Bhringraj and Hibiscus Powder Combo Pack for Hair Care, Wash, Healthy Scalp, Nourishment, M...",Warehouse A,27,21,2025-02-27 14:44:00,6
5557,ORD_5558,19146,Nutriment Seaweed Hair Mask 250 gm,Warehouse A,57,46,2025-02-27 00:42:00,11
5558,ORD_5559,5031,"IFB 6.5 Kg 5 Star Top Load Washing Machine Aqua Conserve (TL-REWS 6.5KG AQUA, White, 2X Power Dual Steam, Inbuilt Heater)",Warehouse B,56,37,2025-02-27 03:37:00,19
5559,ORD_5560,10010,Manish Malhotra Beauty By MyGlamm Honey & Nutmeg Hydrating Sheet Mask 25 ml,Warehouse C,23,7,2025-02-27 20:26:00,16
5560,ORD_5561,2830,"Apple Magic Wireless Keyboard - US English - Silver (for Mac with macOS 11.3 or Later, iPad Running iPad OS 14.5 or Later)",Warehouse A,102,89,2025-02-27 08:54:00,13
5561,ORD_5562,5040,"Face Wash - Oil Control, Active",Warehouse B,95,90,2025-02-27 16:48:00,5
5562,ORD_5563,16726,"RUPALI 7pcs Makeup Brush Set With perfect Makeup eyeshadow Kit,3d Contour Stick,primer, Fixer, Foundation, Kajal, Waterpro...",Warehouse C,88,75,2025-02-27 04:03:00,13
5563,ORD_5564,5045,Ajmal Musk Rose CP And Aurum CP & Neea EDP Of Pack of 3 20 ml,Warehouse A,93,78,2025-02-27 03:02:00,15
5564,ORD_5565,11495,Wottagirl! Perfume Spray - Pure Paradise,Warehouse B,97,90,2025-02-27 18:10:00,7
5565,ORD_5566,582,"Samsung Original 15W Wireless Charger Pad for Cellular Phones, Black",Warehouse C,16,9,2025-02-27 15:35:00,7
5566,ORD_5567,36015,Allerblis 20mg Tablet,Warehouse B,114,99,2025-02-27 08:14:00,15
5567,ORD_5568,4865,Allure 3 in 1 Face Brush set 1's,Warehouse C,110,93,2025-02-27 12:28:00,17
5568,ORD_5569,19294,Aziport-XL Oral Suspension,Warehouse B,34,23,2025-02-27 23:00:00,11
5569,ORD_5570,17981,Maxpod 200mg Tablet,Warehouse C,25,19,2025-02-27 10:11:00,6
5570,ORD_5571,17436,"Mi Smart Bedside Lamp 2 (16 Million Colors, App-Enabled, Touch Panel)",Warehouse A,94,88,2025-02-27 22:39:00,6
5571,ORD_5572,28761,Atnemol MF Oral Suspension,Warehouse B,63,48,2025-02-27 10:49:00,15
5572,ORD_5573,11057,Aloja 25 Tablet,Warehouse A,11,5,2025-02-27 00:31:00,6
5573,ORD_5574,11062,CEDO Oppo A53 / A33 Back Cover | Matte Soft Silicon Flexible | Camera Bump Protection | All Side Shock Proof Rubberised Ba...,Warehouse B,79,71,2025-02-27 05:20:00,8
5574,ORD_5575,18004,SanDisk® Ultra Curve USB 3.2 32GB 100MB/s R Green,Warehouse A,74,64,2025-02-27 18:32:00,10
5575,ORD_5576,18018,D-Vel 30 Tablet,Warehouse C,62,49,2025-02-27 11:15:00,13
5576,ORD_5577,28730,Floxip OZ 500mg/500mg Tablet,Warehouse C,74,59,2025-02-27 11:28:00,15
5577,ORD_5578,17408,Executive Trial Shaving Kit,Warehouse B,25,15,2025-02-27 23:23:00,10
5578,ORD_5579,29098,"Ceptics Europe Travel Adapter, 2 in 1 India to Europe, Germany, France Schuko Adapter - Type E/F European Plug Adapter for...",Warehouse C,17,7,2025-02-27 19:33:00,10
5579,ORD_5580,35689,CEDO Samsung M21 / M30s / M21 (2021) Edition Back Cover | Matte Soft Silicon Flexible | Camera Bump Protection | All Side ...,Warehouse B,59,50,2025-02-27 01:05:00,9
5580,ORD_5581,28722,Jocefi 200mg Tablet DT,Warehouse C,21,6,2025-02-27 22:46:00,15
5581,ORD_5582,5049,"Body Lotion for Very Dry Skin - With 2x Almond Oil, For Men & Women",Warehouse A,14,1,2025-02-27 13:16:00,13
5582,ORD_5583,16754,Canefo 100mg Tablet SR,Warehouse A,89,80,2025-02-27 16:10:00,9
5583,ORD_5584,601,Makreb ED 30mg/40mg Capsule SR,Warehouse B,22,3,2025-02-27 05:53:00,19
5584,ORD_5585,2576,Spe Tulip 58Mm Flower Lens Hood (Black) For Canon Eos 55-250Mm 18-55Mm Ef Lens,Warehouse C,33,26,2025-02-27 04:33:00,7
5585,ORD_5586,29566,Loral Plus 0.25mg/25mg Tablet,Warehouse C,27,17,2025-02-27 05:49:00,10
5586,ORD_5587,19318,Selfie Concentrated Woody Perfume Free From Alcohol For Male,Warehouse C,37,27,2025-02-27 15:33:00,10
5587,ORD_5588,4205,Ashokarishta Asava Kadha - For Menstrual Issues In Women,Warehouse B,86,77,2025-02-27 08:35:00,9
5588,ORD_5589,27958,Mosgard 300mg Tablet,Warehouse A,20,6,2025-02-27 12:06:00,14
5589,ORD_5590,557,Alleto-LM Syrup,Warehouse C,27,20,2025-02-27 21:45:00,7
5590,ORD_5591,32587,Traumanil 50 mg/10 mg Tablet,Warehouse A,88,82,2025-02-27 04:08:00,6
5591,ORD_5592,19349,DeBelle Gel Nail Lacquer French Hydrangea Midtone Green Nail Polish 8 ml,Warehouse A,47,29,2025-02-27 08:56:00,18
5592,ORD_5593,36171,AmazonBasics C Cell Everyday Alkaline Batteries (4-Pack),Warehouse C,102,95,2025-02-27 07:47:00,7
5593,ORD_5594,11560,Cofhim D Syrup Sugar Free,Warehouse B,64,54,2025-02-27 13:47:00,10
5594,ORD_5595,32594,Neucitam 200mg Injection,Warehouse B,76,69,2025-02-27 05:41:00,7
5595,ORD_5596,5117,Angilos H 50mg/12.5mg Tablet,Warehouse A,34,19,2025-02-27 04:05:00,15
5596,ORD_5597,19375,Mecovibe P 750mcg/75mg Capsule,Warehouse B,102,84,2025-02-27 11:11:00,18
5597,ORD_5598,36140,Azylaj 500mg Tablet,Warehouse C,102,95,2025-02-27 10:06:00,7
5598,ORD_5599,36135,Ovaclin 300mg Capsule,Warehouse B,84,67,2025-02-27 15:44:00,17
5599,ORD_5600,19111,iVoltaa Ethernet Cable CAT6A Cable Dual Shielded (SF/UTP) Professional Series - 10Gigabit/Sec LAN Network/High Speed Inter...,Warehouse C,91,80,2025-02-27 17:54:00,11
5600,ORD_5601,19022,R.K's Aroma Facial Kit - Moringa 28 gm,Warehouse C,80,69,2025-02-27 16:05:00,11
5601,ORD_5602,11430,Fastclav 125mg/31.25mg Dry Syrup,Warehouse C,28,13,2025-02-27 15:13:00,15
5602,ORD_5603,35372,Fusiderm Cream,Warehouse C,99,92,2025-02-27 15:08:00,7
5603,ORD_5604,35370,TheGiftKart Shockproof Crystal Clear Back Cover Case for Mi Redmi Note 12 Pro 5G | 360 Degree Protection | Protective Desi...,Warehouse B,77,58,2025-02-27 19:17:00,19
5604,ORD_5605,19061,Fod CV Dry Syrup,Warehouse B,62,54,2025-02-27 19:41:00,8
5605,ORD_5606,1032,Spigen Liquid Air Back Cover Case Compatible with OnePlus 6T (TPU | Matte Black),Warehouse C,94,76,2025-02-27 20:54:00,18
5606,ORD_5607,32120,Berina Hair Shine Up Spray 250 ml,Warehouse A,103,98,2025-02-27 01:44:00,5
5607,ORD_5608,19091,Pacidom O 10mg/20mg Tablet,Warehouse C,112,94,2025-02-27 19:20:00,18
5608,ORD_5609,5016,Baby Dove Rich Moisture Soap 75 g (Pack of 3),Warehouse B,71,56,2025-02-27 17:37:00,15
5609,ORD_5610,14394,"PKST Finger Sleeves Mobile Game Controllers Anti Sweat Breathable Professional Touch Screen Thumb Gaming Gloves (1 Pair, S...",Warehouse C,98,89,2025-02-27 04:21:00,9
5610,ORD_5611,13093,Fundoo Labs Foldscope Basic Kit DIY Microscope,Warehouse B,93,77,2025-02-27 05:00:00,16
5611,ORD_5612,22995,Biosoft Dark Chocolate Premium Titanium Hd Wax 350 S ML,Warehouse B,25,20,2025-02-27 21:49:00,5
5612,ORD_5613,35168,BROTHER BT-D60BK Ink Bottle (Black),Warehouse A,32,25,2025-02-27 16:13:00,7
5613,ORD_5614,27609,Cyclo 20 mg/500 mg Tablet,Warehouse B,93,75,2025-02-27 23:40:00,18
5614,ORD_5615,36279,Tough Lee Back Cover Case for Mi Xiaomi 11i 5G / Xiaomi 11i Hypercharge 5G (Silicon|Transparent),Warehouse A,91,72,2025-02-27 04:08:00,19
5615,ORD_5616,32680,Gocough Syrup,Warehouse A,48,38,2025-02-27 00:13:00,10
5616,ORD_5617,27618,Depot 406 Transparent Shaving Gel Brushless 100 ml,Warehouse C,98,92,2025-02-27 02:23:00,6
5617,ORD_5618,6841,Medimade Licorice & Mulberry Premium Soap (Pack of 3) 1's,Warehouse C,68,56,2025-02-27 20:43:00,12
5618,ORD_5619,19790,"Hugo Boss Element EDT Spray for Men, 90ml",Warehouse C,103,98,2025-02-27 17:23:00,5
5619,ORD_5620,5280,LOHAYA Air Conditioner Remote Compatible for Voltas/Onida/Godrej/Electrolux/GREE Split/Window AC Remote Control (Please Ma...,Warehouse C,22,4,2025-02-27 16:02:00,18
5620,ORD_5621,19785,"Sery Color Flirt Nail Paint, Pastel Shimmer Nail Polish, Glazing Pink 10 ml",Warehouse C,66,49,2025-02-27 03:18:00,17
5621,ORD_5622,6842,"Perfumer's Club ""All Time Classic Fragrances for Men"" Gift Set of 3 ( Party Animal + Gentleman + Challanger) Upto 24 hrs l...",Warehouse A,59,48,2025-02-27 21:54:00,11
5622,ORD_5623,4129,Mytor 10mg Tablet,Warehouse B,40,22,2025-02-27 08:25:00,18
5623,ORD_5624,6847,Plum Candy Melts Vegan Lip Balm Melon Bubble - Yum 12 Gm,Warehouse A,7,2,2025-02-27 15:10:00,5
5624,ORD_5625,29741,Tridoz 500mg Tablet,Warehouse C,51,46,2025-02-27 04:35:00,5
5625,ORD_5626,27652,Honset 25mg Injection,Warehouse C,63,58,2025-02-27 17:00:00,5
5626,ORD_5627,19822,Daily Life Forever52 Glitz Waterproof Eyeliner Eyeshadow Glt010 0.6 gm,Warehouse C,40,27,2025-02-27 12:48:00,13
5627,ORD_5628,27655,Romantic Eau De Toilette For Women,Warehouse C,19,13,2025-02-27 16:55:00,6
5628,ORD_5629,9663,Nofyl-P Tablet,Warehouse B,21,6,2025-02-27 17:26:00,15
5629,ORD_5630,19733,"(Renewed) OnePlus 6T (Mirror Black, 6GB RAM, 128GB Storage)",Warehouse C,102,85,2025-02-27 02:30:00,17
5630,ORD_5631,35137,Anti-Pigmentation Blemish Kit - Mini,Warehouse A,22,6,2025-02-27 12:20:00,16
5631,ORD_5632,31435,Spino 10mg Tablet,Warehouse A,79,61,2025-02-27 20:25:00,18
5632,ORD_5633,9242,Sweet Basil Essential Oil,Warehouse A,32,14,2025-02-27 13:19:00,18
5633,ORD_5634,27579,ERH India Dc to Ac Dual USB Converter 12v to 220v AC Dual USB Converter Inverter Dc to Ac Dual USB Converter 12v Mini Car ...,Warehouse B,75,64,2025-02-27 21:22:00,11
5634,ORD_5635,6826,FEELHIGH Cosmetics 15 Color Soft Matte Lipstick Palette,Warehouse B,24,11,2025-02-27 11:05:00,13
5635,ORD_5636,4076,"Ceptics India to Australia Adapter Plug, China, New Zealand & More - Type I - CE Certified - RoHS Compliant - White - CE -...",Warehouse A,37,19,2025-02-27 14:37:00,18
5636,ORD_5637,16122,Mucofab 600mg Tablet,Warehouse A,94,76,2025-02-27 19:54:00,18
5637,ORD_5638,3224,COMPATIBLE AC REMOTE CONTROL FOR PANASONIC AC REMOTE 23,Warehouse B,111,94,2025-02-27 17:42:00,17
5638,ORD_5639,16140,SKYVIK TRUHOLD Car Dashboard & Windshield Cradle (Clutch) Phone Stand Holder,Warehouse B,36,29,2025-02-27 20:01:00,7
5639,ORD_5640,13452,The Woman's Company Sanitary Napkins - Day Pad 12's,Warehouse A,29,11,2025-02-27 10:58:00,18
5640,ORD_5641,24657,Spigen Rugged Armor Pro Back Cover Case Compatible with iPad Pro 11 inch (2021 | 2020 | 2018) - Black,Warehouse A,103,92,2025-02-27 20:13:00,11
5641,ORD_5642,36285,Resqdol D 80mg/250mg Tablet,Warehouse B,69,55,2025-02-27 01:31:00,14
5642,ORD_5643,20893,"Dog Cat Grooming Automatic Pet Trimmer Comb (Blue, Medium)",Warehouse A,81,64,2025-02-27 04:27:00,17
5643,ORD_5644,33729,Procin Eye Drop,Warehouse C,30,17,2025-02-27 11:33:00,13
5644,ORD_5645,15594,"Noise Buds VS103 - in-Ear Truly Wireless Earbuds with 18-Hour Playtime, HyperSync Technology, with Mic, Full Touch Control...",Warehouse B,102,93,2025-02-27 07:14:00,9
5645,ORD_5646,26930,Captiva D 10mg/20mg Tablet,Warehouse A,114,98,2025-02-27 00:47:00,16
5646,ORD_5647,5652,Edifix-LB Tablet,Warehouse C,36,23,2025-02-27 11:53:00,13
5647,ORD_5648,26881,L.A Girl HD PRO BB Cream Neutral 30 ml,Warehouse A,14,2,2025-02-27 01:00:00,12
5648,ORD_5649,26847,Fashionury Shockproof Crystal Clear Back Cover For Mi Redmi 10 / Redmi 10 Power Back Cover Case | 360 Degree Protection | ...,Warehouse C,54,45,2025-02-27 16:57:00,9
5649,ORD_5650,26855,Beauty People Natural HD Matte Lip Crayon Smile - 114 4 gm,Warehouse C,59,51,2025-02-27 06:22:00,8
5650,ORD_5651,7159,Leukast 5mg/10mg Tablet,Warehouse C,49,44,2025-02-27 05:26:00,5
5651,ORD_5652,13654,The Moms Co. Baby Wash 200 ml,Warehouse A,55,39,2025-02-27 04:24:00,16
5652,ORD_5653,30180,"Dyazo Aluminium Fine Point Stylus Pen with Spare Disk for Touch Screens Devices, Compatible with iPad/ iPhone /X/XR, Amazo...",Warehouse C,94,81,2025-02-27 22:36:00,13
5653,ORD_5654,21049,Daily Life Forever52 Waterproof Smoothenin Eye Pencil Crocodile F511 1 Gm,Warehouse C,20,2,2025-02-27 08:12:00,18
5654,ORD_5655,5680,"JBL Tune 760NC, Wireless Over Ear Active Noise Cancellation Headphones with Mic, up to 50 Hours Playtime, Pure Bass, Dual ...",Warehouse C,75,62,2025-02-27 21:32:00,13
5655,ORD_5656,26874,Lakme Forever Matte Liquid Lip Colour Orange Tango 5.6 Ml,Warehouse B,59,45,2025-02-27 14:22:00,14
5656,ORD_5657,12160,TheGiftKart Ultra-Hybrid Back Case Cover for Samsung Galaxy S20 FE / S20 FE 5G | Crystal Clear Hard Back | Shockproof Desi...,Warehouse C,50,44,2025-02-27 00:21:00,6
5657,ORD_5658,13337,Falcicure 150mg Injection,Warehouse A,27,13,2025-02-27 01:11:00,14
5658,ORD_5659,12149,"Body Spray - Perfumed, Respect",Warehouse A,14,2,2025-02-27 10:33:00,12
5659,ORD_5660,32898,"Physicians Formula Murumuru Butter Lip Cream Spf 15 - Pinkini, Pink, 3 g",Warehouse C,56,39,2025-02-27 18:09:00,17
5660,ORD_5661,21004,Fouz 120 Tablet,Warehouse C,92,83,2025-02-27 10:08:00,9
5661,ORD_5662,26913,Ayurvedic Anti Acne & Skin Whitening Treatment - Tea Tree Skin Repair Serum & Tea Tree Face Wash,Warehouse A,78,62,2025-02-27 15:14:00,16
5662,ORD_5663,20993,Fragrance & Fashion Arabic and Oud Combo Pack of 10 of 6 Ml Each,Warehouse C,80,73,2025-02-27 04:39:00,7
5663,ORD_5664,8984,Miss Claire Waterproof Eyebrow Pencil 01 Black (Mascara Brush) 1.4 Gm,Warehouse C,72,55,2025-02-27 17:05:00,17
5664,ORD_5665,20990,Eco Friendly Washing Granules - Chemical Free,Warehouse C,86,73,2025-02-27 23:40:00,13
5665,ORD_5666,33489,"Redmi SonicBass Wireless in Ear Earphones with Mic Noise Cancellation, IPX4 Splash & Sweat Proof, Multi-Point Dual Pairin...",Warehouse B,28,15,2025-02-27 23:11:00,13
5666,ORD_5667,3275,"NEXDIGITRON A3 Car Dash Camera with Hardwire Kit, 24 Hours Continuous Time-Lapse Parking Mode, 1080p H.265 F2.0 140° G-Sen...",Warehouse C,106,96,2025-02-27 05:24:00,10
5667,ORD_5668,7028,V-Guard Sesto 600 UPS for Power Backup & Protection | Capacity 600VA/300W | Working Range 140-300 VAC (Black),Warehouse B,115,96,2025-02-27 04:58:00,19
5668,ORD_5669,24410,Colizole DS 800mg/160mg Tablet,Warehouse B,71,65,2025-02-27 14:21:00,6
5669,ORD_5670,19900,"Blaupunkt BT02 Portable Wireless Bluetooth Speaker with 5W HD Sound, Deep Bass, TWS Function, AUX Input, Speaker with Mobi...",Warehouse A,46,32,2025-02-27 19:59:00,14
5670,ORD_5671,35112,"boAt LTG 650 Type C to Lightning Apple MFi Certified Cable with Spaceship Grade Aluminum Housing,3A Power Delivery Fast Ch...",Warehouse B,61,43,2025-02-27 16:58:00,18
5671,ORD_5672,33597,"ZINGTEL Flexible Shatterproof Screen Protector, 9H Hardness NanoFiber, Not a Glass, Not Edge to Edge, Impossible Screen Gu...",Warehouse C,71,63,2025-02-27 05:33:00,8
5672,ORD_5673,11716,White Perfect - Day Cream,Warehouse A,70,55,2025-02-27 17:39:00,15
5673,ORD_5674,29644,"7 Days Organic Eyebrow & Eyelash Growth Oil (Brown) | Organic -Eye Brows Eyelash Hair Growth and Volume Serum with Castor,...",Warehouse A,95,87,2025-02-27 03:20:00,8
5674,ORD_5675,19501,"Pikkme Back Cover for Samsung Galaxy M51 (Thermoplastic Polyurethane, Plastic|Black)",Warehouse A,63,57,2025-02-27 19:40:00,6
5675,ORD_5676,16485,Raflozith 250 Tablet,Warehouse A,47,38,2025-02-27 19:35:00,9
5676,ORD_5677,19493,Beauty People Velvet Matte Nail Polish Matte - Me - Cola - 1011 9.9 ml,Warehouse C,78,63,2025-02-27 09:28:00,15
5677,ORD_5678,13372,Lavender Himalayan Pink Rock Aroma Bath Salt - 100% Natural & Organic,Warehouse B,81,75,2025-02-27 16:05:00,6
5678,ORD_5679,5213,"ETZIN Mini AV2VGA to Video Converter, Composite AV to VGA Adapter, TV Set-Top Box Audio Video Converter (White)",Warehouse B,33,28,2025-02-27 01:14:00,5
5679,ORD_5680,16330,Monet Lady Diana Diva Spray Perfume 30 Ml,Warehouse A,85,78,2025-02-27 12:03:00,7
5680,ORD_5681,16292,TheGiftKart Crystal Clear Samsung Galaxy S20 FE / S20 FE 5G Back Cover Case | 360 Degree Protection | Shock Proof Design |...,Warehouse A,42,27,2025-02-27 22:09:00,15
5681,ORD_5682,35173,Cefastar 250mg Drop,Warehouse C,94,78,2025-02-27 04:33:00,16
5682,ORD_5683,9691,Sebastian Professional Penetraitt Strengthening and Repair Shampoo (50ml),Warehouse B,80,72,2025-02-27 15:53:00,8
5683,ORD_5684,27686,Fantizole 150mg Capsule,Warehouse A,108,93,2025-02-27 06:06:00,15
5684,ORD_5685,11787,AmazonBasics AAA Performance Alkaline Non-rechargeable Batteries (36 Count) - Appearance May Vary,Warehouse B,90,72,2025-02-27 22:13:00,18
5685,ORD_5686,27698,Spigen Essential Sand Blast Back Cover Case Compatible for Redmi Note 11T 5G (TPU | Matte Black),Warehouse B,31,26,2025-02-27 02:34:00,5
5686,ORD_5687,4138,"Fashion Colour Kiss Lip No Transfer Lipstick, 91 Chestnut 2.6 gm",Warehouse B,70,57,2025-02-27 19:14:00,13
5687,ORD_5688,29706,Livomed 500mg Tablet,Warehouse B,27,20,2025-02-27 22:55:00,7
5688,ORD_5689,9703,Nexcort 6mg Tablet,Warehouse A,25,12,2025-02-27 21:07:00,13
5689,ORD_5690,24779,Pantolex DSR 30mg/40mg Capsule,Warehouse B,60,51,2025-02-27 03:59:00,9
5690,ORD_5691,5240,"ZEBRONICS Zeb-Sound Bomb N1 True Wireless in Ear Earbuds with Mic ENC, Gaming Mode (up to 50ms), up to 18H Playback, BT V...",Warehouse C,26,17,2025-02-27 18:51:00,9
5691,ORD_5692,36237,Agiset 4mg Injection,Warehouse B,32,16,2025-02-27 17:09:00,16
5692,ORD_5693,24785,Sony WH-CH510 Bluetooth Wireless On Ear Headphones with Mic (Black),Warehouse A,63,49,2025-02-27 23:04:00,14
5693,ORD_5694,27713,Wilzide M 2mg/500mg Tablet,Warehouse A,37,28,2025-02-27 07:26:00,9
5694,ORD_5695,9710,"Uni Posca Paint Marker Pen, Medium Point, Set of 8 (PC-5M8C) - Multicolor",Warehouse A,16,10,2025-02-27 11:16:00,6
5695,ORD_5696,9711,Cetmon-L Tablet,Warehouse C,64,46,2025-02-27 12:28:00,18
5696,ORD_5697,32648,"Zebronics, ZEB-NC3300 USB Powered Laptop Cooling Pad with Dual Fan, Dual USB Port and Blue LED Lights",Warehouse B,85,77,2025-02-27 01:29:00,8
5697,ORD_5698,19638,Lenphor Timeless Eye Liner Gorgeous Grey 06 1.2 Gm,Warehouse C,114,99,2025-02-27 02:11:00,15
5698,ORD_5699,31475,Lava A3 (Dark Blue) - Dual Sim Mobile with 1750 mAh Big Battery and 32 GB Expandable Storage,Warehouse A,91,85,2025-02-27 10:32:00,6
5699,ORD_5700,16456,Dealfreez Protective Full Wrap Silicone Case Compatible with New Siri Apple TV 4k 2nd Generation Remote Skin-Friendly Shoc...,Warehouse C,108,95,2025-02-27 14:55:00,13
5700,ORD_5701,16443,Goldmedal Curve Plus 205101 Plastic 240 i-Strip LED Spike Guard Adaptors (White and Red),Warehouse C,37,27,2025-02-27 05:58:00,10
5701,ORD_5702,1155,Lip Butter - Chocolate,Warehouse B,52,36,2025-02-27 02:20:00,16
5702,ORD_5703,37118,Glimestar-M 2 Tablet PR,Warehouse A,64,57,2025-02-27 08:29:00,7
5703,ORD_5704,19881,Zargesic-SP Tablet,Warehouse A,50,45,2025-02-27 13:18:00,5
5704,ORD_5705,2888,Alcepod 100mg Tablet DT,Warehouse C,26,11,2025-02-27 08:36:00,15
5705,ORD_5706,29797,Serokin 10 Tablet,Warehouse C,32,19,2025-02-27 23:55:00,13
5706,ORD_5707,19871,Comb - Beard Shaping & Styling Tool,Warehouse A,27,13,2025-02-27 03:30:00,14
5707,ORD_5708,35121,Lacopsy 200 Tablet,Warehouse A,72,59,2025-02-27 00:25:00,13
5708,ORD_5709,13436,La Shield Probiotic Moisturizer Face Cream | Restores skin microbiome | 72 HR Hydration | Soft & Supple skin | For All Ski...,Warehouse C,66,55,2025-02-27 02:22:00,11
5709,ORD_5710,29791,Genericart Olmesartan Medoxomil+Chlorthalidone 20mg/12.5mg Tablet,Warehouse C,102,88,2025-02-27 09:48:00,14
5710,ORD_5711,29789,Glimsat GM 1mg/500mg Tablet,Warehouse C,92,73,2025-02-27 18:23:00,19
5711,ORD_5712,9612,Zolberg 100mg Tablet,Warehouse A,21,10,2025-02-27 16:04:00,11
5712,ORD_5713,32024,MyGlamm LIT Creamy Matte Lipstick-Flirtini 3.7 gm,Warehouse A,63,50,2025-02-27 16:12:00,13
5713,ORD_5714,27672,Encold T Tablet,Warehouse A,18,12,2025-02-27 04:45:00,6
5714,ORD_5715,19724,Amazon Brand - Solimo Bumper case for Realme 7 Pro (Silicone_Transparent),Warehouse C,48,34,2025-02-27 19:10:00,14
5715,ORD_5716,24791,Feburin 40mg Tablet,Warehouse C,61,43,2025-02-27 21:11:00,18
5716,ORD_5717,32036,"ZEBRONICS Zeb-Sound Bomb N2 TWS in Ear Earbuds with 50ms Low Latency Gaming, ENC, Voice Assistant, Flash Connect, Splash P...",Warehouse B,86,74,2025-02-27 10:45:00,12
5717,ORD_5718,19604,Physicians Formula Argan Wear Ultra-Nourishing Argan Oil Bb Cream Spf 30 - Light/Medium 35 ml,Warehouse B,40,21,2025-02-27 07:49:00,19
5718,ORD_5719,27761,Thiodoc Ace 100mg/4mg Tablet,Warehouse C,101,96,2025-02-27 16:26:00,5
5719,ORD_5720,27762,"Blue Heaven Hypergel Nailpaint - Vegas Gold, 703 11 ml",Warehouse A,76,62,2025-02-27 17:29:00,14
5720,ORD_5721,3200,Telkris 20mg Tablet,Warehouse B,38,33,2025-02-27 09:23:00,5
5721,ORD_5722,16399,MoonEyes Silky Soft Hair Extensions And Wigs Women Curly/Wavy Hair Extension For Girls To Increase Hair Volume 5 Clips in ...,Warehouse B,70,63,2025-02-27 23:24:00,7
5722,ORD_5723,9750,Kimirica skin Rejuvenating Anti-Aging serum intense revitalizer serum Rejuvenating and Hydrating serum Reduces Pigmentatio...,Warehouse A,61,45,2025-02-27 07:55:00,16
5723,ORD_5724,31469,Fastrack Casual Analog White Dial Men's Watch NM3114PP01/NN3114PP01/NP3114PP01,Warehouse B,14,5,2025-02-27 15:45:00,9
5724,ORD_5725,2852,EV Flu 150mg Tablet,Warehouse C,46,34,2025-02-27 17:55:00,12
5725,ORD_5726,11654,Maha Bhringraj Oil,Warehouse C,103,85,2025-02-27 05:53:00,18
5726,ORD_5727,5193,Faces Canada Weightless Creme Finish Lipstick Dark Cocoa 18 4 Gm,Warehouse C,39,23,2025-02-27 15:04:00,16
5727,ORD_5728,32877,Liquorice & Ginger Gentle Cleansing Milk,Warehouse C,94,88,2025-02-27 12:17:00,6
5728,ORD_5729,19960,"Swiss Beauty Pro Blusher & Highlighter Palette, Face Makeup, Shade-04, 18gm & Swiss Beauty Long lasting Misty Finish Profe...",Warehouse C,28,18,2025-02-27 03:23:00,10
5729,ORD_5730,3183,Vinole 400mg Tablet,Warehouse C,19,2,2025-02-27 09:54:00,17
5730,ORD_5731,31909,"ENVOUS Smartwatch Charger Universal Clip 2-Pin Cable, Smart Watch Fire Bolt Ring Charger Cable for W26, W26Plus, T500, T5...",Warehouse A,74,65,2025-02-27 07:35:00,9
5731,ORD_5732,31910,"Cipla Excela Moisturiser for Oily & Acne Prone Skin, 50g",Warehouse B,31,12,2025-02-27 04:03:00,19
5732,ORD_5733,24962,Mindcure LT Tablet,Warehouse C,37,21,2025-02-27 23:08:00,16
5733,ORD_5734,12035,Drozit MF 80mg/250mg Tablet,Warehouse C,111,97,2025-02-27 19:34:00,14
5734,ORD_5735,34863,HP GT 53 XL Cartridge Ink,Warehouse B,28,12,2025-02-27 04:25:00,16
5735,ORD_5736,9161,"TANTRA Tango Car Mobile Holder, Strong Magnetic Mobile Phone Stand for Car",Warehouse B,59,52,2025-02-27 20:55:00,7
5736,ORD_5737,20759,Bestor 20 Tablet,Warehouse A,76,61,2025-02-27 06:21:00,15
5737,ORD_5738,27070,Pikkme Oppo F9 Pro/Realme 2 Pro/Realme U1 Back Cover Soft Matte Liquid Silicone TPU | Camera Protection | Shockproof Slim ...,Warehouse B,51,32,2025-02-27 05:11:00,19
5738,ORD_5739,1321,"AYA Long lasting Misty Finish Professional Makeup Fixer Spray for Face makeup | Light weight, quick dry makeup Setting spr...",Warehouse A,44,39,2025-02-27 12:35:00,5
5739,ORD_5740,20744,Alclef SP Tablet,Warehouse B,37,21,2025-02-27 21:06:00,16
5740,ORD_5741,34837,Alivher Tablet,Warehouse C,35,23,2025-02-27 09:47:00,12
5741,ORD_5742,15666,Signature Maverick No Gas Body Deodorant For Men,Warehouse A,55,42,2025-02-27 21:37:00,13
5742,ORD_5743,13580,Liquorice Cold Cream,Warehouse A,52,40,2025-02-27 11:02:00,12
5743,ORD_5744,12083,Ringke Fusion-X Compatible with Samsung Galaxy S23 Ultra 5G Case Cover Transparent PC Hard Back Soft Flexible TPU Bumper S...,Warehouse B,29,10,2025-02-27 05:20:00,19
5744,ORD_5745,13568,Natural Fairness Natural Ayurvedic Saffron Soap,Warehouse B,103,96,2025-02-27 04:23:00,7
5745,ORD_5746,15677,Unicalm Plus 0.25mg/50mg Tablet,Warehouse A,72,62,2025-02-27 12:00:00,10
5746,ORD_5747,5571,Charmacy Milano Luxe Creme Lipstick (Plum) 3.8 gm,Warehouse A,23,15,2025-02-27 22:42:00,8
5747,ORD_5748,27083,Besart 50mg Tablet,Warehouse A,41,23,2025-02-27 14:39:00,18
5748,ORD_5749,12069,"BONACE 3 Pack Straps for Samsung Galaxy Watch 5 Pro 45mm/Galaxy Watch 4/5/Classic 40mm 42mm 44mm 46mm Strap, No Gap Silico...",Warehouse B,38,32,2025-02-27 10:43:00,6
5749,ORD_5750,2420,Vantro Car Power Inverter 200W with 4 USB & 2 AC Port with Digital Display and QC3.0,Warehouse B,22,17,2025-02-27 06:39:00,5
5750,ORD_5751,5557,Zexflam P 100mg/325mg Tablet,Warehouse A,93,78,2025-02-27 08:16:00,15
5751,ORD_5752,32844,Cadbury Drinking Chocolate 250 gram,Warehouse B,96,89,2025-02-27 04:18:00,7
5752,ORD_5753,12075,Ajmal Aurum Avid Sacredlove Deodorant Spray (Pack of 3) 200 ml,Warehouse B,69,52,2025-02-27 07:34:00,17
5753,ORD_5754,30151,"TP-Link LS105G 5-Port Desktop/Wallmount Gigabit Ethernet Switch, Ethernet Splitter, Plug & Play, 10/100/1000 Mbps RJ45, St...",Warehouse B,42,28,2025-02-27 00:31:00,14
5754,ORD_5755,32870,"rts [2 Pack] USB C to USB Adapter USB C Male to USB3 Female ,Thunderbolt 3 to Type A OTG Cable Converter Adapter Compatibl...",Warehouse C,13,7,2025-02-27 10:53:00,6
5755,ORD_5756,7107,Nimogen P 100mg/325mg Tablet,Warehouse A,107,90,2025-02-27 20:42:00,17
5756,ORD_5757,385,Logoclav 500 mg/125 mg Tablet,Warehouse B,50,33,2025-02-27 17:30:00,17
5757,ORD_5758,34881,Enerz PG 750mcg/75mg Capsule,Warehouse C,108,97,2025-02-27 09:45:00,11
5758,ORD_5759,24284,"ZEBRONICS Zeb-Comfort Wired USB Mouse, 3-Button, 1000 DPI Optical Sensor, Plug & Play, for Windows/Mac, Black",Warehouse B,89,71,2025-02-27 12:52:00,18
5759,ORD_5760,7068,Piofine 30mg Tablet,Warehouse B,53,38,2025-02-27 23:40:00,15
5760,ORD_5761,24328,IGP's No Issue 72 Tablet,Warehouse B,21,4,2025-02-27 17:56:00,17
5761,ORD_5762,1349,OpenTech® Tempered Glass Screen Protector Compatible for Samsung Galaxy S22 Plus 5G / S23 Plus 5G with Edge to Edge Covera...,Warehouse B,103,95,2025-02-27 21:35:00,8
5762,ORD_5763,30113,Body Wash - Thermal Spa Imported Mineral Massage with Thermal Salts & White Clay,Warehouse C,78,67,2025-02-27 13:43:00,11
5763,ORD_5764,9065,ZigZag Charcoal Medium Bristle Toothbrush,Warehouse B,95,88,2025-02-27 03:00:00,7
5764,ORD_5765,5615,Ufh 25000IU Injection,Warehouse A,22,7,2025-02-27 06:37:00,15
5765,ORD_5766,15648,"Fashion Colour Non - Transfer Matt Waterproof Lipstick, 63 Red Lacquer 2.6 gm",Warehouse A,100,92,2025-02-27 01:40:00,8
5766,ORD_5767,20837,"Beetel F1K GSM Fixed Wireless Phone, Support Quad band 2G,LCD Display,Speed Dial,Two way Speaker phone & Adjustable Volum...",Warehouse C,104,92,2025-02-27 01:33:00,12
5767,ORD_5768,37080,VELL - TECH Smartwatch for boys Y68 Bluetooth Calling Smart Touchscreen Smart Watch Bluetooth 1.44 HD Screen Smart Watch w...,Warehouse B,108,97,2025-02-27 12:16:00,11
5768,ORD_5769,24317,Glimilet M 1mg/500mg Tablet,Warehouse C,71,57,2025-02-27 13:52:00,14
5769,ORD_5770,12116,Aloe Relaxing Toner,Warehouse B,39,21,2025-02-27 18:17:00,18
5770,ORD_5771,36447,Amucob 1500mcg Injection,Warehouse A,30,21,2025-02-27 13:03:00,9
5771,ORD_5772,7070,VISMIINTREND Fashion Vegan Leather Anti Theft Backpack Purse Bags for Women and Girls | Sling | Casual | Bagpack | College...,Warehouse B,78,72,2025-02-27 00:57:00,6
5772,ORD_5773,20672,Elkocet 5mg Tablet,Warehouse B,104,93,2025-02-27 22:25:00,11
5773,ORD_5774,9070,Dompan Forte Tablet,Warehouse C,65,46,2025-02-27 15:41:00,19
5774,ORD_5775,15633,Fanton 2.5mg Tablet,Warehouse A,86,79,2025-02-27 01:29:00,7
5775,ORD_5776,23451,Capcef 200 DT Tablet,Warehouse A,43,26,2025-02-27 18:46:00,17
5776,ORD_5777,15653,Teraderm 250mg Tablet,Warehouse B,41,25,2025-02-27 18:18:00,16
5777,ORD_5778,20630,"boAt LTG 550v3 Lightning Apple MFi Certified Cable with Spaceship Grade Aluminium Housing,Stress Resistance, Rapid 2.4A Ch...",Warehouse A,73,68,2025-02-27 18:35:00,5
5778,ORD_5779,1303,Sofun Ear Drop,Warehouse B,48,42,2025-02-27 16:23:00,6
5779,ORD_5780,9173,Rejuvenating UBTAN Lip Balm - Bergamot & Lime 5 gm,Warehouse A,97,88,2025-02-27 22:00:00,9
5780,ORD_5781,1955,Natural Age Control Under Eye Cream,Warehouse C,79,60,2025-02-27 15:44:00,19
5781,ORD_5782,36424,Damage Repair Protein Shampoo,Warehouse B,45,35,2025-02-27 09:46:00,10
5782,ORD_5783,33508,Tymocil 500mg Capsule,Warehouse A,55,36,2025-02-27 13:26:00,19
5783,ORD_5784,9188,BabyChakra Nourishing Baby Massage Oil 100 ml,Warehouse B,31,20,2025-02-27 19:24:00,11
5784,ORD_5785,1296,The Cosmetic Republic Forever Color Wrap - Dyed Hair,Warehouse B,59,53,2025-02-27 17:46:00,6
5785,ORD_5786,36420,Medimade Fuji Match Green Tea Body Butter 200 ml,Warehouse A,85,76,2025-02-27 07:51:00,9
5786,ORD_5787,7185,Panasonic KX-TG3611SXM Cordless Landline Phone (metallic),Warehouse A,89,83,2025-02-27 16:16:00,6
5787,ORD_5788,5739,Ajmal Nightingale & Distraction & Persuade Deo & Neea EDP Pack of 3 20 ml,Warehouse B,31,13,2025-02-27 04:51:00,18
5788,ORD_5789,1358,Dolrem 100mg/325mg Tablet,Warehouse C,38,23,2025-02-27 22:11:00,15
5789,ORD_5790,34663,TechMount Shockproof Soft Silicone Cute New 3D Cartoon Deigner Protection Cover Case with Lock Lid Compatible with Apple A...,Warehouse B,48,39,2025-02-27 09:51:00,9
5790,ORD_5791,315,Supernac 25mg Injection,Warehouse B,83,65,2025-02-27 20:52:00,18
5791,ORD_5792,1431,"Noise Fit Halo with Leather Strap, Bluetooth Calling Round Dial Smart Watch, 1.43"" AMOLED Display, Premium Metallic Build,...",Warehouse A,80,61,2025-02-27 16:23:00,19
5792,ORD_5793,30262,"Logitech C920 HD Pro Webcam - 1080p, Optical, Full HD Streaming Camera for Widescreen Video Calling and Recording, Dual Mi...",Warehouse A,47,32,2025-02-27 19:35:00,15
5793,ORD_5794,32938,Rejuvenating UBTAN Essential Oil -Sweet Basil 10 ml,Warehouse C,60,55,2025-02-27 14:00:00,5
5794,ORD_5795,25085,Balakalpam,Warehouse C,81,67,2025-02-27 09:29:00,14
5795,ORD_5796,15389,Pierre Cardin Paris - Hd Blur Foundation Fair,Warehouse A,62,43,2025-02-27 14:56:00,19
5796,ORD_5797,21279,Belora Paris Leave No Evidence Liquid Matte Lipstick Iranian Tea 4.5 gm,Warehouse B,25,15,2025-02-27 19:38:00,10
5797,ORD_5798,31287,Makeup Revolution Balayage Brow Dark Brown 0.38 gm,Warehouse B,45,27,2025-02-27 01:44:00,18
5798,ORD_5799,25059,KOSHIN Multi Color Round Shape Size Diameter 1.7 cm Forehead Bindi For Women Ladies (Multi color Bindi) Pack 3,Warehouse A,40,21,2025-02-27 23:59:00,19
5799,ORD_5800,15550,Moximed D 250mg/250mg Capsule,Warehouse C,62,52,2025-02-27 01:23:00,10
5800,ORD_5801,30224,"Fashion Colour Jersy Girl Kiss Proof No Transfer Lipstick, 16 Bordeaux 2 gm",Warehouse B,33,15,2025-02-27 20:15:00,18
5801,ORD_5802,12148,"Fabify Makeup Cosmetic Face Powder, Foundation/blush Brush (Black)",Warehouse A,103,92,2025-02-27 15:06:00,11
5802,ORD_5803,9012,"Blueberry Keyboard bag Compatible With Casio SA-76, Casio SA-77, Casio SA-78 Keyboards",Warehouse A,106,89,2025-02-27 02:14:00,17
5803,ORD_5804,15569,Purifying Spot Corrector,Warehouse C,77,61,2025-02-27 06:11:00,16
5804,ORD_5805,15575,Ofsia 50mg Suspension,Warehouse B,74,63,2025-02-27 22:17:00,11
5805,ORD_5806,20927,"INOVERA World Map Extended Anti Slip Rubber Gaming Stitched Mouse Pad Desk Mat for Computer Laptop (Black, 900L x 400B x 2...",Warehouse A,101,96,2025-02-27 18:50:00,5
5806,ORD_5807,20918,Simlup 20mg Tablet,Warehouse B,77,60,2025-02-27 19:45:00,17
5807,ORD_5808,20909,"DJI OM 4 SE - Handheld 3-Axis Smartphone Gimbal Stabilizer with Grip Tripod Vlog YouTube Live Video for iPhone Android, Gr...",Warehouse B,91,84,2025-02-27 04:13:00,7
5808,ORD_5809,26929,OnePlus USB 3.0 to USB Type C OTG Cable Male-Female Adapter Compatible with All C Type Supported Mobile Smartphone and Oth...,Warehouse B,46,39,2025-02-27 14:34:00,7
5809,ORD_5810,13644,Sultatin 10 Tablet,Warehouse C,100,86,2025-02-27 09:53:00,14
5810,ORD_5811,37062,Conditioner - Dandruff,Warehouse B,93,82,2025-02-27 10:29:00,11
5811,ORD_5812,13232,Ironkey 20mg Injection,Warehouse B,66,48,2025-02-27 18:58:00,18
5812,ORD_5813,37066,Onlycort 6mg Tablet,Warehouse B,69,60,2025-02-27 03:10:00,9
5813,ORD_5814,37048,Faber-Castell Triangular Colour Pencils - Pack of 24 (Assorted),Warehouse A,39,22,2025-02-27 14:31:00,17
5814,ORD_5815,34627,Cinnamon Essential Oil,Warehouse C,60,51,2025-02-27 16:53:00,9
5815,ORD_5816,12276,"OREI Canada to India Converter Plug, USA, UK to India Adapter Plug - Type D Travel Adapter - 2 in 1 USA to India Adapter P...",Warehouse A,30,25,2025-02-27 04:24:00,5
5816,ORD_5817,15344,Klavopen DS Suspension,Warehouse B,98,90,2025-02-27 16:59:00,8
5817,ORD_5818,26798,Medimade Cocoa And Coffee Body Butter 200 ml,Warehouse C,95,81,2025-02-27 16:00:00,14
5818,ORD_5819,31851,realme 10 (Rush Black 128 GB) (8 GB RAM),Warehouse B,28,16,2025-02-27 06:38:00,12
5819,ORD_5820,21192,Fashion Colour Eyeshadow Base Primer 12 ml,Warehouse A,54,36,2025-02-27 09:56:00,18
5820,ORD_5821,8883,ZOUK Orange Wave Printed Handmade Vegan Leather Women's Office Bag for 15.6 inch Laptop with Double Handles - Tidalwave,Warehouse B,111,97,2025-02-27 16:55:00,14
5821,ORD_5822,21180,Neph-Chor Eye Drop,Warehouse A,76,59,2025-02-27 04:42:00,17
5822,ORD_5823,34696,Spigen Optik Armor Back Cover Case for Samsung Galaxy S23 Ultra (Poly Carbonate + TPU | Abyss Green),Warehouse C,102,87,2025-02-27 14:39:00,15
5823,ORD_5824,15451,AGRI CLUB Psyllium Husk (Isabgol Bhusi) 250gm/8.81oz,Warehouse B,27,12,2025-02-27 08:06:00,15
5824,ORD_5825,15455,Esofact 40mg Tablet,Warehouse A,15,10,2025-02-27 08:41:00,5
5825,ORD_5826,33474,Equipod CV 200mg/125mg Tablet,Warehouse B,62,56,2025-02-27 13:16:00,6
5826,ORD_5827,21151,Cutiliv Tablet,Warehouse A,22,10,2025-02-27 20:28:00,12
5827,ORD_5828,335,Ajmal Avid Sacrifice II Him Deodorant (Pack of 2) 200 ml,Warehouse A,40,32,2025-02-27 07:37:00,8
5828,ORD_5829,36493,Cefpolar 100mg/5ml Syrup,Warehouse A,25,13,2025-02-27 17:44:00,12
5829,ORD_5830,7178,"Designer Vent Hair Brush - FBP0206, Colour May Vary",Warehouse B,64,57,2025-02-27 04:36:00,7
5830,ORD_5831,34706,The Natural Wash Anti Acne Face Pack For Acne And Pimple Free Skin 50 Gm,Warehouse B,57,38,2025-02-27 17:51:00,19
5831,ORD_5832,21126,Bio Sandalwood Lotion - 50 Spf Sunscreen For All Skin Types In The Sun Very Water Resistant,Warehouse C,91,86,2025-02-27 05:07:00,5
5832,ORD_5833,7170,Quicktuss-DX Syrup,Warehouse C,94,82,2025-02-27 04:12:00,12
5833,ORD_5834,8860,Procef Forte Tablet,Warehouse A,68,49,2025-02-27 03:50:00,19
5834,ORD_5835,15427,Cefasom 500mg Tablet,Warehouse C,26,14,2025-02-27 03:20:00,12
5835,ORD_5836,13685,Faces Canada Bath N Body Milk & Honey Body Scrub 1 150 Gm,Warehouse C,14,6,2025-02-27 07:48:00,8
5836,ORD_5837,15363,"Fragrance Body Spray - Good Morning, Mega Pack",Warehouse A,83,74,2025-02-27 08:44:00,9
5837,ORD_5838,1912,Levonox 5mg Tablet,Warehouse C,105,92,2025-02-27 13:41:00,13
5838,ORD_5839,26715,CR2032 Lithium Button Cell Battery,Warehouse B,98,84,2025-02-27 12:02:00,14
5839,ORD_5840,12277,Facial Kit - Silver,Warehouse C,62,49,2025-02-27 23:06:00,13
5840,ORD_5841,7237,Raptic 25 Injection,Warehouse A,54,45,2025-02-27 00:50:00,9
5841,ORD_5842,20566,TheGiftKart Flip Back Cover Case for Redmi 11 Prime 5G | Dual-Color Leather Finish | Inbuilt Stand & Pockets | Wallet Styl...,Warehouse C,32,19,2025-02-27 20:58:00,13
5842,ORD_5843,27502,"Yves Rocher Concentrated Shower Gel, Bourbon Vanilla, 100ml",Warehouse A,91,73,2025-02-27 23:21:00,18
5843,ORD_5844,14695,Goree Refreshing Facial Wipes with Ice- Lab Tested - MADE IN INDIA,Warehouse A,18,13,2025-02-27 22:14:00,5
5844,ORD_5845,34288,Matchfix-OF 50mg/50mg Dry Syrup,Warehouse B,43,38,2025-02-27 01:58:00,5
5845,ORD_5846,14758,Asradic S 50mg/15mg Tablet,Warehouse B,37,28,2025-02-27 14:33:00,9
5846,ORD_5847,7438,CEDO OnePlus USB Type C to 3.5 mm Jack Audio Connector Noise Cancelling Headphones Jack Converter Splitter Audio Adapter f...,Warehouse C,104,86,2025-02-27 22:34:00,18
5847,ORD_5848,2260,Yelcef 200mg Tablet,Warehouse A,25,17,2025-02-27 12:51:00,8
5848,ORD_5849,26087,Extraordinary Clay Scalp Refresher,Warehouse B,46,39,2025-02-27 17:14:00,7
5849,ORD_5850,14767,Skin Fruits Oil Regulating Strawberry Scrub,Warehouse A,101,85,2025-02-27 02:43:00,16
5850,ORD_5851,23761,iPhone Wired Earbuds Lightning Apple Headphones Earphone [Apple MFi Certified] Built-in Microphone & Volume Control Headse...,Warehouse B,48,42,2025-02-27 07:38:00,6
5851,ORD_5852,26091,Odan Syrup Sweet Orange,Warehouse A,33,15,2025-02-27 18:22:00,18
5852,ORD_5853,23768,Glimmer Nail Polish Sapphire Light 5 ml,Warehouse C,42,31,2025-02-27 18:59:00,11
5853,ORD_5854,6115,"(The Canvas Arts) Temporary Tattoo Waterproof For Mens & Women Wrist, Arm, Hand, Neck Size X-563 60mmX105mm",Warehouse B,92,84,2025-02-27 05:08:00,8
5854,ORD_5855,3069,TheGiftKart Crystal Clear Back Case Cover for Google Pixel 7 | Shockproof 360 Degree Protection | Camera Protection Bump |...,Warehouse C,72,62,2025-02-27 23:21:00,10
5855,ORD_5856,14778,Prutrip 25mg Tablet,Warehouse A,54,48,2025-02-27 13:56:00,6
5856,ORD_5857,14709,"Pentonic Ball Pen Blister Pack | 0.7 mm Tip Size | Smooth Writing, Sleek Matte Finish | Use For School, office | Black Bod...",Warehouse C,63,55,2025-02-27 09:21:00,8
5857,ORD_5858,8050,Neo Ultra Soft Toothbrush - Assorted,Warehouse C,100,94,2025-02-27 08:09:00,6
5858,ORD_5859,34282,Proedex-T Syrup Sugar Free,Warehouse B,30,23,2025-02-27 03:00:00,7
5859,ORD_5860,23729,"(Renewed) boAt Rockerz 550Bluetooth Wireless On Ear Headphones With Mic With Ergonomic Aesthetics, Plush Padded Earcups, I...",Warehouse C,81,64,2025-02-27 19:38:00,17
5860,ORD_5861,25975,Dotiwak 80mg Tablet,Warehouse A,98,82,2025-02-27 19:19:00,16
5861,ORD_5862,22664,"AmazonBasics 16-Gauge Speaker Wire - 100 Feet, Transparent",Warehouse C,57,39,2025-02-27 05:03:00,18
5862,ORD_5863,12668,Emeecin 25mg Tablet,Warehouse C,73,59,2025-02-27 05:05:00,14
5863,ORD_5864,25981,Vega Black Head Remover - Pointed (BHR - 01) 9 gm,Warehouse B,40,24,2025-02-27 20:20:00,16
5864,ORD_5865,14041,Passion Indulge Body Lotion Berry Brust (pack of 2) 1's,Warehouse B,72,65,2025-02-27 21:40:00,7
5865,ORD_5866,33186,Esrab D 30mg/20mg Capsule SR,Warehouse C,49,30,2025-02-27 07:23:00,19
5866,ORD_5867,7492,DeBelle Gel Nail Lacquer Roseline Fiesta Metallic Light Pink Nail Polish 8 ml,Warehouse B,25,19,2025-02-27 00:42:00,6
5867,ORD_5868,1836,Venzone 1000mg Injection,Warehouse C,41,28,2025-02-27 14:28:00,13
5868,ORD_5869,34224,Stbotanica Bath & Body Combo 500 ml,Warehouse C,111,98,2025-02-27 00:52:00,13
5869,ORD_5870,33177,NV CL Dry Syrup,Warehouse A,12,6,2025-02-27 12:58:00,6
5870,ORD_5871,22589,Mantra Mfs 100 Biometric Fingerprint Scanner with rd Service,Warehouse A,49,40,2025-02-27 19:42:00,9
5871,ORD_5872,31579,Acedo Plus 100mg/500mg Tablet,Warehouse A,114,96,2025-02-27 14:55:00,18
5872,ORD_5873,1659,"Redgear Shadow Helm Gaming Wired Over Ear Headset with Mic with 50Mm Drivers, Superior Fit, Vox Technology and Multi-Purpo...",Warehouse B,92,81,2025-02-27 21:31:00,11
5873,ORD_5874,30675,"Meyaar Compatible for AirPods Pro 2nd Generation Case Cover with Keychain, Soft Silicone Skin Case Cover Full Protective (...",Warehouse C,49,36,2025-02-27 00:14:00,13
5874,ORD_5875,25840,Maono AU-B01 Microphone Suspension Boom Scissor Arm Stand (Black),Warehouse C,36,25,2025-02-27 00:05:00,11
5875,ORD_5876,34179,Alzolid 600mg Infusion,Warehouse C,86,81,2025-02-27 20:18:00,5
5876,ORD_5877,25848,Amla Shampoo - Strengthens Hair Naturally,Warehouse A,101,89,2025-02-27 03:10:00,12
5877,ORD_5878,12742,"Vero Forza Glide PRO (4 Piece) Thumb & Finger Sleeve for Mobile Game, Pubg,Cod,Freefire & Fortnite -Pack of 2 Pair- Black",Warehouse B,73,56,2025-02-27 08:24:00,17
5878,ORD_5879,22881,"KABEER ART Set of 6 Non Toxic Finger Paint Bottles 30ml with Smooth, Mixable, Easy to Wash And Dry Paints for Kids",Warehouse A,73,65,2025-02-27 04:30:00,8
5879,ORD_5880,22879,Tabelito® Delta Casual Waterproof Laptop Backpack/Office Bag/School Bag/College Bag/Business Bag/Unisex Travel Backpack (C...,Warehouse C,66,58,2025-02-27 21:23:00,8
5880,ORD_5881,7928,Ajmal Aurum Aurum Sacrifice II Deodorant Spray (Pack of 3) 200 ml,Warehouse A,35,17,2025-02-27 06:06:00,18
5881,ORD_5882,25855,Evermentin Dry Syrup,Warehouse B,72,65,2025-02-27 19:22:00,7
5882,ORD_5883,36802,UNIGEN 20W Type-C PD 3X Fast Charger [with 1M Type C to Lightening Cable] for Quick Charging Data Sync for iPhone 14 13 12...,Warehouse A,49,32,2025-02-27 02:23:00,17
5883,ORD_5884,22831,"GOVO GOBUDS 600 True Wireless in Ear Earbuds with Mic, ENC, 40H Playtime, Fast Charge, Gaming Mode, Bluetooth V5.2, IPX5, ...",Warehouse A,80,73,2025-02-27 17:46:00,7
5884,ORD_5885,33362,CPM Injection,Warehouse C,25,16,2025-02-27 21:09:00,9
5885,ORD_5886,22801,Isovomi 4mg Tablet MD,Warehouse C,35,26,2025-02-27 16:08:00,9
5886,ORD_5887,23587,"TP-Link AC1200 Mbps Archer A6 Smart WiFi, 5GHz Gigabit Dual Band MU-MIMO Wireless Internet Router, Long Range Coverage by ...",Warehouse B,108,89,2025-02-27 09:53:00,19
5887,ORD_5888,22798,Salben 400mg Tablet,Warehouse A,20,8,2025-02-27 10:48:00,12
5888,ORD_5889,34180,Odimef 80mg/250mg Tablet,Warehouse C,36,25,2025-02-27 08:23:00,11
5889,ORD_5890,34281,"Tabelito® Casual 15.6 Inch Laptop Bag (39.6cm), 25 LTR Water Repellent Backpack Laptop Apple/ Dell/ Lenovo/ Asus/ Hp/ Sams...",Warehouse B,62,49,2025-02-27 09:44:00,13
5890,ORD_5891,2213,"GOVO GOKIXX 952 Bluetooth Neckband, 106 Hours Battery, ENC Technology, Fast Charge, Gaming Mode, 10mm Drivers, Type C Char...",Warehouse C,113,98,2025-02-27 07:32:00,15
5891,ORD_5892,3560,Cipid 10mg Tablet,Warehouse B,58,41,2025-02-27 22:17:00,17
5892,ORD_5893,14518,"BLUEFUSION 7 Pcs Pink Color Hello Kitty Makeup Brushes,1 Beauty Blender (Pack of 8)",Warehouse B,80,73,2025-02-27 13:55:00,7
5893,ORD_5894,99,Rapzeb D 30mg/20mg Capsule SR,Warehouse C,93,85,2025-02-27 20:30:00,8
5894,ORD_5895,22674,Dicloapt 50mg/10mg Tablet,Warehouse B,77,59,2025-02-27 20:16:00,18
5895,ORD_5896,14445,Vominot O 2mg Injection,Warehouse B,82,75,2025-02-27 11:48:00,7
5896,ORD_5897,14696,"pTron Tangent Evo, 14Hrs Playback, Bluetooth 5.0 Earphones, In-Ear Headphones with Mic, Deep Bass, Clear Calls, IPX4 Water...",Warehouse C,50,33,2025-02-27 10:32:00,17
5897,ORD_5898,2258,Norflo 400mg Tablet,Warehouse B,19,12,2025-02-27 05:14:00,7
5898,ORD_5899,14721,Skin Natutals - Sun Control Daily Moisturiser SPF 15,Warehouse A,50,44,2025-02-27 15:48:00,6
5899,ORD_5900,3406,Isoprin 40mg Tablet SR,Warehouse B,51,35,2025-02-27 03:59:00,16
5900,ORD_5901,8148,"FAIRMART Parchment Paper Baking, Cooking Round Cake Shape Sheets (9 Inch, White) - 50 Paper Pack",Warehouse C,96,81,2025-02-27 17:47:00,15
5901,ORD_5902,8107,Mobikuff D Syrup,Warehouse B,75,57,2025-02-27 22:01:00,18
5902,ORD_5903,6505,Tough Lee Tempered Glass Screen Guard for Mi Redmi Note 10 Pro/Note 10 Pro Max/Xiaomi 11T Pro with Camera Cut (Transparen...,Warehouse A,92,82,2025-02-27 08:16:00,10
5903,ORD_5904,26026,Zakter 100mg Tablet DT,Warehouse A,29,17,2025-02-27 06:28:00,12
5904,ORD_5905,132,Montelo BL 20mg/10mg Tablet,Warehouse B,34,19,2025-02-27 05:32:00,15
5905,ORD_5906,34089,Thalitel 80 Tablet,Warehouse A,89,74,2025-02-27 16:40:00,15
5906,ORD_5907,6421,Itrapure 200 Capsule,Warehouse A,113,99,2025-02-27 07:53:00,14
5907,ORD_5908,23430,Ajmal Selfie And Aura Of CP & Ascend EDP Pack of 3 20 ml,Warehouse C,45,26,2025-02-27 12:24:00,19
5908,ORD_5909,6392,Rabicred D 10mg/20mg Tablet,Warehouse B,86,79,2025-02-27 07:18:00,7
5909,ORD_5910,25511,Insight Cosmetics Non Transfer Matte Lipstick - Test Me 4.2 gm,Warehouse C,66,48,2025-02-27 01:42:00,18
5910,ORD_5911,7597,Oxyglow Face Wash - Neem & Tulsi 100 ml,Warehouse C,100,88,2025-02-27 02:14:00,12
5911,ORD_5912,23464,JetLife Premium Mobile Holder/Pouch-Bag for Scooters Scooty's Activa Jupiter EV's etc | Universal X1 Model (Black),Warehouse B,45,31,2025-02-27 18:12:00,14
5912,ORD_5913,25547,"(Renewed) boAt Rockerz 235V2 Bluetooth Wireless In Ear Earphones With Mic With Asap Charge Technology, V5.0, Call Vibratio...",Warehouse B,51,32,2025-02-27 00:15:00,19
5913,ORD_5914,14202,Thiobec A 100mg/4mg Tablet,Warehouse B,50,35,2025-02-27 17:36:00,15
5914,ORD_5915,7631,Flormar Color Up Lip Crayon 07 Red Velvet 3.2 gm,Warehouse C,108,93,2025-02-27 04:59:00,15
5915,ORD_5916,6381,Ntrax 5mg Tablet,Warehouse C,113,99,2025-02-27 05:27:00,14
5916,ORD_5917,23394,"SanDisk Ultra Eco USB Flash Drive USB 3.2 Gen 1 128GB, Upto 100MB/s R, 5Y Warranty",Warehouse C,104,94,2025-02-27 22:22:00,10
5917,ORD_5918,23472,Azimycin 500mg Tablet,Warehouse B,71,54,2025-02-27 14:53:00,17
5918,ORD_5919,31005,"Luxor 5 Subject Single Ruled Notebook - A5 Size, 70 GSM, 300 Pages",Warehouse A,19,4,2025-02-27 09:35:00,15
5919,ORD_5920,25362,"EvoFox Elite Ops Wireless Gamepad for Android TV, PC (X Input) and PS3 | Type-C Charging | 8+ Hours of Play Time | Zero La...",Warehouse A,31,20,2025-02-27 18:11:00,11
5920,ORD_5921,25565,Ajmal Mukhallat Raaqi Concentrated Perfume Oil Floral Fruity And Raindrops Femme Deodorant Floral Chypre Fragrance 210 ml,Warehouse A,41,35,2025-02-27 12:56:00,6
5921,ORD_5922,6375,Lukin Nxt Capsule,Warehouse A,83,77,2025-02-27 19:41:00,6
5922,ORD_5923,7665,Duleron 20mg Tablet,Warehouse B,107,89,2025-02-27 09:51:00,18
5923,ORD_5924,23337,Omeprale 20mg Capsule,Warehouse B,94,87,2025-02-27 18:10:00,7
5924,ORD_5925,25578,"DUCARE Makeup Brushes Set- purple, 17 Pcs",Warehouse C,18,5,2025-02-27 23:16:00,13
5925,ORD_5926,14171,Syofix 100mg Dry Syrup,Warehouse A,24,11,2025-02-27 16:42:00,13
5926,ORD_5927,25585,Robustrion Pack of 2 [Anti-Scratch] & [Smudge Proof] [Bubble Free] Premium Tempered Glass Screen Protector Guard for Samsu...,Warehouse C,35,30,2025-02-27 04:12:00,5
5927,ORD_5928,23504,"CALAILIS False Eyelash, Eye Makeup Lash 3D Faux Mink Fake Eyelash Long Natural Eyelashes 3 Pairs （CS302）",Warehouse A,43,30,2025-02-27 02:12:00,13
5928,ORD_5929,31636,"Lapster compatible for amazfit charger cable with GTS 2 Mini, GTS 2e, GTS 2, GTR 2, GTR 2e, GTR 2 eSIM, BIP U, BIP U Pro, ...",Warehouse C,80,75,2025-02-27 01:43:00,5
5929,ORD_5930,36930,Jin Office Under Desk Keyboard Tray| Non Drill Clamp Type | Smooth Sliding Mechanism | Zinc Sliding Channels | Ergonomic K...,Warehouse C,105,93,2025-02-27 13:49:00,12
5930,ORD_5931,12793,Milast-M Tablet,Warehouse C,48,33,2025-02-27 17:21:00,15
5931,ORD_5932,16116,"Deltoid Lite Face Masks In Grey Knit Fabric With Binding - 1S1022, Small",Warehouse C,30,21,2025-02-27 21:48:00,9
5932,ORD_5933,33310,"Wilbeva Cleaner Kit for Airpods Pro 1 2 3 & Headphones Earbuds and Case, Revolutionary Cleaning Pen for Bluetooth Earphone...",Warehouse C,52,39,2025-02-27 08:27:00,13
5933,ORD_5934,33307,LipiWorld® 133 AC Remote Control with Display Light Compatible for Bluestar AC Remote with Backlight,Warehouse A,82,63,2025-02-27 21:13:00,19
5934,ORD_5935,6432,"Vivo Y16 (Stellar Black, 3GB RAM, 32GB Storage) with No Cost EMI/Additional Exchange Offers",Warehouse A,94,83,2025-02-27 12:47:00,11
5935,ORD_5936,6427,TP-LINK WiFi Dongle 300 Mbps Mini Wireless Network USB Wi-Fi Adapter for PC Desktop Laptop(Supports Windows 11/10/8.1/8/7/...,Warehouse C,114,96,2025-02-27 03:03:00,18
5936,ORD_5937,31687,Parker Vector Stainless Steel GT Fountain Pen,Warehouse A,29,24,2025-02-27 18:30:00,5
5937,ORD_5938,208,"Redmi 10 (Caribbean Green, 4GB RAM, 64GB Storage)",Warehouse C,65,48,2025-02-27 10:29:00,17
5938,ORD_5939,3408,"Zainto Neo Hair Lotion For Hair Treatment, Hair Root Nutrients, Hair Growth, 120ml (Pack Of 1)",Warehouse A,56,48,2025-02-27 07:47:00,8
5939,ORD_5940,26050,Nyamah Sales Liquid Colors Kum Kum Bindi Traditional for Women and Girls 11 Different Color Bindi Multicolor 22g,Warehouse B,28,13,2025-02-27 06:53:00,15
5940,ORD_5941,6460,Tinifur 250mg/300mg Tablet,Warehouse A,26,9,2025-02-27 02:31:00,17
5941,ORD_5942,3533,"Wecool N1 High Bass ENC Neckband in Ear Earphones, Sports Fit Bluetooth Earphones with 12 Hours Battery, Fast Charging, IP...",Warehouse C,40,22,2025-02-27 09:50:00,18
5942,ORD_5943,13719,Tagstil Syrup,Warehouse B,14,8,2025-02-27 12:44:00,6
5943,ORD_5944,12852,Body Fragrance - Alexander,Warehouse C,82,68,2025-02-27 08:46:00,14
5944,ORD_5945,1784,Coco Soul Shower Gel -With Coconut & Ayurveda- Sulphate & Paraben Free 200ml,Warehouse C,49,30,2025-02-27 18:01:00,19
5945,ORD_5946,25485,Spigen Thin Fit Cover Case for Apple Watch 8/7 (45mm) - Crystal Clear (Watch not Included),Warehouse C,99,90,2025-02-27 10:31:00,9
5946,ORD_5947,25631,"Lava Blaze 5G (Glass Green, 4GB RAM, UFS 2.2 128GB Storage) | 5G Ready | 50MP AI Triple Camera | Upto 7GB Expandable RAM |...",Warehouse A,88,75,2025-02-27 03:05:00,13
5947,ORD_5948,12830,Dicloroz 50mg/325mg Tablet,Warehouse A,13,1,2025-02-27 13:09:00,12
5948,ORD_5949,25637,Spigen Liquid Air Back Cover Case for iPhone 12 and iPhone 12 Pro (TPU | Navy Blue),Warehouse C,86,67,2025-02-27 13:14:00,19
5949,ORD_5950,7738,"Mivi Collar Flash Pro Bluetooth Earphones with mic, 72 Hours Playback Time, Dual Battery, Made in India. Neckband with Pow...",Warehouse B,74,62,2025-02-27 06:35:00,12
5950,ORD_5951,2163,"GO SHOPS USB Cable Multi Pins Charging Cables 3 in 1 Magnet Head Data Cable Supported with All iOS, Android & Other Devices",Warehouse A,69,56,2025-02-27 20:55:00,13
5951,ORD_5952,23205,"FLiX Usb Charger,Flix (Beetel) Bolt 2.4 Dual Poart,5V/2.4A/12W Usb Wall Charger Fast Charging,Adapter For Android/Iphone 1...",Warehouse B,101,83,2025-02-27 11:29:00,18
5952,ORD_5953,25660,Itorax 50mg Tablet,Warehouse A,26,14,2025-02-27 23:56:00,12
5953,ORD_5954,157,Casual Eau De Toilette Deodorant - For Man,Warehouse A,47,39,2025-02-27 20:42:00,8
5954,ORD_5955,14323,Eldotel Trio 80 Tablet,Warehouse B,95,77,2025-02-27 00:20:00,18
5955,ORD_5956,30908,"Dark Spot Reduction Creme - Non Greasy Moisturiser, Cream With UV Protect",Warehouse A,24,18,2025-02-27 09:23:00,6
5956,ORD_5957,23160,"LOXXO® Compatible with iPhone 14 Case, Liquid Silicone Case, Full Body Protective Cover, Shockproof, Slim Phone Case, Ant...",Warehouse A,22,7,2025-02-27 11:08:00,15
5957,ORD_5958,14326,Gasoclik 20mg Tablet,Warehouse C,22,10,2025-02-27 03:20:00,12
5958,ORD_5959,14159,Gold Deodorant - For Men,Warehouse A,41,34,2025-02-27 13:51:00,7
5959,ORD_5960,23138,"Riitek PeriPage Mini Pocket Printer; Wireless Bluetooth Portable Thermal Printer with Paper Roll for Picture, Label, Memo,...",Warehouse A,80,68,2025-02-27 18:48:00,12
5960,ORD_5961,34079,"Redmi 9A Sport (Coral Green, 3GB RAM, 32GB Storage) | 2GHz Octa-core Helio G25 Processor | 5000 mAh Battery",Warehouse A,62,51,2025-02-27 20:10:00,11
5961,ORD_5962,36850,Topival 25mg Tablet,Warehouse A,36,31,2025-02-27 07:55:00,5
5962,ORD_5963,22892,PPDISK High HD Focus Spy Magnet Camera Full HD Mini Spy WiFi Magnetic Live Stream Night Vision IP Wireless 1080P Audio Vid...,Warehouse A,52,43,2025-02-27 21:40:00,9
5963,ORD_5964,33165,"CELLUTION Back Tempered Glass Protector Guard For iPhone 13 (6.1 inches) with Easy Installation Kit, (Transparent) Pack of 1",Warehouse B,23,10,2025-02-27 08:01:00,13
5964,ORD_5965,22778,Zidime 100mg Tablet DT,Warehouse C,82,63,2025-02-27 12:37:00,19
5965,ORD_5966,5498,Minimalist Multi Peptide Night Serum 30 ml,Warehouse A,29,19,2025-02-27 10:34:00,10
5966,ORD_5967,20525,"ESR [2 Pack Screen Protector Compatible with iPad Pro 12.9 Inch (2022/2021/2020/2018), Tempered-Glass Film with Alignment ...",Warehouse C,94,84,2025-02-27 21:57:00,10
5967,ORD_5968,20521,Foxed CV 200mg/125mg Tablet,Warehouse C,52,46,2025-02-27 08:16:00,6
5968,ORD_5969,12009,A-Rex Syrup,Warehouse B,117,98,2025-02-27 03:24:00,19
5969,ORD_5970,9280,"iOttie Carrying Case Hard Protective Case Impact Resistant Travel Power Bank Pouch Bag USB Cable Organizer for Earbuds, Ca...",Warehouse B,44,34,2025-02-27 13:09:00,10
5970,ORD_5971,2940,"Amazon Basics USB Type C to USB A 2.0 Male Fast Charging Cable for Laptop - 3 feet (0.9 Meters), White",Warehouse C,74,65,2025-02-27 17:00:00,9
5971,ORD_5972,1448,Cepime O 50mg Dry Syrup,Warehouse C,58,44,2025-02-27 03:58:00,14
5972,ORD_5973,20501,"Revlon Nearly Naked Pressed Powder, Medium Deep/040, 0.28 Ounce",Warehouse B,39,27,2025-02-27 19:56:00,12
5973,ORD_5974,33669,Mi 100 cm (40 inches) Horizon Edition Full HD Android LED TV 4A | L40M6-EI (Black),Warehouse B,101,94,2025-02-27 04:05:00,7
5974,ORD_5975,9288,"Wayona All in One 60W USB Fast Charging Travel Cable Set Type C, Lightening and Micro USB Port Inbuilt Mobile Stand Compat...",Warehouse A,43,26,2025-02-27 06:57:00,17
5975,ORD_5976,20481,Medimade Nourishing Conditioner With Soya & Milk Protein 300 ml,Warehouse B,63,53,2025-02-27 02:56:00,10
5976,ORD_5977,20475,Mebver-C Tablet,Warehouse B,17,6,2025-02-27 06:16:00,11
5977,ORD_5978,34925,"Mivi Rock and Roll E5 Wired In Ear Earphones with HD Sound and Extra Powerful Bass with Mic, Tangle Free & Extra Length Ca...",Warehouse A,95,86,2025-02-27 09:26:00,9
5978,ORD_5979,2434,"HP X1000 Wired USB Mouse with 3 Handy Buttons, Fast-Moving Scroll Wheel and Optical Sensor works on most Surfaces, 3 years...",Warehouse C,33,18,2025-02-27 00:48:00,15
5979,ORD_5980,7846,Bxl Cellular - Cleansing Solution Face Wash,Warehouse B,64,53,2025-02-27 01:09:00,11
5980,ORD_5981,20326,"DEVEDITZ Black and Brown Gel Eyeliner Set Semi-Matte Finish, Waterproof Smudge Proof, Last for All Day Long, Work Great wi...",Warehouse A,46,34,2025-02-27 09:46:00,12
5981,ORD_5982,20303,Amazon Basics USB Adaptor with 1 Universal AC Socket and 2 USB Ports (Black),Warehouse B,82,77,2025-02-27 22:06:00,5
5982,ORD_5983,37112,Charmacy Milano Baked Illuminator 3 4 gm,Warehouse C,50,38,2025-02-27 11:15:00,12
5983,ORD_5984,20293,Metarim 50 Tablet ER,Warehouse B,59,52,2025-02-27 15:07:00,7
5984,ORD_5985,27414,TNW - The Natural Wash Baby Powder 100 gm,Warehouse B,14,1,2025-02-27 20:52:00,13
5985,ORD_5986,24573,Almond Under Eye Cream,Warehouse A,113,97,2025-02-27 06:07:00,16
5986,ORD_5987,32744,Advanced Hair Fall Solution Shampoo,Warehouse B,80,67,2025-02-27 21:30:00,13
5987,ORD_5988,24866,Herbofit - Goodness of Chyawanprash,Warehouse B,31,19,2025-02-27 01:28:00,12
5988,ORD_5989,35043,"Comet Busters Maroon,Black, Red and Green Tear Drop Bindis (9mm) (BV979)",Warehouse A,69,52,2025-02-27 14:15:00,17
5989,ORD_5990,438,GoPro HERO10 Black Waterproof Action Camera with Touch Screen 5K Ultra HD Video 23MP Photos 1080p Optical Zoom 1x Live Str...,Warehouse A,89,77,2025-02-27 08:29:00,12
5990,ORD_5991,11868,Choseal USB Type C to 3.5 mm Audio Jack Connector with Hi-Res DAC Headphone Converter Adapter for Samsung Galaxy S22/S21/S...,Warehouse A,57,51,2025-02-27 03:42:00,6
5991,ORD_5992,2909,Amazon Brand - Solimo Bumper for Samsung Galaxy Note 10 Plus (Silicone_Transparent),Warehouse B,87,81,2025-02-27 14:11:00,6
5992,ORD_5993,35057,Black Naturals Hair Colour Shade 1-Deep Black 20 ml + 20 gm,Warehouse B,82,66,2025-02-27 01:04:00,16
5993,ORD_5994,20527,Bella Voste Luxe Matt Chrome Shade 222 10 Ml,Warehouse B,77,59,2025-02-27 08:26:00,18
5994,ORD_5995,9253,Xone SB 500 mg/250 mg Injection,Warehouse B,41,22,2025-02-27 13:21:00,19
5995,ORD_5996,35063,"Samsung T7 500GB Up to 1,050MB/s USB 3.2 Gen 2 (10Gbps, Type-C) External Solid State Drive (Portable SSD) Red (MU-PC500R)",Warehouse A,89,71,2025-02-27 15:15:00,18
5996,ORD_5997,31382,Rush Deodorant Spray - Men,Warehouse A,13,8,2025-02-27 18:30:00,5
5997,ORD_5998,32779,Lotcetam 250mg Tablet,Warehouse B,57,45,2025-02-27 12:39:00,12
5998,ORD_5999,7499,Neurowell PG Capsule,Warehouse B,27,13,2025-02-27 21:05:00,14
5999,ORD_6000,20460,"BOBO BM4 Jaw-Grip Waterproof Bike / Motorcycle / Scooter Mobile Phone Holder Mount, Ideal for Maps and GPS Navigation (Sil...",Warehouse A,73,65,2025-02-27 22:58:00,8
6000,ORD_6001,34930,GadgetBite External Printed Hard Drive Disk Enclosure Portable Carrying Case Cover Pouch Casing for 2.5-Inch Hard Drive (W...,Warehouse B,89,82,2025-02-27 07:20:00,7
6001,ORD_6002,34932,Ccbest T 10mg/40mg Tablet,Warehouse A,22,10,2025-02-27 19:21:00,12
6002,ORD_6003,29989,Lakme Absolute Matte Ultimate Lip Color With Argan Oil Sinful Cherry 3.4 Gm,Warehouse A,77,60,2025-02-27 08:38:00,17
6003,ORD_6004,15845,Pangard Plus Tablet,Warehouse A,109,91,2025-02-27 01:01:00,18
6004,ORD_6005,34942,Lenovo GX20K11840 45W Laptop Adapter/Charger with Power Cord for Select Models of Lenovo (Round pin) - Black,Warehouse B,27,20,2025-02-27 10:15:00,7
6005,ORD_6006,33663,Morning Energy Face Wash - Lemon Fresh,Warehouse C,41,33,2025-02-27 05:55:00,8
6006,ORD_6007,24453,Faces Canada Weightless Matte Finish Compact Sand 04 9 Gm,Warehouse B,94,87,2025-02-27 15:51:00,7
6007,ORD_6008,32791,MyGlamm Superfoods Onion & Moringa-Conditioner 200 ml,Warehouse A,113,94,2025-02-27 22:23:00,19
6008,ORD_6009,36374,Yves Rocher Anti-Hair Loss Supplement Stimulating Shampoo 300 ml,Warehouse B,53,40,2025-02-27 09:54:00,13
6009,ORD_6010,13273,Teal & Terra Conditioner With Coconut With Shea Butter 200 ml,Warehouse B,41,26,2025-02-27 18:40:00,15
6010,ORD_6011,13530,Pyzina Kid Tablet,Warehouse B,82,76,2025-02-27 12:53:00,6
6011,ORD_6012,20552,Faces Canada Ultime Pro Eyeshadow Pallete Nude 01 10 Gm,Warehouse C,59,42,2025-02-27 00:00:00,17
6012,ORD_6013,6985,Beauty People Sheer Color Lipstick - 203 3.8 gm,Warehouse B,73,54,2025-02-27 23:28:00,19
6013,ORD_6014,5470,Seleno Gel,Warehouse C,102,85,2025-02-27 20:39:00,17
6014,ORD_6015,9349,Flushia Women's and Girl's Synthetic Hair Bun Plan Juda Hair Extension Brown Pack Of 1 pcs,Warehouse A,77,68,2025-02-27 05:42:00,9
6015,ORD_6016,20338,Vega Tail Comb (HMBC - 303) 18 gm,Warehouse A,55,39,2025-02-27 11:26:00,16
6016,ORD_6017,36367,"Jabra Elite 3 in Ear Bluetooth Truly Wireless in Ear Earbuds with mic, Noise Isolating for Clear Calls, with Fast Charging...",Warehouse A,40,34,2025-02-27 00:07:00,6
6017,ORD_6018,20329,Glimmer Premium Nail Enamel Gold Dessert 10 ml,Warehouse C,41,35,2025-02-27 16:57:00,6
6018,ORD_6019,27293,Nimkav 100mg Tablet,Warehouse C,85,68,2025-02-27 22:59:00,17
6019,ORD_6020,24519,"Motorola E22s (4GB, 64GB) (Eco Black)",Warehouse C,83,75,2025-02-27 09:31:00,8
6020,ORD_6021,13552,Dicloryn BR Tablet,Warehouse C,58,44,2025-02-27 00:29:00,14
6021,ORD_6022,15830,"Brustro Artists Wiro Bound Sketchbook, A6 (Small 105 x 148 mm) Size, 116 Pages, 160 GSM (Acid Free)",Warehouse B,26,7,2025-02-27 13:02:00,19
6022,ORD_6023,27222,"Avedia Mobile Phone Dustproof Net Stickers, Speaker Mesh Anti Dust Proof Adhesive Sticker for iPhone and Android Phone Spe...",Warehouse A,90,72,2025-02-27 12:21:00,18
6023,ORD_6024,20503,Resigest Tablet,Warehouse A,41,22,2025-02-27 19:08:00,19
6024,ORD_6025,31358,Xcef 200mg Tablet,Warehouse C,91,79,2025-02-27 15:47:00,12
6025,ORD_6026,20071,Plotipan D 30mg/40mg Capsule SR,Warehouse B,90,81,2025-02-27 00:58:00,9
6026,ORD_6027,30021,LG 27Ml600 Full Hd 27 Inch (69 Cm) LCD 1920 X 1080 Pixels IPS Monitor 3 Side Borderless Design - Dual Hdmi & Vga Port - Re...,Warehouse A,47,30,2025-02-27 11:33:00,17
6027,ORD_6028,6813,"pTron Bassbuds Jade Truly Wireless in Ear Earbuds with 40ms Gaming Low Latency, HD Stereo Calls, 40Hrs Playtime, 1-Step Pa...",Warehouse B,63,52,2025-02-27 20:52:00,11
6028,ORD_6029,12692,Coltech OZ 200mg/500mg Tablet,Warehouse B,94,84,2025-02-27 01:48:00,10
6029,ORD_6030,6798,"Brand Conquer 3 in 1 SD Card Reader | USB Type C, USB 3.0 and Micro USB, OTG, Memory Card | Portable Card Reader | Compati...",Warehouse B,6,1,2025-02-27 17:05:00,5
6030,ORD_6031,13713,"Global Edition, London Luxury and New York Night",Warehouse C,54,46,2025-02-27 20:07:00,8
6031,ORD_6032,26631,Dicid Suspension,Warehouse A,69,62,2025-02-27 22:35:00,7
6032,ORD_6033,21419,Brightening Beads Cleanser+Pigmentation Reduction Complex,Warehouse C,112,93,2025-02-27 13:06:00,19
6033,ORD_6034,3565,Face Cream - Anti-Acne,Warehouse C,34,22,2025-02-27 21:53:00,12
6034,ORD_6035,7997,Ime 200mg Tablet,Warehouse A,74,58,2025-02-27 09:38:00,16
6035,ORD_6036,30776,"BLESSBE BB39, Kids Digital Camera with 3.5"" Screen, Front and Rear Selfie Dual Camera, Child Real Camera, Childrens Cute D...",Warehouse C,106,95,2025-02-27 04:15:00,11
6036,ORD_6037,7531,Ulpan 40mg Injection,Warehouse B,97,86,2025-02-27 23:57:00,11
6037,ORD_6038,182,URBANMAC Set of 10 Pcs Multipurpose Salon Hair Styling (41*25) cm Hairdressing hairdresser Barber Combs Professional Comb ...,Warehouse A,21,9,2025-02-27 16:12:00,12
6038,ORD_6039,8005,"HP 150 Wired Keyboard and Mouse Combo with Instant USB Plug-and-Play Setup, 12 Shortcut Keys, 6° Adjustable Slope Keyboard...",Warehouse C,46,41,2025-02-27 16:46:00,5
6039,ORD_6040,8021,Fairness Naturals Diamond Bleach,Warehouse B,52,39,2025-02-27 02:25:00,13
6040,ORD_6041,8024,Bentiz k 50mg/2mg Tablet,Warehouse B,71,54,2025-02-27 19:20:00,17
6041,ORD_6042,190,Texas Instruments BA II Plus Professional Calculator | Prompt 10-Digit Display | with IRR & NPV for Cash Flow Analysis | N...,Warehouse A,39,34,2025-02-27 01:19:00,5
6042,ORD_6043,22716,Peptizole D 10mg/40mg Capsule,Warehouse C,33,17,2025-02-27 22:43:00,16
6043,ORD_6044,2467,7X Beard Spearmint - 7 Premium Oils Supports Beard Growth & Nourishment,Warehouse C,75,60,2025-02-27 05:59:00,15
6044,ORD_6045,36779,Gemblue Biocare Aloevera Moisturizing cream 500 ml,Warehouse C,38,28,2025-02-27 09:01:00,10
6045,ORD_6046,6188,Lonazep 1mg Injection,Warehouse B,17,3,2025-02-27 13:38:00,14
6046,ORD_6047,33200,Sivanna Colors Contour Highlight & Eyeshadow Palette - HF365 04 10 gm,Warehouse B,25,11,2025-02-27 17:46:00,14
6047,ORD_6048,25399,"Portronics Konnect A Type-C Cable with 3A Rapid Charging & 480mbps Data Transmission,1 M Cord Length(White)",Warehouse B,25,14,2025-02-27 08:06:00,11
6048,ORD_6049,31079,"Ubtan Body Butter, For Dry Skin, With Turmeric & Honey, For Deep Nourishment",Warehouse C,41,28,2025-02-27 01:29:00,13
6049,ORD_6050,25950,"AmazonBasics USB C to Lightning TPE MFi Certified Charging Cable for Smartphone (Black, 1.2 meter)",Warehouse A,53,41,2025-02-27 15:35:00,12
6050,ORD_6051,36772,Risen Plus Tablet,Warehouse C,45,35,2025-02-27 08:57:00,10
6051,ORD_6052,34204,Quess Care Extended Warranty Plan for 2 Year for TV - Less Than 10000 (Email Delivery),Warehouse C,29,23,2025-02-27 07:11:00,6
6052,ORD_6053,3589,Signature Gold Black Musk & Cedar Wood Perfume,Warehouse B,30,23,2025-02-27 02:35:00,7
6053,ORD_6054,16045,Global Desi DremyD EDP & StarG Mist Pack of 2 250 ml,Warehouse B,58,50,2025-02-27 16:12:00,8
6054,ORD_6055,12987,Color Fever Eye Bomb Metallic Eye Pencil cum Eye Shadow Water Proof - Glazed Green 1.8 gm,Warehouse B,98,82,2025-02-27 12:23:00,16
6055,ORD_6056,12986,Navneet Youva | Soft Bound Long Book | A4 Size - 21 Cm X 29.7 Cm | Rainbow Design Notebook For Students | Single Line | 17...,Warehouse C,102,95,2025-02-27 23:23:00,7
6056,ORD_6057,27390,Oboe 46mm Bumper Case Compatible with Samsung Galaxy Watch 4 Classic Shockproof Cover Thin Bumper Shell Protector (Black),Warehouse C,18,6,2025-02-27 07:45:00,12
6057,ORD_6058,12991,"PHILIPS Xenium E209 Premium Multimedia Feature Keypad Mobile Basic Bar Phone with Dual SIM Card, Vivid Display, Rear Camar...",Warehouse B,88,78,2025-02-27 02:14:00,10
6058,ORD_6059,24548,Envie Infinite Plus AA High Capacity (2800mAh) Ni-MH Rechargeable Ready to Use Battery Pack of 4,Warehouse C,104,87,2025-02-27 04:34:00,17
6059,ORD_6060,27332,Ajmal Impress And Aura & Yearn EDP Pack of 3 20 ml,Warehouse A,53,46,2025-02-27 08:29:00,7
6060,ORD_6061,36325,Amcid-OS Oral Suspension,Warehouse C,85,77,2025-02-27 11:05:00,8
6061,ORD_6062,1177,"GoRogue Laptop Desk for Bed, Ventilated Angle Adjustable Notebook Tabletop Stand with Cup, Mobile, Tablet Holder (Black)",Warehouse C,90,85,2025-02-27 17:02:00,5
6062,ORD_6063,6814,Lecenza 5mg Tablet,Warehouse B,58,48,2025-02-27 12:19:00,10
6063,ORD_6064,16072,Pikkme Mi Redmi Note 7 Pro/Note 7 / Note 7s Flip Case | Vintage Leather Finish | Inside TPU | Wallet Stand | Magnetic Clos...,Warehouse C,26,12,2025-02-27 00:31:00,14
6064,ORD_6065,11840,Fusiwal Ointment,Warehouse B,74,57,2025-02-27 22:56:00,17
6065,ORD_6066,29835,"The Face Shop Naturalsun Eco No Shine Sun Powder| Unisex Sunscreen with SPF 30, PA ++| Mattifying, sweat resistant powder ...",Warehouse A,69,60,2025-02-27 03:42:00,9
6066,ORD_6067,16001,"Bath Loofah - Lilac Purple, Colour May Vary",Warehouse A,29,15,2025-02-27 15:23:00,14
6067,ORD_6068,13499,Seagate BarraCuda 1 TB Internal Hard Drive HDD 3.5 Inches (8.8 cm) SATA 6 Gb/s 7200 RPM 64 MB Cache for Computer Desktop P...,Warehouse B,109,97,2025-02-27 05:04:00,12
6068,ORD_6069,15938,Glimihop M Forte 1mg/1000mg Tablet ER,Warehouse C,29,14,2025-02-27 10:28:00,15
6069,ORD_6070,11936,uppercase 26 Ltrs Ryder Professional Laptop Backpack (15.6 Inch) 3x more water resistant sustainable bags with rain proof ...,Warehouse A,52,36,2025-02-27 01:14:00,16
6070,ORD_6071,4028,"Apple 2022 iPad Air M1 Chip (10.9-inch/27.69 cm, Wi-Fi, 64GB) - Purple (5th Generation)",Warehouse C,25,7,2025-02-27 21:20:00,18
6071,ORD_6072,13291,"Melbon T708 4G LTE WiFi USB Tri Band Dongle Stick with All SIM Network Support, Plug & Play 4G Data Card with up to 150Mbp...",Warehouse A,93,81,2025-02-27 03:37:00,12
6072,ORD_6073,20210,Powder Puff,Warehouse A,31,25,2025-02-27 22:26:00,6
6073,ORD_6074,1218,Soft Clean Laundry Sanitizer 1 litre,Warehouse B,49,32,2025-02-27 06:53:00,17
6074,ORD_6075,20251,Celeste Deo For Women,Warehouse C,112,95,2025-02-27 16:05:00,17
6075,ORD_6076,35006,Olsacare 20 Tablet,Warehouse C,44,39,2025-02-27 10:31:00,5
6076,ORD_6077,9406,Cefisa O 200mg/200mg Tablet,Warehouse C,26,17,2025-02-27 00:39:00,9
6077,ORD_6078,24536,SPF 15 Sunscreen Lotion,Warehouse A,74,69,2025-02-27 07:45:00,5
6078,ORD_6079,35023,"Belkin Apple Certified Lightning to Type C Cable, 6.6 feet/2M, Tough Unbreakable Braided Fast Charging for Iphone, Ipad, A...",Warehouse A,25,20,2025-02-27 00:47:00,5
6079,ORD_6080,27377,Acemarc-RB 200mg/20mg Tablet,Warehouse C,104,92,2025-02-27 21:15:00,12
6080,ORD_6081,27371,"JGD PRODUCTS HDTV2AV, HDMI2AV Up Scaler 1080P HDMI to AV Composite Video Audio Converter Adapter Media Streaming Device",Warehouse B,45,26,2025-02-27 16:25:00,19
6081,ORD_6082,24538,Atorindia 20mg Tablet,Warehouse A,50,41,2025-02-27 10:44:00,9
6082,ORD_6083,27375,"ZEBRONICS Zeb-Buds 30 3.5Mm Stereo Wired in Ear Earphones with Mic for Calling, Volume Control, Multifunction Button, 14Mm...",Warehouse C,93,83,2025-02-27 14:15:00,10
6083,ORD_6084,36361,brittle Media Streaming WiFi Display Dongle USB WiFi Adaptors/Dongle with HDMI-USB Output for All LCD | LED | Smart TV,Warehouse B,43,37,2025-02-27 19:57:00,6
6084,ORD_6085,28688,Bluclav 250mg/125mg Tablet,Warehouse C,86,75,2025-02-26 17:42:00,11
6085,ORD_6086,29116,"Lauret Blanc Notebook - A5 Size, 144 Ruled Pages Diary Journal, 80 GSM Natural Shade. (Style 6)",Warehouse B,38,22,2025-02-26 09:18:00,16
6086,ORD_6087,13970,HP 8CA76AA 2 Watt 2.0 Channel USB Multimedia Speaker (Black),Warehouse A,90,83,2025-02-26 21:34:00,7
6087,ORD_6088,36898,Aloe Veda Mild Nourishing Shampoo 200 ml,Warehouse C,59,46,2025-02-26 00:08:00,13
6088,ORD_6089,17361,Sounce Anti Fall Dust Protection Case Cover Compatible with Oppo Enco Buds Headphones Case Silicone Headset case with Keyc...,Warehouse B,38,28,2025-02-26 04:09:00,10
6089,ORD_6090,17381,Dolovent 20mg Tablet DT,Warehouse A,25,11,2025-02-26 14:28:00,14
6090,ORD_6091,14047,"L'Occitane Citrus Verbena Eau De Toilette, 100ml",Warehouse A,54,46,2025-02-26 23:38:00,8
6091,ORD_6092,14150,Sanerv PB 750mcg/75mg Capsule,Warehouse A,59,48,2025-02-26 10:30:00,11
6092,ORD_6093,25470,uppercase Medium 17 Ltrs Vegan Leather (upto 14 inch) Laptop Backpack 2300EBP1 3x more water resistant sustainable bags wi...,Warehouse C,88,74,2025-02-26 18:00:00,14
6093,ORD_6094,33953,Temipod 200mg Tablet,Warehouse B,85,69,2025-02-26 05:38:00,16
6094,ORD_6095,31596,Faces Canada Belle De Luxe Nail Enamel Victorian Mauve 64 9 Ml,Warehouse C,72,63,2025-02-26 00:12:00,9
6095,ORD_6096,10677,"Vitamin C SPF 30 PA+++ Sunscreen - Mineral Based & Water Resistant, UVA & UVB Protection",Warehouse A,16,4,2025-02-26 06:09:00,12
6096,ORD_6097,1831,Sprot N 300 mg/200 mg Tablet,Warehouse C,63,45,2025-02-26 09:08:00,18
6097,ORD_6098,28750,Vega Pumice Stone (PD - 10) 60 gm,Warehouse B,78,64,2025-02-26 12:47:00,14
6098,ORD_6099,12912,Pinzo™ Memo Pad Cube with Approx 800 Multicolor Paper Sheets,Warehouse B,48,37,2025-02-26 19:35:00,11
6099,ORD_6100,31003,"Chambor Velvette Touch Lip Liner Pencil, Shade-13",Warehouse B,68,49,2025-02-26 18:50:00,19
6100,ORD_6101,23459,Atulya Amla Bhringraj Hair Mask 200 gm,Warehouse A,59,52,2025-02-26 16:56:00,7
6101,ORD_6102,31129,Tikpod CV Dry Syrup,Warehouse A,98,88,2025-02-26 13:53:00,10
6102,ORD_6103,31071,Self Care Foot Moisture Mask,Warehouse B,66,57,2025-02-26 19:57:00,9
6103,ORD_6104,33921,"rts USB 3.1 Type C OTG Adapter, USB Type C to USB Type Connector, OTG [Thunderbolt-3 Compatible] Thunderbolt 3/USB Type C ...",Warehouse B,100,89,2025-02-26 22:47:00,11
6104,ORD_6105,4672,Forest Essentials Charcoal Black Gulaab Khaas Kajal 0.30g & Forest essentials Luscious Lip Balm Narangi Glaze 4g,Warehouse B,40,33,2025-02-26 20:03:00,7
6105,ORD_6106,4670,Atonext 18 Tablet,Warehouse A,62,50,2025-02-26 12:58:00,12
6106,ORD_6107,25514,Extra Absorb Adult Pant Style Diapers - Medium,Warehouse A,82,77,2025-02-26 06:59:00,5
6107,ORD_6108,29660,"HAMMER Bash Over The Ear Wireless Bluetooth Headphones with Mic, Deep Bass, Foldable Headphones, Fast Pairing, Upto 8 Hour...",Warehouse B,88,77,2025-02-26 00:51:00,11
6108,ORD_6109,12910,Voxpent 40 Tablet,Warehouse C,97,86,2025-02-26 05:33:00,11
6109,ORD_6110,18113,"Face Mask GP95+ - White, Small",Warehouse C,32,24,2025-02-26 07:14:00,8
6110,ORD_6111,6413,"Ahaglow Face Wash, 50g",Warehouse B,66,49,2025-02-26 10:15:00,17
6111,ORD_6112,12908,"Makeup Brushes Set Of 5 Synthetic Bristle Brush Set- Multicolor, 1 Lip Brush, 1 Highlighter Brush, 1 Foundation Brush, 1 E...",Warehouse B,53,35,2025-02-26 10:58:00,18
6112,ORD_6113,31000,Dott Max Condoms,Warehouse C,58,44,2025-02-26 15:04:00,14
6113,ORD_6114,7593,Aviglip 5mg Tablet,Warehouse B,75,58,2025-02-26 09:37:00,17
6114,ORD_6115,13963,"boAt Airdopes 181 True Wireless in Ear Earbuds with Mic ENx Tech, Beast Mode(Low Latency Upto 60ms) for Gaming, ASAP Charg...",Warehouse B,49,44,2025-02-26 18:36:00,5
6115,ORD_6116,23672,"Beetel B17 Corded Landline Phone, Ringer Volume Control, LED for Ring Indication, Wall/Desk Mountable, Elegant Design,Clea...",Warehouse C,52,38,2025-02-26 17:31:00,14
6116,ORD_6117,3148,Cefoxmat-O 200mg/200mg Tablet,Warehouse A,116,99,2025-02-26 12:27:00,17
6117,ORD_6118,7489,Onstir 4mg Tablet MD,Warehouse A,88,82,2025-02-26 03:47:00,6
6118,ORD_6119,13991,Supprex 400mg Tablet,Warehouse B,66,55,2025-02-26 23:40:00,11
6119,ORD_6120,25392,"REDTECH Latest Mototive Mini K1 Stylish,Single Ear Bluetooth Truly Wireless In Ear Earbuds Universal Earbuds with Mic to S...",Warehouse A,89,83,2025-02-26 01:37:00,6
6120,ORD_6121,35893,Vega Bristle Bath Brush With Massager (NB - A1/2) 207 gm,Warehouse C,100,95,2025-02-26 05:13:00,5
6121,ORD_6122,18028,JUAREZ Viénto JRH24SL 24 Holes 48 Tones Professional Tremolo Polyphonic Harmonica Key of C Scale | Mouth Organ | Cover - S...,Warehouse B,92,78,2025-02-26 20:03:00,14
6122,ORD_6123,33908,Afilex 100mg Capsule,Warehouse B,45,38,2025-02-26 02:25:00,7
6123,ORD_6124,14037,"Florican 2 in 1 Desktop iPad Stand + Mobile Stand | Height, Angle Adjustable; Strong Aluminum Base with Dual Supporting Ro...",Warehouse A,76,58,2025-02-26 06:52:00,18
6124,ORD_6125,31088,"realme narzo 50i (Mint Green, 2GB RAM+32GB Storage) Octa Core Processor | 6.5"" inch Large Display",Warehouse B,18,6,2025-02-26 19:39:00,12
6125,ORD_6126,23764,Shaving Cream Classic,Warehouse B,77,70,2025-02-26 18:36:00,7
6126,ORD_6127,11071,The Body Shop Japanese Matcha Tea Pollution Clearing Mask,Warehouse C,35,17,2025-02-26 06:57:00,18
6127,ORD_6128,17421,BKN® Mini Premium Metal Folding Portable Laptop Stand Non-Slip Base Tabletop Risers for 10-17 Inch Laptop & Keyboard & Tab...,Warehouse B,48,37,2025-02-26 00:17:00,11
6128,ORD_6129,3452,Medabzol 400mg Tablet,Warehouse C,65,55,2025-02-26 10:48:00,10
6129,ORD_6130,6513,Ajmal Blu & Aurum & Sacred Love & Silver Shade Deo & Yearn EDP Pack of 4 20 ml,Warehouse C,111,97,2025-02-26 17:56:00,14
6130,ORD_6131,1829,Canto Pred 8mg Tablet,Warehouse B,41,26,2025-02-26 12:18:00,15
6131,ORD_6132,2689,Dexahim 0.5mg Tablet,Warehouse C,26,15,2025-02-26 19:46:00,11
6132,ORD_6133,7429,"tizum HDMI to VGA/AV Adapter Cable 1080P for Projector, Computer, Laptop, TV, Projectors & TV",Warehouse C,47,34,2025-02-26 07:13:00,13
6133,ORD_6134,31121,Geolev 5mg Tablet,Warehouse A,55,50,2025-02-26 07:18:00,5
6134,ORD_6135,25322,"Wings Phantom Truly Wireless in Ear Earbuds with LED Battery Indiacator 50ms Low Latency 40Hrs Playtime, MEMS with Mic, Bl...",Warehouse C,30,19,2025-02-26 06:09:00,11
6135,ORD_6136,10709,Intimate Wet Wipes,Warehouse B,58,50,2025-02-26 04:47:00,8
6136,ORD_6137,6538,Ranx 500 Tablet ER,Warehouse C,34,25,2025-02-26 06:47:00,9
6137,ORD_6138,35888,"Sery Color Flirt Nail Paint Matte, Dune Maddness, Brown 10 ml",Warehouse B,19,10,2025-02-26 21:03:00,9
6138,ORD_6139,13956,"Amazon Brand - Presto! Premium 3 Ply Facial Tissues, Soft Poly (Refill) Pack, 200 Pulls (Pack of 3)",Warehouse A,96,87,2025-02-26 01:28:00,9
6139,ORD_6140,13051,"Carvaan Saregama M21 Keypad Mobile Phone - 1500 Pre-Loaded Hindi Songs, Dual Sim, 2.4 Inch Display 2500 mAh Battery, 2 GB ...",Warehouse A,62,54,2025-02-26 20:55:00,8
6140,ORD_6141,25313,Sorcure Syrup,Warehouse B,102,88,2025-02-26 22:28:00,14
6141,ORD_6142,25310,"Prime Deals Professional 6-in-1 Cleaning Kit -Air Blower, Cotton Swabs, Suede + Plush Micro-Fiber Cloth, Brush,Cleaning So...",Warehouse C,42,24,2025-02-26 09:14:00,18
6142,ORD_6143,10715,Winlect-M Tablet,Warehouse C,82,69,2025-02-26 13:36:00,13
6143,ORD_6144,17989,Feboxa 40 Tablet,Warehouse A,80,62,2025-02-26 06:09:00,18
6144,ORD_6145,13926,Vega Graduated Dressing Comb (AC - 01) 46 gm,Warehouse C,80,65,2025-02-26 09:43:00,15
6145,ORD_6146,9760,Activ Beaute Advanced Hydration Purifying Face Wash 50 ml,Warehouse B,112,99,2025-02-26 04:43:00,13
6146,ORD_6147,6561,Argest 100mg Injection,Warehouse B,83,73,2025-02-26 15:27:00,10
6147,ORD_6148,33858,"Premium Hygienic Small Period Cup - Reusable, Washable, Before Delivery Or Upto 25 Years",Warehouse A,85,73,2025-02-26 17:31:00,12
6148,ORD_6149,33405,Maryaj Dynamic EDP Spicy Woody Perfume And Ajmal Carbon Homme Deodorant Citrus Spicy Fragrance 300 ml,Warehouse A,43,33,2025-02-26 02:59:00,10
6149,ORD_6150,23820,Tizonec 2mg Tablet,Warehouse A,22,15,2025-02-26 14:36:00,7
6150,ORD_6151,6474,Mimod Tablet,Warehouse B,34,16,2025-02-26 05:05:00,18
6151,ORD_6152,545,Metciphage 500mg Tablet SR,Warehouse A,25,10,2025-02-26 01:28:00,15
6152,ORD_6153,33925,Vilmark M Forte 1000mg/50mg Tablet,Warehouse B,39,28,2025-02-26 09:49:00,11
6153,ORD_6154,27976,Kriflox 200mg Tablet,Warehouse B,57,50,2025-02-26 14:36:00,7
6154,ORD_6155,36463,Emzacort 6mg Tablet,Warehouse C,30,14,2025-02-26 14:35:00,16
6155,ORD_6156,36350,"Western Digital WD 5TB My Passport Portable Hard Disk Drive, USB 3.0 with  Automatic Backup, 256 Bit AES Hardware Encrypti...",Warehouse A,63,56,2025-02-26 18:25:00,7
6156,ORD_6157,20195,"Fashion Colour Dual Face Powder & Blusher, Shade 01 7.5 gm",Warehouse B,50,37,2025-02-26 23:04:00,13
6157,ORD_6158,9920,Revitaliser - Kesari Jivan,Warehouse A,75,69,2025-02-26 22:14:00,6
6158,ORD_6159,15962,Absolute Argan Oil Radiance Night Revival Eye Creme,Warehouse A,71,64,2025-02-26 16:26:00,7
6159,ORD_6160,1362,Amazon Brand - Solimo Basic Case for Apple iPhone XR (Silicone_Transparent),Warehouse A,91,82,2025-02-26 18:19:00,9
6160,ORD_6161,9432,Ecsopan D 10 mg/20 mg Tablet,Warehouse C,83,78,2025-02-26 02:02:00,5
6161,ORD_6162,9397,Flormar Fusion Power Foundation Serum 030 Light Beige 30 ml,Warehouse A,109,91,2025-02-26 23:17:00,18
6162,ORD_6163,26948,Ripin 450mg Tablet,Warehouse B,12,3,2025-02-26 03:37:00,9
6163,ORD_6164,26949,Protobact 200mg/200mg Tablet,Warehouse B,115,97,2025-02-26 15:27:00,18
6164,ORD_6165,15948,"Deborah Milano Fluid Velvet Mat Lip Stick, Loud Coral, 4.5g",Warehouse C,27,9,2025-02-26 20:01:00,18
6165,ORD_6166,20207,Romep D 10mg/20mg Capsule,Warehouse C,52,47,2025-02-26 17:38:00,5
6166,ORD_6167,29918,Macrotor 250 Tablet,Warehouse B,44,29,2025-02-26 19:41:00,15
6167,ORD_6168,19414,HR Soft Kohl 100% Waterproof 18hrs Wear Kajal (Jet Black),Warehouse C,94,89,2025-02-26 12:29:00,5
6168,ORD_6169,34999,"Naked & Raw Coffee Face Scrub, Vitamin E, Tan Removal, Oily/Normal Skin",Warehouse A,42,29,2025-02-26 13:08:00,13
6169,ORD_6170,31070,CP PLUS CP-UVR-0801E1-CV2 1080P Full HD 8 Channel Digital Video Recorder,Warehouse B,65,56,2025-02-26 22:21:00,9
6170,ORD_6171,356,Global Desi Cosmic Dreamer Pack of 2 Body Mist 200ML each Long Lasting Scent Spray Gift For Women Perfume Crafted by Ajmal,Warehouse A,97,87,2025-02-26 14:52:00,10
6171,ORD_6172,9047,Oximars OZ 200mg/500mg Tablet,Warehouse C,22,7,2025-02-26 22:34:00,15
6172,ORD_6173,18017,Beauty People Pout - Me - Matte Lipstick - Smerlot - Mauve - 1008 3.8 gm,Warehouse C,82,76,2025-02-26 18:02:00,6
6173,ORD_6174,26989,"Cool, Charm and Mischief Avatar Deodorant & Body Spray Perfume For Men",Warehouse A,31,18,2025-02-26 06:35:00,13
6174,ORD_6175,15920,"Sery Colorflirt Nail Paint Fuschia Flirt, Pink 10 ml",Warehouse C,109,99,2025-02-26 01:53:00,10
6175,ORD_6176,3918,"GoRogue Stud Foldable Wooden Mini Lapdesk for Couch, Sofa Bed, Study Tray Table Stand for Writing (Beige)",Warehouse B,52,34,2025-02-26 23:33:00,18
6176,ORD_6177,26991,AmazonBasics D Cell Everyday Alkaline Batteries (4-Pack),Warehouse A,52,46,2025-02-26 04:40:00,6
6177,ORD_6178,35301,Mamaearth Rose Face Toner 200 ml,Warehouse B,18,1,2025-02-26 00:19:00,17
6178,ORD_6179,36364,CoCo Face Mask With Coffee & Cocoa For Glowing Skin,Warehouse A,102,97,2025-02-26 22:42:00,5
6179,ORD_6180,28121,LMX 250mg Dry Syrup,Warehouse C,105,87,2025-02-26 08:27:00,18
6180,ORD_6181,35302,NOTE VOLUME ACT MASCARA 16 ml,Warehouse C,41,27,2025-02-26 06:14:00,14
6181,ORD_6182,29944,Coscoril Syrup,Warehouse C,17,1,2025-02-26 09:50:00,16
6182,ORD_6183,28117,House of Beauty Tree Tea Oil 10 ml,Warehouse C,13,3,2025-02-26 04:46:00,10
6183,ORD_6184,6864,MORAZE Nail Polish Glossy Finish Beige Nude 8 Ml,Warehouse C,67,60,2025-02-26 16:19:00,7
6184,ORD_6185,15919,Conditioner For Normal Hair,Warehouse C,70,56,2025-02-26 12:59:00,14
6185,ORD_6186,34753,"Logitech MK215 Wireless Keyboard and Mouse Combo for Windows, 2.4 GHz Wireless, Compact Design, 2-Year Battery Life(Keyboa...",Warehouse A,43,28,2025-02-26 11:50:00,15
6186,ORD_6187,9015,"Wecool Moonwalk Mini Bluetooth Truly Wireless In Ear Earbuds With Mic With Magnetic Charging Case, 30 Hours Playtime, Ipx...",Warehouse C,37,26,2025-02-26 14:20:00,11
6187,ORD_6188,1208,Albro-M 200mg/10mg Tablet,Warehouse B,110,94,2025-02-26 18:46:00,16
6188,ORD_6189,858,Amazon Brand - Solimo Back Cover Case for Realme Narzo 50i | Compatible for Realme Narzo 50i Back Cover Case | 360 Degree ...,Warehouse B,99,86,2025-02-26 09:40:00,13
6189,ORD_6190,737,"Fashion Colour Lip Liner, Waterproof, Long Lasting, 2 Cocoa Bean 0.35 gm",Warehouse C,44,35,2025-02-26 20:54:00,9
6190,ORD_6191,32357,E-Luminance The Bright Mix Face Serum,Warehouse A,71,64,2025-02-26 09:52:00,7
6191,ORD_6192,36923,Coldinic Syrup,Warehouse C,49,42,2025-02-26 21:39:00,7
6192,ORD_6193,6449,"Mars Non Transfer Smudge Proof Butter Smooth Lipstick (LS25-13,Festive Vibe,3.5g)",Warehouse B,81,68,2025-02-26 01:00:00,13
6193,ORD_6194,23549,"Redragon K617 Fizz 60% Wired RGB Gaming Keyboard, 61 Keys Compact Mechanical Keyboard, (Linear RED Switch), Pro Driver/Sof...",Warehouse B,56,47,2025-02-26 08:20:00,9
6194,ORD_6195,3431,"Hoss® Table Mount iPhone Stand - Angle and Height Adjustable Mobile Holder, Compatible with Mobile Phones, iPhone, iPad, T...",Warehouse A,58,40,2025-02-26 01:24:00,18
6195,ORD_6196,11925,Deodorant Spray - Chastity For Men,Warehouse C,83,77,2025-02-26 12:35:00,6
6196,ORD_6197,23568,TP-Link ER605 (TL-R605) | Multi-WAN Wired Single_Band 1000 Mbps VPN Router | Up to 4 Gigabit WAN Ports | SPI Firewall SMB ...,Warehouse C,83,68,2025-02-26 07:54:00,15
6197,ORD_6198,14086,Bella Voste Sand Holo Nail Paints Chartreuse - 406 10 ml,Warehouse C,91,76,2025-02-26 23:20:00,15
6198,ORD_6199,7544,"Ringke Slim Case Compatible with Apple Watch Ultra 49mm, Bezel [Frame Only] Premium PC Hard Thin Cover - Clear & Titanium ...",Warehouse A,45,26,2025-02-26 17:50:00,19
6199,ORD_6200,31588,"TP-Link Archer C50 AC1200 Dual Band Wireless Cable Router, Wi-Fi Speed Up to 867 Mbps/5 GHz + 300 Mbps/2.4 GHz, Supports P...",Warehouse A,90,73,2025-02-26 20:26:00,17
6200,ORD_6201,23586,Ajmal Aurum & Blu & Sacred Love Deo & Prose EDP Pack of 4 20 ml,Warehouse C,99,80,2025-02-26 08:38:00,19
6201,ORD_6202,23593,Nisley Oral Suspension,Warehouse A,70,62,2025-02-26 05:56:00,8
6202,ORD_6203,7567,Flozapt 0.055% Nasal Spray,Warehouse A,65,50,2025-02-26 15:56:00,15
6203,ORD_6204,3136,Trizoryl Forte 1 Tablet SR,Warehouse A,63,57,2025-02-26 03:53:00,6
6204,ORD_6205,5751,Mi Business Casual 21L Water Resistant Laptop Backpack (Blue),Warehouse B,40,27,2025-02-26 04:50:00,13
6205,ORD_6206,5163,Power Gummies For That Time of The Month 40's,Warehouse A,78,64,2025-02-26 15:27:00,14
6206,ORD_6207,20936,"(Renewed) Boult Drift Bluetooth Calling, 1.69inch HD Display Smartwatch (Black Strap, Free Size)",Warehouse A,49,44,2025-02-26 00:04:00,5
6207,ORD_6208,32081,Orthodep 40mg Injection,Warehouse C,16,3,2025-02-26 10:38:00,13
6208,ORD_6209,20257,R A Products LCD Writing Board Slate Drawing Record Notes Digital Notepad with Pen Handwriting Pad Paperless Graphic Table...,Warehouse A,78,67,2025-02-26 06:29:00,11
6209,ORD_6210,35003,"Panasonic Evolta AA Alkaline 1.5V Battery, 20 Times Longer Lasting Than Standard zinc Carbon Batteries,Anti-Leak Seal,Prot...",Warehouse B,12,7,2025-02-26 14:35:00,5
6210,ORD_6211,11931,Bergamot Oil,Warehouse A,98,87,2025-02-26 19:10:00,11
6211,ORD_6212,28132,Xtore® Universal Mobile Phone Holder & Tablet Holder with 360° Rotation,Warehouse C,38,29,2025-02-26 19:45:00,9
6212,ORD_6213,3910,Aegte Glass Skin Broad Spectrum Sunscreen Gel SPF50++ 100 ml,Warehouse C,77,58,2025-02-26 10:00:00,19
6213,ORD_6214,20250,Serovoxin-ER 100 Tablet,Warehouse B,98,81,2025-02-26 10:05:00,17
6214,ORD_6215,4107,Asicold Plus 10mg/500mg/30mg Tablet,Warehouse A,60,41,2025-02-26 20:01:00,19
6215,ORD_6216,35295,Vintel-CtC Tablet,Warehouse C,78,59,2025-02-26 03:07:00,19
6216,ORD_6217,5440,Somib-D Capsule SR,Warehouse B,74,69,2025-02-26 08:25:00,5
6217,ORD_6218,31876,Tough Lee Tempered Glass Screen Guard Protector for Samsung Galaxy F04 / M04 / M13 / M13 5G / M33 5G / M42 5G / M12 / M02...,Warehouse B,99,90,2025-02-26 20:38:00,9
6218,ORD_6219,28137,Senrab 20mg Tablet,Warehouse A,64,47,2025-02-26 20:23:00,17
6219,ORD_6220,28742,Diclolife P 50mg/325mg Tablet,Warehouse B,70,59,2025-02-26 14:38:00,11
6220,ORD_6221,33668,Onsitego 1 Year Extended Warranty for Small Home & Kitchen Appliances from Rs. 1501-2000 (Email Delivery - No Physical Kit),Warehouse C,97,86,2025-02-26 01:11:00,11
6221,ORD_6222,18016,Voglyson GM Tablet,Warehouse C,72,59,2025-02-26 00:15:00,13
6222,ORD_6223,1773,Ajmal Evoke & Wisal Dhahab Deo & Aretha EDP Pack of 3 20 ml,Warehouse B,16,3,2025-02-26 11:01:00,13
6223,ORD_6224,34043,Becozol Cream,Warehouse B,62,43,2025-02-26 06:56:00,19
6224,ORD_6225,25633,Vinolon 4mg Tablet,Warehouse A,74,63,2025-02-26 17:22:00,11
6225,ORD_6226,30931,Nimori Plus 100mg/500mg Tablet,Warehouse B,52,44,2025-02-26 03:02:00,8
6226,ORD_6227,6349,Sucharana - Crack Heel Cream,Warehouse A,40,26,2025-02-26 14:19:00,14
6227,ORD_6228,30938,DR Best Alprazolam 0.5 Tablet,Warehouse C,104,91,2025-02-26 22:01:00,13
6228,ORD_6229,6353,Sreedhar Thalampoo Manjal Kumkum/Bindi 25grm Tabi (red),Warehouse B,59,45,2025-02-26 15:07:00,14
6229,ORD_6230,23230,Ifytrox-TB 250mg/31.25mg Injection,Warehouse A,66,48,2025-02-26 10:34:00,18
6230,ORD_6231,25610,Tusq Tablet,Warehouse A,98,92,2025-02-26 06:30:00,6
6231,ORD_6232,14275,Lekace 200mg Tablet,Warehouse C,96,77,2025-02-26 20:35:00,19
6232,ORD_6233,25603,Nick jones Mobile Phone Chest Strap Mount GoPro Chest Harness Holder for VLOG/POV Compatible with All Cell Phones and GoPr...,Warehouse B,99,87,2025-02-26 17:37:00,12
6233,ORD_6234,30946,Bella Voste Luminizing Highlighter Illuminous (04) 4.5 Gm,Warehouse A,100,87,2025-02-26 08:02:00,13
6234,ORD_6235,25599,"Echo Show 8 (2nd Gen, 2021 release)- Smart speaker with 8"" HD screen, stereo sound & hands-free entertainment with Alexa (...",Warehouse A,56,38,2025-02-26 10:27:00,18
6235,ORD_6236,14297,Nutriment Sandalwood Scrub All Skin Type 250 gm,Warehouse A,13,4,2025-02-26 11:56:00,9
6236,ORD_6237,7724,Amla Tablets - Good Health Naturally,Warehouse A,85,80,2025-02-26 16:28:00,5
6237,ORD_6238,2158,HP 15s- Ryzen 5-5500U 8GB RAM/512GB SSD 15.6 inch(39cm) FHD Laptop (Natural Silver/AMD Radeon Graphics/Alexa/Windows 11/MS...,Warehouse C,24,19,2025-02-26 03:31:00,5
6238,ORD_6239,12896,Axeclo-MR Tablet,Warehouse B,94,75,2025-02-26 22:01:00,19
6239,ORD_6240,17353,Cerapant 40mg Tablet,Warehouse A,57,39,2025-02-26 20:25:00,18
6240,ORD_6241,25545,Amropenem 125mg Injection,Warehouse A,52,37,2025-02-26 11:42:00,15
6241,ORD_6242,25538,Spigen Liquid Air Back Cover Case for Samsung Galaxy S23 Ultra (TPU | Matte Black),Warehouse C,64,59,2025-02-26 16:53:00,5
6242,ORD_6243,14222,The Natural Wash Vitamin C Face Serum For Glowing Youthful & Improved Skin 30 Ml,Warehouse C,23,10,2025-02-26 07:14:00,13
6243,ORD_6244,25531,Aptil 25mg Tablet,Warehouse B,69,51,2025-02-26 04:56:00,18
6244,ORD_6245,23228,Faces Canada Splash Nail Enamel Tropical Green 59 8 Ml,Warehouse C,21,4,2025-02-26 18:54:00,17
6245,ORD_6246,18138,TheGiftKart Ultra Clear Back Cover Case for Samsung Galaxy S23 5G | Slim & Protective Design | Inbuilt Dust Plugs & Anti-S...,Warehouse A,35,18,2025-02-26 08:45:00,17
6246,ORD_6247,23431,Gaipan D 30mg/40mg Capsule SR,Warehouse A,11,1,2025-02-26 02:45:00,10
6247,ORD_6248,2779,Traceta 325 mg/37.5 mg Tablet,Warehouse A,15,7,2025-02-26 15:07:00,8
6248,ORD_6249,3476,Chymovex Plus 50mg/325mg Tablet,Warehouse A,80,64,2025-02-26 19:55:00,16
6249,ORD_6250,7669,Beauty People Natural HD Matte Lip Crayon Poise - 107 4 gm,Warehouse B,56,45,2025-02-26 13:49:00,11
6250,ORD_6251,30955,Telmirose RH 5mg/40mg/12.5mg Tablet,Warehouse B,108,90,2025-02-26 11:52:00,18
6251,ORD_6252,32377,Superdrug Spa Detox Dead Sea Mud Mask 15 ml,Warehouse A,24,9,2025-02-26 18:59:00,15
6252,ORD_6253,14260,Charger Noise Pulse Go Buzz SmartWatch Charger 2 Pin USB Fast Charger Magnetic Charging Cable Adapter Smartwatch Accessories,Warehouse C,32,14,2025-02-26 16:40:00,18
6253,ORD_6254,23735,The Face Shop Fmgt Designing Eyebrow Pencil 01 Light Brown 0.3 gm,Warehouse C,36,29,2025-02-26 21:29:00,7
6254,ORD_6255,24349,Mobiwok 4mg Capsule,Warehouse B,92,85,2025-02-26 06:32:00,7
6255,ORD_6256,31363,Flormar Extreme Matte Lipstick 012 Sweet Blush 4 gm,Warehouse C,53,44,2025-02-26 14:01:00,9
6256,ORD_6257,6766,Deborah Milano Gel Effect - 111 Pomegranate Juice Nail Polish 8.5 ml,Warehouse C,112,96,2025-02-26 15:05:00,16
6257,ORD_6258,1970,IKALL K100 Keypad Mobile (Black),Warehouse B,49,42,2025-02-26 07:31:00,7
6258,ORD_6259,24931,Casio HR-8RC-BK 150 Steps Check & Correct Printing Calculator with Reprint Feature,Warehouse B,24,6,2025-02-26 12:37:00,18
6259,ORD_6260,3250,Brexime LB 200mg Tablet,Warehouse A,41,22,2025-02-26 19:29:00,19
6260,ORD_6261,13536,Toplift XL 75mg Capsule SR,Warehouse A,95,90,2025-02-26 08:59:00,5
6261,ORD_6262,31334,"LASHVIEW eyelash extensions glue, precise drop technology glue,accurate 0.03ml per drop,extending glue life,1 Sec Dry Tim...",Warehouse A,47,42,2025-02-26 02:44:00,5
6262,ORD_6263,6730,Dytrim DS 800mg/160mg Tablet,Warehouse C,90,79,2025-02-26 14:45:00,11
6263,ORD_6264,2072,"DIZO Watch D2 Power (by realme TechLife) –Large 1.91"" Superlight, Single Chipset Bluetooth Calling Smartwatch with Smart S...",Warehouse A,52,42,2025-02-26 02:44:00,10
6264,ORD_6265,37056,Nemok P 100mg/325mg Tablet,Warehouse B,63,57,2025-02-26 03:51:00,6
6265,ORD_6266,31517,Sinox OZ Suspension,Warehouse A,76,70,2025-02-26 13:31:00,6
6266,ORD_6267,7145,Flucot 50mg Tablet DT,Warehouse C,101,94,2025-02-26 02:28:00,7
6267,ORD_6268,11547,Syncwire LTG to USB Cable for Fast Charging Compatible with Phone 5/ 5C/ 5S/ 6/ 6S/ 7/8/ X/XR/XS Max/ 11/12/ 13 Series and...,Warehouse C,103,85,2025-02-26 18:52:00,18
6268,ORD_6269,4522,Thiochi ET 60mg/4mg Tablet,Warehouse B,94,79,2025-02-26 20:09:00,15
6269,ORD_6270,10857,Liquid Hand Wash - Original,Warehouse C,104,98,2025-02-26 12:13:00,6
6270,ORD_6271,30954,Diconac 0.1% Eye Drop,Warehouse B,21,8,2025-02-26 07:36:00,13
6271,ORD_6272,7057,Rapither AB 150mg Injection,Warehouse C,24,11,2025-02-26 00:07:00,13
6272,ORD_6273,23281,Flormar Long Wearing Lipstick L39 Bordeaux 3.9 gm,Warehouse A,21,4,2025-02-26 20:34:00,17
6273,ORD_6274,7392,Cello Technotip Ball Pen | Blue Ball Pens | Jar of 25 Units | Ball Pens for Students | Ball Point Pen Set | Writing Pens f...,Warehouse C,29,11,2025-02-26 22:23:00,18
6274,ORD_6275,33852,Rizatrip 5mg Tablet,Warehouse A,109,99,2025-02-26 18:21:00,10
6275,ORD_6276,10831,Stbotanica Pure Jasmine Essential Oil 15 ml,Warehouse A,63,48,2025-02-26 05:38:00,15
6276,ORD_6277,24975,"MASTADI Contour Stick Face Highlighter and Contour Stick Highlighter (cream) Concealer (Beige, 8 g) & Loose powder (pack o...",Warehouse C,49,31,2025-02-26 17:09:00,18
6277,ORD_6278,28885,"Zitel Case with Screen Protector Compatible with Apple Watch SE 2nd gen 2022 / SE 1st gen/Series 6/5/4, 44mm Hard PC Cover...",Warehouse C,95,81,2025-02-26 15:51:00,14
6278,ORD_6279,17751,Stroget 500mg Tablet,Warehouse B,27,12,2025-02-26 19:42:00,15
6279,ORD_6280,9803,Samsung 138 cm (55 inches) Crystal 4K Neo Series Ultra HD Smart LED TV UA55AUE65AKXXL (Black),Warehouse B,49,32,2025-02-26 13:52:00,17
6280,ORD_6281,792,Aslevast M Oral Suspension,Warehouse C,86,67,2025-02-26 01:09:00,19
6281,ORD_6282,31500,Voglicad 0.2mg Tablet,Warehouse A,30,24,2025-02-26 00:27:00,6
6282,ORD_6283,7037,Perfecta Ultra Extra Soft Sanitary Napkins,Warehouse A,28,18,2025-02-26 18:42:00,10
6283,ORD_6284,13564,Geone-TZ 281.25mg Injection,Warehouse C,61,51,2025-02-26 06:20:00,10
6284,ORD_6285,32291,OF-OF 400 Tablet,Warehouse A,72,56,2025-02-26 04:22:00,16
6285,ORD_6286,882,"KAIASHA Colour Changing Jelly Lipstick  (RED, 3.6 g)",Warehouse B,107,97,2025-02-26 04:28:00,10
6286,ORD_6287,25558,Oftec OZ 200mg/500mg Tablet,Warehouse B,70,53,2025-02-26 20:05:00,17
6287,ORD_6288,9753,Argan-Liquid Gold Hair Spa,Warehouse B,106,91,2025-02-26 22:27:00,15
6288,ORD_6289,33290,Duroxyl 500mg Tablet,Warehouse B,84,67,2025-02-26 11:17:00,17
6289,ORD_6290,25686,"Simply Inked Shareable Mandala Temporary Tattoo, Designer Tattoo for Girls Boys Men Women waterproof Sticker Size: 4 X 4 i...",Warehouse B,100,86,2025-02-26 21:09:00,14
6290,ORD_6291,19476,Bactisan 2% Ointment,Warehouse C,51,44,2025-02-26 00:04:00,7
6291,ORD_6292,9807,Techlife JNL-7513 Waterproof Camera Shoulder Bag for Nikon Canon Sony and All DSLR Cameras,Warehouse C,20,13,2025-02-26 15:57:00,7
6292,ORD_6293,7753,Miss Rose Matte Finish Bullet Lipstick Shade 36 Lris 730 - 026B 36 3.4 gm,Warehouse B,34,16,2025-02-26 00:13:00,18
6293,ORD_6294,16400,Beauty People Velvet Matte Nail Polish Matte - Me - Brick - 371 9.9 ml,Warehouse A,111,97,2025-02-26 22:00:00,14
6294,ORD_6295,36856,Canxime 50mg Dry Syrup,Warehouse C,26,7,2025-02-26 16:18:00,19
6295,ORD_6296,25692,Symbocip TZ 500mg/600mg Tablet,Warehouse C,22,4,2025-02-26 08:14:00,18
6296,ORD_6297,35636,Nimfame P 100mg/325mg Tablet,Warehouse C,74,68,2025-02-26 21:42:00,6
6297,ORD_6298,33295,Monoscot TZ 1.125gm Injection,Warehouse C,37,29,2025-02-26 11:27:00,8
6298,ORD_6299,31627,Digital Shoppy Facial Mask Applying Brushes Face Eyes Makeup Cosmetic Tool Portable brush (Pack of 2),Warehouse B,39,24,2025-02-26 08:55:00,15
6299,ORD_6300,28640,Pikkme Vivo Y12 / Y15 /Y17 / U10 Flip Case Leather Finish | Inside TPU with Card Pockets | Wallet Stand and Shock Proof | ...,Warehouse B,91,79,2025-02-26 20:30:00,12
6300,ORD_6301,14339,POPIO Full Screen Coverage Except Edges Tempered Glass Screen Protector with Easy Installation Kit for Xiaomi Redmi Note 8...,Warehouse B,11,2,2025-02-26 17:41:00,9
6301,ORD_6302,11141,"TP-Link RE300 AC1200 Mesh Wi-Fi Range Extender/WiFi Booster/Wireless Repeater (Up to 1200 Mbps), Intelligent Signal Light,...",Warehouse C,93,77,2025-02-26 19:42:00,16
6302,ORD_6303,14330,"Kodak 180GSM Photo Paper for Canon, HP, Kodak, Epson, Dell, Lexmark Printers - Pack of 100 Sheets, White, 5R (VMS180G5R100KD)",Warehouse A,45,29,2025-02-26 14:37:00,16
6303,ORD_6304,23361,"Redmi Note 11S (Horizon Blue, 6GB RAM, 128GB Storage)|108MP AI Quad Camera | 90 Hz FHD+ AMOLED Display | 33W Charger Inclu...",Warehouse B,66,61,2025-02-26 15:45:00,5
6304,ORD_6305,30988,"Biotique Bio Musk Root, 900g",Warehouse B,73,65,2025-02-26 02:03:00,8
6305,ORD_6306,2119,TheGiftKart Crystal Clear Back Cover Case for OnePlus Nord (2020) | 360 Degree Protection | Shock Proof Design | Transpare...,Warehouse C,34,18,2025-02-26 09:00:00,16
6306,ORD_6307,2118,Samsung original 8GB 1 x 8GB 204-pin SODIMM DDR3 PC3L-12800 1600MHz ram memory module for laptops,Warehouse B,82,70,2025-02-26 20:11:00,12
6307,ORD_6308,32346,Philmont Tablet,Warehouse A,115,97,2025-02-26 02:03:00,18
6308,ORD_6309,18013,Apriglim-MF 1 Tablet PR,Warehouse A,19,10,2025-02-26 14:47:00,9
6309,ORD_6310,18012,"ProElite Smart PU Flip Case Cover for Apple iPad 10.2"" 9th Gen (2021) / 8th Gen / 7th Gen with Pencil Holder, Black",Warehouse C,83,76,2025-02-26 04:02:00,7
6310,ORD_6311,19553,"Dabur Fem Turmeric Body Bleach, 1 Kg",Warehouse B,96,91,2025-02-26 20:36:00,5
6311,ORD_6312,7610,Medocid 1000mg Injection,Warehouse B,26,8,2025-02-26 15:42:00,18
6312,ORD_6313,33980,Lvz 10mg Tablet,Warehouse A,15,2,2025-02-26 08:22:00,13
6313,ORD_6314,6329,Noanx 0.5mg Tablet,Warehouse A,104,87,2025-02-26 11:50:00,17
6314,ORD_6315,25702,Rhymestore 360 Degree Universal Mobile Cellphone Stand car Accessories Smartphone Holder Phone Mount Phone Holder,Warehouse C,50,40,2025-02-26 01:06:00,10
6315,ORD_6316,14337,Zenom 5mg Tablet,Warehouse C,112,94,2025-02-26 15:15:00,18
6316,ORD_6317,28626,LZ 500mg Tablet,Warehouse B,73,57,2025-02-26 03:16:00,16
6317,ORD_6318,14334,"Iba Fairness Instant Facial (3in1 Mask Scrub Facial Wash), 100g l Removes Tan l Brightens Skin l Gives Instant Glow",Warehouse B,60,55,2025-02-26 17:44:00,5
6318,ORD_6319,11612,Wottagirl - Adore Perfume Spray,Warehouse C,52,44,2025-02-26 19:17:00,8
6319,ORD_6320,25711,"Samsung T7 1TB Up to 1,050MB/s USB 3.2 Gen 2 (10Gbps, Type-C) External Solid State Drive (Portable SSD) Blue (MU-PC1T0H)",Warehouse C,55,49,2025-02-26 11:12:00,6
6320,ORD_6321,29185,Azibert-Xl-200 Oral Suspension,Warehouse B,28,23,2025-02-26 18:17:00,5
6321,ORD_6322,23092,Omcin 100mg Injection,Warehouse B,85,70,2025-02-26 13:42:00,15
6322,ORD_6323,12806,Ishzine 25mg Tablet,Warehouse A,99,86,2025-02-26 16:15:00,13
6323,ORD_6324,16394,Crysendo Ear Muffs Headphone Cushion (50mm / 5cm) 6Pcs 5mm Thick Replacement Earpads for Headphone Sponge Cover | High-Den...,Warehouse C,39,20,2025-02-26 16:25:00,19
6324,ORD_6325,3512,Normal Shampoo Restore+ Strengthen,Warehouse A,93,84,2025-02-26 17:09:00,9
6325,ORD_6326,31153,Lemonpure Turmeric & Lemon Cleansing Milk,Warehouse C,26,21,2025-02-26 00:22:00,5
6326,ORD_6327,23215,Rabus D 30mg/20mg Capsule SR,Warehouse A,70,57,2025-02-26 08:20:00,13
6327,ORD_6328,32374,Fung Cid 150mg Tablet,Warehouse C,7,1,2025-02-26 19:15:00,6
6328,ORD_6329,14387,JAGUAR Classic Black Deodorant Spray - For Men (150 ml),Warehouse C,75,64,2025-02-26 04:59:00,11
6329,ORD_6330,31610,Dottrip 25mg Tablet,Warehouse C,95,85,2025-02-26 01:56:00,10
6330,ORD_6331,34002,M Cold Plus Drop,Warehouse A,41,24,2025-02-26 09:06:00,17
6331,ORD_6332,11120,"BOBO BM1 Jaw-Grip Waterproof Bike / Motorcycle / Scooter Mobile Phone Holder Mount with Fast USB 3.0 Charger, Ideal for Ma...",Warehouse B,26,16,2025-02-26 14:51:00,10
6332,ORD_6333,29137,Neem & Turmeric Bathing Soap,Warehouse B,74,66,2025-02-26 02:46:00,8
6333,ORD_6334,27781,Herbal Charcoal Peel Off Mask With Pure Lavender Oil,Warehouse A,25,6,2025-02-26 15:47:00,19
6334,ORD_6335,23091,Coldmox Oral Suspension,Warehouse B,105,86,2025-02-26 03:59:00,19
6335,ORD_6336,25719,"eLzzi® Compatible with AirPod Pro Case, Full Protective Silicone AirPods Pro Case, 2.5mm Thickness Airpod Pro Cover, Suppo...",Warehouse B,70,62,2025-02-26 12:40:00,8
6336,ORD_6337,23089,Biosoft Lavender Pre Wax Gel 100 ml,Warehouse B,21,12,2025-02-26 23:23:00,9
6337,ORD_6338,9748,Natural Handmade Oudh Wood & Rose Soap,Warehouse A,96,84,2025-02-26 11:29:00,12
6338,ORD_6339,16392,Itrasam 200 Capsule,Warehouse B,99,85,2025-02-26 15:30:00,14
6339,ORD_6340,5199,Kadence Drum Stick Maple Wooden Tip 7A,Warehouse B,114,98,2025-02-26 23:23:00,16
6340,ORD_6341,3513,Trivomet Tablet,Warehouse A,21,9,2025-02-26 04:32:00,12
6341,ORD_6342,23212,L'Oreal Paris 6 Oil Nourish Shampoo 82.5 Gm,Warehouse C,28,12,2025-02-26 07:23:00,16
6342,ORD_6343,18260,"ProElite Deer Smart Flip case Cover for Amazon Kindle 6"" 10th Generation 2019 [Wine Red]",Warehouse C,73,68,2025-02-26 04:27:00,5
6343,ORD_6344,25742,20W 20 WATT 7MM HOT MELT Glue Gun with ON Off Switch and LED Indicator (Free 10 Transparent Glue Sticks),Warehouse C,102,93,2025-02-26 12:41:00,9
6344,ORD_6345,11678,SupCares Edge to Edge Tempered Glass for iQOO Neo 6 5G / iQOO Neo 6 SE 5G / iQOO 9 SE 5G / iQOO 7 5G / iQOO 7 Legend 5G (...,Warehouse B,116,97,2025-02-26 18:06:00,19
6345,ORD_6346,18266,MOCA Case for MacBook Air 13.6 inch Case 2022 Release A2681 M2 Chip with Liquid Retina Display & Touch ID Hard Shell Case ...,Warehouse B,98,85,2025-02-26 08:05:00,13
6346,ORD_6347,23030,boAt Bassheads 242 in Ear Wired Earphones with Mic(Red),Warehouse A,68,50,2025-02-26 05:42:00,18
6347,ORD_6348,29180,Notence 1mg Tablet,Warehouse C,63,51,2025-02-26 17:49:00,12
6348,ORD_6349,27853,Brumol Syrup,Warehouse A,40,33,2025-02-26 08:29:00,7
6349,ORD_6350,11392,COSRX Advanced Snail 96 Mucin Power Essence 100ml,Warehouse C,73,63,2025-02-26 13:28:00,10
6350,ORD_6351,11937,Prickly Heat Powder - Cool Gulabjal,Warehouse A,17,4,2025-02-26 19:01:00,13
6351,ORD_6352,29810,Cotul O Syrup,Warehouse B,76,57,2025-02-26 02:41:00,19
6352,ORD_6353,5629,"Logitech G502 Hero High Performance Wired Gaming Mouse, Hero 25K Sensor, 25,600 DPI, RGB, Adjustable Weights, 11 Programma...",Warehouse C,34,26,2025-02-26 23:07:00,8
6353,ORD_6354,11971,"SIRF TUM 7 Soft and Synthetic Bristle Makeup Brushes Kit with A Silver Storage Box- Silver, Set of 12",Warehouse B,107,95,2025-02-26 07:06:00,12
6354,ORD_6355,20757,"Milap Long-wear Weightless Liquid Foundation, High Coverage Foundation, Matte Foundation, Super Stay Foundation, Water- pr...",Warehouse A,25,10,2025-02-26 22:57:00,15
6355,ORD_6356,9331,Zogrell A 150mg/75mg Tablet,Warehouse B,22,5,2025-02-26 18:36:00,17
6356,ORD_6357,27262,The Prop store Fur Rug for Photography for Baby Background (90x80cm)-White,Warehouse A,55,49,2025-02-26 11:47:00,6
6357,ORD_6358,9116,Xonefit-T 281.25 Injection,Warehouse B,31,21,2025-02-26 02:26:00,10
6358,ORD_6359,32860,GLOGEOUS FACE WASH 100GM GEL Aloe Vera Glycolic Acid.,Warehouse A,89,81,2025-02-26 09:02:00,8
6359,ORD_6360,2441,Jeecox MR 60mg/4mg Tablet,Warehouse A,17,5,2025-02-26 12:11:00,12
6360,ORD_6361,9319,"boAt Stone 180 5W Bluetooth Speaker with Upto 10 Hours Playback, 1.75"" Driver, IPX7 & TWS Feature(Blue)",Warehouse A,84,66,2025-02-26 23:25:00,18
6361,ORD_6362,15658,Stomid 40mg Tablet,Warehouse B,85,71,2025-02-26 12:24:00,14
6362,ORD_6363,31931,Calming Body Massage Oil,Warehouse A,53,35,2025-02-26 10:37:00,18
6363,ORD_6364,19070,Zydol 100mg Tablet,Warehouse C,39,29,2025-02-26 16:44:00,10
6364,ORD_6365,1262,Kridef 6mg Tablet,Warehouse A,98,93,2025-02-26 02:38:00,5
6365,ORD_6366,27058,CEDO Clear Case for iPhone 11 | Soft Flexible Full Protection Shock Proof TPU Back Cover for iPhone 11 (Transparent),Warehouse C,107,97,2025-02-26 10:01:00,10
6366,ORD_6367,19204,Loc Tears Plus Eye Drop,Warehouse C,35,30,2025-02-26 17:45:00,5
6367,ORD_6368,27248,Clip T 10mg/40mg Tablet,Warehouse B,114,97,2025-02-26 01:42:00,17
6368,ORD_6369,10050,VEGA I-Curl Hair Curler VHCH-05 (Ananya Panday Signature Collection) Rose Gold 1 gm,Warehouse B,22,9,2025-02-26 21:23:00,13
6369,ORD_6370,20429,Taxazon S 1000mg/500mg Injection,Warehouse B,28,17,2025-02-26 02:55:00,11
6370,ORD_6371,27593,Pregiva-NT Tablet,Warehouse C,14,2,2025-02-26 09:54:00,12
6371,ORD_6372,19739,Omefos DM 10mg/20mg Capsule,Warehouse C,69,56,2025-02-26 10:24:00,13
6372,ORD_6373,34675,Fresh Gel Sensitive Toothpaste,Warehouse B,37,29,2025-02-26 08:55:00,8
6373,ORD_6374,21121,Saregama Carvaan Mini Hindi 2.0- Music Player with Bluetooth/FM/AM/AUX (Sapphire Green),Warehouse C,63,57,2025-02-26 19:18:00,6
6374,ORD_6375,29418,"Miss Claire Miss Claire Prestige Pressed Powder 33 Dark Beige, Beige, 10 Grams, Beige, 10 g",Warehouse C,50,45,2025-02-26 21:48:00,5
6375,ORD_6376,15880,Amchek 5 Tablet,Warehouse B,59,43,2025-02-26 20:34:00,16
6376,ORD_6377,27886,Abiworm Suspension,Warehouse C,106,94,2025-02-26 00:07:00,12
6377,ORD_6378,32599,Face Wash - V-Charge & Scrub,Warehouse C,53,35,2025-02-26 18:35:00,18
6378,ORD_6379,16178,Rosecold Tablet,Warehouse B,98,83,2025-02-26 13:46:00,15
6379,ORD_6380,2844,"Aroma® NB119 Carter Pro Bluetooth Wireless In Ear Neckband with Long Lasting Playtime 48 Hrs, Smart Voice Assistant, Dual ...",Warehouse C,34,29,2025-02-26 18:45:00,5
6380,ORD_6381,20590,Acne Control Face Wash - Sulphate Free,Warehouse A,34,18,2025-02-26 20:44:00,16
6381,ORD_6382,12086,Comyetin 500mg Capsule,Warehouse A,26,8,2025-02-26 15:33:00,18
6382,ORD_6383,27243,Pikkme Nothing Phone 1 Back Cover |Electroplated Chrome Metal Ring | Full Camera Protection | Raised Edges | Super Soft Si...,Warehouse A,22,4,2025-02-26 20:27:00,18
6383,ORD_6384,9101,Mavro Case Cover Compatible with OnePlus Buds Pro 2 | 2R (Earbuds Not Included) (Black),Warehouse A,72,55,2025-02-26 02:20:00,17
6384,ORD_6385,34815,Cosel-D Syrup,Warehouse A,91,76,2025-02-26 11:50:00,15
6385,ORD_6386,20818,Hair Spray - Natural Hold,Warehouse B,102,95,2025-02-26 09:07:00,7
6386,ORD_6387,27291,Spigen Thin Fit Back Cover Case for Samsung Galaxy S23 Ultra (Poly Carbonate + TPU | Black),Warehouse B,13,6,2025-02-26 02:59:00,7
6387,ORD_6388,9644,Timber -  Deodorant Body Spray,Warehouse B,88,82,2025-02-26 08:38:00,6
6388,ORD_6389,16215,Bonumrab-DSR Capsule,Warehouse A,23,16,2025-02-26 08:57:00,7
6389,ORD_6390,34928,"boAt Stone 352 Bluetooth Speaker with 10W RMS Stereo Sound, IPX7 Water Resistance, TWS Feature, Up to 12H Total Playtime, ...",Warehouse B,105,95,2025-02-26 01:53:00,10
6390,ORD_6391,34813,"Vega Hair Straightener Brush with Ionic & Thermoprotect Technology and 16 Temperature Settings, VHSB-04, (NEW IMPROVED Mod...",Warehouse B,63,46,2025-02-26 20:04:00,17
6391,ORD_6392,9351,Ofcinbet-OZ Tablet,Warehouse C,16,10,2025-02-26 02:02:00,6
6392,ORD_6393,27014,I AM EYECONIC FINE GLITTER PLATINUM 4 gm,Warehouse C,101,96,2025-02-26 16:21:00,5
6393,ORD_6394,29454,MISS CLAIRE Soft Matte Lipcream Shade No.56,Warehouse B,48,33,2025-02-26 03:03:00,15
6394,ORD_6395,11531,Clavmox Oral Drops,Warehouse A,76,64,2025-02-26 23:17:00,12
6395,ORD_6396,20358,"Zinq Technologies Super Durable Micro to USB 2.0 Round Cable with High Speed Charging, Quick Data Sync and PVC Connectors ...",Warehouse A,114,98,2025-02-26 10:58:00,16
6396,ORD_6397,15642,TheGiftKart Flip Back Cover Case for Samsung Galaxy A14 5G | Dual-Color Leather Finish | Inbuilt Stand & Pockets | Wallet ...,Warehouse C,28,11,2025-02-26 18:24:00,17
6397,ORD_6398,20783,Endryl Syrup,Warehouse C,26,12,2025-02-26 13:05:00,14
6398,ORD_6399,9360,"S.A.V.I 3D Temporary Tattoo Flying Birds Design Size 10.5x6cm - 1pc, Black, 4 g",Warehouse A,20,4,2025-02-26 10:21:00,16
6399,ORD_6400,2589,"Fashion Colour Hi Tech Face Powder, Shade 05 10 gm",Warehouse B,81,70,2025-02-26 10:59:00,11
6400,ORD_6401,20430,Himalayan Pink Salt Body Wash With Water Lily,Warehouse A,94,78,2025-02-26 04:17:00,16
6401,ORD_6402,16800,Flocy TZ 250 mg/300 mg Tablet,Warehouse B,59,45,2025-02-26 15:55:00,14
6402,ORD_6403,36383,Recefix CV 200mg/125mg Tablet,Warehouse C,104,97,2025-02-26 16:13:00,7
6403,ORD_6404,32091,"Tukzer Portable Foldable Tabletop Laptop Stand Lapdesk, Notebook Riser Stand, Ventilation for Cooling, Compatible with Lap...",Warehouse A,55,38,2025-02-26 14:47:00,17
6404,ORD_6405,20712,Olyflam AS 100mg/325mg/15mg Tablet,Warehouse C,73,63,2025-02-26 06:42:00,10
6405,ORD_6406,403,Tancetam 750mg Tablet,Warehouse C,22,14,2025-02-26 02:35:00,8
6406,ORD_6407,16227,"Fashion Colour Kiss Lip No Transfer Lipstick, 73 Ponceau 2.6 gm",Warehouse C,95,82,2025-02-26 19:26:00,13
6407,ORD_6408,27642,Mirabelle Korea Wine Fairness Facial Sheet Mask 25 Ml,Warehouse A,17,4,2025-02-26 06:25:00,13
6408,ORD_6409,19232,"Redmi Note 10S (Cosmic Purple, 6GB RAM, 128GB Storage)  - Super Amoled Display | 64 MP Quad Camera | 6 Month Free Screen R...",Warehouse A,40,30,2025-02-26 00:28:00,10
6409,ORD_6410,27034,"Fashion Colour Kiss Lip No Transfer Lipstick, 67 Rose Violet 2.6 gm",Warehouse B,83,70,2025-02-26 04:45:00,13
6410,ORD_6411,34978,Skin Natural Serum sheetmask (Sakura white + Light complete +Charcoal),Warehouse A,78,73,2025-02-26 08:54:00,5
6411,ORD_6412,29546,Megragesic DP 10mg/325mg Tablet,Warehouse B,14,1,2025-02-26 03:27:00,13
6412,ORD_6413,2453,C Pod 50mg Syrup,Warehouse C,84,69,2025-02-26 18:27:00,15
6413,ORD_6414,35260,"Shuban A4 Size Thick Gummed Seal-Designed Paper Envelopes for Secure Mailing, 50 Pieces, Green,12x10 Inches",Warehouse C,11,6,2025-02-26 08:31:00,5
6414,ORD_6415,27561,Ajmal Mizyaan Concentrated Perfume Oil Oriental Musky And Carbon Homme Deodorant Citrus Spicy Fragrance 214 ml,Warehouse B,71,54,2025-02-26 23:34:00,17
6415,ORD_6416,31985,Cosmic Byte Meteoroid Laptop Cooling Pad with 6 Fan Upto 17 inch laptops (Black/Blue),Warehouse A,38,27,2025-02-26 11:35:00,11
6416,ORD_6417,34710,"E-COSMOS 5V 1.2W Portable Flexible USB LED Light (Colors May Vary, Small) - Set of 2 Pieces",Warehouse B,105,92,2025-02-26 17:06:00,13
6417,ORD_6418,11784,Zanobact D Eye/Ear Drops,Warehouse C,82,69,2025-02-26 04:28:00,13
6418,ORD_6419,21169,W Lip Crayon-Blessed,Warehouse B,69,59,2025-02-26 04:07:00,10
6419,ORD_6420,34720,Myglamm Lit Nail Enamel - Time Out 7 Ml,Warehouse A,53,42,2025-02-26 16:05:00,11
6420,ORD_6421,27521,Thyrox 75 Tablet,Warehouse A,30,19,2025-02-26 01:36:00,11
6421,ORD_6422,27522,"SanDisk Extreme microSD UHS I Card 256GB for 4K Video on Smartphones,Action Cams,Drones 190MB/s Read,130MB/s Write",Warehouse C,68,59,2025-02-26 16:43:00,9
6422,ORD_6423,16873,Daily Life Forever52 Eye Brow Brush Nx026 1's,Warehouse B,54,36,2025-02-26 01:53:00,18
6423,ORD_6424,21213,Killbact C 250mg/250mg Capsule,Warehouse C,82,76,2025-02-26 09:21:00,6
6424,ORD_6425,21145,Zylo Nasal Drops,Warehouse C,73,67,2025-02-26 08:56:00,6
6425,ORD_6426,29837,UG Cef 500mg Injection,Warehouse C,79,71,2025-02-26 20:08:00,8
6426,ORD_6427,454,CP PLUS 4G WiFi Sim Card Supported Router with LAN Port (CP-XR-DN211-S),Warehouse A,43,36,2025-02-26 13:33:00,7
6427,ORD_6428,36496,Curry Leaf Essential Oil,Warehouse A,95,77,2025-02-26 05:56:00,18
6428,ORD_6429,16575,Spiral 200mg Tablet,Warehouse C,18,10,2025-02-26 08:40:00,8
6429,ORD_6430,29581,Ajmal Desert Rose EDP Floral Oriental Perfume And Blu Homme Deodorant Aquatic Woody Fragrance 300 ml,Warehouse A,36,20,2025-02-26 03:54:00,16
6430,ORD_6431,26820,Wardof D 30mg/40mg Capsule SR,Warehouse C,13,2,2025-02-26 13:01:00,11
6431,ORD_6432,24247,"Dyazo Water Resistant Laptop Sleeve with Handle Compatible for 15 Inch to 15.6 "" Inches laptops & Notebooks - Grey",Warehouse A,70,57,2025-02-26 02:48:00,13
6432,ORD_6433,4068,Facewash - Sandal,Warehouse B,16,8,2025-02-26 01:50:00,8
6433,ORD_6434,36178,DIGITEK® (DFL-088) Universal Electronic Flash Speedlite for DSLR Cameras Canon Nikon Pentax Olympus with Standard Hot Shoe...,Warehouse C,18,8,2025-02-26 02:16:00,10
6434,ORD_6435,19723,"realme narzo 50i (Carbon Black, 4GB RAM+64GB Storage) Octa Core Processor | 6.5"" inch Large Display",Warehouse C,106,90,2025-02-26 21:38:00,16
6435,ORD_6436,29776,"HP Deskjet Ink Advantage 2338 All-in-One Printer, Scanner and Copier for Home for Home for Dependable Printing and scannin...",Warehouse C,21,7,2025-02-26 11:59:00,14
6436,ORD_6437,2391,Chambor Silver Shadow - Ivoire Rr1 32 gm,Warehouse A,46,37,2025-02-26 07:40:00,9
6437,ORD_6438,29576,"Fashion Colour Eyebrow Pencil, EB05 1.3 gm",Warehouse B,73,55,2025-02-26 09:33:00,18
6438,ORD_6439,19398,"SENIVO Laptop Stand 7 Height Adjustable, Aluminium, Ventilated, Foldable, Portable Laptop Holder for Desk & Table Mount Up...",Warehouse A,23,4,2025-02-26 12:22:00,19
6439,ORD_6440,19978,RED4 Color Blast Super Matte Lipstick Red Maroon Combo Lip color for All Daylong stay Smooth Lipstick for Girls,Warehouse B,110,93,2025-02-26 18:24:00,17
6440,ORD_6441,19742,AJM 360 Protection Shockproof Design Soft Rubberised Case with Keychain for Oppo Enco Air 2 Pro (Black),Warehouse C,49,34,2025-02-26 09:39:00,15
6441,ORD_6442,11831,JUDHUR NATURALS Organic Black Seed Oil Or Kalonji Oil | Cold Pressed black seed oil for hair growth and Healthy Skin | Imp...,Warehouse B,49,32,2025-02-26 19:04:00,17
6442,ORD_6443,5123,Montem L Syrup,Warehouse B,25,7,2025-02-26 15:25:00,18
6443,ORD_6444,30242,"UltraProlink PowerLink+ UM1023 12 Functions | Black | Type C-C 3A PD Cable | Micro USB + iPhone | Convertor, 15W Wireless ...",Warehouse A,22,12,2025-02-26 20:58:00,10
6444,ORD_6445,5356,Zitopod 100 DT Tablet,Warehouse A,96,82,2025-02-26 07:28:00,14
6445,ORD_6446,12240,Vega Luxury Bath Back Sponge (BA - 2/1) 109 gm,Warehouse C,85,78,2025-02-26 00:43:00,7
6446,ORD_6447,29841,Lazanol 750mg Tablet,Warehouse C,73,58,2025-02-26 08:02:00,15
6447,ORD_6448,32008,KAZRU Square Empty Luxurious Portable Air Cushion Puff Box BB Cream Container Case White,Warehouse C,60,55,2025-02-26 16:04:00,5
6448,ORD_6449,4067,KartString Imported Makeup Puff Tear Drop Shape (2 pieces Beauty Blender makeup sponge Random Colors),Warehouse B,92,76,2025-02-26 19:22:00,16
6449,ORD_6450,32692,Gold Creme Skin Bleach - Golden Glow,Warehouse B,94,85,2025-02-26 00:30:00,9
6450,ORD_6451,36508,Met XL 50 Tablet,Warehouse B,69,52,2025-02-26 03:24:00,17
6451,ORD_6452,32598,Spigen AlignMaster Tempered Glass Screen Protector Guard for Pixel 7 (2 Pack),Warehouse B,45,33,2025-02-26 08:43:00,12
6452,ORD_6453,11791,"Nothing Phone (1) 5G (White, 256 GB) (8 GB RAM)",Warehouse A,32,26,2025-02-26 03:59:00,6
6453,ORD_6454,27663,Dorafit 80mg Tablet,Warehouse A,97,88,2025-02-26 13:53:00,9
6454,ORD_6455,5352,Dispar Kid 300mg Tablet,Warehouse C,18,11,2025-02-26 17:45:00,7
6455,ORD_6456,29578,Zayn & Myza Vanilla Lip Balm 4.5 gm,Warehouse C,63,47,2025-02-26 07:20:00,16
6456,ORD_6457,15487,Tramakab P 500 mg/37.5 mg Tablet,Warehouse A,15,5,2025-02-26 04:13:00,10
6457,ORD_6458,2975,VIBHU Men's And Women's waterproof Socks For Crack heel PACK OF 1,Warehouse B,38,32,2025-02-26 11:18:00,6
6458,ORD_6459,1383,"Camel Soap Fresh Camel Milk and Oriental Lemongrass Soap, 100g",Warehouse B,28,20,2025-02-26 15:17:00,8
6459,ORD_6460,27572,Spigen EZ Fit Privacy Tempered Glass Screen Protector for iPhone 14 Pro - 2 Pack,Warehouse A,45,33,2025-02-26 05:28:00,12
6460,ORD_6461,11776,Azis 250mg Tablet,Warehouse B,108,98,2025-02-26 20:03:00,10
6461,ORD_6462,12221,Navneet Youva | Soft Bound/Soft Cover Long Book/Notebook For Students | 21 Cm X 29.7 Cm | Single Line | 172 Pages | Pack Of 6,Warehouse A,94,87,2025-02-26 20:06:00,7
6462,ORD_6463,21101,"BlueRigger Premium Digital Optical Audio Toslink Cable With 24K Gold Plated Connectors, 8 Channel (7.1) Audio Support (for...",Warehouse A,17,2,2025-02-26 03:08:00,15
6463,ORD_6464,8847,Moxyzust-CV Dry Syrup,Warehouse B,85,66,2025-02-26 02:12:00,19
6464,ORD_6465,34712,Lyrazine 5mg Tablet,Warehouse B,21,3,2025-02-26 00:27:00,18
6465,ORD_6466,1409,WOW IMAGINE For Samsung Galaxy F13 | M13 4G Slim Ultra Soft Rubberised Back Cover Inner Velvet Fabric Lining Matte Silicon...,Warehouse B,45,27,2025-02-26 14:50:00,18
6466,ORD_6467,35126,"Tizum USB Type C to Type C 5A (100W) Braided Sync & Fast Charging Cable for Mobile, Laptop, Macbook & other Type-C devices...",Warehouse A,82,63,2025-02-26 10:11:00,19
6467,ORD_6468,30232,Hygiene Menstrual Cup Wash,Warehouse B,111,93,2025-02-26 15:23:00,18
6468,ORD_6469,16600,"Photron 13 inches Flexible GorillaPod Octopod Tripod with Mobile Holder Attachment & 360 Degree Ball Head for Smartphones,...",Warehouse C,47,39,2025-02-26 23:16:00,8
6469,ORD_6470,32701,Lime & Basil Body Wash With Mandarine,Warehouse C,85,66,2025-02-26 14:21:00,19
6470,ORD_6471,9557,"SURGICOMFORT 3-Ply Surgical Face Mask with nose wire (100 Pcs, Color-Blue, Elastic Ear-Loop Type) Disposable Non-Woven Bre...",Warehouse B,57,47,2025-02-26 23:11:00,10
6471,ORD_6472,29821,Myglamm Wandurlust Sand Matt Nail Paint Eclairs 11 Ml,Warehouse B,68,51,2025-02-26 14:13:00,17
6472,ORD_6473,19366,Upred 40mg Injection,Warehouse C,76,67,2025-02-26 05:16:00,9
6473,ORD_6474,18917,Trazalon 100mg Tablet,Warehouse A,69,62,2025-02-26 03:20:00,7
6474,ORD_6475,28189,Osizin-M 5mg/10mg Tablet,Warehouse B,49,33,2025-02-26 23:25:00,16
6475,ORD_6476,11398,Hilmox 500mg Capsule,Warehouse C,96,79,2025-02-26 09:12:00,17
6476,ORD_6477,19428,Serjet 50mg Tablet,Warehouse A,48,33,2025-02-26 01:28:00,15
6477,ORD_6478,4965,Signature Dark Temptation - No Gas Body Deodorant For Men,Warehouse C,60,51,2025-02-26 01:37:00,9
6478,ORD_6479,9880,KAPAVER Rugged Back Cover Case for Samsung Galaxy S21 FE 5G MIL-STD 810G Officially Drop Tested Solid Black Shock Proof Sl...,Warehouse C,86,67,2025-02-26 10:52:00,19
6479,ORD_6480,21197,L Mikacin 100mg Injection,Warehouse B,97,86,2025-02-26 05:27:00,11
6480,ORD_6481,29729,"Camera Video Recording Vlogging Kit for Video Making, Mic, Mini Tripod Stand, LED Light & Phone Holder Clip for Making Vid...",Warehouse C,44,37,2025-02-26 19:08:00,7
6481,ORD_6482,19889,Passion Kiss Lip Balm,Warehouse C,9,4,2025-02-26 00:20:00,5
6482,ORD_6483,9671,"Fashion Colour Super Matte Lipstick, Spicy Affair 4 gm",Warehouse C,73,63,2025-02-26 00:33:00,10
6483,ORD_6484,15891,Nimvon S Tablet,Warehouse C,79,63,2025-02-26 18:08:00,16
6484,ORD_6485,1329,Efzid 1000mg Injection,Warehouse C,19,13,2025-02-26 19:38:00,6
6485,ORD_6486,32899,Montef-L Kid Tablet,Warehouse B,74,63,2025-02-26 16:35:00,11
6486,ORD_6487,36185,Hello Zone Exclusive Matte Finish Soft Back Case Cover for Apple iPhone 5 / 5S / Se - Black,Warehouse C,101,90,2025-02-26 11:27:00,11
6487,ORD_6488,1367,"Oil - Ayurvedic, Cool",Warehouse A,15,4,2025-02-26 14:58:00,11
6488,ORD_6489,29898,Radiant Syrup,Warehouse C,84,77,2025-02-26 06:04:00,7
6489,ORD_6490,19308,Fission Eau De Toilette Deodorant - For Man,Warehouse B,103,97,2025-02-26 15:15:00,6
6490,ORD_6491,31959,O Glimaday 1 Tablet PR,Warehouse B,101,87,2025-02-26 05:00:00,14
6491,ORD_6492,4040,TYCON 7 INCH Double Din Car Screen Stereo Media Player Audio Video Touch Screen Stereo Full HD with MP3/MP4/MP5/USB/FM Pla...,Warehouse A,79,64,2025-02-26 09:22:00,15
6492,ORD_6493,21017,Tordac 10 Tablet,Warehouse A,58,48,2025-02-26 17:38:00,10
6493,ORD_6494,5136,Fluclik 20mg Capsule,Warehouse A,97,83,2025-02-26 02:41:00,14
6494,ORD_6495,16042,Beardo Beard Brush - Nylon Bristle,Warehouse B,99,88,2025-02-26 12:28:00,11
6495,ORD_6496,15513,Eurepa 2 Tablet,Warehouse C,68,61,2025-02-26 06:24:00,7
6496,ORD_6497,16867,CZ-DSR 30mg/40mg Capsule,Warehouse C,27,11,2025-02-26 15:58:00,16
6497,ORD_6498,2567,Sounce Soft TPU Front Protection Case Cover for Samsung Galaxy Watch Active 2 44mm Smart Watch (Flexible/Silicone),Warehouse C,108,95,2025-02-26 02:57:00,13
6498,ORD_6499,29849,Panzax-DSR Capsule,Warehouse B,91,72,2025-02-26 07:56:00,19
6499,ORD_6500,26927,Faces Canada Splash Nail Enamel Voluptuous 135 8 Ml,Warehouse B,61,52,2025-02-26 03:54:00,9
6500,ORD_6501,20981,Fusibest Cream,Warehouse B,56,44,2025-02-26 15:56:00,12
6501,ORD_6502,26873,Stbotanica Vitamin C Spf 30 Pa+++ Sunscreen Oil Mineral Based 120 ml,Warehouse A,53,34,2025-02-26 08:51:00,19
6502,ORD_6503,8981,L Cbit FX 120mg Tablet,Warehouse B,31,14,2025-02-26 21:16:00,17
6503,ORD_6504,29880,Refreshing Body Oil With Terai Mint & Sugandhara,Warehouse A,111,95,2025-02-26 14:30:00,16
6504,ORD_6505,20112,Anti-Marks Natural Ayurvedic Turmeric Face Cream,Warehouse A,57,41,2025-02-26 22:04:00,16
6505,ORD_6506,32685,Zapcase Back Case Cover for Mi Redmi Note 10 Lite/Redmi Note 9 Pro/Redmi Note 9 Pro Max/Poco M2 Pro | 360 Degree Back Cove...,Warehouse B,20,14,2025-02-26 16:08:00,6
6506,ORD_6507,4988,Samsung Charger Original 25W C-Type Super Fast Charger Adapter with Cable Set Charger for Galaxy S22/S21+/S21 Ultra/S20/S2...,Warehouse A,66,60,2025-02-26 10:54:00,6
6507,ORD_6508,29883,Divinectar Skin Lightening Face Serum - Sea Buckthorn 30 ml,Warehouse A,85,71,2025-02-26 19:38:00,14
6508,ORD_6509,8980,Spaxone S 1000mg/500mg Injection,Warehouse C,107,90,2025-02-26 17:59:00,17
6509,ORD_6510,2401,mCaffeine Quick Coffee Sip - Scrub + Balm Kit 24 gm,Warehouse C,60,41,2025-02-26 11:30:00,19
6510,ORD_6511,35034,Pantocar 40 Tablet,Warehouse C,15,4,2025-02-26 20:52:00,11
6511,ORD_6512,15541,Aegte Growlong Conditioner For Hair 250 ml,Warehouse A,65,49,2025-02-26 09:56:00,16
6512,ORD_6513,20136,Hisense 139 cm (55 inches) 4K Ultra HD Smart IPS QLED TV 55U7H (Black),Warehouse C,85,80,2025-02-26 04:07:00,5
6513,ORD_6514,12151,Spigen Full Coverage Tempered Glass Screen Protector Guard for MacBook Pro 16 inch (M2 Pro / M2 Max / M1 Pro / M1 Max) - 1...,Warehouse B,89,83,2025-02-26 03:37:00,6
6514,ORD_6515,29889,Denip 50 mg/125 mg Syrup,Warehouse C,111,92,2025-02-26 23:25:00,19
6515,ORD_6516,11882,Global Desi MythiB EDP & MagicM Mist Pack of 2 250 ml,Warehouse A,47,36,2025-02-26 01:43:00,11
6516,ORD_6517,26918,Dromen & Co Dromen & Co Niacinamide Serum 30 ml,Warehouse B,115,98,2025-02-26 11:03:00,17
6517,ORD_6518,1173,Bella Voste Sand Holo Nail Paints Forest Green - 411 10 ml,Warehouse B,59,46,2025-02-26 11:35:00,13
6518,ORD_6519,19344,Matce VG Forte 1mg/1000mg/0.3mg Tablet SR,Warehouse A,41,28,2025-02-26 09:28:00,13
6519,ORD_6520,12099,"Noise ColorFit Pro 2 Full Touch Control Smart Watch with 35g Weight & Upgraded LCD Display,IP68 Waterproof,Heart Rate Moni...",Warehouse C,25,7,2025-02-26 08:48:00,18
6520,ORD_6521,36460,iEDS Lens Guard Cap for Insta360 ONE X3 Camera (One X3 Cap),Warehouse C,67,59,2025-02-26 12:04:00,8
6521,ORD_6522,32021,Cortilup 100mg Injection,Warehouse A,19,10,2025-02-26 11:33:00,9
6522,ORD_6523,19335,Parker Vector Standard Chrome Trim Ball Pen (Ink - Blue),Warehouse C,96,83,2025-02-26 04:16:00,13
6523,ORD_6524,21044,Napcet Tablet,Warehouse C,89,83,2025-02-26 05:49:00,6
6524,ORD_6525,2925,Digiway Maser Universal Wall Mount Stand for 14 inch to 32 inch LCD & LED TV,Warehouse B,88,79,2025-02-26 14:09:00,9
6525,ORD_6526,32887,"PTron Bullet 3.1A Fast Charging Car Charger, 3 USB Port, Fire Resistant, Lightweight, & Compact Car Charger for All Mobile...",Warehouse C,101,93,2025-02-26 13:15:00,8
6526,ORD_6527,18998,Ajmal Nightingale & Distraction & Persuade Deo & Aretha EDP Pack of 3 20 ml,Warehouse B,59,43,2025-02-26 16:33:00,16
6527,ORD_6528,15925,The Cosmetic Republic Multivitamin Shampoo 200 ml,Warehouse A,49,37,2025-02-26 07:58:00,12
6528,ORD_6529,29867,Flormar Highlighter Stick 01 Moon Light 10 gm,Warehouse A,68,52,2025-02-26 07:11:00,16
6529,ORD_6530,1219,Amazon Basics L6LUC022-CS-R USB USB Type C to USB 3.1 Gen1 Female Adapter - White,Warehouse C,113,96,2025-02-26 06:53:00,17
6530,ORD_6531,9382,Gemblue Biocare Gold Peel Off Mask 500 ml,Warehouse A,37,29,2025-02-26 11:49:00,8
6531,ORD_6532,12128,Speraflox 500mg Tablet,Warehouse B,89,84,2025-02-26 01:10:00,5
6532,ORD_6533,34780,Insight Cosmetics Non - Transfer Lip Color - 23 GLAM 4 ml,Warehouse C,30,11,2025-02-26 19:19:00,19
6533,ORD_6534,20883,Stbotanica Moroccan Argan Oil Day Cream With Spf 30 Uva/Uvb Pa+++ 50 gm,Warehouse C,105,97,2025-02-26 18:58:00,8
6534,ORD_6535,11427,"Seagate Barracuda 1TB Internal Hard Drive HDD – 2.5 Inch (6.35 cm) SATA 6 Gb/s, 5400 RPM, 128MB Cache for Computer Desktop...",Warehouse B,114,97,2025-02-26 10:52:00,17
6535,ORD_6536,9495,Urisort 200mg Tablet,Warehouse B,21,5,2025-02-26 16:11:00,16
6536,ORD_6537,26887,"Glow & Lovely BB Cream Make up + Multivitamin Cream Shade 01, 9 g",Warehouse B,97,91,2025-02-26 19:43:00,6
6537,ORD_6538,27471,Essential Oil - Orange,Warehouse C,10,5,2025-02-26 23:18:00,5
6538,ORD_6539,3892,"The Face Shop Waterproof and Long Lasting Water Fit Lip Tint, Lip Stain, Matte Finish, 5g - Cherry Kiss",Warehouse A,90,73,2025-02-26 11:24:00,17
6539,ORD_6540,1077,Herbal Sensitive pH balanced Liquid Handwash - Refill Pouch,Warehouse A,87,80,2025-02-26 19:45:00,7
6540,ORD_6541,29855,Essemm-Cold Oral Suspension Strawberry,Warehouse B,99,86,2025-02-26 05:13:00,13
6541,ORD_6542,16608,Protolock D 30mg/40mg Capsule SR,Warehouse C,42,31,2025-02-26 10:16:00,11
6542,ORD_6543,26875,Safe Hair Color - Burgundy,Warehouse A,96,81,2025-02-26 15:43:00,15
6543,ORD_6544,2870,F Gear Luxur Black 25 liter Laptop Backpack,Warehouse B,41,32,2025-02-26 22:43:00,9
6544,ORD_6545,27393,Drotamef Tablet,Warehouse C,85,76,2025-02-26 20:23:00,9
6545,ORD_6546,16058,Ace-Dalcare T 8 Tablet,Warehouse B,45,38,2025-02-26 01:36:00,7
6546,ORD_6547,32022,"One Plus Latest USB 3.0 to Type-C OTG Cable Male-Female Adapter Mouse, Pendrive Connector Compatible with All C Type Suppo...",Warehouse B,20,10,2025-02-26 11:24:00,10
6547,ORD_6548,20044,Silver Charcoal Anti Bacterial Tooth Brush - Soft,Warehouse A,30,11,2025-02-26 12:00:00,19
6548,ORD_6549,36472,Scotgesic SP 50mg/325mg/10mg Tablet,Warehouse A,82,67,2025-02-26 13:59:00,15
6549,ORD_6550,16613,OpenTech® Tempered Glass Screen Protector Compatible for iQOO 9T 5G / iQOO 11 / iQOO Neo 7 with Edge to Edge Coverage and ...,Warehouse A,46,34,2025-02-26 04:23:00,12
6550,ORD_6551,2907,Green Tea High Gloss Lip Balm,Warehouse B,33,27,2025-02-26 01:42:00,6
6551,ORD_6552,19337,Baby Hair Oil with Jojoba & Almond Oil,Warehouse C,98,82,2025-02-26 13:01:00,16
6552,ORD_6553,20088,Jasmine Bloom Soap Bar,Warehouse C,15,3,2025-02-26 17:03:00,12
6553,ORD_6554,18979,"ACESHLEY 19mm Soft Silicone Smartwatch Band, Color Metal Buckle Strap for Noise ColorFit Pulse, ColorFit Pro 2/Oxy, Noise ...",Warehouse C,56,45,2025-02-26 06:46:00,11
6554,ORD_6555,1370,"Sounce Earphone Case Cover Compatible with Boult Audio AirBass PowerBuds, Soft Silicone Skin Case Cover Shock-Absorbing Pr...",Warehouse C,97,84,2025-02-26 15:03:00,13
6555,ORD_6556,27154,Robustrion Smart Trifold Hard Back Flip Stand Case Cover for Samsung Galaxy Tab A8 10.5 inch [SM-X200/X205/X207] 2022 - Ei...,Warehouse C,32,23,2025-02-26 23:47:00,9
6556,ORD_6557,34872,Trumph P 37.5mg/325mg Tablet,Warehouse B,51,35,2025-02-26 19:58:00,16
6557,ORD_6558,5528,Ocvlin Eye Drop,Warehouse B,28,12,2025-02-26 11:20:00,16
6558,ORD_6559,28068,"AmazonBasics 3.5mm to 2-Male RCA Adapter Cable For Tablet, Smartphone (Black, 15 feet)",Warehouse A,46,38,2025-02-26 12:23:00,8
6559,ORD_6560,35341,Livatira 750mg Tablet,Warehouse A,89,72,2025-02-26 08:03:00,17
6560,ORD_6561,19141,boAt Bass Heads 225 in-Ear Wired Headphones with Mic (Neon Lime),Warehouse C,57,40,2025-02-26 19:11:00,17
6561,ORD_6562,20629,DHOTRA Magnetic Phone Holder in Car Airvent Mount Universal Magnetic Mobile Phone Holder Stand Magnet Support for All Smar...,Warehouse C,61,45,2025-02-26 01:59:00,16
6562,ORD_6563,9183,"Nycil Cool Herbal, 50g - Pack of 3",Warehouse C,106,93,2025-02-26 23:36:00,13
6563,ORD_6564,1294,Xpect-D Syrup Mixed Fruit Sugar Free,Warehouse C,73,54,2025-02-26 03:48:00,19
6564,ORD_6565,5027,"Vivo Y02 (Orchid Blue, 3GB RAM, 32GB Storage) with No Cost EMI/Additional Exchange Offers",Warehouse A,46,29,2025-02-26 21:58:00,17
6565,ORD_6566,20607,Amlotes AT 5mg/50mg Tablet,Warehouse B,82,77,2025-02-26 17:44:00,5
6566,ORD_6567,27900,Hair Nourishing Oil,Warehouse B,56,42,2025-02-26 03:21:00,14
6567,ORD_6568,32565,Mast Tattoo Flip Rotary Pen Machine Six Stroke Length Changeble Custom Coreless Motor for All Tattoo Styles M829 (Black),Warehouse B,42,24,2025-02-26 22:38:00,18
6568,ORD_6569,36413,Brutal 200mg/50mg Syrup,Warehouse B,35,24,2025-02-26 14:11:00,11
6569,ORD_6570,19045,Casio DJ-220D Plus 300 Steps Check & Correct Premium Desktop Calculator with Metallic faceplate & Bigger Screen/Keys (12 D...,Warehouse C,13,6,2025-02-26 21:57:00,7
6570,ORD_6571,20655,Dizer Suspension,Warehouse C,56,51,2025-02-26 19:33:00,5
6571,ORD_6572,35311,Estizide 2mg Tablet,Warehouse A,35,18,2025-02-26 19:36:00,17
6572,ORD_6573,10055,Ajmal Avid & Raindropss & Blu & Aurum Deo & Aretha EDP Pack of 5 20 ml,Warehouse A,115,96,2025-02-26 23:15:00,19
6573,ORD_6574,20322,Twinblok Trio Tablet ER,Warehouse B,82,66,2025-02-26 14:30:00,16
6574,ORD_6575,36094,"Amazon Brand - Solimo Portable Tyre Inflator, 12V (Black)",Warehouse A,105,89,2025-02-26 18:39:00,16
6575,ORD_6576,36393,INEFABLE Mi Band 5 and 6 Straps Original for Mi Band M5 and M6 Wristband Strap Soft Silicone Adjustable Band Strap-Device ...,Warehouse C,23,10,2025-02-26 17:04:00,13
6576,ORD_6577,5022,Bio Mountain Ebony - Fresh Growth Stimulating Vitalising Serum,Warehouse B,63,49,2025-02-26 17:58:00,14
6577,ORD_6578,382,Fluka 150 Tablet,Warehouse A,11,6,2025-02-26 07:04:00,5
6578,ORD_6579,15779,"Cason - Helmet Mount for Action Camera/Helmet Chin Mount/Helmet Strap Belt for Cason Action Camera CN10 CS6, Go pro Hero 1...",Warehouse C,16,9,2025-02-26 10:20:00,7
6579,ORD_6580,15786,"Fashion Colour Non - Transfer Matt Waterproof Lipstick, 6 Violet Light 2.6 gm",Warehouse B,14,5,2025-02-26 19:03:00,9
6580,ORD_6581,29486,Acp  Tablet MR,Warehouse C,118,99,2025-02-26 03:16:00,19
6581,ORD_6582,27179,House Of Makeup Nail Lacquer - Inferno 12 ml,Warehouse B,79,67,2025-02-26 21:57:00,12
6582,ORD_6583,10131,Nirnorf TZ Tablet,Warehouse A,100,93,2025-02-26 16:10:00,7
6583,ORD_6584,15731,Maryaj Edp Wild Speed For Him 100 Ml,Warehouse B,75,56,2025-02-26 06:51:00,19
6584,ORD_6585,16249,Quitin 50mg Tablet,Warehouse B,80,61,2025-02-26 01:32:00,19
6585,ORD_6586,12015,Aclirene MR Tablet,Warehouse A,46,38,2025-02-26 00:32:00,8
6586,ORD_6587,5037,Atarstin 10mg Tablet,Warehouse A,29,18,2025-02-26 22:08:00,11
6587,ORD_6588,15793,The Man Company Beard Growth Oil - Almond & Thyme 50 ml,Warehouse B,48,29,2025-02-26 21:16:00,19
6588,ORD_6589,5513,"Tombow 57316 Mono Zero Eraser Value Pack, Round 2.3 mm. Precision Tip Eraser with Refills",Warehouse B,51,45,2025-02-26 18:04:00,6
6589,ORD_6590,29482,Methylco Plus Injection,Warehouse B,97,79,2025-02-26 14:15:00,18
6590,ORD_6591,15804,Lakme 9 To 5 Weightless Lip & Cheek Color Chocolate Mousse 9 Gm,Warehouse A,55,50,2025-02-26 03:29:00,5
6591,ORD_6592,31918,Cghest 8mg Tablet,Warehouse B,96,89,2025-02-26 17:36:00,7
6592,ORD_6593,19104,Vaadi Herbals Foot Cream - Clove Oil & Sandalwood 150 gm,Warehouse B,34,25,2025-02-26 09:23:00,9
6593,ORD_6594,15712,Vlcc Ayurveda Soothing Aleo Vera Gel 100 Gm,Warehouse C,89,79,2025-02-26 04:16:00,10
6594,ORD_6595,27189,Zeconac TH 100mg/8mg Tablet,Warehouse B,19,7,2025-02-26 21:45:00,12
6595,ORD_6596,30058,Pikkme Bumper Back Cover for Samsung Galaxy M21 2021 / M21 / M30S (TPU | Black | Solid),Warehouse C,22,14,2025-02-26 06:40:00,8
6596,ORD_6597,34914,Red Lemon Swisslook Polyester Bange Series 45L 15.6-inch Laptop Bags Backpack for Men and Women Waterproof USB Anti Theft ...,Warehouse C,58,43,2025-02-26 03:40:00,15
6597,ORD_6598,19774,Levonex 500mg Tablet,Warehouse B,84,68,2025-02-26 05:41:00,16
6598,ORD_6599,27187,Yves Rocher Energizing Bath And Shower Gel Raspberry Peppermint 200 ml,Warehouse C,60,53,2025-02-26 21:58:00,7
6599,ORD_6600,30066,Cudrox 250mg Tablet,Warehouse C,67,60,2025-02-26 08:23:00,7
6600,ORD_6601,345,ABOUT SPACE Multipurpose Scissors Set - (Set of 3) Stainless Steel Multicoloured Scissors at Different Sizes for Househol...,Warehouse A,93,83,2025-02-26 20:25:00,10
6601,ORD_6602,15905,Afodin-CV 250mg/125mg Tablet,Warehouse B,52,36,2025-02-26 12:04:00,16
6602,ORD_6603,5563,"FUR JADEN Travel Laptop Backpack, Business Backpacks with USB Charging Port, Water Resistant College School Computer Bag f...",Warehouse C,99,86,2025-02-26 08:04:00,13
6603,ORD_6604,20502,Zapcase Back Case Cover for Oppo A9 (2020) / Oppo A5 (2020) | Compatible for Oppo A9 (2020) / Oppo A5 (2020) Back Case Cov...,Warehouse B,25,20,2025-02-26 01:09:00,5
6604,ORD_6605,29514,Nature's Essence Hydra White Whitening Face Wash Gel 65 ml,Warehouse B,94,77,2025-02-26 12:09:00,17
6605,ORD_6606,11745,"Ambrane 50000mAh Power Bank, 20W Fast Charging, Metallic Body, Triple Output, Type C PD (Input & Output), Li-Polymer, Mult...",Warehouse C,20,2,2025-02-26 06:47:00,18
6606,ORD_6607,20684,Lenovo GX20P92532 65W AC Adapter/Charger with Power Cord for Select Models of Lenovo (Type-C Pin) Laptops Black,Warehouse C,59,48,2025-02-26 07:20:00,11
6607,ORD_6608,5131,"boAt AUX 500 Indestructible 3.5mm Male to Male Metallic Aux Audio Cable with Gold Plated Connectors for Smartphone, 1.5 Me...",Warehouse B,83,64,2025-02-26 01:52:00,19
6608,ORD_6609,20496,Scotch 3M Wall Safe Tape | 1 Roll with Dispenser | Holds Upto 14g | for Damage Free Mounting and Décor | Removes Without R...,Warehouse C,26,15,2025-02-26 09:37:00,11
6609,ORD_6610,16776,"TOSHIBA Canvio Basics 1TB Portable External HDD - USB 3.2 for PC Laptop Windows and Mac, 3 Years Warranty, External Hard D...",Warehouse A,114,97,2025-02-26 22:49:00,17
6610,ORD_6611,1041,Mrka P Oral Suspension,Warehouse C,49,31,2025-02-26 23:05:00,18
6611,ORD_6612,30075,Maryaj Cosmo Girl EDP Floral Powdery Perfume And Ajmal Raindrops Femme Deodorant Floral Chypre Fragrance 300 ml,Warehouse C,37,28,2025-02-26 07:42:00,9
6612,ORD_6613,12071,"Callas Metal Mesh Desk Organizer, Black LD 708-05",Warehouse B,19,4,2025-02-26 14:15:00,15
6613,ORD_6614,27086,Rabefen D 200mg/20mg Capsule SR,Warehouse A,99,83,2025-02-26 12:38:00,16
6614,ORD_6615,20489,"Rozia Set Of 2 Pcs Face Cleansing Sponge Puff Makeup Washing Pad Deep Cleansing & Exfoliating Facial Sponge, Pink",Warehouse A,63,56,2025-02-26 01:35:00,7
6615,ORD_6616,27084,Eyetex Dazller Classique Compact Powder- 8010 Dusky 9 gm,Warehouse C,42,25,2025-02-26 03:39:00,17
6616,ORD_6617,36123,Spigen Liquid Crystal Back Cover Case for Samsung Galaxy S23 Ultra (TPU | Crystal Clear),Warehouse A,15,2,2025-02-26 19:37:00,13
6617,ORD_6618,20470,"Etude House Dia Darling Water Gel Lip Tint, Matte Finish - RD 307 Suicobar",Warehouse B,87,78,2025-02-26 21:03:00,9
6618,ORD_6619,20707,"10W to 65W Type-C USB Cable for Realme 7 Pro USB Cable Original Charger Cable | Quick, Dash, Warp, Dart, Flash, Turbo, Sup...",Warehouse C,65,60,2025-02-26 03:50:00,5
6619,ORD_6620,13219,Spikalon DV 250mg Tablet ER,Warehouse C,108,96,2025-02-26 05:32:00,12
6620,ORD_6621,7088,Zenworm 400mg Tablet,Warehouse A,67,56,2025-02-26 12:53:00,11
6621,ORD_6622,10825,Coconut Hair & Skin Oil,Warehouse B,96,85,2025-02-26 15:18:00,11
6622,ORD_6623,10488,Face Wash - White Tea & Chamomile,Warehouse C,22,16,2025-02-26 05:15:00,6
6623,ORD_6624,30572,AEIDESS Tempered Glass Screen Guard Compatible for OnePlus 7 Pro / 7T Pro with Edge to Edge Full Screen Coverage With Inst...,Warehouse B,15,9,2025-02-26 02:36:00,6
6624,ORD_6625,16365,Nykaa Eyem Smoky Kajal,Warehouse C,49,37,2025-02-26 15:24:00,12
6625,ORD_6626,14616,"Fashion Colour Colour Correction Makeup Base Single Packing, FS27 3.5 gm",Warehouse A,98,79,2025-02-26 10:41:00,19
6626,ORD_6627,28509,Green Coffee Beans Powder - Supports Fat Metabolism,Warehouse B,27,17,2025-02-26 19:26:00,10
6627,ORD_6628,14614,Brozeet-LS Plus Syrup,Warehouse A,72,67,2025-02-26 07:55:00,5
6628,ORD_6629,27740,Robustrion Smart Trifold Hard Back Flip Stand Case Cover for Samsung Galaxy Tab A8 10.5 inch [SM-X200/X205/X207] 2022 - Stars,Warehouse A,94,77,2025-02-26 16:03:00,17
6629,ORD_6630,8331,Henna & Ginseng Anti Hair Loss Shampoo,Warehouse C,53,41,2025-02-26 18:04:00,12
6630,ORD_6631,17201,BabyChakra Strengthening Baby Hair Oil 100 ml,Warehouse B,88,72,2025-02-26 23:56:00,16
6631,ORD_6632,30744,Clavicure LB 625 Tablet,Warehouse B,74,68,2025-02-26 18:01:00,6
6632,ORD_6633,22686,SheOak Empty Luxurious Air Cushion Puff Box BB Cream Container Makeup Case Portable B,Warehouse C,70,51,2025-02-26 06:33:00,19
6633,ORD_6634,3587,"BESTOR® USB C Hub 4K 30Hz, 7-in-1 USB-C Hub Multiport Adapter with HDMI, 87W PD, Ethernet, SD/TF Cards Reader, 1 USB-C,1 U...",Warehouse A,55,45,2025-02-26 06:50:00,10
6634,ORD_6635,19626,"Insight Non Transfer Lip Color, 4ml (22 Autumn) & Insight Non Transfer Lip Color, 4ml (LG40=28)",Warehouse B,96,88,2025-02-26 12:14:00,8
6635,ORD_6636,12681,Dotclav Dry Syrup,Warehouse A,53,35,2025-02-26 01:07:00,18
6636,ORD_6637,26264,Richfix 200mg Tablet,Warehouse C,51,34,2025-02-26 04:08:00,17
6637,ORD_6638,36570,Bodylicious Deodorant Spray For Women - Spell,Warehouse B,89,80,2025-02-26 04:15:00,9
6638,ORD_6639,8029,Ajmal Sacrifice II Wisal Dahab Wisal Dahab Deodorant Spray (Pack of 3) 200 ml,Warehouse C,78,66,2025-02-26 08:23:00,12
6639,ORD_6640,15228,MI Micro USB 100cm Braided Cable Red Micro USB/type B|Tangle free |Sturdy built with kevlar protection|480Mbps Speed|Suppo...,Warehouse C,100,90,2025-02-26 20:20:00,10
6640,ORD_6641,32497,Monticlay-LC Tablet,Warehouse C,102,96,2025-02-26 17:02:00,6
6641,ORD_6642,26605,Lustree Scratch Proof Tab Tempered Glass Screen Protector for Realme Pad 10.4 inch,Warehouse A,101,95,2025-02-26 07:54:00,6
6642,ORD_6643,8690,TheGiftKart Ultra-Hybrid Crystal Clear Back Case Cover for iPhone 14 Pro MAX Back Cover Case | Slim Fit Shockproof Design...,Warehouse B,71,56,2025-02-26 00:00:00,15
6643,ORD_6644,21602,"Blue Heaven Hypergel Nailpaint - Ray of Gold, 702 11 ml",Warehouse B,61,47,2025-02-26 07:00:00,14
6644,ORD_6645,5836,GlucoPlus C - Lemon,Warehouse A,74,58,2025-02-26 22:00:00,16
6645,ORD_6646,26588,"Oraimo Premium Cordless Electric Shaver for men Built in pop-up Trimmer,Super Fast Charge 90 minutes Runtime with Digital ...",Warehouse C,103,92,2025-02-26 22:47:00,11
6646,ORD_6647,26570,Paro 10mg Tablet,Warehouse B,28,19,2025-02-26 01:10:00,9
6647,ORD_6648,27689,St.Botanica HA-Hyaluronic Acid Professional Facial Serum 20 ml,Warehouse B,52,47,2025-02-26 11:33:00,5
6648,ORD_6649,26580,Vega Wooden Paddle Brush (E2 - PB) 152 gm,Warehouse C,72,60,2025-02-26 03:45:00,12
6649,ORD_6650,21628,Ifax Eye Drop,Warehouse B,64,48,2025-02-26 15:10:00,16
6650,ORD_6651,30359,"Samsung Galaxy S20 FE 5G (Cloud Navy, 8GB RAM, 128GB Storage) with No Cost EMI & Additional Exchange Offers",Warehouse C,78,68,2025-02-26 11:15:00,10
6651,ORD_6652,19695,"TheGiftKart Back Cover Case for Redmi Note 10 Pro/Pro Max (Polycarbonate, TPU | Transparent Back | Black Bumper)",Warehouse A,66,55,2025-02-26 21:02:00,11
6652,ORD_6653,36575,"ProElite Sleek Smart Flip Case Cover for Lenovo Tab M10 HD 2nd Gen TB-X306X / Smart Tab M10 HD 2nd Gen TB-X306F, Black",Warehouse A,74,55,2025-02-26 02:30:00,19
6653,ORD_6654,25945,"Natural Health Products Amla Indian Gooseberry (Emblica Officinallis) Powder For Hair Growth & Skin Care, 200 g",Warehouse C,78,68,2025-02-26 14:56:00,10
6654,ORD_6655,32191,"Amazon Brand - Solimo Silicone, Thermoplastic Polyurethane Anti Dust Plug Mobile Cover (Soft & Flexible Back Cover) for Re...",Warehouse C,104,92,2025-02-26 06:35:00,12
6655,ORD_6656,22767,Feuxo M 10mg/120mg Tablet,Warehouse B,52,40,2025-02-26 21:31:00,12
6656,ORD_6657,25997,Hair Oil - Daily Care Nourishing,Warehouse B,40,22,2025-02-26 15:39:00,18
6657,ORD_6658,6197,Clamotus 500mg/125mg Tablet,Warehouse A,107,91,2025-02-26 11:53:00,16
6658,ORD_6659,26015,Serie Expert ZNPT+Citric Acid Instant Clear Anti Dandruff Shampoo,Warehouse B,94,85,2025-02-26 08:26:00,9
6659,ORD_6660,2239,Fashion Colour Ultra Matte Lip Primer 2.8 gm,Warehouse A,91,86,2025-02-26 14:53:00,5
6660,ORD_6661,22621,DeBelle Gel Nail Lacquer Pandora Blush Rose Gold Glitter Nail Polish 8 ml,Warehouse C,47,42,2025-02-26 11:32:00,5
6661,ORD_6662,2860,Flormar Camouflage Palette Concealer 8 ml,Warehouse C,39,23,2025-02-26 18:19:00,16
6662,ORD_6663,22623,Skin Cottage Bath + Scrub (Peach) 400 ml,Warehouse B,90,73,2025-02-26 05:05:00,17
6663,ORD_6664,33181,MAPPERZ Handle Grip Nail Brush Hand Finger Toe Nail Scrub Cleaning Brush Manicure Pedicure Scrubbing Cleaner Brush for Men...,Warehouse B,69,58,2025-02-26 02:46:00,11
6664,ORD_6665,14662,Vomiover Syrup,Warehouse C,86,77,2025-02-26 23:34:00,9
6665,ORD_6666,12650,Liquid Handwash - Original,Warehouse B,16,7,2025-02-26 21:56:00,9
6666,ORD_6667,10476,Zumrab 20mg Tablet,Warehouse C,80,65,2025-02-26 05:13:00,15
6667,ORD_6668,8069,cute lipstick set of 2( orange ),Warehouse B,28,14,2025-02-26 13:51:00,14
6668,ORD_6669,34222,Blue Heaven Lipstick Glam Diva (Matte),Warehouse C,63,46,2025-02-26 06:03:00,17
6669,ORD_6670,18409,Monotax O 50mg Syrup,Warehouse C,80,66,2025-02-26 22:03:00,14
6670,ORD_6671,6135,VM - PROTEC 3D Back Camera Lens Protector For OnePlus 11R 5G Full Coverage 360 Degree Protection Tempered Glass Bubble-Fre...,Warehouse B,108,89,2025-02-26 03:44:00,19
6671,ORD_6672,4791,Sirona Non-applicator Tampon - Super + Heavy Flow 20's,Warehouse A,39,33,2025-02-26 05:50:00,6
6672,ORD_6673,8113,"Shiseido Waso Fresh Jelly Lotion, 150ml",Warehouse B,51,41,2025-02-26 05:21:00,10
6673,ORD_6674,35201,"Garnier Skin Naturals, Lotion for Body, Brightening and Anti-Dark Spots, Bright Complete, 250 ml",Warehouse A,54,47,2025-02-26 08:43:00,7
6674,ORD_6675,3579,French Lavender Handmade Soap,Warehouse C,97,83,2025-02-26 03:41:00,14
6675,ORD_6676,4398,Superdrug Tea Tree Spot Gel 15 ml,Warehouse C,21,11,2025-02-26 23:19:00,10
6676,ORD_6677,928,Balm - Pain,Warehouse B,60,51,2025-02-26 15:56:00,9
6677,ORD_6678,14549,"Cute Mini Lipstick Set, Cute Capsule Waterproof Lipstick Long Lasting Mini Capsules Lipstick Finish - Multicolor",Warehouse A,45,28,2025-02-26 23:54:00,17
6678,ORD_6679,22654,Indrox 500 Tablet,Warehouse B,109,95,2025-02-26 16:51:00,14
6679,ORD_6680,22640,Spozone 1000mg/500mg Injection,Warehouse C,108,98,2025-02-26 13:05:00,10
6680,ORD_6681,26025,Spigen TPU + Polycarbonate Thin Fit Cover Case for Apple Watch 8 / 7 (45mm) - Graphite (Watch not Included),Warehouse C,29,15,2025-02-26 14:19:00,14
6681,ORD_6682,29689,Mefcure Suspension,Warehouse B,17,10,2025-02-26 04:39:00,7
6682,ORD_6683,11230,Lakme Absolute Matte Ultimate Lip Color With Argan Oil Brunch Nude 3.4 Gm,Warehouse C,33,25,2025-02-26 05:12:00,8
6683,ORD_6684,26034,Apsara Avengers Extra Dark Pencil,Warehouse C,73,67,2025-02-26 01:05:00,6
6684,ORD_6685,4793,Tozaar RH Tablet,Warehouse B,25,12,2025-02-26 05:42:00,13
6685,ORD_6686,8115,Lakme Absolute Mattereal Mousse Concealer 03 Honey 9 Gm,Warehouse B,22,8,2025-02-26 20:53:00,14
6686,ORD_6687,3611,Glimmer Ne Coffee Brown 5Ml Btl M 20 ml,Warehouse B,30,15,2025-02-26 05:28:00,15
6687,ORD_6688,12321,"sekyo S1 Smartwatch Kids AGPS/LBS Tracking Watch with Mobile Tracking, SOS, Calling Function for Kids Safety, Smart Watch ...",Warehouse C,106,89,2025-02-26 10:39:00,17
6688,ORD_6689,2347,Lakme Absolute Plump & Shine Lip Gloss Beige Shine 3 Ml,Warehouse A,45,26,2025-02-26 12:10:00,19
6689,ORD_6690,4927,Exlla 100mg Tablet DT,Warehouse B,33,25,2025-02-26 09:20:00,8
6690,ORD_6691,11597,Apple iPhone 12 (64GB) - Black,Warehouse C,55,45,2025-02-26 20:27:00,10
6691,ORD_6692,3852,Seurox 250mg Tablet,Warehouse A,23,7,2025-02-26 19:37:00,16
6692,ORD_6693,21318,R for Rabbit Snicker The Playful Automatic Baby Swing with Hanging Toys and Remote Control for Newborn Baby (Grey Blue),Warehouse B,93,84,2025-02-26 18:52:00,9
6693,ORD_6694,3851,Maybelline New York Set of 2 Super Stay Matte Ink Liquid Lipstick,Warehouse B,44,36,2025-02-26 19:39:00,8
6694,ORD_6695,30261,KC One SB 1000mg/500mg Injection,Warehouse A,25,8,2025-02-26 19:10:00,17
6695,ORD_6696,21342,Universal Remote Control Compatible for All Samsung TV LED QLED UHD SUHD HDR LCD Frame Curved Solar HDTV 4K 8K 3D Smart TV...,Warehouse B,22,6,2025-02-26 22:56:00,16
6696,ORD_6697,642,"Amazon Basics USB 2.0 Cable - A-Male to Mini-B - 6 Feet (1.8 Meters),Black",Warehouse C,71,60,2025-02-26 08:47:00,11
6697,ORD_6698,15360,"Panasonic Eneloop CC55N Smart and Quick Charger for AA & AAA Rechargeable Batteries,Input AC100V‐240V 50‐60HZ,Charging Out...",Warehouse B,57,41,2025-02-26 17:39:00,16
6698,ORD_6699,34646,"NoiseFit Force Rugged Round Dial Bluetooth Calling Smart Watch with 1.32"" HD screen, Functional Crown, 550 NITS, 7 days ba...",Warehouse B,19,14,2025-02-26 09:03:00,5
6699,ORD_6700,10149,"USM I8 Pro Max Smart Watch Latest Fitness Smart Watch, Bluetooth Function 50 Sports Mode Smartwatch for Mens & Women, Hear...",Warehouse C,65,52,2025-02-26 21:05:00,13
6700,ORD_6701,18861,Dell Original 45W 19.5V Laptop Charger Adapter with 4.5mm pin for Inspiron 3552 5557 5565 and 7368 Models - Black,Warehouse C,42,27,2025-02-26 02:47:00,15
6701,ORD_6702,30273,Lefo 500mg Tablet,Warehouse C,29,20,2025-02-26 23:44:00,9
6702,ORD_6703,26721,Vega Eye Shadow Brush Medium (EV - 02) 10 gm,Warehouse A,55,45,2025-02-26 14:53:00,10
6703,ORD_6704,18853,"Samsung Galaxy S23 Ultra 5G (Cream, 12GB, 256GB Storage)",Warehouse B,100,90,2025-02-26 14:34:00,10
6704,ORD_6705,21396,Creme Care Soap - For Hands & Body,Warehouse A,21,12,2025-02-26 20:58:00,9
6705,ORD_6706,18887,"KABEER ART 48 Pc Color gel pens,Glitter, Metallic, Neon pens Set Good gift For Coloring,Sketching,Painting, Drawing",Warehouse C,37,28,2025-02-26 08:15:00,9
6706,ORD_6707,3853,Khadi Essentials The Kajli Collection Hair Rinser - Activated Bamboo Charcoal & Barley 200 ml,Warehouse A,20,10,2025-02-26 22:47:00,10
6707,ORD_6708,8679,"COAL Clean Beauty , Night Cream 50 ml",Warehouse B,37,23,2025-02-26 17:38:00,14
6708,ORD_6709,8704,"Eveready Rechargeable AA Battery, 04 Pieces Pack, White (1000 Series, BP4 700 NIMH)",Warehouse B,72,56,2025-02-26 07:15:00,16
6709,ORD_6710,21525,Thermal Grizzly Kryonaut Thermal Grease Paste - 1.0 Gram,Warehouse A,60,42,2025-02-26 09:46:00,18
6710,ORD_6711,26649,"OnePlus 11R 5G (Galactic Silver, 8GB RAM, 128GB Storage)",Warehouse B,13,3,2025-02-26 11:17:00,10
6711,ORD_6712,1483,Vitality Capsules,Warehouse B,22,15,2025-02-26 14:04:00,7
6712,ORD_6713,3827,Ceftec O 200mg/250mg Tablet,Warehouse B,30,23,2025-02-26 01:41:00,7
6713,ORD_6714,35256,"Sandisk Cruzer force USB Pen drive durable 64GB, Metal, Silver",Warehouse B,97,92,2025-02-26 13:12:00,5
6714,ORD_6715,36521,Coxitas P 60mg/325mg Tablet,Warehouse A,25,14,2025-02-26 07:37:00,11
6715,ORD_6716,8692,"mobimint Gorilla Tripod/Mini 33 cm (12 Inch) Tripod for Mobile Phone with Phone Mount & R-Mote, Flexible Gorilla Stand",Warehouse B,106,90,2025-02-26 14:25:00,16
6716,ORD_6717,1462,Nervistar 1500mcg Injection,Warehouse C,90,74,2025-02-26 15:46:00,16
6717,ORD_6718,28235,Telsartan-H 80 Activ Tablet,Warehouse B,16,1,2025-02-26 15:24:00,15
6718,ORD_6719,21436,Beauty People Sheer Color Lipstick - 602 3.8 gm,Warehouse A,38,32,2025-02-26 10:45:00,6
6719,ORD_6720,12288,FREXCEZ USB-C to i Phone Cable Compatible for iPhone 12/12mini/12pro/12promax [CABLE],Warehouse A,78,67,2025-02-26 07:13:00,11
6720,ORD_6721,3840,MYVN WARP/Dash Charging Type c Charging Adapter Cable Compatible for One Plus 8T 8 8pro 7 Pro / 7T / 7T Pro Nord and Dash ...,Warehouse C,109,99,2025-02-26 11:06:00,10
6721,ORD_6722,15330,"Syncwire Type C to 3.5 mm Jack Audio Connector, Headphones Jack Converter Audio Adapter Compatible with OnePlus Nord CE/ 1...",Warehouse C,26,12,2025-02-26 15:05:00,14
6722,ORD_6723,12287,Avclif 250mg/125mg Tablet,Warehouse B,103,88,2025-02-26 06:20:00,15
6723,ORD_6724,21710,MARVIK Silicone Band Strap Belt for Realme Smart Band RMA183 (Tracker Not Included),Warehouse B,87,74,2025-02-26 11:15:00,13
6724,ORD_6725,284,Nuramed 75mg Capsule,Warehouse B,110,97,2025-02-26 03:26:00,13
6725,ORD_6726,11710,"ZEBRONICS Zeb-Sound Bomb 5 TWS V5.0 Bluetooth Truly Wireless in Ear Earbuds with Up to 22H Backup, Flash Connect, Splash P...",Warehouse A,91,75,2025-02-26 09:52:00,16
6726,ORD_6727,15160,Conaril DX Syrup,Warehouse A,49,44,2025-02-26 09:39:00,5
6727,ORD_6728,21728,"iQOO 9 SE 5G (Sunset Sierra, 8GB RAM, 128GB Storage) | Qualcomm Snapdragon 888 | 66W Flash Charge",Warehouse B,86,69,2025-02-26 20:19:00,17
6728,ORD_6729,33012,Insight Cosmetics Pastel Color Nail Polish - 39 9 ml,Warehouse A,22,15,2025-02-26 13:41:00,7
6729,ORD_6730,26563,Pure Extra Virgin Golden Jojoba Oil - Boutique Quality,Warehouse B,36,17,2025-02-26 22:26:00,19
6730,ORD_6731,21351,Itrahit 200mg Capsule,Warehouse A,70,64,2025-02-26 22:24:00,6
6731,ORD_6732,8626,Uncle Tony Hydrating Face Mask 100 ml,Warehouse B,94,80,2025-02-26 03:34:00,14
6732,ORD_6733,26566,Wet N Wild Megaglo Highlighting Powder - Blossom Glow 5.4 gm,Warehouse B,106,94,2025-02-26 17:51:00,12
6733,ORD_6734,21652,"Noise Newly Launched Bravo Bluetooth Neckband in Ear with Upto 35 Hours of Playtime, Instacharge (10-min Charge=10-hrs Pla...",Warehouse B,86,72,2025-02-26 01:24:00,14
6734,ORD_6735,16297,Comet Busters Matte Black Eyeliner Stickers (EYE055),Warehouse B,35,18,2025-02-26 13:51:00,17
6735,ORD_6736,36038,"The Canvas Arts After Dark, Dark Desire Hot & Sexy Honeymoon Temporary Tattoo, Waterproof Hot & Sexy Tattoo for Women TL-8...",Warehouse C,101,94,2025-02-26 16:09:00,7
6736,ORD_6737,21705,"Kanget USB C to 3.5mm Headphone Jack, Hi-Res DAC Type C to Audio Adapter Cable Compatible with Pixel 2/2XL/3/3XL , OnePlus...",Warehouse C,100,81,2025-02-26 01:00:00,19
6737,ORD_6738,15184,Earmok Refill Ink Compatible for Canon G Series GI790 Printer G1000 G1010 G2000 G2002 G2010 G2012 G3000 G3010 G3012 G4000 ...,Warehouse C,75,68,2025-02-26 13:40:00,7
6738,ORD_6739,5868,Beauty People Natural HD Matte Lip Crayon Riot - 104 4 gm,Warehouse C,65,48,2025-02-26 08:15:00,17
6739,ORD_6740,21694,Flu Z 150mg Tablet,Warehouse C,73,60,2025-02-26 02:27:00,13
6740,ORD_6741,35177,Genera 100 mg/100 mg Syrup,Warehouse B,95,90,2025-02-26 18:17:00,5
6741,ORD_6742,15197,"V-Guard Voltino Grand Digi Plus TV Stabilizer for up to 203 cm 80"" Smart TV+Set Top Box (Black)",Warehouse C,77,67,2025-02-26 04:09:00,10
6742,ORD_6743,4914,TheGiftKart Crystal Clear Back Cover Case for Samsung Galaxy A14 5G | 360 Degree Protection | Shock Proof Design | Transpa...,Warehouse C,91,79,2025-02-26 23:43:00,12
6743,ORD_6744,21681,Ofly-OZ Oral Suspension,Warehouse A,26,7,2025-02-26 20:50:00,19
6744,ORD_6745,34516,SERY Mattish Lipstick Girls Night 3.5 gm,Warehouse A,61,49,2025-02-26 20:14:00,12
6745,ORD_6746,16977,INOVERA Girl's PU Travel Waterproof Anti Theft Backpack With Shoulder Strap,Warehouse B,106,95,2025-02-26 22:44:00,11
6746,ORD_6747,21673,Blacip-TZ 500mg/600mg Tablet,Warehouse C,86,79,2025-02-26 12:38:00,7
6747,ORD_6748,9695,Fogg Fragrance Deo Men Royal 150 Ml,Warehouse A,99,87,2025-02-26 07:26:00,12
6748,ORD_6749,10232,"ZEBRONICS Zeb-Juke Bar 2550 Soundbar with 35W Rms, Power Dual Drivers, Bt V5.0, Optical in, Aux, USB Input, Wall Mount, Re...",Warehouse A,88,72,2025-02-26 02:51:00,16
6749,ORD_6750,21552,Dicof A Syrup,Warehouse A,46,31,2025-02-26 08:01:00,15
6750,ORD_6751,995,"OREI India to UAE, Hong Kong, Dubai, UK Adapter - Type G Plug Adapter - 2 in 1 - Perfect for Laptop, Camera, Chargers - Tr...",Warehouse C,108,98,2025-02-26 22:24:00,10
6751,ORD_6752,3780,Sounce VGA to HDMI 1080P Full HD Mini VGA to HDMI Audio Video Converter Adapter Box with USB Cable and 3.5mm Audio Port Ca...,Warehouse A,29,12,2025-02-26 14:45:00,17
6752,ORD_6753,22743,Onsitego 1 Year Extended Warranty for Small Household Appliances from Rs. 2001-2500 (Email Delivery - No Physical Kit),Warehouse B,58,41,2025-02-26 18:35:00,17
6753,ORD_6754,22901,Febudrive 80mg Tablet,Warehouse C,17,11,2025-02-26 10:15:00,6
6754,ORD_6755,21515,Eardin 5mg Tablet,Warehouse C,28,11,2025-02-26 15:49:00,17
6755,ORD_6756,10355,HP Smart Tank 520 All-in-one Colour Printer with 1 Extra Black Ink Bottle(Upto 12000 Black and 6000 Colour Prints Include...,Warehouse C,16,5,2025-02-26 11:44:00,11
6756,ORD_6757,22238,Essential Souls Face Scrub for All Skin Types - Charcoal 50 gm,Warehouse A,36,26,2025-02-26 05:26:00,10
6757,ORD_6758,31733,"TOUGH LEE Case Cover for Samsung Galaxy Buds 2 Pro (2022), Buds2 Pro | Galaxy Buds 2 (2021) | Galaxy Buds Pro (2021) | Gal...",Warehouse B,69,52,2025-02-26 08:11:00,17
6758,ORD_6759,1609,Generic Universal Microphone Shock Mount Cradle Holder Clip Stand Mic-57000479MG,Warehouse C,69,52,2025-02-26 16:36:00,17
6759,ORD_6760,22242,"(Renewed) boAt Rockerz 370 5.0 Bluetooth Wireless Over Ear Headphones With Mic, Immersive Audio, Lightweight Ergonomic Des...",Warehouse A,113,99,2025-02-26 20:50:00,14
6760,ORD_6761,1614,Ramace 10mg Tablet,Warehouse A,41,24,2025-02-26 18:38:00,17
6761,ORD_6762,30588,Piglow Cream,Warehouse C,82,67,2025-02-26 20:01:00,15
6762,ORD_6763,35529,Schwarzkopf Professional Bonacure Hyaluronic Moisture Kick Deep Conditioning Treatment Hair Mask | For Dry Hair | 200ml,Warehouse B,21,4,2025-02-26 12:37:00,17
6763,ORD_6764,8288,Perfume - Forest Spice,Warehouse B,101,92,2025-02-26 17:58:00,9
6764,ORD_6765,4825,"IKALL K100 1.8 Inch Display Keypad Mobile (Dual Sim, 1000 mAh Battery) (Blue)",Warehouse C,50,36,2025-02-26 20:37:00,14
6765,ORD_6766,1640,"Fitbit Inspire 2 Health & Fitness Tracker with a Free 1-Year Premium Trial, 24/7 Heart Rate, Black/Black, One Size (S & L ...",Warehouse A,111,95,2025-02-26 19:41:00,16
6766,ORD_6767,3654,Dalcip TZ 500mg/600mg Tablet,Warehouse B,62,43,2025-02-26 10:03:00,19
6767,ORD_6768,229,Phenergan Plus Syrup,Warehouse B,90,77,2025-02-26 17:04:00,13
6768,ORD_6769,22426,Nomarks - Ayurvedic Antimarks Cream For Dry Skin,Warehouse B,23,12,2025-02-26 06:49:00,11
6769,ORD_6770,10412,Dot & Key Glow Revealing Vitamin C Serum Concentrate - Kakadu Plum & Acerola Cherry 30 ml,Warehouse B,92,74,2025-02-26 07:29:00,18
6770,ORD_6771,26220,Decotaz 30 Tablet,Warehouse C,71,63,2025-02-26 16:28:00,8
6771,ORD_6772,12533,CASOSHIELD Screen Guard Film Designed For Apple MacBook Air 13 inches (2018-2021 / M1) A1932 A2179 A2337 Touch ID Screen P...,Warehouse A,67,48,2025-02-26 15:37:00,19
6772,ORD_6773,28455,Yves Rocher Sebo Pure Vegetal Pore Clearing Charcoal Mask 75 ml,Warehouse C,111,93,2025-02-26 06:28:00,18
6773,ORD_6774,22191,"Fashion Colour Fixup Hair Wax, Red 150 gm",Warehouse B,77,65,2025-02-26 05:07:00,12
6774,ORD_6775,22273,Ajmal Silvershade Aurum Deodorants (Pack of 2) 200 ml,Warehouse C,16,5,2025-02-26 22:21:00,11
6775,ORD_6776,22260,Spigen PE2008 Fast GaN Wall Charger 30W 1-Port Designed for All C Type Mobile Phones and Devices - Black,Warehouse B,49,37,2025-02-26 12:37:00,12
6776,ORD_6777,35193,"POPIO Tempered Glass Screen Protector Compatible for iPhone 12 Mini with Edge to Edge Coverage and Easy Installation kit, ...",Warehouse B,60,48,2025-02-26 03:45:00,12
6777,ORD_6778,17099,Lozat 50mg Tablet,Warehouse B,35,27,2025-02-26 02:23:00,8
6778,ORD_6779,22184,Satmax Infusion,Warehouse B,30,19,2025-02-26 23:45:00,11
6779,ORD_6780,8323,Absolute - Argan Oil Radiance Rinse Off Cleansing Oil,Warehouse C,40,30,2025-02-26 18:43:00,10
6780,ORD_6781,22218,"CodersParadise Pack of 58 Random Music Aesthetic Vinyl Stickers for Laptop, Journal, Bike Helmet, Diary, Guitar, Mobile Ca...",Warehouse B,37,29,2025-02-26 04:03:00,8
6781,ORD_6782,964,Lakme Color Crush Nail Art F3 6 Ml,Warehouse C,44,32,2025-02-26 13:50:00,12
6782,ORD_6783,8311,Esomak 40mg Tablet,Warehouse B,12,2,2025-02-26 06:26:00,10
6783,ORD_6784,8306,Pasmol Cold Tablet,Warehouse C,113,98,2025-02-26 01:18:00,15
6784,ORD_6785,14887,Nempect B Syrup,Warehouse A,52,38,2025-02-26 12:48:00,14
6785,ORD_6786,22391,"Fashion Colour Lip Crayon, Waterproof, Long Lasting, 13 Summer Blossom 2.8 gm",Warehouse A,73,63,2025-02-26 14:31:00,10
6786,ORD_6787,12587,Judibat 40 Capsule,Warehouse A,75,60,2025-02-26 03:28:00,15
6787,ORD_6788,18466,Arbitel R 40 mg/5 mg Tablet,Warehouse B,86,68,2025-02-26 16:00:00,18
6788,ORD_6789,22904,Parker Frontier Gold Roller Ball Pen Gt,Warehouse A,42,25,2025-02-26 08:29:00,17
6789,ORD_6790,4810,Aurolube Eye Drop,Warehouse C,53,47,2025-02-26 22:32:00,6
6790,ORD_6791,8193,Riwell IT 20mg/150mg Capsule,Warehouse A,19,12,2025-02-26 01:42:00,7
6791,ORD_6792,30625,Xiaomi Mi 4A Dual_Band Ethernet 1200Mbps Speed Router| 2.4GHz & 5GHz Frequency|128MB RAM | DualCore 4 Thread CPU|4 Omni Di...,Warehouse A,60,46,2025-02-26 15:23:00,14
6792,ORD_6793,2525,Lyntra 200 Capsule,Warehouse C,39,22,2025-02-26 18:23:00,17
6793,ORD_6794,35981,Soulflower Herbal Beard & Moustache Grooming Oil 120 ml,Warehouse B,44,35,2025-02-26 00:25:00,9
6794,ORD_6795,4822,Supreme Scalp Rejuvenation Shampoo,Warehouse A,71,62,2025-02-26 19:53:00,9
6795,ORD_6796,4821,SPYKART Universal Mobile Tabletop Stand for Table with Adjustable Height | 360 Degree Rotation Mobile Holder for Table & B...,Warehouse A,82,64,2025-02-26 10:50:00,18
6796,ORD_6797,6094,"CEUTA Waterproof Sport Armband, Unisex Running Jogging Gym Arm Band Case, Mobile for Fitness Exercise with Adjustable Elas...",Warehouse A,90,84,2025-02-26 15:13:00,6
6797,ORD_6798,17119,Burpex Capsule,Warehouse C,98,87,2025-02-26 22:57:00,11
6798,ORD_6799,10398,Clavilect A 250 mg/125 mg Tablet,Warehouse A,109,97,2025-02-26 00:33:00,12
6799,ORD_6800,36704,Rabio-LS Capsule SR,Warehouse B,43,30,2025-02-26 16:16:00,13
6800,ORD_6801,19639,Parker Vector Standard Roller Ball Pen and Ball Pen - Red Body,Warehouse C,52,43,2025-02-26 08:47:00,9
6801,ORD_6802,2653,LOHAYA Voice Remote Compatible for Amazon Fire Tv Stick Remote Control [ 3rd Generation ][ Fire TV Remote ] [ Fire Stick R...,Warehouse C,80,73,2025-02-26 18:01:00,7
6802,ORD_6803,34311,Felix 100mg Tablet,Warehouse A,59,51,2025-02-26 01:59:00,8
6803,ORD_6804,16183,Raberu Tablet,Warehouse C,46,27,2025-02-26 03:50:00,19
6804,ORD_6805,22460,Betalosin 0.4mg Capsule SR,Warehouse A,73,56,2025-02-26 22:35:00,17
6805,ORD_6806,33720,Ajmal 2 Persuade & Magnetize Deodorant Pack of 3 Deodorants 200 ml,Warehouse A,12,1,2025-02-26 12:30:00,11
6806,ORD_6807,36718,The Natural Wash Avocado Moisturizing Lotion With Argan Oil For All Skin Type 100 Ml,Warehouse C,28,13,2025-02-26 04:53:00,15
6807,ORD_6808,4805,Mothercare Quick Absorb Diaper Pants (L) 42's,Warehouse C,107,88,2025-02-26 09:48:00,19
6808,ORD_6809,34286,Clinch Lotion,Warehouse A,33,17,2025-02-26 01:56:00,16
6809,ORD_6810,22420,Celmol-Kid Oral Suspension,Warehouse A,20,14,2025-02-26 01:07:00,6
6810,ORD_6811,11245,Pierre Cardin Paris - Studio Nails 66,Warehouse B,107,97,2025-02-26 01:39:00,10
6811,ORD_6812,29251,TheGiftKart Crystal Clear Back Cover Case for Samsung Galaxy M53 5G | 360 Degree Protection | Shock Proof Design | Transpa...,Warehouse A,33,15,2025-02-26 06:28:00,18
6812,ORD_6813,26073,Muscoside 4mg Capsule,Warehouse A,100,94,2025-02-26 15:42:00,6
6813,ORD_6814,36738,boAt Deuce Usb 500 Stress Resistant Tangle-Free Sturdy 2-In-1 Micro Usb + Type-C 6.5A Fast Charging Cable With 480Mbps Dat...,Warehouse B,105,90,2025-02-26 14:49:00,15
6814,ORD_6815,36232,Global Desi SoulT EDP & StarG Mist Pack of 2 250 ml,Warehouse C,99,83,2025-02-26 04:05:00,16
6815,ORD_6816,12603,EGOTUDE Ultra Thin Slim Anti Scratch Back Cover Case Designed for iPhone SE (2020) / iPhone 8 / iPhone 7 (Black),Warehouse A,99,88,2025-02-26 14:46:00,11
6816,ORD_6817,16360,Telmiqueen Tablet,Warehouse C,25,11,2025-02-26 03:57:00,14
6817,ORD_6818,18436,"CRAZY HUDA Waterproof Professional Long lasting Mascara, Liquid Eyeliner and Eyebrow Pencil (Black) , Pack 3 in 1",Warehouse B,85,77,2025-02-26 23:27:00,8
6818,ORD_6819,18431,Normaglim 2mg Tablet,Warehouse A,58,39,2025-02-26 23:04:00,19
6819,ORD_6820,35966,Mandoxid O 200mg/200mg Tablet,Warehouse C,51,36,2025-02-26 22:47:00,15
6820,ORD_6821,14870,Lavender Essential Oil,Warehouse C,68,62,2025-02-26 20:28:00,6
6821,ORD_6822,1670,"E-COSMOS 5V 1.2W Portable Flexible USB LED Light (Colours May Vary, Small, EC-POF1)",Warehouse B,51,35,2025-02-26 01:56:00,16
6822,ORD_6823,35541,Amazon Brand - Solimo Back Cover Case for Huawei Honor 9N | Compatible for Huawei Honor 9N Back Cover Case | 360 Degree Pr...,Warehouse A,95,84,2025-02-26 21:48:00,11
6823,ORD_6824,10507,Zebronics Zeb-Comfort+ Wired Mouse,Warehouse B,42,34,2025-02-26 17:53:00,8
6824,ORD_6825,3523,Atulya Amla & Bhringraj Shampoo 300 ml,Warehouse C,51,32,2025-02-26 08:43:00,19
6825,ORD_6826,29195,Serflam A Tablet,Warehouse A,80,74,2025-02-26 07:05:00,6
6826,ORD_6827,7913,"20W Charger Compatible with Apple iPhone 13 Charger, iPhone 12 Charger, iPhone 11 Charger, iPhone X Series | 20 Watt Charg...",Warehouse C,62,57,2025-02-26 21:57:00,5
6827,ORD_6828,12749,Vega Grooming Comb (HMBC - 203) 45 gm,Warehouse B,97,91,2025-02-26 06:51:00,6
6828,ORD_6829,18331,Tramagesic 50mg Tablet,Warehouse A,48,32,2025-02-26 07:09:00,16
6829,ORD_6830,22776,"JUICE Quick-dry, Long Lasting, Chip Resistant, Gel Finish, High Gloss, F&D APPROVED COLORS & PIGMENTS, One Coat, 5 in 1 Na...",Warehouse B,16,1,2025-02-26 19:02:00,15
6830,ORD_6831,28586,Efotel 80mg Tablet,Warehouse A,18,10,2025-02-26 04:44:00,8
6831,ORD_6832,18349,Vilsurge 50mg Tablet,Warehouse C,79,67,2025-02-26 07:55:00,12
6832,ORD_6833,2210,Gexib-P Tablet,Warehouse B,76,61,2025-02-26 03:08:00,15
6833,ORD_6834,1705,Rozer 150mg Tablet,Warehouse C,111,92,2025-02-26 06:34:00,19
6834,ORD_6835,22812,Glimmer Premium Nail Enamel Maroon 10 ml,Warehouse A,98,88,2025-02-26 01:07:00,10
6835,ORD_6836,19584,Jypan D 10mg/40mg Tablet,Warehouse C,8,3,2025-02-26 05:11:00,5
6836,ORD_6837,22967,Amozo Sensor Protection Easy Fit Tempered Glass Screen Protector Guard for iPhone 14 Pro (with easy applicator) - Pack of 2,Warehouse A,78,67,2025-02-26 20:34:00,11
6837,ORD_6838,30618,Eradiclav Duo 1000mg/200mg Injection,Warehouse B,28,16,2025-02-26 07:58:00,12
6838,ORD_6839,3526,Azitress 250mg Tablet,Warehouse B,33,17,2025-02-26 22:24:00,16
6839,ORD_6840,7905,"EVM 2.5"" 512GB SATA SSD Next-gen 3D TLC NAND Internal SSD, Flash Fast Performance Ultra Low Power Consumption (EVM25, Black)",Warehouse C,72,56,2025-02-26 03:05:00,16
6840,ORD_6841,4409,Xabipro 0.03% Eye Drop,Warehouse A,98,81,2025-02-26 22:17:00,17
6841,ORD_6842,36819,Beauty Color Board Eyeshadow Palette Eyes Shadow 60 Color Makeup Palette Highlighters Eye Make Up High Pigmented Professio...,Warehouse A,105,86,2025-02-26 23:57:00,19
6842,ORD_6843,9730,"Portronics Toad One Wireless 2.4GHz & Bluetooth Connectivity Optical Mouse with 7 Colors RGB Lights, Rechargeable Battery(...",Warehouse C,49,32,2025-02-26 01:24:00,17
6843,ORD_6844,32396,Jemto 40 Tablet,Warehouse C,92,81,2025-02-26 17:39:00,11
6844,ORD_6845,7882,OneAssist Mobile 1 Year Extended Warranty Plan - 15001 to 20000,Warehouse C,34,26,2025-02-26 07:57:00,8
6845,ORD_6846,18284,Torex Oral Drops,Warehouse B,19,7,2025-02-26 23:28:00,12
6846,ORD_6847,22947,Pikkme Vivo Y12s / Y20 / Y20i / Y20G Flip Case Leather Finish | Inside TPU with Card Pockets | Wallet Stand and Shock Proo...,Warehouse B,57,50,2025-02-26 11:16:00,7
6847,ORD_6848,36823,Stbotanica Moroccan Argan Shampoo + Argan Hair Oil 500 ml,Warehouse A,68,61,2025-02-26 22:11:00,7
6848,ORD_6849,35240,Telmikind Beta 40mg/25mg Tablet ER,Warehouse A,82,75,2025-02-26 08:53:00,7
6849,ORD_6850,29188,"Phy Hair Setting Clay | For a Strong Hold & Matte Finish | No Synthetic Polymers | Safe to use, no damage to the hair | 10...",Warehouse C,31,21,2025-02-26 12:47:00,10
6850,ORD_6851,16375,Makeup Revolution Prime Bright Brightening Primer 27 ml,Warehouse C,99,85,2025-02-26 06:00:00,14
6851,ORD_6852,35934,Zitropid 200mg Oral Suspension,Warehouse A,37,18,2025-02-26 10:26:00,19
6852,ORD_6853,22815,"Glowhouse Professional Combo Waterproof Eyeliner, Mascara, Eyebrow Pencil (Mascara set combo) Black color (pack of 3) Matt...",Warehouse A,51,43,2025-02-26 22:25:00,8
6853,ORD_6854,22749,"Lakmé Lip Color Red Sangria,Pink Galm (Matte)",Warehouse B,42,31,2025-02-26 20:35:00,11
6854,ORD_6855,22820,AMiRiTE AGW02 20MM Milanese Mesh Replacement Watch Bands / Straps Compatible with Samsung Galaxy Galaxy Watch5 Pro (45mm) ...,Warehouse B,51,40,2025-02-26 11:39:00,11
6855,ORD_6856,14847,Clovia Sanitary Pads- XXL+ for Day & Night Usage - 350mm (Pack of 10) 1's,Warehouse C,90,72,2025-02-26 17:01:00,18
6856,ORD_6857,22344,"Sanitary Pads - Secure Dry Cover, with Wings",Warehouse C,62,57,2025-02-26 18:07:00,5
6857,ORD_6858,30603,Dolaza Oral Suspension,Warehouse B,6,1,2025-02-26 03:50:00,5
6858,ORD_6859,31725,Insight Cosmetics Non Transfer Matte Lipstick - Shady 4.2 gm,Warehouse B,107,93,2025-02-26 17:43:00,14
6859,ORD_6860,5228,Vilcon-OD 100 Tablet SR,Warehouse A,64,47,2025-02-26 23:59:00,17
6860,ORD_6861,16354,Spigen Liquid Air Back Cover Case Compatible with iPhone 14 Pro max (TPU | Matte Black),Warehouse C,32,19,2025-02-26 14:18:00,13
6861,ORD_6862,6073,"Beggie Combo Of 4 Shade Mini Red Edition Liquid Lipstick Waterproof Glitter Eyeliner, 3 In 1 Eyeliner, Mascara & Black Kajal",Warehouse A,51,36,2025-02-26 16:24:00,15
6862,ORD_6863,4831,Omd Tablet MD,Warehouse A,44,35,2025-02-26 00:24:00,9
6863,ORD_6864,14504,Metford 1000 SR Tablet,Warehouse A,51,43,2025-02-26 23:40:00,8
6864,ORD_6865,12553,CANIXA Zitcare-S gel Cream(20gm),Warehouse C,111,97,2025-02-26 15:29:00,14
6865,ORD_6866,14837,Arizine 10mg Tablet,Warehouse A,59,44,2025-02-26 18:13:00,15
6866,ORD_6867,26151,Cefixum 200mg Tablet,Warehouse C,45,38,2025-02-26 00:15:00,7
6867,ORD_6868,28428,Safin 200mg Tablet,Warehouse B,45,30,2025-02-26 02:17:00,15
6868,ORD_6869,28430,Americos Chemicals Private Limited Glow in The Dark Pigment Powder 40 g,Warehouse C,57,44,2025-02-26 22:41:00,13
6869,ORD_6870,22370,Aziwave 500 Tablet,Warehouse C,95,76,2025-02-26 10:12:00,19
6870,ORD_6871,3060,Novamentin 250mg/125mg Tablet,Warehouse C,18,3,2025-02-26 10:19:00,15
6871,ORD_6872,17109,Sureof Suspension,Warehouse B,16,5,2025-02-26 19:17:00,11
6872,ORD_6873,26189,"Redmi 9 (Sporty Orange, 4GB RAM, 64GB Storage) | 2.3GHz Mediatek Helio G35 Octa core Processor",Warehouse C,32,22,2025-02-26 03:17:00,10
6873,ORD_6874,8266,Charmistic Nude Eyeshadow Palette 18 Color Makeup Palette Highlighters Eye Make Up High Pigmented Professional Mattes and ...,Warehouse C,72,60,2025-02-26 15:18:00,12
6874,ORD_6875,26049,Aslonac S Tablet,Warehouse B,32,27,2025-02-26 11:24:00,5
6875,ORD_6876,22540,Pineclo Plus Tablet,Warehouse A,45,39,2025-02-26 13:10:00,6
6876,ORD_6877,22533,Episcab 5% Lotion,Warehouse A,98,83,2025-02-26 20:42:00,15
6877,ORD_6878,6246,Thiotrac Plus 10mg/5mg/200mg Tablet,Warehouse C,17,5,2025-02-26 16:02:00,12
6878,ORD_6879,4749,ZARALA For Oneplus Nord 2T 5G Camera Lens Protector Tempered Glass Smooth Finish HD Clear Camera Glass Protector Camera Le...,Warehouse C,63,50,2025-02-26 23:25:00,13
6879,ORD_6880,33235,Milk'O'Mix 2 Piece Combo(1 Butterscotch Falooda 200g + 1 Rabdi Falooda 200g),Warehouse C,23,15,2025-02-26 20:11:00,8
6880,ORD_6881,914,Arazap 450mg Tablet,Warehouse B,75,67,2025-02-26 10:33:00,8
6881,ORD_6882,31655,House of Aroma Citrus Forest Fragrance Oil 10 ml,Warehouse C,104,89,2025-02-26 13:33:00,15
6882,ORD_6883,33231,360 Degree Whole Mouth Clean Soft Bristle Toothbrush,Warehouse B,95,88,2025-02-26 23:00:00,7
6883,ORD_6884,174,Alicamox-CV 625 Tablet,Warehouse A,103,92,2025-02-26 00:46:00,11
6884,ORD_6885,22848,Pantonum 40mg Tablet,Warehouse B,92,80,2025-02-26 01:49:00,12
6885,ORD_6886,26658,Alicin 200mg Suspension,Warehouse A,43,33,2025-02-26 15:07:00,10
6886,ORD_6887,31699,"BROLAVIYA Cell Phone Tablet Tabletop Stand, Gooseneck Flexible Clip Lazy Arm Bracket for Both Mobiles and Tablets Fits Dev...",Warehouse B,111,93,2025-02-26 01:33:00,18
6887,ORD_6888,18815,Ziplan 20mg Tablet,Warehouse A,56,41,2025-02-26 16:10:00,15
6888,ORD_6889,31155,Nes Tablet,Warehouse C,85,76,2025-02-26 21:12:00,9
6889,ORD_6890,820,Comet Busters Multicolor Basic Square Bindis (2mm) (BV1278),Warehouse B,24,5,2025-02-26 21:07:00,19
6890,ORD_6891,35875,Techzere Overhead Shooting Tripod with 16 cm USB LED Ring Light & Mobile Holder,Warehouse C,100,86,2025-02-26 19:44:00,14
6891,ORD_6892,6591,Liftra 200 Capsule,Warehouse B,76,64,2025-02-26 05:20:00,12
6892,ORD_6893,25241,"Navahridaya Kalpa, 500mg",Warehouse B,103,88,2025-02-26 23:29:00,15
6893,ORD_6894,25243,"Aqualogica Radiance+ Mousse Night Gel With Watermelon & Niacinamide | Light, Gel-Based Formula | Makes Skin Radiant And Br...",Warehouse A,38,22,2025-02-26 09:21:00,16
6894,ORD_6895,25282,Yves Rocher Relaxing Bath And Shower Gel Almond Orange Blossom 200 ml,Warehouse C,104,98,2025-02-26 04:17:00,6
6895,ORD_6896,7386,"PKST Wi-Fi Wireless Nanny Small Security Indoor USB Plug Camera,1080p Cam with Cell Phone App Live Feed, Motion Detection...",Warehouse A,63,51,2025-02-26 16:05:00,12
6896,ORD_6897,7293,"OREI India to UK Plug Adapter, Hong Kong, Dubai - Type G Plug Adapter - 2 in 1 - Perfect for Laptop, Camera Charger and Mo...",Warehouse C,109,94,2025-02-26 06:56:00,15
6897,ORD_6898,9762,Pierre Cardin Paris - Pearly Velvet Eyeshadow 970-Marshmallow,Warehouse A,43,30,2025-02-26 08:50:00,13
6898,ORD_6899,33411,Quantum RJ45 Ethernet Patch/LAN Cable with Gold Plated Connectors Supports Upto 1000Mbps - (3 Meters) - (White),Warehouse A,63,47,2025-02-26 18:04:00,16
6899,ORD_6900,28767,Tifnim Forte Tablet,Warehouse B,71,54,2025-02-26 02:40:00,17
6900,ORD_6901,35715,Sahacharadi Kwath,Warehouse C,67,51,2025-02-26 12:07:00,16
6901,ORD_6902,13086,Sunaina Bridal Collection Dark Pink Bindi for Women (size-7) (Size 2.5mm),Warehouse B,59,53,2025-02-26 20:50:00,6
6902,ORD_6903,17878,Cebocontin 200 Tablet CR,Warehouse A,53,40,2025-02-26 17:28:00,13
6903,ORD_6904,23988,"Yardley London Floral Essence Shower Gel Peony & Ylang Ylang 250ml, White",Warehouse A,53,46,2025-02-26 13:28:00,7
6904,ORD_6905,11030,Sevza 400mg Tablet,Warehouse A,25,11,2025-02-26 19:00:00,14
6905,ORD_6906,25216,CEFRON 250 MG CAPSULE,Warehouse B,37,20,2025-02-26 20:20:00,17
6906,ORD_6907,31191,Ravezole D 30mg/20mg Capsule SR,Warehouse C,43,37,2025-02-26 02:28:00,6
6907,ORD_6908,13119,Navneet Youva | Primed Canvas Board for Acrylic and Oil Colour Painting | 12x16 inch | for Students and Budding Artists,Warehouse C,17,2,2025-02-26 10:21:00,15
6908,ORD_6909,13822,Roxinic 250mg Tablet,Warehouse B,19,14,2025-02-26 23:07:00,5
6909,ORD_6910,3161,Kokuyo Correction Tape 5mm - 6 metre - Color May Vary,Warehouse B,116,97,2025-02-26 07:48:00,19
6910,ORD_6911,32630,Zoul USB Type C Fast Charging 3A Nylon Braided Data Cable Quick Charger Cable QC 3.0 for Samsung Galaxy M31s M30 S10 S9 S2...,Warehouse C,84,72,2025-02-26 22:40:00,12
6911,ORD_6912,10761,DIVYRUTI 8 Piece Wall Mounted Storage Box Remote Storage Organizer Case for Air Conditioner TV Mobile Phone Plug Holder St...,Warehouse A,64,51,2025-02-26 16:36:00,13
6912,ORD_6913,31198,Stacy Lash Extra Strong Eyelash Extension Glue Stacy Lash 5 Ml / Maximum Bonding Power / Professional Black Adhesive / Dry...,Warehouse B,69,63,2025-02-26 05:22:00,6
6913,ORD_6914,1884,Megmadruff 200mg Tablet,Warehouse B,98,80,2025-02-26 09:04:00,18
6914,ORD_6915,3163,Sazro 500mg Tablet,Warehouse C,65,55,2025-02-26 10:07:00,10
6915,ORD_6916,11018,Lazine D Tablet,Warehouse B,90,85,2025-02-26 09:41:00,5
6916,ORD_6917,23970,Strauss Bicycle Bottle Holder (Black),Warehouse A,110,96,2025-02-26 09:33:00,14
6917,ORD_6918,28811,Maskofung Cream,Warehouse A,92,73,2025-02-26 23:17:00,19
6918,ORD_6919,7380,Levera Rtu 1000 Infusion,Warehouse B,85,67,2025-02-26 17:54:00,18
6919,ORD_6920,10728,"Oraimo Shark 4 Bluetooth Neckband Wireless in Ear Earphones Deep Bass,20Hrs Playtime,ASAP Charge,ENC Tech,Low-Latency Ergo...",Warehouse A,39,29,2025-02-26 08:22:00,10
6920,ORD_6921,17804,"Teal & Terra Activated Charcoal 3 In 1 Face Mask, Black 100 gm",Warehouse A,94,85,2025-02-26 17:09:00,9
6921,ORD_6922,37050,Brorab-LS Capsule SR,Warehouse C,52,33,2025-02-26 18:24:00,19
6922,ORD_6923,33765,DeBelle Gel Nail Lacquer Fuschia Rose Bright Pink Nail Polish 8 ml,Warehouse B,34,25,2025-02-26 12:39:00,9
6923,ORD_6924,28840,Winopar 650mg Tablet,Warehouse B,18,9,2025-02-26 16:31:00,9
6924,ORD_6925,13695,"Ambrane 20000mAh Power Bank, 20W Fast Charging, Tripe Output, Type C PD (Input & Output), Quick Charge, Li-Polymer, Multi-...",Warehouse C,80,75,2025-02-26 10:45:00,5
6925,ORD_6926,4505,(Renewed) Lenovo ThinkCentre Desktop Computer PC (Intel Core i7 2600/ 16 GB RAM/ 1 TB HDD + 256 GB SSD/ Windows 10 Pro/ MS...,Warehouse B,48,35,2025-02-26 07:55:00,13
6926,ORD_6927,25092,"KHOOBREZ Cable Management Box | Mobile, Tablet & Charging Stand | Wire Organizer Box | Desk Organizer Wire Bin (White)",Warehouse B,85,79,2025-02-26 08:06:00,6
6927,ORD_6928,7208,Zithroline 250mg Tablet,Warehouse C,50,44,2025-02-26 19:33:00,6
6928,ORD_6929,7198,Daily Life Forever52 Eye Shadow Brush Nx019 1's,Warehouse B,103,91,2025-02-26 19:55:00,12
6929,ORD_6930,24120,Combizol F Syrup,Warehouse A,87,80,2025-02-26 08:50:00,7
6930,ORD_6931,35758,UD Spas 20 mg/250 mg Tablet,Warehouse C,91,83,2025-02-26 12:00:00,8
6931,ORD_6932,33470,Quacool Eye Drop,Warehouse A,112,95,2025-02-26 21:53:00,17
6932,ORD_6933,808,"Amazon Basics LED Ring Light (12-inch) with Hot Shoe Adapter, Stand & Cameras, and 3 Temperature Modes",Warehouse B,78,65,2025-02-26 22:55:00,13
6933,ORD_6934,31274,Todolex TH 400mg/4mg Tablet,Warehouse B,12,6,2025-02-26 01:12:00,6
6934,ORD_6935,33756,Cipex TZ 500mg/600mg Tablet,Warehouse A,108,91,2025-02-26 05:32:00,17
6935,ORD_6936,27812,"LG 688 L Frost Free Smart Inverter Side-by-Side Refrigerator (GC-B257KQDV, Dark Graphite Steel | Multi Digital Sensors and...",Warehouse A,77,71,2025-02-26 03:34:00,6
6936,ORD_6937,17817,Ceftmark-S 1.5GM Injection,Warehouse A,75,63,2025-02-26 19:52:00,12
6937,ORD_6938,13704,"pTron Tangent Duo Bluetooth 5.2 Wireless Earphones with Mic, 24Hrs Playback, 13mm Driver, Deep Bass, Fast Charging Type-C ...",Warehouse C,44,33,2025-02-26 19:58:00,11
6938,ORD_6939,3372,Acecap SP 100mg/325mg/15mg Tablet,Warehouse C,108,97,2025-02-26 19:17:00,11
6939,ORD_6940,13869,Amartee 60mg Injection,Warehouse A,81,64,2025-02-26 10:16:00,17
6940,ORD_6941,2098,"Samsung Galaxy S23 5G (Cream, 8GB, 256GB Storage)",Warehouse B,107,88,2025-02-26 02:04:00,19
6941,ORD_6942,1869,Bclav 250mg/125mg Tablet,Warehouse B,80,71,2025-02-26 21:49:00,9
6942,ORD_6943,33418,"Fashion Colour Proffessional Makeup Kit, Fc948 - 01 62.4 gm",Warehouse A,62,47,2025-02-26 20:07:00,15
6943,ORD_6944,13871,Catuaba Nourishing Essence (Imported Without Box) EXP: 06/2024,Warehouse B,99,92,2025-02-26 21:37:00,7
6944,ORD_6945,4474,Clavix Gold 10 Capsule,Warehouse C,16,9,2025-02-26 13:32:00,7
6945,ORD_6946,833,"AmazonBasics Water Repellent and Wear Resistant Laptop Backpack - 24L, Blue",Warehouse B,20,12,2025-02-26 10:16:00,8
6946,ORD_6947,35757,"Cushion Hair Brush - CBP0103, Colour May Vary",Warehouse B,37,24,2025-02-26 21:27:00,13
6947,ORD_6948,33834,Transcend StoreJet 2TB Slim External Hard Drive (Gray),Warehouse A,28,18,2025-02-26 08:49:00,10
6948,ORD_6949,17958,DeBelle Gel Nail Lacquer Fleur Pistachio Turqoise Mint Green Nail Polish 8 ml,Warehouse C,81,68,2025-02-26 20:21:00,13
6949,ORD_6950,17509,"FAMEZA 4 PCS Hair Clips Hair Claw Clips 2"" Matte Hair Clips for Thick Hair Square Claw Clips Hair Claw for women",Warehouse C,57,40,2025-02-26 02:45:00,17
6950,ORD_6951,31223,Osia Osia French Lavender 125 gm,Warehouse A,80,75,2025-02-26 22:59:00,5
6951,ORD_6952,11643,Body Luster Sandal-Turmeric Ubtan Pack,Warehouse C,57,44,2025-02-26 20:47:00,13
6952,ORD_6953,7351,Floximil TZ 250mg/300mg Tablet,Warehouse C,106,94,2025-02-26 12:12:00,12
6953,ORD_6954,31520,"ADOFYS Helmet Chin Strap Mount with Mobile Clip & Screw Compatible with All Smart Phones Go pro Hero 9/8/7/6,SJCAM, Yi, DJ...",Warehouse A,51,33,2025-02-26 19:00:00,18
6954,ORD_6955,24671,s.Oliver Men Deodorant Natural Spray 150 ml,Warehouse B,71,56,2025-02-26 09:48:00,15
6955,ORD_6956,6919,Azithral 200mg/5ml Stat Liquid,Warehouse B,35,24,2025-02-26 12:16:00,11
6956,ORD_6957,6839,"Yantralay School Of Gadgets 360 ° Rotatable Ball Head Flexible Gorillapod Tripod with Mobile Attachment for DSLR, Action C...",Warehouse B,42,34,2025-02-26 14:23:00,8
6957,ORD_6958,24655,Gear Parker 23L Water Resistant Anti Theft Laptop Bag/Backpack for Men/Women - Black,Warehouse A,38,33,2025-02-26 17:24:00,5
6958,ORD_6959,24660,Original 65w Warp Charger for One Plus For OnePlus Nord CE 2 5G Original 65w Warp Charger for OnePlus 65 Watt Warp Chargin...,Warehouse A,26,9,2025-02-26 05:51:00,17
6959,ORD_6960,10904,Ajmal Aurum Carbon Sacrifice II Deodorant Spray (Pack of 3) 200 ml,Warehouse B,22,8,2025-02-26 09:35:00,14
6960,ORD_6961,24804,"Derma Essentia Mattifying Moisturizer for Oily Skin, Sensitive and Acne Prone Skin | Non-Comedogenic | Oil Free Moisturize...",Warehouse B,99,83,2025-02-26 18:31:00,16
6961,ORD_6962,6896,Glivomet 2mg/500mg/0.2mg Tablet,Warehouse A,8,3,2025-02-26 00:13:00,5
6962,ORD_6963,24921,Clopan 40mg Tablet,Warehouse A,68,61,2025-02-26 18:58:00,7
6963,ORD_6964,24699,Linicort 6mg Tablet,Warehouse C,105,99,2025-02-26 06:47:00,6
6964,ORD_6965,19487,Lenphor I Craze Eye Liner Glitzy Gold 1.7 Ml,Warehouse B,116,98,2025-02-26 02:36:00,18
6965,ORD_6966,13411,Capaldo-SP Tablet,Warehouse B,60,51,2025-02-26 09:29:00,9
6966,ORD_6967,24716,Hanumex® 8x12 FT Premium Professional Backdrop Chromakey Screen Background Photo Light Studio Photography Background for V...,Warehouse C,10,3,2025-02-26 01:11:00,7
6967,ORD_6968,9,REMOTEX Remote Compatible for Blue Star/Voltas/Hitachi/Onida Split/Window AC Remote Control Model :- R51M/CE (Please Match...,Warehouse B,18,3,2025-02-26 18:58:00,15
6968,ORD_6969,24503,Myket Tablet,Warehouse B,51,36,2025-02-26 09:16:00,15
6969,ORD_6970,24206,"ProElite Deer Flip case Cover for Realme PadMini 8.68 inch Tablet, Wine Red",Warehouse B,102,97,2025-02-26 11:15:00,5
6970,ORD_6971,17511,Aquadol Tpm Gel,Warehouse C,64,59,2025-02-26 12:24:00,5
6971,ORD_6972,35849,ARURA (LABEL) Multipurpose Desktop and Wall Mounted Landline Caller ID Telephone Corded Phone for Home Office Hotel (Multi...,Warehouse C,74,64,2025-02-26 16:52:00,10
6972,ORD_6973,8707,Plantas Hair Fall Control & Repair Organic Hair Serum 30 ml,Warehouse C,32,13,2025-02-26 09:59:00,19
6973,ORD_6974,25030,Refresh Tears Eye Drop,Warehouse A,29,11,2025-02-26 03:24:00,18
6974,ORD_6975,771,"Lukoog Kewra Water 300ml+Rose Water 300ml (Combo Pack of 2 Bottles) Use for Biryani,Pulao,Fried Rice & Other Recipes,It Mu...",Warehouse B,31,24,2025-02-26 00:37:00,7
6975,ORD_6976,24264,"LIDBOX Foldable Wooden Mini Laptop Table for Bed, Study Table with Drawer, Tablet/Mobile Holder for Kids & Adults (Black F...",Warehouse B,29,23,2025-02-26 16:57:00,6
6976,ORD_6977,32302,Omecon D 10mg/20mg Capsule,Warehouse A,86,81,2025-02-26 15:57:00,5
6977,ORD_6978,33496,Azipolis 500mg Tablet,Warehouse A,64,53,2025-02-26 05:39:00,11
6978,ORD_6979,13633,Glimmer Premium Nail Enamel Deep Red 10 ml,Warehouse A,84,79,2025-02-26 01:46:00,5
6979,ORD_6980,25012,Tamstream D Tablet,Warehouse B,54,35,2025-02-26 01:01:00,19
6980,ORD_6981,31317,Thicosafe Tablet,Warehouse C,24,19,2025-02-26 02:05:00,5
6981,ORD_6982,31320,Hydro Replenish Radiance Day Crème with SPF 15,Warehouse A,79,62,2025-02-26 12:41:00,17
6982,ORD_6983,35844,Nair Legs & Body Hair Removal Cream - Rose 110 gm,Warehouse B,108,95,2025-02-26 20:51:00,13
6983,ORD_6984,32297,Xaria Kid 2.5mg/4mg Tablet,Warehouse B,62,49,2025-02-26 04:09:00,13
6984,ORD_6985,6727,Lenphor Nail Tint Gragreen 52 12 Ml,Warehouse C,16,5,2025-02-26 17:38:00,11
6985,ORD_6986,13396,Benidin 8 Tablet,Warehouse A,58,39,2025-02-26 20:21:00,19
6986,ORD_6987,32267,Neem Wood Regular Comb,Warehouse B,39,32,2025-02-26 21:16:00,7
6987,ORD_6988,6874,Baeye 4.3v ultra fast USB charging cable compatible with philips trimmer model- BT3203 (Replacement for A00390 Charger) N5,Warehouse A,96,86,2025-02-26 12:00:00,10
6988,ORD_6989,24616,For You Gift Set,Warehouse B,54,44,2025-02-26 05:01:00,10
6989,ORD_6990,6775,Tevrol 50mg Tablet,Warehouse B,68,53,2025-02-26 14:40:00,15
6990,ORD_6991,33610,"Fashion Colour Dual Eyebrow Powder, Brown 8 gm",Warehouse B,8,3,2025-02-26 08:16:00,5
6991,ORD_6992,17688,Falcitar 60mg Injection,Warehouse A,78,66,2025-02-26 23:46:00,12
6992,ORD_6993,33544,Ana 100mg Tablet MD,Warehouse C,100,84,2025-02-26 06:00:00,16
6993,ORD_6994,13461,Axus 100mg Tablet,Warehouse C,105,93,2025-02-26 22:17:00,12
6994,ORD_6995,24843,Riskar 2mg Tablet,Warehouse B,36,29,2025-02-26 23:55:00,7
6995,ORD_6996,24745,OpenTech® Tempered Glass Screen Protector Compatible with iQOO Z6 Pro 5G with Edge to Edge Coverage and Easy Installation kit,Warehouse A,75,70,2025-02-26 16:26:00,5
6996,ORD_6997,24618,Riscon Forte Tablet,Warehouse A,42,23,2025-02-26 03:44:00,19
6997,ORD_6998,24622,Tsart MCL 25 Tablet ER,Warehouse B,13,1,2025-02-26 22:13:00,12
6998,ORD_6999,13313,Revolution Pro Small Empty Magnetic Palette 1's,Warehouse A,94,77,2025-02-26 02:45:00,17
6999,ORD_7000,24831,Logitech H111 Wired On Ear Headphones With Mic Black,Warehouse C,94,76,2025-02-26 23:41:00,18
7000,ORD_7001,17599,Fulnest Plus Tablet,Warehouse C,46,36,2025-02-26 14:46:00,10
7001,ORD_7002,22999,Fitbit Inspire 3 Health & Fitness Tracker (Midnight Zen/Black) with 6-Month Premium Membership,Warehouse B,22,3,2025-02-26 15:06:00,19
7002,ORD_7003,13484,Pikkme Mi Redmi 10 / Redmi 10 Power Flip Cover | PU Leather Finish | 360 Protection | Wallet & Stand | Strong Magnetic Fli...,Warehouse C,113,94,2025-02-26 13:04:00,19
7003,ORD_7004,13485,"Total Effects 7-In-1 - Anti-Ageing Skin Cream Moisturizer, Normal SPF15",Warehouse B,52,34,2025-02-26 08:27:00,18
7004,ORD_7005,13296,Camel Artist Water Colour Cake Set - Pack of 24 (Blue),Warehouse B,96,88,2025-02-26 11:03:00,8
7005,ORD_7006,10949,Moisture Repair Keratin Shampoo With Argan Oil & Curry Leaf Extract,Warehouse A,59,52,2025-02-26 13:19:00,7
7006,ORD_7007,17706,Brustro Blending Stump Set of 5,Warehouse B,74,58,2025-02-26 21:47:00,16
7007,ORD_7008,33533,Ajmal 2 Aurum Deo & Prose EDP Pack of 3 20 ml,Warehouse C,68,52,2025-02-26 22:59:00,16
7008,ORD_7009,31400,Temisar 40mg Tablet,Warehouse C,94,75,2025-02-26 09:00:00,19
7009,ORD_7010,1993,Wet n Wild Lipstick Mauve Outta Here,Warehouse B,74,58,2025-02-26 16:37:00,16
7010,ORD_7011,28991,TDX 25MG INJECTION,Warehouse C,95,78,2025-02-26 03:41:00,17
7011,ORD_7012,31386,"Stbotanica Hyaluronic Acid Hydra Boost Nutrient Face Mist, Moisture Surge Face Spray 120 ml",Warehouse A,64,56,2025-02-26 02:37:00,8
7012,ORD_7013,24632,Ratanjot Powder - Supports Wound Healing & Itching Lowering Response,Warehouse A,87,76,2025-02-26 12:52:00,11
7013,ORD_7014,32274,Rifakos 400mg Tablet,Warehouse A,99,94,2025-02-26 09:11:00,5
7014,ORD_7015,35812,Tea Tree Face Wash,Warehouse A,27,16,2025-02-26 13:40:00,11
7015,ORD_7016,33569,"POPIO Screen Guard Protector Compatible for Apple Watch Series 4, 5, 6, Watch SE & Watch SE 2022, 44mm (Transparent) with ...",Warehouse C,22,6,2025-02-26 02:10:00,16
7016,ORD_7017,24748,REALCASE Samsung S21 FE 5G Back Cover | Scratch Resistant Protective Crystal Clear Transparent | Polycarbonate Bumper Back...,Warehouse B,113,96,2025-02-26 17:31:00,17
7017,ORD_7018,13677,Fixdart LB 200mg Tablet,Warehouse B,65,57,2025-02-26 14:52:00,8
7018,ORD_7019,24316,Intensive Care Hand Cream,Warehouse C,98,79,2025-02-26 01:52:00,19
7019,ORD_7020,2707,Blisdox CV Dry Syrup,Warehouse A,81,76,2025-02-26 21:18:00,5
7020,ORD_7021,17089,Naxim O 200mg/200mg Tablet,Warehouse C,107,96,2025-02-26 23:28:00,11
7021,ORD_7022,18578,Spigen EZ Fit Optik Pro Tempered Glass Camera Lens Protector Guard for iPhone 14 Pro / 14 Pro Max (DeepPurple) - 2 Pack,Warehouse A,64,56,2025-02-26 00:49:00,8
7022,ORD_7023,6009,"USB Charger, Oraimo Elite Dual Port 5V/2.4A Wall Charger, USB Wall Charger Fast Charging Adapter for iPhone 11/Xs/XS Max/X...",Warehouse A,41,32,2025-02-26 21:43:00,9
7023,ORD_7024,8374,Kifen-SP Tablet,Warehouse A,97,81,2025-02-26 01:42:00,16
7024,ORD_7025,26273,"Nature - Germ Protection Handwash, Refill",Warehouse B,36,23,2025-02-26 10:18:00,13
7025,ORD_7026,29299,"COSTAR Mateband Bluetooth Wireless Neckband Earphones - 24H Playtime, Dual Equalizer Bass Boost Drivers, 20 Mins Charge, M...",Warehouse B,42,35,2025-02-26 00:28:00,7
7026,ORD_7027,14905,Tamlago-D 0.4mg/0.5mg Tablet,Warehouse B,63,46,2025-02-26 14:24:00,17
7027,ORD_7028,12510,Nexcobal 750mcg Tablet,Warehouse B,51,33,2025-02-26 07:44:00,18
7028,ORD_7029,34119,Faces Canada Hi Shine Nail Enamel Red Coral 214 9 Ml,Warehouse B,36,19,2025-02-26 05:46:00,17
7029,ORD_7030,17093,Dulcet DC-D9000X 220W Detachable Front Panel Universal Fit Single Din Mp3 Car Stereo with Dual USB Ports/Bluetooth/Hands F...,Warehouse C,27,9,2025-02-26 14:00:00,18
7030,ORD_7031,22154,Luminous Oil Essential Argan Oil & Camelia Extracts Shampoo,Warehouse B,94,77,2025-02-26 12:44:00,17
7031,ORD_7032,22035,Exudase D 50 mg/10 mg Tablet,Warehouse B,15,10,2025-02-26 04:42:00,5
7032,ORD_7033,675,Aziyan 500mg Tablet,Warehouse A,73,66,2025-02-26 12:53:00,7
7033,ORD_7034,673,"OnePlus 10T 5G (Moonstone Black, 16GB RAM, 256GB Storage)",Warehouse B,44,31,2025-02-26 20:11:00,13
7034,ORD_7035,22085,Glimmer Nail Polish Pasture 5 ml,Warehouse B,23,15,2025-02-26 01:29:00,8
7035,ORD_7036,30544,"pTron Studio Pixel Over-Ear Wireless Gaming Headphones with 30ms Low Latency, 40Hrs Playtime, 40mm Drivers, Punchy Bass, B...",Warehouse B,24,13,2025-02-26 22:14:00,11
7036,ORD_7037,8554,Ceftrizen 500mg Injection,Warehouse C,80,73,2025-02-26 20:57:00,7
7037,ORD_7038,5953,Suhagra Force 50mg/30mg Tablet,Warehouse A,66,48,2025-02-26 03:48:00,18
7038,ORD_7039,21818,VARS LONDON Matte and shimmer blusher| 8 color blusher palette| matte blush palette| shimmer blush palette| blush palette|...,Warehouse A,85,69,2025-02-26 16:35:00,16
7039,ORD_7040,16997,Cefzone 500mg/500mg Injection,Warehouse C,83,68,2025-02-26 18:59:00,15
7040,ORD_7041,1091,"Fashion Colour Non - Transfer Matt Waterproof Lipstick, 68 Pink Violet 2.6 gm",Warehouse B,57,38,2025-02-26 05:58:00,19
7041,ORD_7042,31781,Clavfit Dry Syrup,Warehouse B,77,71,2025-02-26 10:44:00,6
7042,ORD_7043,8461,"NOPLUS Soft Bristle Makeup Brush Set with Storage Pouch- Pink, 24 Pieces",Warehouse B,105,86,2025-02-26 06:44:00,19
7043,ORD_7044,18579,Restjoy 0.25 Tablet MD,Warehouse C,73,65,2025-02-26 23:31:00,8
7044,ORD_7045,5236,"Logitech G402 Hyperion Fury USB Wired Gaming Mouse, 4,000 DPI, Lightweight, 8 Programmable Buttons, Compatible for PC/Mac...",Warehouse C,105,95,2025-02-26 17:57:00,10
7045,ORD_7046,22048,OFX 50mg Oral Suspension,Warehouse A,97,88,2025-02-26 18:07:00,9
7046,ORD_7047,26302,Nykaa GLAMOReyes Liquid Eyeliner - 06 Whimsical Potion (5ml),Warehouse A,38,26,2025-02-26 14:09:00,12
7047,ORD_7048,14947,Florobid 200mg Tablet,Warehouse A,32,13,2025-02-26 07:41:00,19
7048,ORD_7049,8400,Aspirin  50mg Tablet DR,Warehouse A,76,64,2025-02-26 05:12:00,12
7049,ORD_7050,2549,Silitel-H 40 Tablet,Warehouse B,71,57,2025-02-26 14:42:00,14
7050,ORD_7051,5956,Freeflam-SP Tablet,Warehouse A,26,16,2025-02-26 11:06:00,10
7051,ORD_7052,30475,"akshar fashion Parasmani Ayurvedic Malam, 25gm (Pack Of 2)",Warehouse B,34,27,2025-02-26 22:09:00,7
7052,ORD_7053,15315,"Blaupunkt Newly Launched SBW250 200W Soundbar I 8 Inch SubwooferI 3D Surround Sound I HDMI(ARC), AUX, USB & Bluetooth, 4 E...",Warehouse C,46,40,2025-02-26 07:05:00,6
7053,ORD_7054,3719,Clozteo 100 Tablet,Warehouse A,99,83,2025-02-26 16:44:00,16
7054,ORD_7055,32463,Ultra Nights XXL+  With Wings,Warehouse B,28,16,2025-02-26 13:00:00,12
7055,ORD_7056,10351,Wella Professionals Wella Professionals Nutricurls Sulphate Free Shampoo 250ml and Deep Treatment Mask 150ml Duo For Waves...,Warehouse A,74,65,2025-02-26 04:09:00,9
7056,ORD_7057,33017,Revaldo 20mg Tablet,Warehouse C,54,44,2025-02-26 13:39:00,10
7057,ORD_7058,12372,BINGEABLE...ENJOY THE DIFFERENCE Makeup Brush- Cream,Warehouse B,43,27,2025-02-26 14:33:00,16
7058,ORD_7059,34587,Floxalik 200mg Tablet,Warehouse A,102,84,2025-02-26 16:15:00,18
7059,ORD_7060,4874,Pikkme Mi Redmi Note 5 Pro Back Cover Soft Matte Liquid Silicone TPU | Camera Protection | Shockproof Slim Back Case for M...,Warehouse A,22,13,2025-02-26 16:36:00,9
7060,ORD_7061,34584,Skin Lightening Hiz Mens Aloe Bleach,Warehouse A,84,79,2025-02-26 02:45:00,5
7061,ORD_7062,26669,HIFFIN HOT-L-Type Quick Release Camera Vertical Plate Dual Camera Bracket Plate Universal SLR Stabilizer,Warehouse A,30,21,2025-02-26 10:24:00,9
7062,ORD_7063,27681,DHVANI COLLECTION Stainless Steel Cosmetic Makeup Mixing Palette (Finger),Warehouse B,76,60,2025-02-26 22:29:00,16
7063,ORD_7064,30308,Ajmal 2 Magnetize & Nightingale Deodorant Pack of 3 Deodorants 200 ml,Warehouse B,13,1,2025-02-26 07:46:00,12
7064,ORD_7065,7240,Bacter NZ Oral Suspension,Warehouse A,34,24,2025-02-26 19:37:00,10
7065,ORD_7066,26663,Mydol P 100mg/325mg Tablet,Warehouse B,16,10,2025-02-26 04:06:00,6
7066,ORD_7067,22014,Termafil 250mg Tablet,Warehouse B,65,46,2025-02-26 13:21:00,19
7067,ORD_7068,14977,Zapcase Carbon Fibre Rugged Armour Rubber Back Cover for Samsung Galaxy M30 / Samsung Galaxy M30 (Black),Warehouse C,102,86,2025-02-26 01:21:00,16
7068,ORD_7069,18601,Camlin Kokuyo Artist 5ml Water Color Tube - 24 Shades (Multicolor),Warehouse B,31,24,2025-02-26 14:52:00,7
7069,ORD_7070,12473,Mucomeg T 500mg/150mg Tablet,Warehouse C,49,33,2025-02-26 05:43:00,16
7070,ORD_7071,14998,Dtel-MT 25 Tablet ER,Warehouse B,73,65,2025-02-26 01:35:00,8
7071,ORD_7072,21987,Acmeglim-MV 2 Tablet SR,Warehouse A,102,89,2025-02-26 16:23:00,13
7072,ORD_7073,8428,Montituss L 5mg/10mg Tablet,Warehouse A,28,19,2025-02-26 05:54:00,9
7073,ORD_7074,32031,Kabeer Art Sticky Notes and Page Markers Binder Pack 250 Different Size Notes 125 Page Markers 25 x 19 cm,Warehouse C,74,67,2025-02-26 08:25:00,7
7074,ORD_7075,18617,Antiseptic Liquid 1 L + Laundry Sanitizer- Fresh Linen 480 ml,Warehouse C,96,88,2025-02-26 22:41:00,8
7075,ORD_7076,21926,"ESR Paper-Feel Screen Protector Compatible for iPad Pro 12.9 inches 2022/2021/2020/2018, Put Pencil to Paper, Thin and Res...",Warehouse C,85,69,2025-02-26 01:57:00,16
7076,ORD_7077,5977,Ayurvedic Meetha Swadisth Powder,Warehouse B,31,22,2025-02-26 09:40:00,9
7077,ORD_7078,15010,Magmark Tablet,Warehouse A,27,12,2025-02-26 02:46:00,15
7078,ORD_7079,35513,Matte Hair Wax for Men,Warehouse C,55,49,2025-02-26 02:20:00,6
7079,ORD_7080,15016,Kingston SSDNow A400 480GB Internal Solid State Drive (SA400S37/480GIN),Warehouse C,27,10,2025-02-26 21:09:00,17
7080,ORD_7081,2309,Avindo 500mg Tablet,Warehouse C,22,9,2025-02-26 19:08:00,13
7081,ORD_7082,3037,"MOCA 13 inch Laptop Carrying Case Sleeve Bag for 13-inch MacBook Air M1/A2337 A2179 A1932, MacBook Pro M1/A2337 2016-2021,...",Warehouse C,79,63,2025-02-26 07:30:00,16
7082,ORD_7083,3031,Faces Canada Ultime Pro Matte Lip Crayon Runway Ready 31 2.8 Gm,Warehouse B,82,69,2025-02-26 20:58:00,13
7083,ORD_7084,21455,Asrapan D 10mg/40mg Tablet,Warehouse B,60,48,2025-02-26 15:28:00,12
7084,ORD_7085,11700,Ulcoat 1000mg Oral Suspension,Warehouse C,49,39,2025-02-26 22:37:00,10
7085,ORD_7086,31246,Goldmedal Curve Plus 205132 Plastic 16A G-Expert 3-Pin 3.5m High Grade Cable Extension Cord (White and Red),Warehouse B,61,48,2025-02-26 12:56:00,13
7086,ORD_7087,24060,"SanDisk Ultra Flair 64GB USB 3.0 Pen Drive, Multicolor",Warehouse B,49,31,2025-02-26 23:30:00,18
7087,ORD_7088,7253,Saregama Carvaan Mini Hindi 2.0- Music Player with Bluetooth/FM/AM/AUX (Skyline Blue),Warehouse B,81,62,2025-02-26 22:16:00,19
7088,ORD_7089,7252,Libacef 125mg Oral Suspension,Warehouse B,77,71,2025-02-26 17:34:00,6
7089,ORD_7090,7245,Finturn 1mg Tablet,Warehouse C,84,68,2025-02-26 07:54:00,16
7090,ORD_7091,25121,Winter Defense Moisturizing Cream,Warehouse B,43,37,2025-02-26 00:09:00,6
7091,ORD_7092,56,Mcrofy 25mg Tablet,Warehouse A,46,30,2025-02-26 18:33:00,16
7092,ORD_7093,25777,"L'Oréal Paris Matte Lipstick, Longwear and Hydrating Lip Colour, With Jojoba Oil, Color Riche Moist,300 Flaming Cloud, 3.7 g",Warehouse B,48,43,2025-02-26 00:24:00,5
7093,ORD_7094,31252,Rushikanti Multani Mitti With Sandal,Warehouse B,93,84,2025-02-26 16:38:00,9
7094,ORD_7095,30863,Crofivent 100 Capsule,Warehouse A,89,71,2025-02-26 21:19:00,18
7095,ORD_7096,36828,"Safari Seek 32 Ltrs Overnighter Travel Laptop Backpack (Blue), Water Resistant Spacious Bag for Travelling and Camping, Al...",Warehouse C,42,36,2025-02-26 02:47:00,6
7096,ORD_7097,21863,Lavirabe D 10mg/20mg Tablet,Warehouse C,31,21,2025-02-26 09:11:00,10
7097,ORD_7098,21865,MELODINE 7 Pcs Soft Bristles Pink Makeup Brushes Set with Pack of 6in1 Makeup Sponges Beauty Blender - (Pack of 13),Warehouse A,73,68,2025-02-26 00:33:00,5
7098,ORD_7099,12419,Corsair Vengeance LPX 8GB DDR4 3000 (PC4-24000) C16 PC Memory (CMK8GX4M1D3000C16),Warehouse A,109,92,2025-02-26 04:12:00,17
7099,ORD_7100,21870,"Sennheiser CX True Wireless in Ear Earbuds - Headphone with Mic for Music and Calls with Passive Noise Cancellation, Custo...",Warehouse A,33,23,2025-02-26 12:38:00,10
7100,ORD_7101,13184,Shatavari Tablet,Warehouse B,72,56,2025-02-26 09:42:00,16
7101,ORD_7102,9770,Vedapride 2mg Tablet,Warehouse A,71,65,2025-02-26 11:16:00,6
7102,ORD_7103,10282,OpenTech® Tempered Glass Screen Protector Compatible for Google Pixel 7 with Edge to Edge Coverage and Easy Installation kit,Warehouse B,48,35,2025-02-26 07:59:00,13
7103,ORD_7104,13159,"Maxima Max Pro X4+ Rugged Bluetooth Calling Smart Watch 1.32"" Round Always on Premium Display with 360x360 px Resolution, ...",Warehouse B,106,92,2025-02-26 05:45:00,14
7104,ORD_7105,13712,"Black Cotton Hair Ties, IKOCO 50Pcs Seamless Hair Bands Ponytail Holders Thick Hair No Damage Hair Ties for Women and Men",Warehouse A,68,51,2025-02-26 22:26:00,17
7105,ORD_7106,34478,Eyetex Dazller Nail Glitter - DG11 (Ultramarine Green) 12 ml,Warehouse B,91,82,2025-02-26 07:05:00,9
7106,ORD_7107,24017,RAVIRANDAL Baby Shower Cap Bathing Baby Wash Hair Eye Ear Protector Hat for New Born Infants babies Baby Bath Cap Shower P...,Warehouse C,81,62,2025-02-26 15:45:00,19
7107,ORD_7108,28817,Tramawin 50mg Capsule,Warehouse B,37,28,2025-02-26 04:03:00,9
7108,ORD_7109,13763,"LAKMÉ Forever Matte Liquid Lip Colour, Mauve Party, 5.6ml",Warehouse A,84,76,2025-02-26 20:07:00,8
7109,ORD_7110,24032,Bella Voste Sand Holo Nail Paints Aqua Blue - 402 10 ml,Warehouse C,36,19,2025-02-26 07:16:00,17
7110,ORD_7111,17846,Ascodex BR Syrup,Warehouse A,78,62,2025-02-26 15:20:00,16
7111,ORD_7112,24035,Benocef 200mg Tablet,Warehouse B,49,42,2025-02-26 18:02:00,7
7112,ORD_7113,24046,"GemBlue Biocare De-Tan Scrub, 500 ml",Warehouse B,58,48,2025-02-26 14:24:00,10
7113,ORD_7114,7265,Men Sport Defence Underarm Protection Deodorant,Warehouse B,80,65,2025-02-26 01:39:00,15
7114,ORD_7115,2763,Doxyruth P 20mg/20mg Tablet,Warehouse C,25,7,2025-02-26 09:48:00,18
7115,ORD_7116,24008,"Sundarya Body Oil - Aloevera & Sandalwood, For Tri-Dosha",Warehouse B,39,34,2025-02-26 14:51:00,5
7116,ORD_7117,13734,Omlin D Capsule,Warehouse C,49,30,2025-02-26 04:36:00,19
7117,ORD_7118,26429,Cesafe 500mg Injection,Warehouse B,16,5,2025-02-26 06:17:00,11
7118,ORD_7119,25157,Glyconex M 2mg/500mg Tablet PR,Warehouse B,62,44,2025-02-26 12:31:00,18
7119,ORD_7120,21876,Agnar 75mg Injection,Warehouse B,99,91,2025-02-26 09:39:00,8
7120,ORD_7121,21780,"Fashion Colour Lip Crayon, Waterproof, Long Lasting, 16 Pinky Spring 2.8 gm",Warehouse A,14,5,2025-02-26 20:24:00,9
7121,ORD_7122,18720,"Jaquline USA Onestroke Super Black Kajal Twin Pack, Smudge Proof, Water Proof, Black, Matte Finish (Pack Of 2)",Warehouse A,63,46,2025-02-26 02:13:00,17
7122,ORD_7123,21756,Ofzorix OZ 200mg/500mg Tablet,Warehouse A,103,98,2025-02-26 03:40:00,5
7123,ORD_7124,10254,Arozyt 500 Tablet,Warehouse A,65,59,2025-02-26 03:02:00,6
7124,ORD_7125,21765,"Merit Vco Extra Virgin Coconut Oil - Pack of 2 (500 Ml Each) | 100% Pure, Edible Grade | For Cooking, Skin & Hair Health, ...",Warehouse C,69,52,2025-02-26 19:33:00,17
7125,ORD_7126,3030,MI LED Smart Color Bulb (B22) - (16 Million Colors + 11 Years Long Life + Compatible with Amazon Alexa and Google Assistant),Warehouse B,114,95,2025-02-26 10:01:00,19
7126,ORD_7127,1531,Osaka 18 Inches LED Ring Light 65W adjustable Color Temperature Wireless Remote Control 9 Feet Light Stand For MX Takatak ...,Warehouse C,32,14,2025-02-26 18:03:00,18
7127,ORD_7128,34484,Sumitrex 25mg Tablet,Warehouse B,28,21,2025-02-26 19:54:00,7
7128,ORD_7129,26439,7SEVEN® Compatible Mi Tv Remote Control Original for Smart Android 4K Led UHD HD Television with Bluetooth Feature and Voi...,Warehouse B,37,27,2025-02-26 18:14:00,10
7129,ORD_7130,976,Mizral 10mg Tablet,Warehouse A,109,97,2025-02-26 10:02:00,12
7130,ORD_7131,8556,Rebolin-ASR Capsule,Warehouse C,41,23,2025-02-26 05:11:00,18
7131,ORD_7132,16995,Rebzol 20 Tablet,Warehouse B,34,19,2025-02-26 14:32:00,15
7132,ORD_7133,15042,"OnePlus Nord Buds CE Truly Wireless Bluetooth in Ear Earbuds (Mist Grey, True Wireless)",Warehouse C,58,47,2025-02-26 08:22:00,11
7133,ORD_7134,276,BKN® Spiral Charger Cable Protector USB Data Cable Saver & Earphones Elastic Cord Protective Cable Cover (Grey 8pcs),Warehouse C,51,36,2025-02-26 05:10:00,15
7134,ORD_7135,15084,Hair Mask - Argan,Warehouse A,28,20,2025-02-26 21:27:00,8
7135,ORD_7136,31780,"L'Oreal Paris Scrub, Fights Dulness abd Evens Skin Tone, Unclogs Pores, Removes Dead Skin, Aura Perfect, 100ml",Warehouse C,79,66,2025-02-26 01:28:00,13
7136,ORD_7137,29351,Agrikof-LS Syrup Sugar Free,Warehouse B,105,93,2025-02-26 09:04:00,12
7137,ORD_7138,8524,"SanDisk Ultra microSD UHS-I Card 32GB, 120MB/s R",Warehouse C,42,23,2025-02-26 08:32:00,19
7138,ORD_7139,28336,"WELBORN ENEL14 Battery Pack Compatible with Nikon Digital Camera,D5600,D3500,D3400, D3100,D3200,D3300, D5100, D5200, D530...",Warehouse A,96,79,2025-02-26 14:57:00,17
7139,ORD_7140,12411,Cefpod-CV Tablet,Warehouse C,108,98,2025-02-26 04:50:00,10
7140,ORD_7141,36614,"Uniball Eye UB150 Roller Pen (Blue Ink, Pack of 5)",Warehouse A,88,73,2025-02-26 14:39:00,15
7141,ORD_7142,8503,"boAt Airdopes 441 Pro Bluetooth Truly Wireless in Ear Earbuds with mic, Upto 150 Hours Playback, Signature Sound, IWP™ Tec...",Warehouse C,106,89,2025-02-26 02:02:00,17
7142,ORD_7143,3756,"Fashion Colour Kiss Lip No Transfer Lipstick, 69 Barbie Pink 2.6 gm",Warehouse B,38,24,2025-02-26 13:21:00,14
7143,ORD_7144,12425,Bigunyl 5mg/800mg Tablet,Warehouse A,90,82,2025-02-26 19:32:00,8
7144,ORD_7145,18653,EMbox Timer Switch Electrical On Off-Automatic Power Cut off Smart Plug with Programmable Countdown Control Switch-250 Vol...,Warehouse B,88,70,2025-02-26 01:01:00,18
7145,ORD_7146,17024,Yves Rocher Concentrated Shower Gel - Raspberry Peppermint 100 ml,Warehouse C,68,58,2025-02-26 14:54:00,10
7146,ORD_7147,10286,Emery 90mg Tablet,Warehouse A,31,12,2025-02-26 02:07:00,19
7147,ORD_7148,16333,Azicure 250mg Tablet,Warehouse B,48,40,2025-02-26 02:29:00,8
7148,ORD_7149,5950,Skullcandy Jib Wired in-Earphone with Mic (Black) (S2DUYK-343),Warehouse A,26,11,2025-02-26 16:55:00,15
7149,ORD_7150,30468,MVYNO Gorgeous iPhone 13 Cover | Pretty Beautiful Pink Protective Case for Women & Girls (Soft Flexible | Silicone | iPhon...,Warehouse A,33,24,2025-02-26 22:30:00,9
7150,ORD_7151,26281,"IONIX LCD Writing Tablet 8.5 Inch/21.8 cm Screen, Kids Toys, LCD Writing pad, Writing Tablet,Kis Toys for Boys 4 Years, To...",Warehouse B,42,28,2025-02-25 06:44:00,14
7151,ORD_7152,15640,Mecorose 1500mcg Injection,Warehouse B,55,47,2025-02-25 12:43:00,8
7152,ORD_7153,11691,Healol 5% Solution,Warehouse C,21,12,2025-02-25 22:54:00,9
7153,ORD_7154,29274,Livtor 750 Tablet,Warehouse C,91,83,2025-02-25 07:35:00,8
7154,ORD_7155,1338,Flormar Jelly Look Nail Enamel JL51 Perfect Selfie 11 ml,Warehouse B,61,56,2025-02-25 13:50:00,5
7155,ORD_7156,22395,Nature's Essence Diamond Creme Bleach 21 gm,Warehouse A,105,99,2025-02-25 23:18:00,6
7156,ORD_7157,10390,Climate Protection Conditioner,Warehouse B,64,56,2025-02-25 15:44:00,8
7157,ORD_7158,12570,"Fire-Boltt Dazzle Plus 1.81"" Smartwatch Full Touch Largest Borderless Display & 60 Sports Modes (Swimming) with IP68 Ratin...",Warehouse C,40,21,2025-02-25 21:11:00,19
7158,ORD_7159,5598,Allermont FX 10mg/120mg Tablet,Warehouse C,35,30,2025-02-25 11:10:00,5
7159,ORD_7160,18512,Deborah Milano Eye Liner - 01 Black 1.3 gm,Warehouse B,39,32,2025-02-25 20:25:00,7
7160,ORD_7161,34355,Virmox Eye Drop,Warehouse C,64,48,2025-02-25 03:34:00,16
7161,ORD_7162,26164,Sounce Blue and Green Adjustable Strap Combo for Xiaomi Mi Band 3/ Mi Band 4,Warehouse A,11,2,2025-02-25 11:21:00,9
7162,ORD_7163,8230,Ajmal Selfie Concentrated Perfume Oil Woody Aromatic And Shadow Homme Deodorant Citrus Woody Fragrance 210 ml,Warehouse C,76,61,2025-02-25 14:46:00,15
7163,ORD_7164,8223,Aerodol 4mg Injection,Warehouse C,22,16,2025-02-25 11:28:00,6
7164,ORD_7165,10061,"Fashion Colour Dual Face Powder & Blusher, Shade 07 7.5 gm",Warehouse A,81,64,2025-02-25 07:13:00,17
7165,ORD_7166,5304,Zulicon 1% Cream,Warehouse A,20,14,2025-02-25 04:27:00,6
7166,ORD_7167,2275,Ralimox-CV Dry Syrup,Warehouse A,104,85,2025-02-25 07:10:00,19
7167,ORD_7168,29285,FYM Dr. Drawing BB Glow kit shade no -23 (1pc).,Warehouse A,89,84,2025-02-25 08:40:00,5
7168,ORD_7169,10339,OUT OF BOX Make Up Cosmetic Foundation Power Sponge,Warehouse C,58,52,2025-02-25 19:47:00,6
7169,ORD_7170,12513,"AmazonBasics Male to Male Stereo Audio Aux Cable with Gold Plated Connectors for Tablet, Smartphone (8 Feet)",Warehouse A,86,75,2025-02-25 22:56:00,11
7170,ORD_7171,4851,Merlion Naturals Organic Gokshura Powder 227 gm,Warehouse B,46,36,2025-02-25 02:27:00,10
7171,ORD_7172,34377,Axocef S 1000mg/500mg Injection,Warehouse A,88,79,2025-02-25 18:45:00,9
7172,ORD_7173,14908,NOTE GEL LOOK NAIL ENAMEL 22 9 ml,Warehouse C,16,1,2025-02-25 10:56:00,15
7173,ORD_7174,29300,Green Coffee,Warehouse B,74,63,2025-02-25 13:25:00,11
7174,ORD_7175,10088,Swacold Syrup,Warehouse B,51,43,2025-02-25 18:46:00,8
7175,ORD_7176,10371,"Logitech B170 Wireless Mouse, 2.4 GHz with USB Nano Receiver, Optical Tracking, 12-Months Battery Life, Ambidextrous, PC/M...",Warehouse A,15,10,2025-02-25 18:44:00,5
7176,ORD_7177,1616,"Hoteon Extension Board with 5 Meters Heavy Duty Long Wire Cord, Single Outlet Socket 2500W 10A Expandable Electric Extensi...",Warehouse A,59,52,2025-02-25 11:19:00,7
7177,ORD_7178,36682,Zyrtec Drops,Warehouse C,60,53,2025-02-25 23:09:00,7
7178,ORD_7179,2960,ERHETUS Ergonomic Aluminum Laptop Stand for Table | Universal & Height Adjustable Lapdesks Compatible with All Laptops & T...,Warehouse B,66,48,2025-02-25 15:19:00,18
7179,ORD_7180,26911,Labewell Tablet,Warehouse B,58,46,2025-02-25 01:57:00,12
7180,ORD_7181,33037,Sandhimitra Arka,Warehouse C,67,57,2025-02-25 06:48:00,10
7181,ORD_7182,10341,Ajmal Blu Femme EDP Floral Woody Perfume 50ml for Women and Aristocrat EDP Citrus Woody Perfume 75ml for Men +1 Perfume Te...,Warehouse C,112,94,2025-02-25 03:53:00,18
7182,ORD_7183,10285,Azitus 250mg Tablet,Warehouse C,84,74,2025-02-25 06:10:00,10
7183,ORD_7184,26414,Soulflower Neem Heena Hair Cleansing Bar Soap 150 gm,Warehouse C,93,84,2025-02-25 00:37:00,9
7184,ORD_7185,21875,"Note Italy Mattemoist Lipstick 314, Red, 4.5g",Warehouse A,82,77,2025-02-25 06:51:00,5
7185,ORD_7186,5935,Vega Cushion Brush (R7 - CB) 85 gm,Warehouse C,35,22,2025-02-25 16:37:00,13
7186,ORD_7187,26900,Acelexin 250mg Capsule,Warehouse C,18,10,2025-02-25 19:42:00,8
7187,ORD_7188,18671,TheGiftKart Shockproof Crystal Clear Back Cover Case for Samsung Galaxy A13 4G | 360 Degree Protection | Protective Design...,Warehouse A,45,37,2025-02-25 02:33:00,8
7188,ORD_7189,10332,"Duracell Specialty 2450 Lithium Coin Battery 3V, Pack of 5 (DL2450/CR2450) Suitable for use in keyfobs, Scales, wearables ...",Warehouse B,114,96,2025-02-25 03:48:00,18
7189,ORD_7190,3044,Milceft 1000mg Injection,Warehouse C,98,80,2025-02-25 14:47:00,18
7190,ORD_7191,34398,Vibez by Lifelong Haile Smartwatch For Men with HD Display|24x7 Heart Rate & Blood Oxygen Tracking|Sports Mode|Sleep Monit...,Warehouse A,97,89,2025-02-25 19:04:00,8
7191,ORD_7192,14872,"Lenovo IdeaPad Slim 3 Intel Core i3 11th Gen 15.6"" (39.62cm) FHD Laptop (8GB/256GB SSD/Win 11/Office 2021/2 Year Warranty/...",Warehouse C,102,91,2025-02-25 10:54:00,11
7192,ORD_7193,22296,Adicef 100 Tablet DT,Warehouse A,36,17,2025-02-25 11:39:00,19
7193,ORD_7194,9072,Frexcez 5V/4A USB Vooc Flash Power Adapter Cable Wall Charger for Oppo F11 Pro & All Oppo Smartphone -Cable,Warehouse C,87,74,2025-02-25 20:47:00,13
7194,ORD_7195,22258,S Noid 10mg Capsule,Warehouse B,80,69,2025-02-25 03:09:00,11
7195,ORD_7196,16353,Omedoz 20mg Capsule,Warehouse B,30,12,2025-02-25 14:59:00,18
7196,ORD_7197,22253,"Rsentera HD Pro Conceal Orange Corrector 8g Concealer Natural Cream (orange corrector, 8 g)",Warehouse A,95,80,2025-02-25 15:49:00,15
7197,ORD_7198,685,SpinBot BattleMods X1 | Mobile Gaming Triggers | Capacitive Conduction | for BGMI/Free Fire Max/COD Mobile - (Blue),Warehouse A,47,30,2025-02-25 06:01:00,17
7198,ORD_7199,2651,Skin Perfect 20+ Facial Foam,Warehouse A,39,24,2025-02-25 16:27:00,15
7199,ORD_7200,32128,Justoza-M 10/500 Tablet ER,Warehouse C,106,91,2025-02-25 02:39:00,15
7200,ORD_7201,12538,Astigo Air Conditioner Remote Compatible Daikin Split AC Remote Control [ Compatible for Daikin AC Remote ] [ AC-132A ],Warehouse A,55,46,2025-02-25 22:25:00,9
7201,ORD_7202,12119,"Leaf Bass Wireless Bluetooth Over Ear Headphones with Mic and 10 Hours Battery Life, Over Ear Headphones with Super Soft C...",Warehouse A,54,38,2025-02-25 21:26:00,16
7202,ORD_7203,34350,Vomirite DP 10mg/10mg/2.5mg Tablet,Warehouse B,50,40,2025-02-25 16:04:00,10
7203,ORD_7204,14877,Rabition DSR 30mg/20mg Capsule,Warehouse C,26,21,2025-02-25 17:08:00,5
7204,ORD_7205,22244,Floral Touch Eau De Toilette,Warehouse C,64,53,2025-02-25 10:12:00,11
7205,ORD_7206,19007,POPIO Tempered Glass for Poco X2 / Poco M2 Pro/Redmi K30 / Redmi Note 9 Pro/Redmi Note 9 Pro Max (Black) Edge to Edge Full...,Warehouse C,77,67,2025-02-25 22:36:00,10
7206,ORD_7207,4931,Welminic LS Plus Syrup,Warehouse C,62,51,2025-02-25 06:11:00,11
7207,ORD_7208,4279,"Lava Flip, Blue - Dual Sim Keypad GSM Mobile with Unique Design, Notification LED and Number Talker",Warehouse C,51,45,2025-02-25 10:01:00,6
7208,ORD_7209,34694,ABAJ Bubble Wrap (50 m Long x 01 m) Multipurpose Packing Material for Your Packaging Safety and Needs,Warehouse B,65,55,2025-02-25 08:31:00,10
7209,ORD_7210,21518,"EcoBerry Mineral BB Cream For All Skin Tones, Skin Types | Suits Sensitive Skin | Acne Prone Skin | Subtle Natural Look | ...",Warehouse B,58,52,2025-02-25 23:07:00,6
7210,ORD_7211,21516,"TVARA LCD Writing Tablet 8.5 Inch E-Note Pad LCD Writing Tablet, Kids Drawing Pad 8.5 Inch Doodle Board, Toddler Boy and G...",Warehouse A,92,76,2025-02-25 06:15:00,16
7211,ORD_7212,8879,MISS ROSE 3D Shimmer Powder Highlighter Palette Face Base Makeup Highlight 02,Warehouse C,105,89,2025-02-25 22:55:00,16
7212,ORD_7213,35418,Eltocin Tablet,Warehouse B,49,32,2025-02-25 08:41:00,17
7213,ORD_7214,21196,Lasma LC Tablet,Warehouse A,60,53,2025-02-25 09:40:00,7
7214,ORD_7215,26797,Yumin Polyester Handlebar Universal Mobile Holder Mount Pouch Bag Waterproof for Activa Jupiter EV Ola-S1 Pleasure Ntroq_A...,Warehouse A,91,84,2025-02-25 14:44:00,7
7215,ORD_7216,29384,Eyetex Pallavi G5 Maroon bindis(pack of 10 flaps),Warehouse C,76,57,2025-02-25 03:02:00,19
7216,ORD_7217,4313,"Amazon Brand - Solimo Fast Charging Braided Type C Data Cable Seam, Suitable For All Supported Mobile Phones (1 Meter, Black)",Warehouse C,23,4,2025-02-25 10:59:00,19
7217,ORD_7218,8728,Albendz 400mg Tablet,Warehouse C,84,78,2025-02-25 08:36:00,6
7218,ORD_7219,21460,Belora Paris Serum Great Glow (Serum Grand Eclat) 30 ml,Warehouse C,26,11,2025-02-25 10:48:00,15
7219,ORD_7220,4964,Nimnil 100mg Tablet,Warehouse A,66,53,2025-02-25 20:55:00,13
7220,ORD_7221,30312,Rive D 10mg/20mg Tablet,Warehouse A,55,47,2025-02-25 19:01:00,8
7221,ORD_7222,30316,Dell 20mg Tablet,Warehouse C,95,78,2025-02-25 20:35:00,17
7222,ORD_7223,35416,"Miss Claire Glimmersticks for Eyes E-23, Peacock Blue, 1.8 g",Warehouse A,105,98,2025-02-25 02:08:00,7
7223,ORD_7224,21147,Mahanarayana Thailam,Warehouse A,59,52,2025-02-25 08:49:00,7
7224,ORD_7225,29716,Kidodent Mouth Wash Bubble Fruit,Warehouse A,114,98,2025-02-25 04:54:00,16
7225,ORD_7226,21581,Fujifilm Instax Mini 9 Instant Camera (Ice Blue),Warehouse B,102,96,2025-02-25 08:58:00,6
7226,ORD_7227,36059,Trendy Store 23A Pack of 5 Pieces 12V Alkaline Battery High Voltage Cell Car Remote Battery(5 pc),Warehouse C,37,20,2025-02-25 07:22:00,17
7227,ORD_7228,15474,"Smart Watch Melbon MD115 Smart Band, Activity Tracker Fitness Band, Sleep Monitor, Step Tracking, Heart Rate Sensor, Smart...",Warehouse C,60,53,2025-02-25 14:28:00,7
7228,ORD_7229,16956,"realme 10 Pro 5G (Nebula Blue, 128 GB) (8 GB RAM)",Warehouse A,89,73,2025-02-25 20:00:00,16
7229,ORD_7230,27881,"KINGONE Stylus Pen for iPad with Palm Rejection, Tilt Sensitive and Magnetic Design, Digital Pencil Compatible with 2018 a...",Warehouse B,20,8,2025-02-25 03:50:00,12
7230,ORD_7231,11354,"SHENY Best Professional Liquid Concealer, Face MakeUp Concealer  (skin, 5 ml)",Warehouse B,100,86,2025-02-25 12:28:00,14
7231,ORD_7232,5820,Kangaro Stapler DS 45L - Colour May Vary,Warehouse C,83,73,2025-02-25 21:55:00,10
7232,ORD_7233,15272,Streetwear Nail Enamel - Fine Grey 8 Ml,Warehouse C,81,71,2025-02-25 17:18:00,10
7233,ORD_7234,15262,"DIGITEK® (DRL-14C) Professional (31cm) Dual Temperature LED Ring Light with Tripod Stand & Mini Tripod for YouTube, Photo-...",Warehouse C,30,11,2025-02-25 21:06:00,19
7234,ORD_7235,5818,Telmi 40 Tablet,Warehouse A,43,24,2025-02-25 21:57:00,19
7235,ORD_7236,5945,"Redmi K50i 5G (Quick Silver, 6GB RAM, 128GB Storage) | Flagship Mediatek Dimensity 8100 Processor | 144Hz Liquid FFS Display",Warehouse A,31,26,2025-02-25 14:26:00,5
7236,ORD_7237,8689,Neurodin G 300 mg/1500 mcg Tablet,Warehouse C,63,47,2025-02-25 08:03:00,16
7237,ORD_7238,3830,"Banjara's Hibiscus Flower Powder for Hair | 100% Natural & Herbal | - 100 Grams, Hair Pack",Warehouse A,53,38,2025-02-25 12:22:00,15
7238,ORD_7239,21527,Argan & Tea Tree Pre Shave Oil,Warehouse C,93,87,2025-02-25 02:28:00,6
7239,ORD_7240,31747,Bilanext 20mg Tablet,Warehouse C,93,76,2025-02-25 07:05:00,17
7240,ORD_7241,4967,Parag Fragrances Natural Attar 12ml (Sandalwood),Warehouse A,77,67,2025-02-25 08:07:00,10
7241,ORD_7242,14924,MorningVale Palmate Mini Boost Smart Wireless Portable Bluetooth Speaker (3Cm),Warehouse B,38,21,2025-02-25 03:32:00,17
7242,ORD_7243,12500,Amizep 25 mg/10 mg Tablet,Warehouse B,91,85,2025-02-25 10:42:00,6
7243,ORD_7244,22059,"Redgear A-15 Wired Gaming Mouse with Upto 6400 DPI, RGB & Driver Customization for PC(Black)",Warehouse C,76,65,2025-02-25 21:29:00,11
7244,ORD_7245,20930,Electvision Remote Compatible with Amazon fire Stick Remote only [3rd Generation ][ Fire TV Remote ] [ Fire Stick Remote ]...,Warehouse C,14,3,2025-02-25 20:43:00,11
7245,ORD_7246,11284,"WeCool S5 Long Selfie Stick, with Large Reinforced Tripod Stand up to 61 Inch / 156 Cms, Ultra Long Multi Function Bluetoo...",Warehouse A,88,76,2025-02-25 09:50:00,12
7246,ORD_7247,1022,Krotus-DX Syrup,Warehouse B,25,13,2025-02-25 21:06:00,12
7247,ORD_7248,12134,ONUMTZ Oneplus Upgraded USB Type C to 3.5 mm Jack Audio Connector with Noise Cancelling Headphones Jack Converter Audio Ad...,Warehouse A,18,6,2025-02-25 20:16:00,12
7248,ORD_7249,9817,Almond Oil With Avocado,Warehouse B,93,79,2025-02-25 16:17:00,14
7249,ORD_7250,30568,"Facial Serum - Hydrating, Rose",Warehouse A,10,4,2025-02-25 11:23:00,6
7250,ORD_7251,9042,Red Onion Hair Oil,Warehouse C,26,9,2025-02-25 23:37:00,17
7251,ORD_7252,32540,"REVLON Colorstay Over Time Lip Color - Brown, Relentless Raisin, 2 ml, Glossy",Warehouse B,103,91,2025-02-25 03:07:00,12
7252,ORD_7253,29287,Dr.Sheth's Basic Brightening Daily Sunscreen Lotion 50 ml,Warehouse B,21,13,2025-02-25 23:36:00,8
7253,ORD_7254,36673,Brightening Lotion - Brightens Complexion & Detoxifies,Warehouse C,114,95,2025-02-25 01:23:00,19
7254,ORD_7255,14892,"Lamy Safari Medium Nib Fountain Pen | Sturdy Plastic, Umbra | Metal Clip, Ergonomic Grip | Black Chromium-Plated Steel Nib...",Warehouse A,107,93,2025-02-25 09:11:00,14
7255,ORD_7256,684,Myglamm Iridescent Brightening Foam Cleanser 50 Ml,Warehouse A,30,15,2025-02-25 07:31:00,15
7256,ORD_7257,1025,Methycobal Tablet,Warehouse A,72,58,2025-02-25 02:18:00,14
7257,ORD_7258,26253,Revlon Colorstay Eyeshadow Palette - Vibrant Hues 14.2 Gm,Warehouse A,18,5,2025-02-25 07:35:00,13
7258,ORD_7259,22121,LOHAYA Air Conditioner Remote Compatible for Voltas Smart Split AC Remote Control with WiFi Function [ Compatible for Volt...,Warehouse C,100,92,2025-02-25 04:56:00,8
7259,ORD_7260,17095,Glisen MF Forte 2  Tablet PR,Warehouse B,40,24,2025-02-25 20:28:00,16
7260,ORD_7261,20894,"Secure XL Cottony Soft - Sanitary Pads for Women, With Wings",Warehouse A,29,12,2025-02-25 15:06:00,17
7261,ORD_7262,11265,Natural Bright Face Cream SPF 15,Warehouse B,75,61,2025-02-25 16:12:00,14
7262,ORD_7263,354,Berina A42 Deep Dark Brown Hair Color Cream 60 gm,Warehouse A,52,43,2025-02-25 05:19:00,9
7263,ORD_7264,14903,Citrus Lotion,Warehouse C,45,30,2025-02-25 14:07:00,15
7264,ORD_7265,14904,"Duracell Ultra Alkaline C Battery, 4 Pcs",Warehouse B,94,81,2025-02-25 14:07:00,13
7265,ORD_7266,9029,Apple iPhone 13 (128GB) - Starlight,Warehouse A,68,58,2025-02-25 14:34:00,10
7266,ORD_7267,5915,Ofceed OZ 200mg/500mg Tablet,Warehouse B,17,2,2025-02-25 16:01:00,15
7267,ORD_7268,30419,Drosyn 10% Eye Drop,Warehouse A,75,69,2025-02-25 03:20:00,6
7268,ORD_7269,10392,Vent Adult 50mg/2mg Syrup,Warehouse A,27,21,2025-02-25 21:36:00,6
7269,ORD_7270,8553,Sea Breeze Man EDT,Warehouse B,57,49,2025-02-25 14:45:00,8
7270,ORD_7271,18648,Sery Colorflirt Nail Paint Fire Orange 10 ml,Warehouse B,39,28,2025-02-25 12:35:00,11
7271,ORD_7272,1415,"TECHTONIC Edge To Edge Tempered Glass For Google Pixel 6A With Easy Installation Kit, (Pack Of 1)",Warehouse A,66,58,2025-02-25 08:12:00,8
7272,ORD_7273,1547,Serie Expert B6 + Biotin Inforcer Shampoo,Warehouse A,105,96,2025-02-25 20:56:00,9
7273,ORD_7274,21810,C-Cort 40 Injection,Warehouse A,103,91,2025-02-25 13:57:00,12
7274,ORD_7275,4652,ESR [3-Pack Tempered-Glass Screen Protector for iPhone 12/12 Pro [Easy Installation Frame] [Case-Friendly] Premium Tempere...,Warehouse B,46,31,2025-02-25 18:10:00,15
7275,ORD_7276,31357,"Redmi 8A Dual (Sea Blue, 2GB RAM, 32GB Storage) – Dual Cameras & 5,000 mAH Battery",Warehouse A,23,14,2025-02-25 02:40:00,9
7276,ORD_7277,19402,"HP 330 Wireless Black Keyboard and Mouse Set with Numeric Keypad, 2.4GHz Wireless Connection and 1600 DPI, USB Receiver, L...",Warehouse A,16,1,2025-02-25 01:47:00,15
7277,ORD_7278,10962,POPIO Tempered Glass Screen Protector Compatible for Xiaomi Redmi Note 12 Pro/Note 12 Pro Plus/Note 12 Discovery/Xiaomi Po...,Warehouse A,47,42,2025-02-25 18:10:00,5
7278,ORD_7279,564,"DEVEDITZ Lip Shape Apple Lipstick Long Lasting Waterproof- Matte Lipstick (Red, 20 g)",Warehouse C,107,99,2025-02-25 23:26:00,8
7279,ORD_7280,14040,XX Revolutionact eyeliner pencil kohl 0.1 gm,Warehouse A,18,11,2025-02-25 19:56:00,7
7280,ORD_7281,1163,FreshDcart TV-AC Remote Organiser Stand Holder with Plastic Desk Organizer stylish Pen Makeup Mobile 6-Slot Shelf Stackabl...,Warehouse A,81,74,2025-02-25 04:14:00,7
7281,ORD_7282,32289,Offcet MT Syrup,Warehouse B,107,89,2025-02-25 03:55:00,18
7282,ORD_7283,20260,Eceft TZ 1000mg/125mg Injection,Warehouse A,106,90,2025-02-25 03:15:00,16
7283,ORD_7284,7468,Normal Saline Infusion,Warehouse C,68,58,2025-02-25 19:42:00,10
7284,ORD_7285,16119,Losain-H 50mg/12.5mg Tablet,Warehouse A,71,54,2025-02-25 05:51:00,17
7285,ORD_7286,3140,(Renewed) Lenovo ThinkPad T Series T450 (20BV0064US) Laptop Intel Core i5 5300U (2.30 GHz) 4 GB Memory 500 GB HDD 14 1366 ...,Warehouse C,20,15,2025-02-25 05:21:00,5
7286,ORD_7287,6748,"Seagate One Touch 1TB External HDD with Password Protection – Light Blue, for Windows and Mac, with 3 yr Data Recovery Ser...",Warehouse A,16,2,2025-02-25 12:33:00,14
7287,ORD_7288,33,"SanDisk Ultra Dual Drive Luxe 32GB USB Type C Flash Drive (Silver, 5Y - SDDDC4-032G-I35)",Warehouse A,55,39,2025-02-25 21:32:00,16
7288,ORD_7289,3405,"Colors Queen Base foundation| Oil Control Oil Free Foundation for brightening skin Long lasting, liquid foundation| Comes ...",Warehouse B,14,5,2025-02-25 18:13:00,9
7289,ORD_7290,19264,Cifzone 1000mg Injection,Warehouse C,83,75,2025-02-25 23:08:00,8
7290,ORD_7291,9565,Naxim LB 200mg Tablet,Warehouse B,24,11,2025-02-25 04:18:00,13
7291,ORD_7292,15935,GIZGA ESSENTIALS Spiral Charger Cable Protector (Set of 10) (G55),Warehouse B,76,63,2025-02-25 03:15:00,13
7292,ORD_7293,14010,Cagrab-DSR Capsule,Warehouse B,88,78,2025-02-25 11:50:00,10
7293,ORD_7294,27818,Heptiz 150mg/100mg Tablet,Warehouse A,99,85,2025-02-25 23:21:00,14
7294,ORD_7295,27346,"Amozo Poly Carbonate, Silicone, TPU, Back Cover for Samsung Galaxy S22 Ultra 5G (Transparent)",Warehouse C,43,32,2025-02-25 22:37:00,11
7295,ORD_7296,13009,Valamate 8mg Injection,Warehouse A,90,78,2025-02-25 10:59:00,12
7296,ORD_7297,7453,"OREI US Adapter Converter for India, (USA, UK, China & More) Australia to India Plug Converter - Type D Plug Adapter - 2 i...",Warehouse A,13,8,2025-02-25 05:44:00,5
7297,ORD_7298,2690,Myglamm Spotlight Illuminating Liquid - Sunkissed 13 Gm,Warehouse A,104,85,2025-02-25 01:26:00,19
7298,ORD_7299,3256,"Original Battery Compatible for Reliance Jio 4G Router JioFi 3 (JMR540, JMR541) JioFI 4 (JMR1140) - 2600mAh - 1 Year Warranty",Warehouse A,22,14,2025-02-25 23:27:00,8
7299,ORD_7300,13562,"Duracell Specialty Alkaline MN21 Battery 12V, Pack of 2 (A23 / 23A / V23GA / LRV08 / 8LR932) Suitable for use in Remote Co...",Warehouse A,71,61,2025-02-25 17:53:00,10
7300,ORD_7301,23701,Zyclav Syrup,Warehouse C,74,65,2025-02-25 08:17:00,9
7301,ORD_7302,30867,Neem Face Wash,Warehouse A,31,21,2025-02-25 20:32:00,10
7302,ORD_7303,17752,Neksium 40mg Tablet,Warehouse B,87,75,2025-02-25 14:41:00,12
7303,ORD_7304,27339,"Loofah/Sponge Scrubber/Body Bath - Dual Side, Cream, BH-070 CRM",Warehouse C,29,15,2025-02-25 09:21:00,14
7304,ORD_7305,29764,Sectocef 100mg Tablet,Warehouse A,98,93,2025-02-25 22:32:00,5
7305,ORD_7306,32079,Ajmal Bastion EDP Woody Aromatic Perfume And Blu Homme Deodorant Aquatic Woody Fragrance 300 ml,Warehouse B,25,11,2025-02-25 21:27:00,14
7306,ORD_7307,21548,Zolib M 2mg/500mg Tablet,Warehouse A,39,34,2025-02-25 03:02:00,5
7307,ORD_7308,16636,Radicof Syrup,Warehouse B,41,31,2025-02-25 16:22:00,10
7308,ORD_7309,1853,WZATCO W6 Polar Native 1080P LED Projector for Home | 6900 Lumens (660 ANSI) | Android 9.0 | 4K Supported Full HD Cinema |...,Warehouse A,105,99,2025-02-25 15:55:00,6
7309,ORD_7310,16118,Kivzole B  Lotion,Warehouse B,88,74,2025-02-25 15:18:00,14
7310,ORD_7311,31562,Wet N Wild Makeup Brush - Contour Brush 1's,Warehouse B,56,50,2025-02-25 13:39:00,6
7311,ORD_7312,31136,Sedell Lipstick Light Brown (Matte),Warehouse B,37,21,2025-02-25 08:25:00,16
7312,ORD_7313,7419,"Bodywash - 3-In-1, Orange Blossom",Warehouse C,16,3,2025-02-25 09:41:00,13
7313,ORD_7314,19813,"Boult Audio Airbass Propods X Bluetooth Truly Wireless in Ear Earbuds with Mic, 32H Playtime, Fast Charging Type-C, Ipx5 W...",Warehouse C,40,27,2025-02-25 10:04:00,13
7314,ORD_7315,27374,Levorev M 5mg/10mg Tablet,Warehouse C,87,80,2025-02-25 06:50:00,7
7315,ORD_7316,13584,"Syncwire LCD Writing Pad/ Tablet for Kids, Study Tab, e-Slate, Notebook, Portable writting Learning Slate Erasable Electri...",Warehouse A,107,95,2025-02-25 23:19:00,12
7316,ORD_7317,31146,Medlivo M 5mg/10mg Tablet,Warehouse C,74,59,2025-02-25 22:06:00,15
7317,ORD_7318,23802,Flormar Highlighter Stick 02 Medium Rose 10 gm,Warehouse A,71,63,2025-02-25 14:13:00,8
7318,ORD_7319,742,Kangaro Heavy Duty Stapler DS-23 S 24 FL,Warehouse C,104,93,2025-02-25 12:43:00,11
7319,ORD_7320,36974,Colorbar Just Smoky Pencil Kajal Jsp009 1.2 Gm,Warehouse B,105,96,2025-02-25 17:30:00,9
7320,ORD_7321,23673,Benzo 400mg Tablet,Warehouse C,53,37,2025-02-25 16:06:00,16
7321,ORD_7322,28754,"Fashion Colour Jersy Girl Kiss Proof No Transfer Lipstick, 7 Lotus Red 2 gm",Warehouse B,20,10,2025-02-25 18:49:00,10
7322,ORD_7323,89,Hair Fall Care Shampoo,Warehouse C,48,34,2025-02-25 05:32:00,14
7323,ORD_7324,19273,Ramclav Duo 500mg/125mg Tablet,Warehouse A,108,98,2025-02-25 00:18:00,10
7324,ORD_7325,43,Mefixime 100mg Dry Syrup,Warehouse C,56,50,2025-02-25 19:46:00,6
7325,ORD_7326,13054,Zanox 200mg Tablet,Warehouse A,102,93,2025-02-25 16:58:00,9
7326,ORD_7327,19951,"Ajmal 1 Silver Shade Homme, 1 Wisal, 1 Nightingale And 1 Magnetize Deodorants Pack of 4 200 ml",Warehouse B,116,98,2025-02-25 02:11:00,18
7327,ORD_7328,6544,"O3+ Purifying Sulfur Cooling Facial Mask with Organic Willow Bark and Mint for Acne Mark Removal and Radiant Glow, 50g",Warehouse A,92,74,2025-02-25 21:48:00,18
7328,ORD_7329,13985,Mdcold Tablet,Warehouse A,84,67,2025-02-25 09:15:00,17
7329,ORD_7330,7056,Celfee Dry Syrup,Warehouse A,20,7,2025-02-25 13:48:00,13
7330,ORD_7331,23750,NOTE NAIL ENAMEL 08 9 ml,Warehouse C,62,44,2025-02-25 14:28:00,18
7331,ORD_7332,7469,Wipeout Baby Safety Wipes 80 Gm,Warehouse C,81,75,2025-02-25 20:59:00,6
7332,ORD_7333,6498,Ajmal Sacrifice II & Silver Shade & Wisal Dahab Deo & Prose EDP Pack of 4 20 ml,Warehouse C,54,41,2025-02-25 12:48:00,13
7333,ORD_7334,23676,Ajmal Nightingale And Distraction For Men & Women And Shadow Him Deodorants Pack of 3 200 ml,Warehouse B,53,38,2025-02-25 11:23:00,15
7334,ORD_7335,12748,Diasmin 50mg Capsule,Warehouse C,111,97,2025-02-25 09:39:00,14
7335,ORD_7336,34423,Cixdop 50 LB Dry Syrup,Warehouse C,61,50,2025-02-25 12:53:00,11
7336,ORD_7337,30462,"Samsung Galaxy M13 (Aqua Green, 4GB, 64GB Storage) | 6000mAh Battery | Upto 8GB RAM with RAM Plus",Warehouse B,81,73,2025-02-25 09:20:00,8
7337,ORD_7338,3738,"T.O.S Jio 4G WiFi Dual_Band Hotspot - Support only Jio 4g Sim Card (2300mah Battery+Data Cable, Charger) Sim Card Not Incl...",Warehouse A,49,37,2025-02-25 20:56:00,12
7338,ORD_7339,34754,Flormar Waterproof Eyeliner 114 Blue Sky 1.14 gm,Warehouse A,60,54,2025-02-25 09:23:00,6
7339,ORD_7340,1093,Amidox 500mg Injection,Warehouse A,36,30,2025-02-25 08:44:00,6
7340,ORD_7341,2638,Babisure 200mg Tablet,Warehouse A,83,73,2025-02-25 20:56:00,10
7341,ORD_7342,32530,"boAt A 350 Type C Cable for Smartphone, Charging Adapter (1.5m, Carbon Black)",Warehouse C,74,55,2025-02-25 06:43:00,19
7342,ORD_7343,9660,Calcade-D3 Chewable Tablet,Warehouse A,22,14,2025-02-25 10:38:00,8
7343,ORD_7344,28320,Ajmal Blu & Aurum & Wisal & Wisal Dhahab Deo & Neea EDP Pack of 5 20 ml,Warehouse C,100,94,2025-02-25 08:05:00,6
7344,ORD_7345,2321,Papaya Leaf Powder,Warehouse C,101,82,2025-02-25 14:52:00,19
7345,ORD_7346,1544,"Mamaearth Moisturizing Bathing Bar Soap For Babies, Pack of 2 150 gm",Warehouse B,70,56,2025-02-25 04:55:00,14
7346,ORD_7347,2806,Faces Canada Matte Nail Enamel Spruce 46 9 Ml,Warehouse C,75,65,2025-02-25 01:52:00,10
7347,ORD_7348,8527,Cpred M 4mg Tablet,Warehouse B,71,59,2025-02-25 14:50:00,12
7348,ORD_7349,28322,Amc Syrup,Warehouse C,43,36,2025-02-25 15:40:00,7
7349,ORD_7350,3897,Lakme Absolute 3D Lipstick Peach Pinch 3.6 Gm,Warehouse A,22,14,2025-02-25 23:12:00,8
7350,ORD_7351,4888,Rabetop 20mg Tablet,Warehouse B,62,52,2025-02-25 16:58:00,10
7351,ORD_7352,8515,"S.A.V.I Full Arm Tattoo, Full Sleeve Arm Tattoo For Men, Mother Virgin Mary Tattoo For Girls Women, Temporary Tattoo Stick...",Warehouse B,81,72,2025-02-25 20:33:00,9
7352,ORD_7353,18679,Eloric 300mg Tablet,Warehouse B,48,43,2025-02-25 07:23:00,5
7353,ORD_7354,32154,"Fashion Colour Non - Transfer Matt Waterproof Lipstick, 3 Blood 2.6 gm",Warehouse A,100,88,2025-02-25 18:32:00,12
7354,ORD_7355,15535,"boAt Partypal 50 20W Bluetooth, Wireless, Auxiliary, USB, Fm Speaker - Knight Black",Warehouse B,63,47,2025-02-25 07:45:00,16
7355,ORD_7356,29346,ZIPLINE Office Laptop Synthetic Leather Executive Formal 15.6 inch Laptop & MacBook Briefcase Messenger/Office/Travel/Busi...,Warehouse A,55,48,2025-02-25 13:25:00,7
7356,ORD_7357,8542,Clodip Tablet,Warehouse A,103,97,2025-02-25 09:50:00,6
7357,ORD_7358,28309,"Fashion Colour Hd Foundation, Waterproof, Long Lasting, Shade 04 30 ml",Warehouse C,31,22,2025-02-25 01:17:00,9
7358,ORD_7359,8549,Clovia Botaniqa 8-IN-1 Breast Firming Oil & No Stretch Marks Oil 13-IN-1 Formulation 200 ml,Warehouse A,112,95,2025-02-25 01:48:00,17
7359,ORD_7360,26898,Dermaquit Lotion,Warehouse B,67,61,2025-02-25 19:00:00,6
7360,ORD_7361,30163,"WeCool 5 in 1 Multi Function Earbud Cleaning Pen for Airpods Pro, Camera Lense, Smartwatch, Cleaning Tool kit, Electronics...",Warehouse A,16,1,2025-02-25 16:45:00,15
7361,ORD_7362,36187,Emcoril Syrup,Warehouse B,54,45,2025-02-25 21:20:00,9
7362,ORD_7363,2605,"Rsentera Sh.Huda 12 pc Set Liquid Matte Lipstick (Multicolor, 60ml)",Warehouse C,106,97,2025-02-25 12:08:00,9
7363,ORD_7364,10298,Lotus Herbals Sunscreen SPF 70 PA+++ - 60 grams Cream,Warehouse A,97,82,2025-02-25 12:19:00,15
7364,ORD_7365,11599,Acek 100mg Tablet,Warehouse A,59,41,2025-02-25 01:03:00,18
7365,ORD_7366,21995,Hamodam 250mg Tablet,Warehouse C,25,7,2025-02-25 12:40:00,18
7366,ORD_7367,19752,"SanDisk 1TB Extreme Portable SSD 1050MB/s R, 1000MB/s W,Upto 2 Meter Drop Protection with IP55 Water/dust Resistance, HW E...",Warehouse A,99,89,2025-02-25 06:12:00,10
7367,ORD_7368,21959,"GREEN STICK MASK Stick, GreenTea Solid Mask, Purifying Clay Mask, Face Moisturizes Oil Control With Ice Cream Mask Acne Mo...",Warehouse A,21,4,2025-02-25 02:49:00,17
7368,ORD_7369,2640,Dubix-MF Tablet,Warehouse A,88,73,2025-02-25 15:59:00,15
7369,ORD_7370,12465,Wescob 1500mcg Injection,Warehouse B,49,43,2025-02-25 09:49:00,6
7370,ORD_7371,30481,"ADOFYS ulanzi G9-4 Mount and Accessory forGopro 9/10/11 Black , Cold Shoe Mount Mic Light Stand Housing Case for GoPro Mic...",Warehouse A,67,61,2025-02-25 15:32:00,6
7371,ORD_7372,34747,"ZORBES® 3 Pairs Replacement Ear Buds Tips, Silicone Earbud Tips for Airpods Pro,Silicone Earbud Tips for Airpods pro，Ear F...",Warehouse B,18,12,2025-02-25 05:43:00,6
7372,ORD_7373,8456,Bambudil 20mg Tablet,Warehouse A,49,33,2025-02-25 03:32:00,16
7373,ORD_7374,31766,Cottflam-MR Tablet,Warehouse A,61,54,2025-02-25 11:06:00,7
7374,ORD_7375,8458,"POPIO Data Sync Charging Cable compatible For Apple iPod Shuffle 5G, iPod Shuffle 4G & iPod Shuffle 3G - White",Warehouse A,33,23,2025-02-25 13:50:00,10
7375,ORD_7376,33056,Aqualogica Glow+ Luminous Under Eye Gel with Papaya & Vitamin C | Under eye cream | Reduces Dark Circles | 20 g,Warehouse B,33,25,2025-02-25 19:27:00,8
7376,ORD_7377,30477,Flormar Nail Enamel 313 Black Minimalism 11 ml,Warehouse A,45,34,2025-02-25 12:19:00,11
7377,ORD_7378,5238,Ultra Smooth After-Shave Balm,Warehouse C,23,16,2025-02-25 22:23:00,7
7378,ORD_7379,32132,Flormar Extreme Matte Lipstick 005 Carmen Dress 4 gm,Warehouse A,87,76,2025-02-25 03:24:00,11
7379,ORD_7380,21928,Pikkme Samsung Galaxy M31 / M31 Prime / F41 Flip Case | Vintage Leather Finish | Inside TPU | Wallet Stand | Magnetic Clos...,Warehouse A,72,53,2025-02-25 17:39:00,19
7380,ORD_7381,30158,Tegamox Plus Capsule,Warehouse C,61,46,2025-02-25 01:11:00,15
7381,ORD_7382,34417,Dant Rakshak Paste - 32 Ayurvedic Herbs Kills Germs & Longevity Of Teeth & Gums,Warehouse A,23,12,2025-02-25 18:49:00,11
7382,ORD_7383,33064,"Rsentera 6171 eyeshadow makeup kit, Multicolor Matte & Shimmery Finish",Warehouse A,28,21,2025-02-25 10:44:00,7
7383,ORD_7384,20974,Youth Eternity Night Cream,Warehouse B,65,55,2025-02-25 07:02:00,10
7384,ORD_7385,4340,Dysliptin 20 Tablet,Warehouse C,53,45,2025-02-25 10:13:00,8
7385,ORD_7386,26314,TATA SKY HD Connection with 1 month basic package and free installation,Warehouse C,22,17,2025-02-25 07:26:00,5
7386,ORD_7387,22022,Glam21 Multi Baked Eyeshadow palette| 8 Bold Glittering Shades|Ultra Micronized Pigments| Silky And Blendable Formula|Long...,Warehouse A,94,79,2025-02-25 12:49:00,15
7387,ORD_7388,28372,Bathing Bar Soap - Cool,Warehouse B,38,32,2025-02-25 12:26:00,6
7388,ORD_7389,17051,"Samsung Original EHS64 Wired in Ear Earphones with Mic, Black",Warehouse A,99,83,2025-02-25 10:58:00,16
7389,ORD_7390,34762,Ajmal Aura Concentrated Perfume Oil Floral Fruity And Carbon Homme Deodorant Citrus Spicy Fragrance 210 ml,Warehouse C,87,81,2025-02-25 04:22:00,6
7390,ORD_7391,22013,Avifenac-R Capsule,Warehouse B,100,81,2025-02-25 23:58:00,19
7391,ORD_7392,35389,Vasicard 12.5mg Tablet,Warehouse B,30,15,2025-02-25 18:22:00,15
7392,ORD_7393,22003,Mo-Floren 5ml Eye Drop,Warehouse A,54,36,2025-02-25 08:11:00,18
7393,ORD_7394,2867,HP V165w 64GB USB 2.0 Pen Drive (Blue),Warehouse C,73,61,2025-02-25 01:44:00,12
7394,ORD_7395,5815,Biz 400mg Tablet,Warehouse B,111,98,2025-02-25 20:21:00,13
7395,ORD_7396,4402,Slim Soft Toothbrush,Warehouse C,67,61,2025-02-25 00:58:00,6
7396,ORD_7397,21547,Insight Cosmetics 2X Cover Master Concealer - Porcelain 6 ml,Warehouse C,44,37,2025-02-25 23:27:00,7
7397,ORD_7398,27059,AmazonBasics Extended Gaming Mouse Pad Desk Mat for Computer Laptop| Stitched Embroidery Edges| Non-Slip Rubber Base | Key...,Warehouse A,63,50,2025-02-25 12:05:00,13
7398,ORD_7399,14726,Acortuss LS Syrup,Warehouse C,59,41,2025-02-25 06:19:00,18
7399,ORD_7400,6127,"ESR Classic Hybrid Magnetic Case with HaloLock, Compatible with iPhone 14 Pro, Compatible with MagSafe, Shockproof Militar...",Warehouse A,79,63,2025-02-25 20:29:00,16
7400,ORD_7401,33218,"Lenovo 100 Wireless Keyboard & Mouse Combo, Ambidextrous 1000 DPI Mouse Optical Sensor, upto 3M clicks, Ultra slim water r...",Warehouse A,64,48,2025-02-25 16:29:00,16
7401,ORD_7402,1661,Niricef 100mg Tablet DT,Warehouse C,103,98,2025-02-25 12:22:00,5
7402,ORD_7403,22504,Ucidin 150mg Tablet,Warehouse C,86,75,2025-02-25 04:10:00,11
7403,ORD_7404,12715,TheGiftKart Shockproof Crystal Clear Back Cover Case for iQOO Z6 Lite 5G | 360 Degree Protection | Protective Design | Tra...,Warehouse C,89,77,2025-02-25 08:42:00,12
7404,ORD_7405,2823,Floxade 200mg Tablet,Warehouse C,44,29,2025-02-25 17:29:00,15
7405,ORD_7406,33216,Glycin 500mg Injection,Warehouse B,103,84,2025-02-25 16:56:00,19
7406,ORD_7407,18351,"Fashion Colour Lip Crayon, Waterproof, Long Lasting, 17 Sweet Peach 2.8 gm",Warehouse A,25,20,2025-02-25 16:02:00,5
7407,ORD_7408,1698,Immunity Booster,Warehouse A,69,63,2025-02-25 19:31:00,6
7408,ORD_7409,12047,OpenTech® Tempered Glass Screen Protector Compatible for Samsung Galaxy M51 / M52 / M62 / F62 / A71 with Edge to Edge Cove...,Warehouse B,97,80,2025-02-25 06:01:00,17
7409,ORD_7410,25920,Inventory Aluminum Javelin for Red Practice Double Colour 800 GRM,Warehouse A,102,90,2025-02-25 10:33:00,12
7410,ORD_7411,14538,Levowave Tablet,Warehouse A,17,3,2025-02-25 23:16:00,14
7411,ORD_7412,34209,Winble Silicone Back Cover for OnePlus Nord CE 2 Lite 5G Camera Protection Soft Silicon Protective Back Cover Case for One...,Warehouse B,49,32,2025-02-25 23:14:00,17
7412,ORD_7413,3596,VARS ; LONDON Waterproof white kohl kajal for Glam Eyes,Warehouse C,17,5,2025-02-25 01:25:00,12
7413,ORD_7414,26009,Superdrug Essential Facial Cleansing Wipes X25 (For Dry & Sensitive Skin Care) 1's,Warehouse C,69,53,2025-02-25 23:17:00,16
7414,ORD_7415,31901,Citimed Cold Tablet,Warehouse C,46,32,2025-02-25 10:39:00,14
7415,ORD_7416,20706,Ajmal Prose EDP & Persuade Deodorant Pack of 2 300 ml,Warehouse B,34,29,2025-02-25 23:17:00,5
7416,ORD_7417,27736,Lav 500mg/125mg Tablet,Warehouse B,51,38,2025-02-25 19:39:00,13
7417,ORD_7418,8049,Keratin Smooth Shampoo,Warehouse B,65,52,2025-02-25 12:35:00,13
7418,ORD_7419,14654,"Samsung Original 45W Power Adapter with Type C to C Cable, Compatible with Smarthphone, Black",Warehouse C,25,14,2025-02-25 09:13:00,11
7419,ORD_7420,31677,"HP Smart Tank 589 All-in-one WiFi Colour Printer (Upto 6000 Black and 6000 Colour Pages Included in The Box). - Print, Sca...",Warehouse A,23,14,2025-02-25 00:43:00,9
7420,ORD_7421,4390,Biosalic Ointment,Warehouse A,24,19,2025-02-25 02:17:00,5
7421,ORD_7422,22666,Ayush Men Shaving Gel,Warehouse B,78,71,2025-02-25 11:37:00,7
7422,ORD_7423,30067,"Bath Brush - Large Mesh, Electric Blue",Warehouse A,73,61,2025-02-25 19:01:00,12
7423,ORD_7424,26003,Quantum RJ45 Ethernet Patch Cable/LAN Router Cable with Heavy Duty Gold Plated Connectors Supports Hi-Speed Gigabit Upto 1...,Warehouse B,50,39,2025-02-25 23:57:00,11
7424,ORD_7425,2789,"Zebronics Zeb-UTE101 USB to RJ45 Ethernet LAN Adapter, Up to 1000 Mbps, for Windows/Mac/Linux (Black)",Warehouse A,81,69,2025-02-25 13:12:00,12
7425,ORD_7426,5569,Ofly 200mg Tablet,Warehouse C,53,36,2025-02-25 15:54:00,17
7426,ORD_7427,26070,Nutriment Fruit Mask All Skin Type 300 gm,Warehouse A,102,97,2025-02-25 18:02:00,5
7427,ORD_7428,27056,Snighda Night Cream 50 Gm,Warehouse B,101,86,2025-02-25 02:02:00,15
7428,ORD_7429,32182,Winble Back Cover for Redmi Note 11 Pro/Redmi Note 11 Pro Plus 5G Back Cover Camera Protection Soft Silicone Protective Ba...,Warehouse C,62,44,2025-02-25 09:29:00,18
7429,ORD_7430,19082,Mobijoint D Tablet,Warehouse A,70,62,2025-02-25 18:37:00,8
7430,ORD_7431,2422,"Sadhev Herbal Body Lotion - Almond Nut, Indian Aloe & Bluewater Lily 200 ml",Warehouse A,63,58,2025-02-25 05:12:00,5
7431,ORD_7432,925,Bella Voste Sand Holo Nail Paints Peach Gold - 407 10 ml,Warehouse A,32,26,2025-02-25 03:07:00,6
7432,ORD_7433,17190,Medimade Olive And Macadamia Shampoo (Pack of 2) 1's,Warehouse A,102,84,2025-02-25 10:52:00,18
7433,ORD_7434,10460,Gesicare-TH Plus Tablet,Warehouse A,93,87,2025-02-25 15:02:00,6
7434,ORD_7435,3563,"Amazon Basics Flexible Premium HDMI Cable (Black, 4K@60Hz, 18Gbps), 3-Foot",Warehouse C,75,57,2025-02-25 07:46:00,18
7435,ORD_7436,711,Evamix ET 250mg/250mg Tablet,Warehouse C,92,79,2025-02-25 18:25:00,13
7436,ORD_7437,8132,Bridal Glow Facial Kit,Warehouse B,69,62,2025-02-25 23:28:00,7
7437,ORD_7438,211,Rahul Phate's Research Product Gaurangi Sunscreen Lotion for oily skin & dry skin | tan protection | For Women & Men 100ml,Warehouse A,105,99,2025-02-25 17:31:00,6
7438,ORD_7439,7991,Disposable RN95 Face Mask - White,Warehouse B,32,22,2025-02-25 07:03:00,10
7439,ORD_7440,4771,"uni-ball Eye UB157 Roller Pen (Assorted Color, Pack of 10)",Warehouse B,117,99,2025-02-25 20:10:00,18
7440,ORD_7441,18360,Zuemeth Tablet,Warehouse A,44,35,2025-02-25 21:40:00,9
7441,ORD_7442,1035,"Samsung Galaxy Buds2 Pro, Bluetooth Truly Wireless in Ear Earbuds with Noise Cancellation (Graphite, with Mic)",Warehouse A,74,55,2025-02-25 05:25:00,19
7442,ORD_7443,7999,"Honeywell 4-1 USB 2.0 Non-Powered Hub, 1.2M Cable, with a Transmission Speed of 480MBPS, Current 500mA per Port, Universal...",Warehouse C,93,75,2025-02-25 12:24:00,18
7443,ORD_7444,27068,Slevo 5mg Tablet,Warehouse B,41,24,2025-02-25 16:39:00,17
7444,ORD_7445,375,M-Cam 7.5mg Tablet,Warehouse A,20,8,2025-02-25 10:27:00,12
7445,ORD_7446,25900,Licoflox 500 Tablet,Warehouse B,48,30,2025-02-25 10:41:00,18
7446,ORD_7447,14712,Nocin L Ointment,Warehouse C,70,59,2025-02-25 08:20:00,11
7447,ORD_7448,11250,"Verilux® USB Hub 3.0 for PC, 4-Port High Speed USB Hub with Aluminium Shell, USB Port Hub 3.0 Compatible for PC, MacBook, ...",Warehouse C,105,88,2025-02-25 03:50:00,17
7448,ORD_7449,35559,Real Techniques 1894 Miracle Powder Sponge,Warehouse C,100,84,2025-02-25 03:34:00,16
7449,ORD_7450,11477,TheGiftKart Ultra-Hybrid Crystal Clear Back Case Cover for Samsung Galaxy A73 5G | Shockproof Design | Camera Protection B...,Warehouse B,43,29,2025-02-25 06:51:00,14
7450,ORD_7451,20634,Rosemarry Oil,Warehouse B,52,43,2025-02-25 15:10:00,9
7451,ORD_7452,6218,Amazon Basics Car Charger with 36W Fast Charging | Dual Port -Type C and USB Output | Micro USB Cable Included (Grey),Warehouse A,38,32,2025-02-25 08:31:00,6
7452,ORD_7453,20746,L'Occitane Oily Hair Purifying Freshness Shampoo 300ml,Warehouse B,110,92,2025-02-25 02:46:00,18
7453,ORD_7454,29469,"TP-Link Next-Gen Wi-Fi 6 AX3000 Mbps Gigabit Dual Band Smart Wireless Router, OneMesh Supported, Dual-Core CPU,HomeShield,...",Warehouse A,89,81,2025-02-25 01:57:00,8
7454,ORD_7455,32110,Abkill 200mg Oral Suspension,Warehouse B,59,45,2025-02-25 23:23:00,14
7455,ORD_7456,22662,"EvoFox Frost Laptop Cooling Pad with Silent Fans, 5 Adjustment Level, Silicon Pads, Iron mesh and Blue LED Lights, 2 USB P...",Warehouse C,57,49,2025-02-25 16:01:00,8
7456,ORD_7457,18398,Travel Kit,Warehouse B,88,76,2025-02-25 03:50:00,12
7457,ORD_7458,31683,Tacliment Eye Ointment,Warehouse C,95,80,2025-02-25 11:53:00,15
7458,ORD_7459,15698,Rapitus LS Syrup,Warehouse A,64,53,2025-02-25 07:53:00,11
7459,ORD_7460,540,Bella Vita Organic Peppermint Essential Oil 15 ml,Warehouse A,11,1,2025-02-25 11:17:00,10
7460,ORD_7461,31472,"Fitbit FB507RGPK Versa 2 Health & Fitness Smartwatch with Heart Rate, Music, Alexa Built-in, Sleep & Swim Tracking, Petal/...",Warehouse B,37,27,2025-02-25 05:19:00,10
7461,ORD_7462,22850,Amway Dynamite Foaming Face Wash (150ML),Warehouse C,79,66,2025-02-25 15:08:00,13
7462,ORD_7463,14464,Stbotanica Vitamin C Brightening Face Wash 100 ml,Warehouse B,16,6,2025-02-25 15:09:00,10
7463,ORD_7464,14777,Amazon Basics 4G LTE WiFi Single_Band Dongle with All SIM Support | Up to 150Mbps WiFi Hotspot | 2100 mAh Rechargeable Bat...,Warehouse A,20,15,2025-02-25 05:02:00,5
7464,ORD_7465,9117,Prostate Care Capsules,Warehouse A,92,75,2025-02-25 04:22:00,17
7465,ORD_7466,18481,Magikisses Lip Balm Merry Cherry 4 Gm,Warehouse A,28,22,2025-02-25 14:06:00,6
7466,ORD_7467,33149,"BESTOR ® 8K Hdmi 2.1 48Gbps Ultra High Speed Hdmi Braided Cord-4K 120Hz 8K 60Hz, Dts:X, Hdcp 2.2 & 2.3, Hdr 10 Cable Compa...",Warehouse B,48,32,2025-02-25 20:07:00,16
7467,ORD_7468,35156,Lakme Color Crush Nailart M10 Fern Green 6 Ml,Warehouse C,21,16,2025-02-25 20:49:00,5
7468,ORD_7469,20593,Liflox OZ 200mg/500mg Tablet,Warehouse B,43,27,2025-02-25 14:38:00,16
7469,ORD_7470,30638,"Wella Professionals Wella Professionals Nutricurls Regime For Waves & Curls - Sulfate Free Shampoo 250ml, Conditioner 200m...",Warehouse B,43,27,2025-02-25 03:44:00,16
7470,ORD_7471,12096,CrossBeats Mini Bluetooth Receiver Wireless Bluetooth Car Adapter Mini Portable 3.5mm Aux Adapter and Build-in Mic for Car...,Warehouse A,9,2,2025-02-25 15:07:00,7
7471,ORD_7472,32431,Ajmal Carbon Sacrifice II Sacrifice II Deodorant Spray (Pack of 3) 200 ml,Warehouse A,14,4,2025-02-25 18:42:00,10
7472,ORD_7473,20595,Amlonova 2.5mg/25mg Tablet,Warehouse B,71,60,2025-02-25 10:03:00,11
7473,ORD_7474,7958,Oytra 20 Piece Stamps for Kids Emoji and Motivation Reward Art Teachers Students Birthday Gift Craft Scrapbooking,Warehouse A,20,15,2025-02-25 03:39:00,5
7474,ORD_7475,27641,"Samsung Galaxy Buds2 Pro, Bluetooth Truly Wireless in Ear Earbuds with Noise Cancellation (Bora Purple, with Mic)",Warehouse A,91,72,2025-02-25 14:43:00,19
7475,ORD_7476,26113,Clamy 300mg Capsule,Warehouse C,94,76,2025-02-25 16:44:00,18
7476,ORD_7477,12097,"Faber-Castell Paint Brush Set - Round, Pack of 7 (Navy Blue)",Warehouse B,74,67,2025-02-25 19:25:00,7
7477,ORD_7478,15647,Bella Voste Luxe Matt Chrome Shade 224 10 Ml,Warehouse A,97,82,2025-02-25 11:16:00,15
7478,ORD_7479,11181,Ceflin 125mg Injection,Warehouse B,103,87,2025-02-25 12:24:00,16
7479,ORD_7480,29201,Algoset 200mg Oral Suspension,Warehouse B,70,63,2025-02-25 16:22:00,7
7480,ORD_7481,12721,The Beard Story Pore Minimizing After Shave Gel 50 gm,Warehouse C,50,39,2025-02-25 20:45:00,11
7481,ORD_7482,22839,Isoverin 80mg Tablet,Warehouse C,18,3,2025-02-25 16:39:00,15
7482,ORD_7483,14487,Reganor Tablet SR,Warehouse A,23,15,2025-02-25 21:17:00,8
7483,ORD_7484,22429,Charmacy Milano Stunning Longstay Liquid Lip (Cherry Red) 5.6 ml,Warehouse B,106,99,2025-02-25 01:40:00,7
7484,ORD_7485,6526,"Women Deodorant Roll On - Protect & Care, Non-Irritating & 48h Protection",Warehouse B,96,86,2025-02-25 17:20:00,10
7485,ORD_7486,30071,Amosym CV 1000mg/200mg Injection,Warehouse C,50,44,2025-02-25 07:44:00,6
7486,ORD_7487,7965,Musk Soap,Warehouse A,66,49,2025-02-25 11:46:00,17
7487,ORD_7488,18381,Tbf 250mg Tablet,Warehouse B,40,21,2025-02-25 22:01:00,19
7488,ORD_7489,30765,Aziera 500mg Tablet,Warehouse A,97,87,2025-02-25 03:09:00,10
7489,ORD_7490,6168,"realme C33 (Aqua Blue, 3GB RAM, 32GB Storage)",Warehouse A,58,39,2025-02-25 16:36:00,19
7490,ORD_7491,14626,Stbotanica Pink Grapefruit And Vitamin C Luxury Shower Gel Body Wash 300 ml,Warehouse B,50,36,2025-02-25 13:07:00,14
7491,ORD_7492,203,Lip Butter - Lavender,Warehouse B,105,86,2025-02-25 20:44:00,19
7492,ORD_7493,34218,My Story For Him - Perfumed Deodorant Natural Spray,Warehouse C,25,7,2025-02-25 11:38:00,18
7493,ORD_7494,25956,Mamaearth Ubtan Night Cream For Glowing Skin With Turmeric & Saffron For Skin Brightening - 50 G,Warehouse B,97,84,2025-02-25 23:47:00,13
7494,ORD_7495,6151,Okacet-L Tablet,Warehouse B,41,25,2025-02-25 17:02:00,16
7495,ORD_7496,22585,"FEDUS Cat6 Ethernet Cable, 3 Meter High Speed 550MHZ / 10 Gigabit Speed UTP LAN Cable, Network Cable Internet Cable RJ45 C...",Warehouse C,90,79,2025-02-25 15:44:00,11
7496,ORD_7497,14572,Ajmal Tempest Concentrated Perfume Oil Floral And Carbon Homme Deodorant Citrus Spicy Fragrance 212 ml,Warehouse A,46,40,2025-02-25 06:04:00,6
7497,ORD_7498,15673,"TP-Link TL-WR940N 450Mbps WiFi Wireless Single Band Router, 4 Fast LAN Ports, Easy Setup, WPS Button, Supports Parent Cont...",Warehouse C,57,52,2025-02-25 23:01:00,5
7498,ORD_7499,36747,AND Eternal Radiance Eau De Parfum 50ML & Dainty Glam Body Mist 200ML Pack of 2 for Women Crafted by Ajmal,Warehouse B,77,62,2025-02-25 09:00:00,15
7499,ORD_7500,10504,"CrossBeats Newly launched Spectra max Super Retina AMOLED Always on Display Smartwatch, 1.81 Inch Smart Watch, AI ENC BT C...",Warehouse C,48,30,2025-02-25 18:45:00,18
7500,ORD_7501,12704,"HOLD UP Selfie Stick, Extendable Selfie Stick with Wireless Remote and Tripod Stand, Portable, Lightweight, Compatible wit...",Warehouse C,23,9,2025-02-25 10:13:00,14
7501,ORD_7502,25930,Gemblue Biocare Rose Petal Gel 500 ml,Warehouse B,15,4,2025-02-25 15:50:00,11
7502,ORD_7503,9723,Ajmal Sacred Love EDP Floral Musky Perfume 50ml for Women and Wisal Dhahab EDP Fruity Floral Perfume 50ml for Men +1 Perfu...,Warehouse A,82,63,2025-02-25 20:22:00,19
7503,ORD_7504,14600,Gleva Portable Washing Tool Cosmetic Brush Cleaner Hand Washing Silicone Makeup Cleaning Brush Scrubber Mat with Suction Cup,Warehouse C,31,25,2025-02-25 10:43:00,6
7504,ORD_7505,5217,Cuticare Cream,Warehouse C,53,38,2025-02-25 06:05:00,15
7505,ORD_7506,8027,Bella Voste Sugar Baby Nail Paints Shade 364 10 Ml,Warehouse B,72,63,2025-02-25 10:10:00,9
7506,ORD_7507,19780,Ufloxy 200mg Tablet,Warehouse B,100,82,2025-02-25 02:37:00,18
7507,ORD_7508,18374,Dermitop Spray,Warehouse C,100,82,2025-02-25 21:23:00,18
7508,ORD_7509,1678,TRUEUPGRADE Silicone Back Case Cover Compatible with OnePlus Nord CE 2 Lite 5G Case Cover | Raised Lip Protection Back Cas...,Warehouse B,39,22,2025-02-25 12:47:00,17
7509,ORD_7510,28488,Onsitego 1 Year Extended Warranty for Small Household Appliances from Rs. 3001-4000 (Email Delivery - No Physical Kit),Warehouse B,97,86,2025-02-25 10:47:00,11
7510,ORD_7511,27743,"Wayona Nylon Braided (2 Pack) USB Syncing and Charging Cable sync and Charging Cable for Iphone, Ipad, (3 FT Pack of 2, Bl...",Warehouse B,38,23,2025-02-25 23:04:00,15
7511,ORD_7512,195,Remexin 200mg Tablet,Warehouse A,15,6,2025-02-25 06:16:00,9
7512,ORD_7513,9146,Innomune Tablet,Warehouse C,98,88,2025-02-25 20:45:00,10
7513,ORD_7514,22566,OUXUS Premium Smart Foldable Tabletop Mobile Stand for Table and Bed & Office use Height Adjustable Universal Phone Holder...,Warehouse A,90,74,2025-02-25 07:42:00,16
7514,ORD_7515,29226,Ristab 1mg Tabcap,Warehouse C,38,29,2025-02-25 22:09:00,9
7515,ORD_7516,14660,Isoelite Remote Compatible with Panasonic Split Ac Remote Control [ Compatible for Panasonic AC Remote Control ],Warehouse B,70,62,2025-02-25 20:00:00,8
7516,ORD_7517,31895,mCaffeine Latte Coffee Moisturizing Face Wash for Mild Cleansing with Almond Milk & Shea Butter 75 ml,Warehouse C,49,36,2025-02-25 22:53:00,13
7517,ORD_7518,25906,Organic & Natural Lavender-Chamomile Sensitive Skin Face Wash - Sulfate & Paraben Free,Warehouse A,79,69,2025-02-25 02:01:00,10
7518,ORD_7519,27749,M4 Perfume Spray - for Men,Warehouse A,74,67,2025-02-25 10:09:00,7
7519,ORD_7520,29361,Deborah Milano Ultrafine Compact Powder - 2 Beige 9 gm,Warehouse B,89,77,2025-02-25 19:00:00,12
7520,ORD_7521,1438,Nutriment Fruit Gel All Skin Type 250 gm,Warehouse A,52,40,2025-02-25 07:13:00,12
7521,ORD_7522,4946,Montimax LC Syrup,Warehouse A,93,83,2025-02-25 20:40:00,10
7522,ORD_7523,21395,Ajmal Mukhallat Raaqi Concentrated Perfume Oil Floral Fruity Attar And Jannatul Firdaus Concentrated Perfume Oil Oriental Attar 20 ml,Warehouse B,117,99,2025-02-25 17:05:00,18
7523,ORD_7524,34674,De Tan Spf 50 Sunscreen Gel Creme 100 Gm,Warehouse C,29,16,2025-02-25 19:00:00,13
7524,ORD_7525,314,Bisowin 5 Tablet,Warehouse C,82,72,2025-02-25 11:30:00,10
7525,ORD_7526,21387,Carecroft USB Rechargeable eyebrow trimmer electric razor shaver hair eyebrows threading machine for Women removal tool fo...,Warehouse A,46,38,2025-02-25 08:38:00,8
7526,ORD_7527,12278,Oysiprox 100mg Tablet,Warehouse C,29,14,2025-02-25 12:03:00,15
7527,ORD_7528,18856,El Sueno 20pcs Soft Facial Puff Makeup Sponge Face Cream Powder Beauty Blender for Women Face Neck Dry & Wet Makeup,Warehouse C,113,95,2025-02-25 23:11:00,18
7528,ORD_7529,26606,Tazy 100mg/5ml Oral Suspension,Warehouse A,79,63,2025-02-25 23:08:00,16
7529,ORD_7530,34549,"Ikoo Infusions-Thermal Treatment Wrap, Color Protect & Repair (Single Sachet) 35 gm",Warehouse A,14,9,2025-02-25 03:51:00,5
7530,ORD_7531,18772,Ajmal 4 Wisal Dhahab Deo & Ascend EDP Pack of 5 20 ml,Warehouse A,59,46,2025-02-25 06:35:00,13
7531,ORD_7532,16871,Teletab Tablet,Warehouse C,71,63,2025-02-25 12:19:00,8
7532,ORD_7533,8586,Dolide MR Tablet,Warehouse B,109,98,2025-02-25 16:57:00,11
7533,ORD_7534,32656,Tigatel-CH 40mg/12.5mg Tablet,Warehouse A,102,83,2025-02-25 12:49:00,19
7534,ORD_7535,34500,Sefixy LB 200mg Tablet,Warehouse A,86,69,2025-02-25 21:36:00,17
7535,ORD_7536,8588,Footlogix Rubber Steel Scraper 20 gm,Warehouse C,54,39,2025-02-25 11:21:00,15
7536,ORD_7537,34726,The Fresh Mask Sheet - Rose,Warehouse C,82,64,2025-02-25 08:32:00,18
7537,ORD_7538,26862,"Meilin (Hong Kong) Non Transfer Lipstick, Matte Finish, 4g - In Rose Gala",Warehouse C,107,91,2025-02-25 12:50:00,16
7538,ORD_7539,1520,Alcipro 750mg Tablet,Warehouse B,103,84,2025-02-25 12:00:00,19
7539,ORD_7540,15164,Ofvin O 200mg/500mg Tablet,Warehouse C,99,87,2025-02-25 21:20:00,12
7540,ORD_7541,30400,Dom Suspension,Warehouse C,29,22,2025-02-25 11:37:00,7
7541,ORD_7542,8595,Bella Voste Matt Nail Paint Shade 302 10 Ml,Warehouse A,41,32,2025-02-25 02:43:00,9
7542,ORD_7543,26525,Medimade Olive And Macadamia Hair Mask (Pack of 2) 1's,Warehouse B,23,13,2025-02-25 05:44:00,10
7543,ORD_7544,10922,Nature's Essence Anti-Pollution Face Wash Gel - Active Charcoal 65 ml,Warehouse B,73,65,2025-02-25 22:23:00,8
7544,ORD_7545,21713,Dumox 1000 mg/200 mg Injection,Warehouse A,107,92,2025-02-25 00:38:00,15
7545,ORD_7546,8949,Allure Eyebrow Brush ( ASB322 ) 1's,Warehouse A,85,77,2025-02-25 04:31:00,8
7546,ORD_7547,15174,"Portronics Power Plate 7 with 6 USB Port + 8 Power Sockets Smart Electric Universal Extension Board Multi Plug with 2500W,...",Warehouse A,43,35,2025-02-25 00:28:00,8
7547,ORD_7548,29360,"Loofah/Sponge Scrubber/Body Bath - Pink, BH-061D PNK",Warehouse A,77,58,2025-02-25 22:13:00,19
7548,ORD_7549,26508,"Yves Rocher Concentrated Shower Gel, Olive Petitgrain, 100ml",Warehouse C,42,24,2025-02-25 17:35:00,18
7549,ORD_7550,5777,Glimispica M 1mg/1000mg Tablet,Warehouse A,35,17,2025-02-25 22:50:00,18
7550,ORD_7551,11368,URBANHUDA M10 TWS Bluetooth 5.1 Earphone Charging boxwireless In Ear Earbuds Stereo Sports Waterproof with Microphone True...,Warehouse B,27,15,2025-02-25 18:01:00,12
7551,ORD_7552,26700,8 Shade Eyeshadow With Highlighter and Blusher and Shimmer Eyeshadow Pallet Colorful Eye Makeup Pallets Rainbow Eye shadow...,Warehouse A,110,91,2025-02-25 06:34:00,19
7552,ORD_7553,8800,Pept-D Tablet,Warehouse A,26,8,2025-02-25 04:37:00,18
7553,ORD_7554,5793,Sensitive Toothpaste - Fresh Mint,Warehouse C,76,58,2025-02-25 18:34:00,18
7554,ORD_7555,10167,Colorbar Lavender Lace - (704) 12 ml,Warehouse C,33,26,2025-02-25 08:40:00,7
7555,ORD_7556,36545,worldmacs 12'' Inches 2 Sided Drum Practice Pad + Bag + Drumsticks,Warehouse A,96,82,2025-02-25 09:21:00,14
7556,ORD_7557,2365,"Stylus-Pen-for-Apple-iPad-Pencil-with-Case, Palm Rejection, Power Display, Tilt Sensitivity, Magnetic Adsorption for 2018-...",Warehouse A,32,23,2025-02-25 16:28:00,9
7557,ORD_7558,30233,"Lava A1 2021(Blue Silver), Bluetooth Support, Smart AI Battery, Military Grade Certified,4 Days Battery Backup, Keypad Mobile",Warehouse A,106,97,2025-02-25 04:53:00,9
7558,ORD_7559,32946,Volicure Trio 1mg/500mg/0.2mg Tablet,Warehouse B,29,20,2025-02-25 16:11:00,9
7559,ORD_7560,18880,Uribuz 80mg Tablet,Warehouse A,29,24,2025-02-25 16:46:00,5
7560,ORD_7561,8792,V-Glim M2 Tablet SR,Warehouse C,73,64,2025-02-25 08:46:00,9
7561,ORD_7562,16892,AmazonBasics 14-Gauge Speaker wire - 50 feet,Warehouse C,71,55,2025-02-25 21:32:00,16
7562,ORD_7563,21364,Fragrant Jasmine Toning Mist,Warehouse A,41,24,2025-02-25 05:45:00,17
7563,ORD_7564,21319,T Clox 500mg Tablet,Warehouse A,45,30,2025-02-25 19:34:00,15
7564,ORD_7565,15432,Nipple Butter,Warehouse C,27,15,2025-02-25 11:50:00,12
7565,ORD_7566,15407,Deo 300mg Tablet,Warehouse A,98,81,2025-02-25 02:57:00,17
7566,ORD_7567,5754,"TP-Link Nano AC1300 Wireless MU-MIMO Wi-Fi Adapter(Archer T3U Nano), Dual Band Wireless Network Adapter for PC/Desktop/Lap...",Warehouse C,85,76,2025-02-25 23:37:00,9
7567,ORD_7568,8834,Doxasma 400mg Tablet,Warehouse B,49,44,2025-02-25 23:48:00,5
7568,ORD_7569,26760,Trazaril 100mg Tablet,Warehouse B,32,18,2025-02-25 07:54:00,14
7569,ORD_7570,15385,Tnw The Natural Wash Face Moisturising Gel Cream for Deep Nourishment 50 gm,Warehouse A,86,77,2025-02-25 11:35:00,9
7570,ORD_7571,28219,Visodf 0.05% Eye Drop,Warehouse B,55,45,2025-02-25 10:37:00,10
7571,ORD_7572,21240,Vega Eye Shadow Brush (PB - 06) 20 gm,Warehouse A,40,27,2025-02-25 18:58:00,13
7572,ORD_7573,34680,Translucent Stay Matte Finish Loose Powder for Oily Skin Control,Warehouse B,29,14,2025-02-25 01:25:00,15
7573,ORD_7574,16923,Superdrug Fragrance Free Essential Cleansing Wipes X25 (For sensitive Skin Care) 1's,Warehouse A,18,4,2025-02-25 05:41:00,14
7574,ORD_7575,30225,Faces Canada Longstay Liquid Matte Lipstick Deep Nude 01 6 Ml,Warehouse C,90,84,2025-02-25 16:13:00,6
7575,ORD_7576,21216,Nosardi Plus Syrup,Warehouse C,107,92,2025-02-25 01:32:00,15
7576,ORD_7577,15320,Mojer LC 5mg/10mg Tablet,Warehouse A,15,8,2025-02-25 23:52:00,7
7577,ORD_7578,30284,"boAt Immortal 121 TWS Gaming Truly Wireless in Ear Earbuds with Beast Mode(40ms Low Latency), 40H Playtime, Blazing LEDs, ...",Warehouse B,56,50,2025-02-25 23:54:00,6
7578,ORD_7579,16993,Gabris NT 400mg/10mg Tablet,Warehouse C,89,76,2025-02-25 04:10:00,13
7579,ORD_7580,15525,Canon GI790 Y Ink Cartridge (Yellow),Warehouse B,86,70,2025-02-25 11:51:00,16
7580,ORD_7581,34268,Comet Busters Fancy Om Maroon Bindi (BIN500),Warehouse B,89,72,2025-02-25 14:23:00,17
7581,ORD_7582,28308,Be Soulfull Drops of Brillance Brightening Serum 30 ml,Warehouse C,25,17,2025-02-25 14:19:00,8
7582,ORD_7583,29370,Minimalist Niacinamide Face Serum 30 ml,Warehouse B,74,63,2025-02-25 21:12:00,11
7583,ORD_7584,8659,mCaffeine Naked Detox Hydrating Green Tea Night Gel 50 ml,Warehouse A,15,10,2025-02-25 08:40:00,5
7584,ORD_7585,29609,Dumcef 250mg Injection,Warehouse A,96,82,2025-02-25 01:39:00,14
7585,ORD_7586,15213,"MMOBIEL E-8000 Glue 50 ml - Strong Glue for All Purpose Repair Glue for Mobiles, Jewellery, Shoes and more - Transparent A...",Warehouse C,56,40,2025-02-25 02:09:00,16
7586,ORD_7587,35170,"Beetel M90N Caller ID Corded Landline Phone with 16 Digit LCD Display,FSK/DTMF Compatable Caller N ID,8 Direct One Touch &...",Warehouse C,85,75,2025-02-25 01:03:00,10
7587,ORD_7588,12356,Diclomove Gel,Warehouse B,25,9,2025-02-25 04:04:00,16
7588,ORD_7589,21697,Roztan F 160 mg/10 mg Tablet,Warehouse C,20,6,2025-02-25 08:27:00,14
7589,ORD_7590,21081,Prelid 4mg Tablet,Warehouse A,75,67,2025-02-25 03:17:00,8
7590,ORD_7591,21686,"Cosmic Byte CB-EP-04 Gaming Wired in Ear Earphone with Microphone Detachable for PC, PS4, Mobiles, Tablets (Black/Silver)",Warehouse A,91,80,2025-02-25 14:46:00,11
7591,ORD_7592,12350,Ajmal Wisal Wisal Dhahab Sacrificeiihim Carbon Deodorant Spray (Pack of 4) 200 ml,Warehouse C,34,25,2025-02-25 06:01:00,9
7592,ORD_7593,8946,Amazon Brand - Solimo TPU Basic Back Cover for OnePlus Nord (Transparent),Warehouse C,102,95,2025-02-25 16:57:00,7
7593,ORD_7594,26552,Advansed Gold Coconut Hair Oil,Warehouse A,20,4,2025-02-25 14:17:00,16
7594,ORD_7595,3796,Essential Oil - Cinnamon,Warehouse C,33,16,2025-02-25 03:03:00,17
7595,ORD_7596,12337,SupCares Edge to Edge Privacy Tempered Glass for iPhone 14 Plus and iPhone 13 Pro Max (6.7 Inch) with Easy Self Installati...,Warehouse B,65,53,2025-02-25 10:03:00,12
7596,ORD_7597,21659,Vanifect O 200mg/500mg Tablet,Warehouse C,80,62,2025-02-25 01:17:00,18
7597,ORD_7598,1508,OpenTech® Tempered Glass Screen Protector Compatible for OnePlus 8T / 9 with Edge to Edge Coverage and Easy Installation kit,Warehouse C,112,96,2025-02-25 15:44:00,16
7598,ORD_7599,5697,Torpan Sugar Free Oral Gel,Warehouse A,14,5,2025-02-25 13:29:00,9
7599,ORD_7600,8938,Cefizen 200mg Tablet,Warehouse C,66,50,2025-02-25 07:29:00,16
7600,ORD_7601,21651,Tagamox DX Eye Drop,Warehouse A,89,80,2025-02-25 17:40:00,9
7601,ORD_7602,21648,TheGiftKart Shockproof Crystal Clear Oppo F11 / F11 Pro Back Cover Case | 360 Degree Protection | Protective Design | Tran...,Warehouse A,72,53,2025-02-25 05:04:00,19
7602,ORD_7603,34528,Vaadi Herbals Face Pack - Chandan Kesar-Haldi 120 gm,Warehouse A,35,27,2025-02-25 09:14:00,8
7603,ORD_7604,26128,Khadi Essentials Purifying Bath Bar - Swarnim 125 gm,Warehouse B,30,11,2025-02-25 19:55:00,19
7604,ORD_7605,19640,Perfect Balance Conditioner- For Normal To Dry Hair,Warehouse C,61,56,2025-02-25 12:33:00,5
7605,ORD_7606,16519,TOSHIBA 80 cm (32 inches) V Series HD Ready Smart Android LED TV 32V35KP (Silver),Warehouse A,66,58,2025-02-25 22:40:00,8
7606,ORD_7607,29213,"BBlite Premium Skin Cream - All-in-One Benefits | Skin Whitening, Anti-Ageing, SPF25, PA++, Broad Spectrum, UVA, UVB Prote...",Warehouse A,65,49,2025-02-25 12:27:00,16
7607,ORD_7608,8654,Elival 500mg Tablet CR,Warehouse A,28,16,2025-02-25 07:33:00,12
7608,ORD_7609,3810,"JBL C50HI, Wired in Ear Headphones with Mic, One Button Multi-Function Remote, Lightweight & Comfortable fit (Black)",Warehouse C,101,93,2025-02-25 14:31:00,8
7609,ORD_7610,27878,POPIO Tempered Glass Compatible for iPhone 6; iPhone 6S; iPhone 7; iPhone 8 (Transparent) Full Screen Coverage (Except Edg...,Warehouse A,70,63,2025-02-25 09:20:00,7
7610,ORD_7611,4980,Ajmal Nightingale And Distraction For Men & Women And Blu Homme Deodorants Pack of 3 200 ml,Warehouse C,83,74,2025-02-25 08:49:00,9
7611,ORD_7612,18969,Fluoc 150mg Tablet,Warehouse A,32,19,2025-02-25 15:51:00,13
7612,ORD_7613,34732,Woman - Azure Body Mist,Warehouse C,103,96,2025-02-25 19:22:00,7
7613,ORD_7614,18707,Allercet-L Syrup,Warehouse A,91,80,2025-02-25 19:38:00,11
7614,ORD_7615,5904,Iogen Syrup,Warehouse B,17,9,2025-02-25 22:03:00,8
7615,ORD_7616,34481,"Myra Veda Natural and Premium Rose Water for Face, Skin | Pore Minimizing & Makeup Remover | Chemical Free | Gulab Jal for...",Warehouse C,104,89,2025-02-25 03:27:00,15
7616,ORD_7617,8568,Apsara Art Kit,Warehouse B,35,25,2025-02-25 18:30:00,10
7617,ORD_7618,30175,Neuroprime NT Tablet,Warehouse B,42,25,2025-02-25 01:35:00,17
7618,ORD_7619,27876,"Maybelline New York Super Stay 24H Full coverage Liquid Foundation,Natural Beige 220 30 gm",Warehouse B,70,51,2025-02-25 12:47:00,19
7619,ORD_7620,28299,"Fashion Colour Kiss Lip Balm, Shade 05 3.6 gm",Warehouse A,51,40,2025-02-25 18:51:00,11
7620,ORD_7621,5902,Ajmal Bastion EDP Woody Aromatic Perfume And Shadow Homme Deodorant Citrus Woody Fragrance 300 ml,Warehouse A,82,68,2025-02-25 00:23:00,14
7621,ORD_7622,18963,EVOTECH M-10 TWS Bluetooth Headset in Ear/Earbuds with Mic/Noise Cancelling/Power Bank/Bluetooth 5.1 Earphones/ 3500mAh Ch...,Warehouse A,37,24,2025-02-25 22:42:00,13
7622,ORD_7623,32487,Plum Bodylovin' Oopsie Daisy Shower Gel 240 Ml,Warehouse A,52,46,2025-02-25 03:19:00,6
7623,ORD_7624,30402,"Maybelline New York City Mini Palette, 5th Avenue Sunset 6.1 gm",Warehouse C,113,97,2025-02-25 08:33:00,16
7624,ORD_7625,16963,"tizum EVA Universal Electronic Travel Gadgets & Accessories Organizer, Portable Multipurpose Protective Storage Pouch for ...",Warehouse C,41,26,2025-02-25 18:06:00,15
7625,ORD_7626,1517,Sucoriv O Oral Suspension,Warehouse A,96,77,2025-02-25 02:08:00,19
7626,ORD_7627,21704,Aroxim 50mg Tablet DT,Warehouse A,107,94,2025-02-25 20:53:00,13
7627,ORD_7628,4923,"SIDRUM WF-18 DSLR/SLR Camera Shoulder Bag Case with Adjustable Shoulder Strap & Rain Cover, Compatible for Nikon, Canon, S...",Warehouse A,18,4,2025-02-25 02:58:00,14
7628,ORD_7629,21131,Vrikka Sanjivini Vati - Kidney Care,Warehouse C,116,97,2025-02-25 04:33:00,19
7629,ORD_7630,5847,Wisely |Pack 4| For Fire Boltt Invincible Plus SmartWatch Screen Guard Scratch Guard Full Screen Protector Compatible for ...,Warehouse A,75,68,2025-02-25 12:16:00,7
7630,ORD_7631,295,Kouf-X-DC Syrup Lemon Sugar Free,Warehouse B,31,24,2025-02-25 20:36:00,7
7631,ORD_7632,36245,Deep Nourish Elbow & Foot Cream,Warehouse B,48,36,2025-02-25 05:39:00,12
7632,ORD_7633,297,Vega Loofah Pad (NBA - 3/5) 35 gm,Warehouse B,15,7,2025-02-25 23:48:00,8
7633,ORD_7634,10218,Lolip 10mg Tablet,Warehouse C,76,58,2025-02-25 21:17:00,18
7634,ORD_7635,5705,Berina A27 Light Natural Brown Hair Color Cream 60 gm,Warehouse B,70,64,2025-02-25 22:08:00,6
7635,ORD_7636,30348,Forest Essentials Ultra-Rich Body Milk Mashobra Honey & Vanilla|Hydrates & Nourishes|Lightweight Moisturiser For Men And W...,Warehouse C,114,95,2025-02-25 01:42:00,19
7636,ORD_7637,11729,"Quantum Wireless Keyboard and Mouse Set, 12 Months* Battery(Cells Included), Nano Receiver, Silent Keys 800/1200/1600 DPI,...",Warehouse A,18,2,2025-02-25 06:18:00,16
7637,ORD_7638,21627,& Moms - Sandal Soap,Warehouse B,44,39,2025-02-25 20:06:00,5
7638,ORD_7639,23760,Daily Life Forever52 Duo Fiber Brush Nx013 1's,Warehouse A,92,85,2025-02-25 05:19:00,7
7639,ORD_7640,11790,Passion Indulge CLEANSER-PEARL BLACK 100 ml,Warehouse B,70,54,2025-02-25 00:32:00,16
7640,ORD_7641,18005,Lakme 9 To 5 Primer + Gloss Nail Color Pink Pace 6 Ml,Warehouse A,28,13,2025-02-25 20:02:00,15
7641,ORD_7642,14396,Allure Small Blending Brush - (221) 1's,Warehouse C,56,47,2025-02-25 21:17:00,9
7642,ORD_7643,6876,Multani Mitti + Sandal Face Pack,Warehouse B,98,84,2025-02-25 20:58:00,14
7643,ORD_7644,18224,"Biotique Bio Almond Oil Nourishing Body Soap, Pack of 3, 225 g (3 x 75 g)",Warehouse C,104,88,2025-02-25 12:03:00,16
7644,ORD_7645,9859,Face Wash - Blush & Glow Peach Gel,Warehouse C,73,66,2025-02-25 04:16:00,7
7645,ORD_7646,13382,OneAssist 3Yrs Total Protection Plan for TV (Price Range 15001-20000)-Digital Delivery in 2 Hours,Warehouse C,114,97,2025-02-25 03:02:00,17
7646,ORD_7647,7828,Davidoff Cool Water For Men. Eau De Toilette Spray 4.2 Ounces,Warehouse B,49,31,2025-02-25 04:24:00,18
7647,ORD_7648,19578,Pitsafe 4 Tablet,Warehouse B,24,8,2025-02-25 12:18:00,16
7648,ORD_7649,35342,Amozo Slim Soft Flexible TPU Camera Protection Back Case Cover for iPhone 13 (TPU|Green),Warehouse C,97,78,2025-02-25 22:11:00,19
7649,ORD_7650,22991,Fujifilm Instax Mini Confetti Film- 10 Exposures,Warehouse C,74,55,2025-02-25 17:53:00,19
7650,ORD_7651,30860,Action Pro™ Helmet Chin Mount Strap Set Compatible with All Smartphones GoPro Hero 11 10 9 8 7 6 5 4 SJCAM DJI Osmo and Al...,Warehouse B,38,30,2025-02-25 01:43:00,8
7651,ORD_7652,6288,"AmazonBasics Magnetic Framed Dry Erase White Board, 23 x 35 Inch",Warehouse C,14,8,2025-02-25 19:31:00,6
7652,ORD_7653,16739,Spigen Tough Armor Magfit Back Cover Case Compatible with MagSafe Designed for iPhone 14 Pro Max (TPU + Poly Carbonate | D...,Warehouse B,58,51,2025-02-25 23:01:00,7
7653,ORD_7654,17652,Payal's Herbal Ubtan 150 gm | Natural Ubtan Herbal Bath Powder for Women,Warehouse C,26,14,2025-02-25 10:28:00,12
7654,ORD_7655,32618,"SAARA Organic Green Gram Powder |Moong Dal Powder|Pachai Payaru Powder, 100g Food Grade for Glowing Skin & Face",Warehouse C,84,78,2025-02-25 12:17:00,6
7655,ORD_7656,25787,Argan Oil - Conditioner,Warehouse B,60,48,2025-02-25 18:09:00,12
7656,ORD_7657,391,DavaIndia Glimepiride 2mg Tablet,Warehouse A,53,46,2025-02-25 18:26:00,7
7657,ORD_7658,36827,Spigen PE2007 GaN Dual Port Fast iPhone Charger 70W for All C Type Mobile Phones and Devices - White,Warehouse A,33,16,2025-02-25 00:24:00,17
7658,ORD_7659,20551,Cefilet LB 50mg Syrup,Warehouse B,16,6,2025-02-25 21:14:00,10
7659,ORD_7660,22989,FatCherry 6A 4 Way Extension Board max Rating 1440 W Wire Length 3 Meters (White),Warehouse A,27,22,2025-02-25 21:38:00,5
7660,ORD_7661,25779,Dilter CD 60mg Capsule,Warehouse C,43,38,2025-02-25 03:14:00,5
7661,ORD_7662,19846,"Seagate One Touch 5TB External HDD with Password Protection – Red, for Windows and Mac, with 3 yr Data Recovery Services, ...",Warehouse B,59,50,2025-02-25 08:41:00,9
7662,ORD_7663,1281,Amazon Brand - Solimo Protection Matte Finished Back Cover Case for OnePlus 6 | Rubberized TPU | Slim Thin Soft Matte Flex...,Warehouse A,57,48,2025-02-25 06:59:00,9
7663,ORD_7664,30024,"AirCase Office Sling Messenger Bag fits upto 15.6"" Laptop/Macbook, Detachable Shoulder Strap, Waterproof, Shockproof, Spac...",Warehouse C,72,57,2025-02-25 13:50:00,15
7664,ORD_7665,32673,Dorz Eye Drop,Warehouse A,104,97,2025-02-25 20:18:00,7
7665,ORD_7666,28592,Lapster USB 3.0 A to Micro B SuperSpeed for hard disk cable - short cable,Warehouse B,87,73,2025-02-25 04:35:00,14
7666,ORD_7667,25764,Fresh Active Roll On,Warehouse A,26,18,2025-02-25 04:51:00,8
7667,ORD_7668,27835,StayHappi Risperidone 1mg Tablet,Warehouse C,39,26,2025-02-25 03:46:00,13
7668,ORD_7669,24819,"UltraProlink UM1063 Powerlink 9 in1 Functions Type C-C Cable | Black | 3A/PD Cable,Micro USB, | iPhone Pin Convertor, USB-...",Warehouse C,39,27,2025-02-25 04:17:00,12
7669,ORD_7670,17663,Pansure 40mg Tablet,Warehouse C,88,70,2025-02-25 14:40:00,18
7670,ORD_7671,6920,"House of Quirk Wall Cable Management Covers, Paintable, Flat Design Cover Conceals 11.8 inch Wall Raceway Wall Mount TV Ca...",Warehouse C,15,3,2025-02-25 10:20:00,12
7671,ORD_7672,13355,Metos 0.1% Lotion,Warehouse C,38,23,2025-02-25 12:39:00,15
7672,ORD_7673,28969,"Amazon Basics USB A to Lightning Aluminum with Nylon Braided MFi Certified Charging Cable (Grey, 1.2 meter)",Warehouse A,44,26,2025-02-25 08:35:00,18
7673,ORD_7674,7706,"POND'S Vitamin C Brightening Sheet Mask, With Pineapple Extract For Clear Glowing Skin, Paraben Free, Biodegradable Fabri...",Warehouse C,33,17,2025-02-25 21:31:00,16
7674,ORD_7675,36272,Acilen T 100mg/4mg Tablet,Warehouse B,59,53,2025-02-25 18:58:00,6
7675,ORD_7676,27553,Pierre Cardin Paris - Studio Nails 55,Warehouse B,59,45,2025-02-25 16:56:00,14
7676,ORD_7677,14361,Rumox Pain Balm,Warehouse B,45,29,2025-02-25 22:08:00,16
7677,ORD_7678,10555,"HP 15s, AMD Athlon Silver 3050U 8GB RAM/512GB SSD 15.6-inches/39.6 cm HD, Micro-Edge Display/Windows 11/AMD Radeon Graphic...",Warehouse A,60,51,2025-02-25 22:27:00,9
7678,ORD_7679,32040,RPM Euro Games Gaming Mousepad Speed Type Extended Large (Size - 800 mm x 300 mm x 3 mm),Warehouse A,88,80,2025-02-25 00:08:00,8
7679,ORD_7680,13431,Pro 6 Plus Shaving Razor for Men - Blade + Handle + Cap,Warehouse A,63,53,2025-02-25 05:00:00,10
7680,ORD_7681,13430,Panicol Tablet,Warehouse B,46,30,2025-02-25 06:16:00,16
7681,ORD_7682,898,Doxifol-B6 Tablet,Warehouse C,108,91,2025-02-25 12:46:00,17
7682,ORD_7683,28605,Passion Indulge FACIAL KIT - PEARL LIGHT 5 STAR (pack of 3) 1's,Warehouse C,32,27,2025-02-25 09:08:00,5
7683,ORD_7684,33588,Retracef CV Dry Syrup,Warehouse B,76,68,2025-02-25 07:50:00,8
7684,ORD_7685,36839,Antonio Banderas Spirit for Women Deodorant Spray 150ML,Warehouse C,40,26,2025-02-25 23:07:00,14
7685,ORD_7686,28042,"Hilary Rhoda Power of Blur Perfect Matte & Smooth Face Primer, Makeup Primer for Poreless, Oil Control & Long Lasting Make...",Warehouse C,39,23,2025-02-25 22:43:00,16
7686,ORD_7687,23053,"CALAILIS Magnetic Eyelashes for Women, Eyelashes Magnetic with Eyeliner Kit, Natural Magnetic Lashes Reusable 5 Pairs, Fre...",Warehouse B,84,76,2025-02-25 17:32:00,8
7687,ORD_7688,35931,Corsa Cream,Warehouse C,62,47,2025-02-25 12:19:00,15
7688,ORD_7689,24668,Dragest 200mg Capsule,Warehouse C,62,50,2025-02-25 09:57:00,12
7689,ORD_7690,4718,Tickle Deo Spray,Warehouse C,69,54,2025-02-25 03:59:00,15
7690,ORD_7691,28941,Pro-Health Criss-Cross Charcoal Toothbrush - Extra Soft,Warehouse C,49,34,2025-02-25 06:54:00,15
7691,ORD_7692,16185,Daily Life Forever52 Long Wear El Eyeliner & Tattoo Gt001 5 GM,Warehouse A,105,97,2025-02-25 13:24:00,8
7692,ORD_7693,9747,"Toyshine Dinosaur Design Writing Tablet for Kids, 8.5 inches LCD Tab for Kids Drawing Pad Doodle Board Scribble and Play f...",Warehouse B,96,88,2025-02-25 04:17:00,8
7693,ORD_7694,28970,"Tukzer Universal Tabletop Mobile & Tablet Holder with 360 Degree Flexible Rotation for Bed, Table, Kitchen, Bathroom Compa...",Warehouse C,88,79,2025-02-25 06:17:00,9
7694,ORD_7695,11160,Doubledicestore Tempered Glass Screen Protector Compatible for Google Pixel 6A with Edge to Edge Full Coverage and Easy In...,Warehouse A,71,52,2025-02-25 22:05:00,19
7695,ORD_7696,24650,Revolution Pro New Neutrals Blushed Satin Matte Lipstick Tease 3.2 gm,Warehouse C,108,90,2025-02-25 23:44:00,18
7696,ORD_7697,23084,Tesam Injection Combipack,Warehouse A,24,15,2025-02-25 19:33:00,9
7697,ORD_7698,27191,Ajmal CD 99 Mukhallat Concentrated Perfume Oil Floral Oriental And Silver Shade Homme Deodorant Citrus Woody Fragrance 214 ml,Warehouse A,43,26,2025-02-25 14:00:00,17
7698,ORD_7699,30869,"Zayn & Myza Transfer - Proof Power Matte Lip Color, Rose Pink 6 ml",Warehouse B,64,53,2025-02-25 08:02:00,11
7699,ORD_7700,27926,Sennheiser CX 300s Wired in Ear Earphones with Mic (Black),Warehouse C,45,31,2025-02-25 21:23:00,14
7700,ORD_7701,22970,Vega Detangling Comb (2 Row) (1265) 36 gm,Warehouse C,84,67,2025-02-25 15:42:00,17
7701,ORD_7702,23223,Aloevera Moisturising Beauty Gel,Warehouse C,80,71,2025-02-25 22:10:00,9
7702,ORD_7703,27904,"Marcelle microSDXC Ultra Card 128GB, 140MB/s",Warehouse A,61,50,2025-02-25 15:27:00,11
7703,ORD_7704,10891,Walaphage 850 Tablet,Warehouse C,74,60,2025-02-25 00:29:00,14
7704,ORD_7705,35637,"OnePlus 10R 5G (Sierra Black, 12GB RAM, 256GB Storage, 80W SuperVOOC)",Warehouse B,40,22,2025-02-25 19:24:00,18
7705,ORD_7706,25785,Pcid 40 Tablet,Warehouse B,90,76,2025-02-25 13:21:00,14
7706,ORD_7707,24603,LOHAYA Voice Assistant Remote Compatible for Airtel Xstream Set-Top Box Remote Control with Netflix Function (Black) (Non...,Warehouse C,59,41,2025-02-25 10:45:00,18
7707,ORD_7708,20448,"Robustrion 50 in 1 Mounts, Straps & Accessories Kit for GoPro Hero 10 / 9 / 8 /7/6/5/4/3/2/1/SJCAM/Akaso/Apeman/Xiaomi/Son...",Warehouse A,67,51,2025-02-25 14:33:00,16
7708,ORD_7709,6269,Allure Powder Brush - (107) 1's,Warehouse C,86,77,2025-02-25 03:20:00,9
7709,ORD_7710,11680,Brustro Kidney Shaped Plain Wooden Palette 40 x 30CM,Warehouse B,102,95,2025-02-25 12:21:00,7
7710,ORD_7711,7759,Metotid 5mg Syrup,Warehouse C,108,93,2025-02-25 18:32:00,15
7711,ORD_7712,4741,"Dr. ORG INDIA 3 In 1 Steam Vaporizer, Nose Steamer, Cough Steamer, Nozzle Inhaler & Nose vaporizer machine for cold and co...",Warehouse B,19,8,2025-02-25 14:35:00,11
7712,ORD_7713,18312,Supro Plus 0.25mg/20mg Tablet,Warehouse C,44,34,2025-02-25 04:48:00,10
7713,ORD_7714,12780,TheGiftKart Ultra-Hybrid Crystal Clear Back Cover Case for iPhone 14 Pro MAX | Slim Fit Shockproof Design | Camera Protect...,Warehouse B,29,14,2025-02-25 03:54:00,15
7714,ORD_7715,9796,"Fashion Colour Eyebrow Pencil, EB01 1.3 gm",Warehouse A,31,15,2025-02-25 13:02:00,16
7715,ORD_7716,30898,Cgfru 40mg Tablet,Warehouse A,53,44,2025-02-25 23:47:00,9
7716,ORD_7717,4199,TheGiftKart Tough Armor Back Cover Case for Redmi 10 / Redmi 10 Power Bumper | Ring Holder & Kickstand in-Built | 360 Degr...,Warehouse C,27,20,2025-02-25 21:07:00,7
7717,ORD_7718,10894,"Nillkin Galaxy S23 Ultra Case with Camera Cover, CamShield Pro for Samsung S23 Ultra Case, Slim Fit Thin Shockproof Cover ...",Warehouse B,106,88,2025-02-25 15:09:00,18
7718,ORD_7719,29793,Lakme True Wear Nail Color Shade Tt20 9 Ml,Warehouse B,111,97,2025-02-25 01:39:00,14
7719,ORD_7720,19792,Ice cube velvet Lip Glaze mushed Lip Gloss Waterproof Lipstick (02# Heart cold berry Gentle bean paste berry color The sen...,Warehouse C,73,65,2025-02-25 06:46:00,8
7720,ORD_7721,33280,TNW - The Natural Wash Baby Body Lotion 150 ml,Warehouse B,73,64,2025-02-25 01:22:00,9
7721,ORD_7722,7792,"AmazonBasics RJ45 Cat-6 Ethernet Patch/LAN Cable for Smartphone, Router, Printer - 25Feet (7.6Meters)-Black",Warehouse C,73,64,2025-02-25 21:21:00,9
7722,ORD_7723,11996,"Pragati Systems® Genius Regular Steel (Magnetic) Whiteboard for Office, Home & School (GRMWB6090), Lightweight Aluminium F...",Warehouse C,63,47,2025-02-25 07:08:00,16
7723,ORD_7724,9283,Attitude Celebration Pack Crème Lipstick Sizzling Rouge (1),Warehouse B,28,13,2025-02-25 13:30:00,15
7724,ORD_7725,28628,Bath & Body Works Rose Gold Glitter Visor & Vent Clip Car Fragrance Holder,Warehouse C,32,23,2025-02-25 11:23:00,9
7725,ORD_7726,33550,Insight Cosmetics Color Rich Lipstick - Maple Map 4.2 gm,Warehouse B,100,94,2025-02-25 10:27:00,6
7726,ORD_7727,10893,Disinfectant Spray,Warehouse C,23,15,2025-02-25 16:49:00,8
7727,ORD_7728,7880,"TABLE MAGIC Multipurpose Laptop Table Mat Finish Top Work Home Study (TM Regular Mandala Black)(Polypropylene,Alloy Steel)",Warehouse A,63,44,2025-02-25 12:51:00,19
7728,ORD_7729,33283,Telma ACT 40mg/5mg/6.25mg Tablet,Warehouse C,74,68,2025-02-25 16:01:00,6
7729,ORD_7730,24913,"JBL Wave 200 TWS, True Wireless in-Ear Earbuds with Mic, 20 Hours Playtime, Deep Bass Sound, use Single Earbud or Both, Bl...",Warehouse B,37,29,2025-02-25 03:01:00,8
7730,ORD_7731,27224,"Sanitary Pads - XL, Ultra Soft 50 pcs + XXXL Wings, Ultra Nights 10 pcs",Warehouse B,78,66,2025-02-25 06:18:00,12
7731,ORD_7732,402,Antiseptic - Disinfectant Liquid 1 L + Clinical Strength Hand Sanitizer 500 ml,Warehouse B,25,8,2025-02-25 16:49:00,17
7732,ORD_7733,3187,boAt Bassheads 242 in Ear Wired Earphones with Mic(Blue),Warehouse A,61,55,2025-02-25 08:19:00,6
7733,ORD_7734,30917,SKYVIK TRUHOLD StickOn Magnetic Mount Mobile or Remote Holder for Car-Bike-Scooter-Home-Kitchen-Office-Desk-(Black),Warehouse C,82,72,2025-02-25 21:48:00,10
7734,ORD_7735,3196,"Dasher Hair Cream - 12 Herbs Nourish - Hair Strength, Anti-Hair fall, Styling Hold, Anti-Dandruff - Non-Sticky - Almond, A...",Warehouse C,69,57,2025-02-25 10:20:00,12
7735,ORD_7736,17639,DUcare Makeup Brushes 27Pcs Professional Makeup Brush Set Christmas Gift Premium Synthetic Goat Pony Hair Kabuki Foundatio...,Warehouse A,105,87,2025-02-25 01:26:00,18
7736,ORD_7737,14398,Serifen 50mg/500mg Tablet,Warehouse A,83,68,2025-02-25 15:31:00,15
7737,ORD_7738,28977,Fair And Handsome Long Lasting Radiance Cream™,Warehouse B,57,44,2025-02-25 07:55:00,13
7738,ORD_7739,13340,Ronzille Glass Glow Pre Makeup oil Primer enriched with Vitamin-E 10 ml Primer - 10 ml (Transparent),Warehouse B,50,37,2025-02-25 14:24:00,13
7739,ORD_7740,7830,"Ambrane Wired in Ear Earphones with in-line Mic for Clear Calling, 14mm Dynamic Drivers for BoostedBass™, 3.5mm Jack, Mult...",Warehouse A,66,61,2025-02-25 18:54:00,5
7740,ORD_7741,27196,Appimer Syrup,Warehouse B,61,50,2025-02-25 20:10:00,11
7741,ORD_7742,35630,Cinar Gel,Warehouse A,43,34,2025-02-25 11:47:00,9
7742,ORD_7743,32207,Clofert 50 Tablet,Warehouse C,44,29,2025-02-25 22:55:00,15
7743,ORD_7744,30915,Kelvin M 100mg/250mg Dry Syrup,Warehouse C,105,97,2025-02-25 06:32:00,8
7744,ORD_7745,33604,Phy Mintin It Refreshing Body Wash 300 Ml,Warehouse A,31,22,2025-02-25 06:06:00,9
7745,ORD_7746,28029,Saliclo Lotion,Warehouse B,49,37,2025-02-25 06:25:00,12
7746,ORD_7747,33293,Radiant Platinum Cellular Anti-Ageing 4 Facial Kit,Warehouse A,37,25,2025-02-25 04:47:00,12
7747,ORD_7748,4121,Glimcyn-M Tablet SR,Warehouse C,63,53,2025-02-25 11:57:00,10
7748,ORD_7749,30921,Aegte Age Rewind Night Cream 50 gm,Warehouse C,94,79,2025-02-25 15:59:00,15
7749,ORD_7750,23197,Spigen Cyrill Leather Brick Back Cover Case Compatible with iPhone 12 Pro/iPhone 12 (2020) (Faux Leather + PC) - Navy,Warehouse B,110,99,2025-02-25 04:16:00,11
7750,ORD_7751,25668,"Samsung Galaxy M13 (Stardust Brown, 4GB, 64GB Storage) | 6000mAh Battery | Upto 8GB RAM with RAM Plus",Warehouse B,73,60,2025-02-25 10:19:00,13
7751,ORD_7752,35332,Apkos-D Tablet,Warehouse A,45,34,2025-02-25 19:36:00,11
7752,ORD_7753,31487,"Pragati Systems® Genius Melamine (Non-Magnetic) Whiteboard for Office, Home and School (GWB6090), Lightweight Aluminium Fr...",Warehouse B,60,50,2025-02-25 04:48:00,10
7753,ORD_7754,28032,"Noise Buds VS304 Truly Wireless in Ear Earbuds with 35H of Playtime, Instacharge(10 min=120 min), 13 mm Driver and BT v5.3...",Warehouse B,80,61,2025-02-25 22:19:00,19
7754,ORD_7755,11134,Faces Canada Ultime Pro Primerizer Primer + Moisturizer 30 Gm,Warehouse C,38,33,2025-02-25 14:22:00,5
7755,ORD_7756,23175,"Fashion Colour Kiss Lip Balm, Shade 03 3.6 gm",Warehouse B,75,67,2025-02-25 19:53:00,8
7756,ORD_7757,28931,"Philips Radio DL167/94 with MW/SW/FM Bands, 2xR20 (UM1),External 3V DC (Optional)",Warehouse C,39,33,2025-02-25 05:23:00,6
7757,ORD_7758,27849,Rabezol DSR  Capsule,Warehouse B,52,39,2025-02-25 13:06:00,13
7758,ORD_7759,32811,Styce 250mg Tablet,Warehouse C,85,79,2025-02-25 08:33:00,6
7759,ORD_7760,36124,"HP G8 Core Intel i3 11th Gen - (8 GB/512 GB SSD/Windows 11 Home) 240 G8 Business Laptop (14 inch, Black Grey, 1.47 kg) 689...",Warehouse A,26,21,2025-02-25 04:51:00,5
7760,ORD_7761,6401,"Bestor® Scribble Board, Doodle Pad Tablet E-Writer/Writing Digital Memo Erasable 12 Inch LCD Tablet with Screen Lock Funct...",Warehouse A,12,4,2025-02-25 08:35:00,8
7761,ORD_7762,17708,Tasya Vit C + Hyaluronic Radiance Sunscreen 60 ml,Warehouse A,85,79,2025-02-25 19:20:00,6
7762,ORD_7763,23145,Clobmic Neo Cream,Warehouse B,115,96,2025-02-25 15:53:00,19
7763,ORD_7764,18164,Gear Turbo 45L Expandable Water Resistant Antitheft Laptop Bag/Backpack/Briefcase For Men/Women With Raincover (Grey),Warehouse C,13,7,2025-02-25 09:39:00,6
7764,ORD_7765,2571,"Sunaina Matching Plaza Round Red Bindi for Women (Size 4mm,Pack of 180 Bindis) [SRMP604] Size-8",Warehouse A,68,59,2025-02-25 20:03:00,9
7765,ORD_7766,32804,Fixinox LB 200mg Tablet,Warehouse A,89,71,2025-02-25 00:56:00,18
7766,ORD_7767,36867,realme narzo 50i Prime (Dark Blue 4GB RAM+64GB Storage) Octa-core Processor | 5000 mAh Battery,Warehouse C,62,47,2025-02-25 23:04:00,15
7767,ORD_7768,11982,Amble S 100mg/15mg Tablet,Warehouse A,16,4,2025-02-25 21:25:00,12
7768,ORD_7769,2437,"Moschino Pink Fresh Couture Eau De Toilette for her, 50ml",Warehouse A,21,9,2025-02-25 01:20:00,12
7769,ORD_7770,33304,"Philips Radio RL118/94 with MW/SW/FM Bands, 200mW RMS soundoutput,3-1 Power Source External Battery:2xR6 (3V DC), Mains: 2...",Warehouse B,110,97,2025-02-25 21:49:00,13
7770,ORD_7771,23375,loreal strudio Pure Wet gel no.6,Warehouse C,69,64,2025-02-25 08:53:00,5
7771,ORD_7772,9227,Sencort Oral Suspension,Warehouse A,26,9,2025-02-25 13:42:00,17
7772,ORD_7773,22922,Paracip Syrup,Warehouse B,88,74,2025-02-25 03:33:00,14
7773,ORD_7774,27247,Durifax D 0.4mg/0.5mg Tablet,Warehouse B,52,33,2025-02-25 10:40:00,19
7774,ORD_7775,1266,Jovees Shea Butter Moisturizer - Rich Cream with Fruit Extracts 100 gm,Warehouse C,109,93,2025-02-25 18:36:00,16
7775,ORD_7776,22925,Losadoc 25mg Tablet,Warehouse C,45,28,2025-02-25 01:56:00,17
7776,ORD_7777,24860,M2 Perfume Spray - for Men,Warehouse A,83,74,2025-02-25 11:34:00,9
7777,ORD_7778,781,Rexipan D 30mg/20mg Capsule SR,Warehouse C,29,18,2025-02-25 19:49:00,11
7778,ORD_7779,12859,"SERY Soft Matte Lip Crayon|Creamy Matte Texture Lipstick, Light Weight, Long Lasting,Transfer-Proof, Highly Pigmented, Sin...",Warehouse C,68,58,2025-02-25 12:09:00,10
7779,ORD_7780,32801,The Moms Co. Natural Vanilla Lip Balm 5 gm,Warehouse A,55,43,2025-02-25 06:22:00,12
7780,ORD_7781,25598,NOTE EYESHADOW PENCIL 04 1.6 gm,Warehouse B,57,44,2025-02-25 09:14:00,13
7781,ORD_7782,3230,I Am Eyeconic Matte Neon Pure Pigments RED LOACTIVE 2 gm,Warehouse B,41,27,2025-02-25 04:16:00,14
7782,ORD_7783,7691,Colors Purple For Her Eau De Toilette,Warehouse B,46,41,2025-02-25 10:39:00,5
7783,ORD_7784,11967,"Wipro 4 Way multiplug with 2 Universal sockets [2020 Model], White (NWM0100)",Warehouse A,46,33,2025-02-25 18:44:00,13
7784,ORD_7785,3482,Tymist-H 80mg/12.5mg Tablet,Warehouse B,95,90,2025-02-25 21:59:00,5
7785,ORD_7786,24855,Ndpin 50mg Injection,Warehouse A,16,7,2025-02-25 15:04:00,9
7786,ORD_7787,6356,Fashionury Back Cover Case for Mi Redmi Note 10 / Redmi Note 10S / Redmi Note 11 SE/Note 10S (Shockproof | Crystal Clear |...,Warehouse B,80,68,2025-02-25 10:36:00,12
7787,ORD_7788,13297,"Redmi LCD Writing Pad with Stylus, 21.59 cm(8.5-inch), Smart Lock, ABS Material, Anti-Blue Light Screen, Handwriting Gifts...",Warehouse C,46,27,2025-02-25 00:03:00,19
7788,ORD_7789,28653,Reynolds TRIMAX BLUE - 5 COUNTI Lightweight Roller Pen With Comfortable Grip for Extra Smooth Writing I School and Office ...,Warehouse C,42,34,2025-02-25 19:04:00,8
7789,ORD_7790,25582,Bio Clove - Purifying Anti-Blemish Face Pack For Oily & Acne Prone Skin,Warehouse C,36,26,2025-02-25 15:04:00,10
7790,ORD_7791,4745,Artebact 150mg Injection,Warehouse B,22,4,2025-02-25 22:12:00,18
7791,ORD_7792,19376,Inalam 10mg Tablet,Warehouse C,23,6,2025-02-25 12:26:00,17
7792,ORD_7793,4410,DeBelle Gel Nail Lacquer Polaris Dark Metallic Grey Nail Polish 8 ml,Warehouse B,25,12,2025-02-25 09:49:00,13
7793,ORD_7794,31491,Clavorxime Kid Dry Syrup,Warehouse A,107,91,2025-02-25 10:54:00,16
7794,ORD_7795,11969,realme Smart Tv Stick 4K,Warehouse B,50,43,2025-02-25 12:52:00,7
7795,ORD_7796,25580,Kencef 200mg Tablet,Warehouse B,24,10,2025-02-25 14:10:00,14
7796,ORD_7797,18183,Spigen Rugged Armor Pro Fabric Case Compatible with Nintendo Switch | Nintendo Switch OLED (2021) - Matte Black [Video Game],Warehouse A,37,31,2025-02-25 07:29:00,6
7797,ORD_7798,3123,Yves Rocher Volume And Substance Amplifying Spray 150 ml,Warehouse A,54,49,2025-02-25 00:03:00,5
7798,ORD_7799,15851,Kangaro Paper Punch DP 700 - Colour May Vary,Warehouse B,77,64,2025-02-25 06:53:00,13
7799,ORD_7800,28661,REALCASE Thermoplastic Polyurethane Samsung Galaxy Z Flip 3 5G Back Cover Carbon Fiber Design Crystal Clear Hard | Ring Ho...,Warehouse A,95,87,2025-02-25 09:32:00,8
7800,ORD_7801,20412,"CableCreation USB C to HDMI Cable, Type C to HDMI Cable HDR 4K@60Hz, 2K@144Hz, USB Type C to HDMI Adapter Thunderbolt 3 Co...",Warehouse A,90,79,2025-02-25 04:05:00,11
7801,ORD_7802,19884,Skin Whitening & Brightening Facial Kit For Dry Skin - Single Time Use,Warehouse C,110,99,2025-02-25 03:11:00,11
7802,ORD_7803,4556,"Amazfit GTS 2 (New Version) Smart Watch with Ultra HD AMOLED Display, Built-in Amazon Alexa, Built-in GPS, SpO2 & Stress M...",Warehouse C,19,13,2025-02-25 04:18:00,6
7803,ORD_7804,29985,Atik 50mg/325mg Tablet,Warehouse B,37,19,2025-02-25 07:46:00,18
7804,ORD_7805,18179,Advanced All Night XL- Sanitary Pads For Women,Warehouse B,93,75,2025-02-25 18:33:00,18
7805,ORD_7806,34006,3M Scotch White Glue Stick - Pack of 5,Warehouse B,17,5,2025-02-25 02:52:00,12
7806,ORD_7807,3472,Nutriment Vitamin C Mask All Skin Type 300 gm,Warehouse B,72,58,2025-02-25 02:00:00,14
7807,ORD_7808,3234,"Noise Champ 2 Smart Watch for Kids with Habit Reminders (Handwash, Brushing, etc), 7 Days Battery, IP68 Waterproof, Activi...",Warehouse C,28,22,2025-02-25 03:36:00,6
7808,ORD_7809,29141,99Auth 450g Energy Enhance Original Pure Ragi Flour/Finger Millet Flour No Preservative,Warehouse B,35,22,2025-02-25 08:54:00,13
7809,ORD_7810,16746,Miss Claire Tinted Lip Balm 04 3 Gm,Warehouse B,32,13,2025-02-25 01:53:00,19
7810,ORD_7811,13304,Stalchlor 125mg/5ml Syrup,Warehouse A,82,68,2025-02-25 23:42:00,14
7811,ORD_7812,15844,Apple iPhone 13 (256GB) - Blue,Warehouse B,10,3,2025-02-25 21:12:00,7
7812,ORD_7813,35937,Cefister LB 200mg Tablet,Warehouse C,48,39,2025-02-25 10:02:00,9
7813,ORD_7814,16677,"ZEBRONICS Zeb-Fame 1 USB Powered 2.0 Speaker with 10W RMS Output, 7 RGB Modes, LED Control Switch, Volume Control, 3.5mm I...",Warehouse B,47,36,2025-02-25 05:07:00,11
7814,ORD_7815,1285,Beard Growth Oil - Cedarwood & Mandarin,Warehouse C,61,43,2025-02-25 04:51:00,18
7815,ORD_7816,2889,Fayo S 500mg/500mg Injection,Warehouse A,69,60,2025-02-25 06:03:00,9
7816,ORD_7817,10526,Manish Malhotra Cinnamon Ginger Night Gel 50 Gm,Warehouse A,113,95,2025-02-25 16:58:00,18
7817,ORD_7818,12038,"POPIO Tempered Glass for Samsung Galaxy M31s / A51 (Transparent) Full Screen Coverage (except edges), Pack of 2",Warehouse A,49,43,2025-02-25 00:23:00,6
7818,ORD_7819,6382,Piptal Oral Drops,Warehouse A,35,18,2025-02-25 12:35:00,17
7819,ORD_7820,33536,Glucart 500mg Tablet,Warehouse C,14,6,2025-02-25 07:57:00,8
7820,ORD_7821,29132,Emofexine Plus 50mg/0.5mg Tablet,Warehouse C,106,93,2025-02-25 16:36:00,13
7821,ORD_7822,33537,Levozip 500mg Tablet,Warehouse A,86,78,2025-02-25 03:08:00,8
7822,ORD_7823,20577,I AM EYECONIC 3D GLITTER GIRL GANG 4 gm,Warehouse B,82,77,2025-02-25 10:41:00,5
7823,ORD_7824,5306,Adipod 100mg Tablet,Warehouse A,11,1,2025-02-25 22:28:00,10
7824,ORD_7825,23404,YOUTH MOBI ( Pack of 2 Tempered Glass Screen Protector For Apple Watch Ultra (49mm) With Easy Installation Kit; Transparent,Warehouse A,80,62,2025-02-25 12:40:00,18
7825,ORD_7826,36211,Tramared 50mg Injection,Warehouse C,54,47,2025-02-25 05:07:00,7
7826,ORD_7827,7632,Ashlof OZ Infusion,Warehouse B,62,43,2025-02-25 23:53:00,19
7827,ORD_7828,31492,Brutex 200mg Tablet,Warehouse C,90,71,2025-02-25 22:29:00,19
7828,ORD_7829,24562,"Quantum 3-in-1 USB Type C to HDMI 4K Adapter, USB 3.0, USB C, Aluminium USB C Hub, High Speed Upto 5Gbps, 60W Power Pass T...",Warehouse A,107,98,2025-02-25 11:49:00,9
7829,ORD_7830,7711,Passion Indulge E OILS-FRANKINCESE 10 ml,Warehouse C,49,34,2025-02-25 00:44:00,15
7830,ORD_7831,5329,Fashion Colour Transparent Moisturizing Lipgloss 3 ml,Warehouse C,63,53,2025-02-25 14:14:00,10
7831,ORD_7832,14231,"Tizum Mobile & Tablet Holder with 360 Rotation, Mobile Stand with Anti-Slip Silicone Pads & Fully Flexible Gooseneck Arm &...",Warehouse C,69,63,2025-02-25 03:37:00,6
7832,ORD_7833,876,Fluzom 150mg Tablet,Warehouse C,104,92,2025-02-25 19:47:00,12
7833,ORD_7834,33981,Parker Vector Standard CT Roller Ball Pen (Red),Warehouse A,59,45,2025-02-25 11:37:00,14
7834,ORD_7835,33322,Revolution Pro Full Cover Camouflage Concealer-C17 8.5 ml,Warehouse A,94,78,2025-02-25 21:48:00,16
7835,ORD_7836,5333,Comet Busters Long Fancy Golden Bindi (BIN539),Warehouse A,53,36,2025-02-25 15:46:00,17
7836,ORD_7837,28014,"MARS 16 Color Ultra Pigmented Infinity Matte Lip Color Palette (Multicolor, 36 g)",Warehouse B,47,29,2025-02-25 19:57:00,18
7837,ORD_7838,4004,Fogg Absolute Deodorant For Men 150 ML (Black),Warehouse A,50,39,2025-02-25 03:58:00,11
7838,ORD_7839,2426,Molkuf BR Syrup,Warehouse B,38,27,2025-02-25 12:36:00,11
7839,ORD_7840,28920,"Syrup - Brahmi, Mind Wellness, Improves Alertness",Warehouse A,75,57,2025-02-25 19:19:00,18
7840,ORD_7841,20373,"Fullmosa Compatible Apple Watch Straps 42mm 44mm 45mm 49mm 38mm 40mm 41mm, Stainless Steel iWatch Band with Case for Apple...",Warehouse B,34,24,2025-02-25 18:46:00,10
7841,ORD_7842,9338,Illmont Syrup,Warehouse A,34,24,2025-02-25 21:48:00,10
7842,ORD_7843,7609,Terbotac 250mg Tablet,Warehouse A,63,57,2025-02-25 18:17:00,6
7843,ORD_7844,13517,"A Accessories kart Case for Oneplus 11 5G Case, Crystal Clear Case ipaky Slim Anti Scratch TPU Shockproof Protective Phone...",Warehouse B,86,79,2025-02-25 03:26:00,7
7844,ORD_7845,13277,Eveready Ultima Alkaline AA Battery - Pack of 4,Warehouse A,50,44,2025-02-25 21:42:00,6
7845,ORD_7846,30995,Bella Voste Hi Definition Mascara Raven Black 9 Ml,Warehouse C,103,89,2025-02-25 12:09:00,14
7846,ORD_7847,32059,Senteron 2mg Injection,Warehouse A,22,4,2025-02-25 18:28:00,18
7847,ORD_7848,31605,Hydro Replenish Ultimate Hydration Overnight Sleeping Pack,Warehouse C,100,91,2025-02-25 05:09:00,9
7848,ORD_7849,33636,ANCHOR 250V 1440W Power Strip 6 Way with Single Switch,Warehouse C,64,56,2025-02-25 13:56:00,8
7849,ORD_7850,9347,Levocar 250mg Tablet,Warehouse A,13,4,2025-02-25 08:45:00,9
7850,ORD_7851,14204,"Wooum Cable and Electronic Accessories Storage Bag, Carrying and Traveling Case for Wires Charger USB Digital Gadget Power...",Warehouse C,97,79,2025-02-25 14:18:00,18
7851,ORD_7852,3949,Tongue Scraper,Warehouse B,90,76,2025-02-25 07:36:00,14
7852,ORD_7853,19787,Beauty People Matte Lucious Liquid Lip Colorrusted - Crush - L26 ,Warehouse A,61,50,2025-02-25 15:39:00,11
7853,ORD_7854,10871,Beer Shampoo - Shiny & Bouncy,Warehouse C,46,35,2025-02-25 20:21:00,11
7854,ORD_7855,33975,Rabtry IT 20mg/150mg Capsule SR,Warehouse C,28,12,2025-02-25 07:25:00,16
7855,ORD_7856,29128,Ajmal Impress And Aura & Neea EDP Of Pack of 3 20 ml,Warehouse B,57,41,2025-02-25 09:56:00,16
7856,ORD_7857,7604,TheGiftKart Crystal Clear Back Cover Case for Mi Redmi Note 11T 5G / Poco M4 Pro 5G | 360 Degree Protection | Shock Proof ...,Warehouse A,100,90,2025-02-25 21:19:00,10
7857,ORD_7858,25837,Plum Bright Years All-Day Defence Cream - SPF 45 50 ml,Warehouse B,54,40,2025-02-25 13:27:00,14
7858,ORD_7859,17721,Bioqfresh Gel Eye Drop,Warehouse B,46,38,2025-02-25 21:10:00,8
7859,ORD_7860,14195,Fluarai 10mg Tablet,Warehouse A,73,61,2025-02-25 09:30:00,12
7860,ORD_7861,4748,Red Wine Advance Anti Ageing Facial Kit,Warehouse B,81,65,2025-02-25 08:03:00,16
7861,ORD_7862,13373,Lamocent -DT 100 Tablet,Warehouse B,55,44,2025-02-25 04:10:00,11
7862,ORD_7863,36895,Spruce Streak6 Pivot - 6 Blade Shaving Razor For Men (Titanium and Diamond Coated Blades),Warehouse A,65,59,2025-02-25 18:59:00,6
7863,ORD_7864,31385,Solofix Plus Dry Syrup,Warehouse B,32,13,2025-02-25 19:06:00,19
7864,ORD_7865,3537,Plum Bodylovin Hawaiian Rumba Colada (Gel Lotion) 240 Ml,Warehouse C,11,2,2025-02-25 02:11:00,9
7865,ORD_7866,15738,Ultragin 500mg Injection,Warehouse B,72,66,2025-02-25 14:14:00,6
7866,ORD_7867,9595,Cerofene 25mg Tablet,Warehouse C,13,3,2025-02-25 06:51:00,10
7867,ORD_7868,7590,Dotipen AC 80mg/100mg Tablet,Warehouse C,95,90,2025-02-25 01:57:00,5
7868,ORD_7869,16586,"Wella Professionals Nutricurls Shampoo for Waves | 250 ml | Nourishing, Moisturizing Hair Cleanser for Waves & Curls | Wit...",Warehouse A,71,54,2025-02-25 06:58:00,17
7869,ORD_7870,3245,"AmazonBasics Multiplug Adaptor with 3 Universal Sockets and in-Built Surge Protection, 6A, Set of 2",Warehouse B,34,25,2025-02-25 16:30:00,9
7870,ORD_7871,13278,Caprina Fresh Goat's Milk Soap with Delicate Orchid Flower Oil,Warehouse A,77,70,2025-02-25 01:10:00,7
7871,ORD_7872,13524,Neurabol Injection,Warehouse C,53,45,2025-02-25 21:01:00,8
7872,ORD_7873,10645,INVICTO TG113 Portable Bluetooth Speaker with USB/Micro SD Card/AUX/Mic Multimedia Speaker System Super Bass Compatible wi...,Warehouse A,74,63,2025-02-25 08:56:00,11
7873,ORD_7874,25842,Aboutthefit 360 Degrees Rotate Pu Leather Stand Flip Cover for Tablets Samsung Galaxy Tab A 2019 8.0 Inches Inches Sm-T29...,Warehouse A,104,96,2025-02-25 15:38:00,8
7874,ORD_7875,6936,Apple iPhone 14 Pro (128 GB) - Space Black,Warehouse A,111,96,2025-02-25 17:33:00,15
7875,ORD_7876,774,"Dhvsam Power Strip Holder Fixator, No Hole Plug-in Wall Socket Sticker Fixer, Loading 10 Kg Maximum, for Desk, Wall, WiFi ...",Warehouse B,114,95,2025-02-25 14:40:00,19
7876,ORD_7877,27934,"VEMIGON Stainless Steel Magnetic Strap Compatible with Apple Watch Series 8 7 6 5 4 3 2 1 SE, Women and Men [Watch Not Inc...",Warehouse B,27,21,2025-02-25 03:53:00,6
7877,ORD_7878,817,Mi 33W SonicCharge 2.0 USB Charger|Wall Charger Adapter with USB to Type-C Cable Included|Fast Charging|QC Charging|(Adapt...,Warehouse A,88,75,2025-02-25 14:35:00,13
7878,ORD_7879,11854,Quench Botanics Mama Cica Instabright Peel Pads 300 g,Warehouse A,85,70,2025-02-25 10:03:00,15
7879,ORD_7880,35056,Dermiflam Ointment,Warehouse B,77,59,2025-02-25 07:05:00,18
7880,ORD_7881,11056,Hawink Mini Tattoo Battery Tattoo Rechargeable USB Power Supply Digital Display Tattoo Machine RCA Connector P198-RCA,Warehouse B,36,27,2025-02-25 16:47:00,9
7881,ORD_7882,15960,Benprazole-D Capsule,Warehouse B,111,95,2025-02-25 16:57:00,16
7882,ORD_7883,13585,"Fashion Colour Satin Smooth Lip Definer, 10 Burgundy Wine 1.41 gm",Warehouse C,76,63,2025-02-25 01:35:00,13
7883,ORD_7884,7543,Firming Glow Pack,Warehouse C,63,47,2025-02-25 08:19:00,16
7884,ORD_7885,13545,YellowInc Breathe Silicone Case Cover Skin Compatible for Oneplus Buds Pro (2021),Warehouse B,57,48,2025-02-25 01:40:00,9
7885,ORD_7886,13543,"Worldwide Universal Power Adapter Converter, FENTICO All in One International Out of Country Travel Wall Charger Plug for ...",Warehouse A,85,73,2025-02-25 21:27:00,12
7886,ORD_7887,11077,"APCSA Original New Series 7 D20 Bluetooth Wireless Smart Watch, Fitness Band for Boys, Girls, Men, Women & Kids | Sports W...",Warehouse C,22,10,2025-02-25 10:20:00,12
7887,ORD_7888,10666,Spigen Ultra Hybrid Back Cover Case for iPhone 11 (TPU + Poly Carbonate | Matte Black),Warehouse C,53,40,2025-02-25 16:27:00,13
7888,ORD_7889,17572,HELLO ZONE Rubber Exclusive Matte Finish Soft Back Case Cover for Oppo A74 5G - Black,Warehouse B,85,79,2025-02-25 15:38:00,6
7889,ORD_7890,20295,boAt Rockerz 261 in Ear Wireless Earphones with mic(Raging Red),Warehouse C,33,27,2025-02-25 14:05:00,6
7890,ORD_7891,20299,"Parker Safety Razor 100 Parker Premium Platinum 1/2 Blades - For Professional Barber Razors, Shavette Razors And isposable...",Warehouse B,9,1,2025-02-25 05:52:00,8
7891,ORD_7892,27845,Storite SATA 2nd 2.5'' Hard Drive Caddy for 12.7mm Universal CD/DVD-ROM (for SSD and HDD),Warehouse A,32,23,2025-02-25 08:11:00,9
7892,ORD_7893,14046,Nazofed Plus 5mg/500mg/5mg Tablet,Warehouse A,55,36,2025-02-25 11:06:00,19
7893,ORD_7894,16589,Zithrolect 100mg/5ml Suspension,Warehouse B,38,32,2025-02-25 04:43:00,6
7894,ORD_7895,14092,Dot & Key Pollution + Acne Defense Green Clay Mask 85 gm,Warehouse A,61,51,2025-02-25 20:11:00,10
7895,ORD_7896,29104,"Oppo A55 (Rainbow Blue, 4GB RAM, 128GB Storage) | 5000mAh Battery | 50MP AI Camera | 18W Fast Charging | with No Cost EMI/...",Warehouse B,62,45,2025-02-25 18:56:00,17
7896,ORD_7897,31052,Odpep 20mg/40mg Capsule,Warehouse C,82,66,2025-02-25 04:39:00,16
7897,ORD_7898,31050,Adeone-S Plus Injection,Warehouse B,66,52,2025-02-25 18:21:00,14
7898,ORD_7899,18073,Dyazo 13/13.3 Inch Laptop Sleeve/Case Cover Compatible with All Notebook and Laptops with Handle & 2 Accessory Pockets (Bl...,Warehouse A,46,38,2025-02-25 14:55:00,8
7899,ORD_7900,24470,BXL Cellular Seaweed Hydrating Eye Gel,Warehouse C,72,55,2025-02-25 12:14:00,17
7900,ORD_7901,18059,"Samsung Galaxy A14 5G (Light Green, 4GB, 64GB Storage) | Triple Rear Camera (50 MP Main) | Upto 8 GB RAM with RAM Plus | T...",Warehouse C,56,38,2025-02-25 23:52:00,18
7901,ORD_7902,27844,Bestor Portable LCD Writing Tablet 10 inches Paperless Memo Digital Tablet Pad for Writing/Drawing/Scribble Board/Erasable...,Warehouse A,98,91,2025-02-25 13:51:00,7
7902,ORD_7903,9883,Clinsup V Vaginal Wash,Warehouse B,102,88,2025-02-25 20:00:00,14
7903,ORD_7904,1160,Diclon Forte 500mg/50mg/500mg Tablet,Warehouse B,107,97,2025-02-25 17:31:00,10
7904,ORD_7905,35278,Bploc 50mg Tablet,Warehouse A,111,97,2025-02-25 00:45:00,14
7905,ORD_7906,32303,"Adidas Climacool Male Deodorant, Blue, 150 Ml",Warehouse C,69,63,2025-02-25 23:13:00,6
7906,ORD_7907,35751,"Rimmel London Lasting Finish 25 Hour Foundation Spf 20, Toffee, 15ml",Warehouse C,16,7,2025-02-25 15:03:00,9
7907,ORD_7908,16458,Nervecare Forte Injection,Warehouse A,68,60,2025-02-25 22:39:00,8
7908,ORD_7909,36179,Canomin 100mg Capsule,Warehouse C,12,1,2025-02-25 17:55:00,11
7909,ORD_7910,16028,Trustcef-S 1gm/0.5gm Injection,Warehouse C,22,12,2025-02-25 15:49:00,10
7910,ORD_7911,11011,"AMKETTE PowerPro iPhone Fast Charging Cable, USB to 8-Pin Fast Charging with Up to 480 Mbps Transfer Speed and 1 Year warr...",Warehouse C,68,56,2025-02-25 05:36:00,12
7911,ORD_7912,6642,Nitrocin 50mg Injection,Warehouse C,88,83,2025-02-25 03:02:00,5
7912,ORD_7913,17783,Charmacy Milano Duo Eyebrow Filler & Eyeliner Sketch (Black) 1's,Warehouse C,41,25,2025-02-25 01:22:00,16
7913,ORD_7914,24029,Epra 40mg Injection,Warehouse B,54,35,2025-02-25 00:48:00,19
7914,ORD_7915,27596,Pro Sanitize Hand Sanitizer,Warehouse A,12,6,2025-02-25 16:17:00,6
7915,ORD_7916,13156,Crysendo Ear Muffs Headphone Cushion (55mm / 5.5cm) 6Pcs 5mm Thick Replacement Earpads for Headphone Sponge Cover | High-D...,Warehouse C,20,14,2025-02-25 16:40:00,6
7916,ORD_7917,16027,"The Body Shop Vegan Body Yogurt Strawberry, 200 Ml",Warehouse C,31,24,2025-02-25 11:59:00,7
7917,ORD_7918,24268,AVTY Eyeshadow Applicators AVTY Eyeshadow Brush Sponge Applicator 50pcs Disposable Eyeshadow Brush Eyeshadow Sponge Brush ...,Warehouse C,16,11,2025-02-25 11:25:00,5
7918,ORD_7919,33796,SUNMI Bike Phone Mount Anti Shake and Stable Cradle Clamp with 360° Rotation Bicycle Phone Mount/Bike Accessories/Bike Pho...,Warehouse A,11,4,2025-02-25 12:57:00,7
7919,ORD_7920,31965,Olisur 10mg Tablet,Warehouse B,72,63,2025-02-25 18:23:00,9
7920,ORD_7921,16026,"Roller Comb For Girls - Plastic, Golden, Bb-1196",Warehouse C,65,53,2025-02-25 18:25:00,12
7921,ORD_7922,65,"Smart Watch for men women boys 1.3"" OLED HD Display, Multiple watch Faces, SpO2 Monitoring, Sleep Monitor for Boys, Girls,...",Warehouse C,44,33,2025-02-25 02:02:00,11
7922,ORD_7923,24253,XYKOS Camera Lens Protector [Pack of 3] for iPhone 14/14 Plus [Keep Lens Original Design] [Metal Finish] - (Blue),Warehouse A,104,88,2025-02-25 06:15:00,16
7923,ORD_7924,24009,KLEENEX® Facial Tissue Box 60036-2 ply Flat Box Facial Tissue - 4 Tissue Boxes x 100 Face Tissues - Sheet Size 20 x 20 cm...,Warehouse A,89,71,2025-02-25 18:30:00,18
7924,ORD_7925,10788,"Oakremote WiFi All in One Smart Universal Remote | IR Blaster | for TV, AC, Music System etc. Pre-Installed Library for Al...",Warehouse C,35,18,2025-02-25 21:12:00,17
7925,ORD_7926,36282,"ProElite Smart Trifold Flip Stand Case Cover for Apple iPad 10.2"" 9th Gen (2021) / 8th Gen / 7th Gen, Translucent Back, Da...",Warehouse C,36,30,2025-02-25 03:00:00,6
7926,ORD_7927,6645,Moroccan Argan Oil Ultra Nourishing Body Lotion,Warehouse C,26,19,2025-02-25 13:59:00,7
7927,ORD_7928,1911,Amozo Ultra Hybrid Camera and Drop Protection Back Cover Case for iPhone 13 (Polycarbonate|Back Transparent - Sides Blue),Warehouse A,35,26,2025-02-25 02:18:00,9
7928,ORD_7929,17832,Metasulfin 50mg/1000mg Tablet,Warehouse C,103,89,2025-02-25 03:45:00,14
7929,ORD_7930,32242,Doltan AM 40mg/5mg Tablet,Warehouse C,44,28,2025-02-25 04:41:00,16
7930,ORD_7931,17784,Spigen Rugged Armor Back Cover Case Compatible with Samsung Galaxy S20 FE 5G (TPU | Black),Warehouse C,97,92,2025-02-25 23:45:00,5
7931,ORD_7932,28829,"(Renewed) Xiaomi Mi Smart Band 6, 50% Larger 1.56 inches AMOLED Screen, SpO2 Tracking, Continuous HR, Stress and Sleep Mon...",Warehouse A,20,4,2025-02-25 09:05:00,16
7932,ORD_7933,2762,Peiroks LTG to USB Cable for Fast Charging Compatible for Phone 5/ 5C/ 5S/ 6/ 6S/ 7/8/ X/XR/XS Max/ 11/12/ 13 Series and P...,Warehouse A,60,48,2025-02-25 10:38:00,12
7933,ORD_7934,9631,Beetel B15 Basic Corded Phone (Dark Red),Warehouse A,90,76,2025-02-25 18:49:00,14
7934,ORD_7935,35793,Caceff Tablet,Warehouse B,63,52,2025-02-25 04:12:00,11
7935,ORD_7936,25116,L.A. Colors Lash Build Mascara - Black 7 ml,Warehouse B,98,91,2025-02-25 06:16:00,7
7936,ORD_7937,29096,FRANXIT O 25MG/10MG TABLET,Warehouse B,39,28,2025-02-25 13:28:00,11
7937,ORD_7938,10658,Natural Green Tea Face Scrub,Warehouse C,13,2,2025-02-25 15:29:00,11
7938,ORD_7939,12959,Clonazep 0.5mg Tablet,Warehouse B,96,85,2025-02-25 19:27:00,11
7939,ORD_7940,25448,TheGiftKart Back Cover Soft Case for Samsung Galaxy A14 5G | Best Camera Protection | Inbuilt Dust Plugs & Anti-Slip Grip...,Warehouse C,77,61,2025-02-25 06:58:00,16
7940,ORD_7941,16553,Glucotim 0.5% Eye Drop,Warehouse A,44,38,2025-02-25 02:27:00,6
7941,ORD_7942,14118,Morium 40mg Tablet,Warehouse C,88,70,2025-02-25 08:53:00,18
7942,ORD_7943,23540,AmazonBasics 3A Fast Charging L Shaped Braided USB A to USB Type C Data cable for Smartphone (Black/White -1.2 Meter),Warehouse C,92,74,2025-02-25 18:36:00,18
7943,ORD_7944,860,Reltek Plus 100mg/325mg Tablet,Warehouse C,91,75,2025-02-25 01:28:00,16
7944,ORD_7945,36922,TheGiftKart Shockproof Crystal Clear Back Cover Case for OnePlus 5T | 360 Degree Protection | Protective Design | Transpar...,Warehouse B,66,47,2025-02-25 15:10:00,19
7945,ORD_7946,25454,Mikopan 40mg Tablet,Warehouse B,100,90,2025-02-25 12:00:00,10
7946,ORD_7947,23538,Anti-Lice Treatement Hair Oil,Warehouse B,49,44,2025-02-25 10:35:00,5
7947,ORD_7948,15906,Standlast Extension Board Cord 10 AMP 240V 6-Socket Surge Protector Multi Plug Spike Guard with 1.8 Meter Cord-Grey,Warehouse B,35,17,2025-02-25 17:10:00,18
7948,ORD_7949,9365,Carvaan Saregama Mini Shrimad Bhagavad Gita 50 Watt 2.0 Channel Wireless Bluetooth Outdoor Speaker (Saffron Orange),Warehouse A,15,3,2025-02-25 01:50:00,12
7949,ORD_7950,27304,Solvin-OD Tablet SR,Warehouse A,32,16,2025-02-25 11:26:00,16
7950,ORD_7951,28703,Rexez Tempered Glass Compatible for Vivo V27 Pro 5G Advanced Border-Less Full Edge to Edge UV Screen Protector and Easy In...,Warehouse B,63,51,2025-02-25 02:55:00,12
7951,ORD_7952,5076,Ajmal Aurum Sacred Love Sacred Love Deodorant Spray (Pack of 3) 200 ml,Warehouse A,17,7,2025-02-25 19:38:00,10
7952,ORD_7953,2466,Metsunate 60mg Injection,Warehouse C,69,52,2025-02-25 05:37:00,17
7953,ORD_7954,33686,Agicold Plus Syrup,Warehouse A,52,33,2025-02-25 04:53:00,19
7954,ORD_7955,801,Bonjour Paris Satin Matte Nail Polish - Red 9 ml,Warehouse A,51,34,2025-02-25 23:53:00,17
7955,ORD_7956,800,DeBelle Gel Nail Lacquer Sparkling Dust Glitter Nail Polish 8 ml,Warehouse C,79,68,2025-02-25 18:25:00,11
7956,ORD_7957,22886,Scalp & Hair Medicine Anti-Hairfall Conditioner,Warehouse A,25,9,2025-02-25 04:34:00,16
7957,ORD_7958,17544,"Loofah/Sponge Scrubber/Body Bath  - Hangable, Pink, BH-010 PNK",Warehouse C,17,9,2025-02-25 14:43:00,8
7958,ORD_7959,5429,Biosoft Shea Butter Paraffin Wax 500 S gm,Warehouse A,39,23,2025-02-25 02:34:00,16
7959,ORD_7960,24366,Black Charcoal Peel Off Mask - Ultimate Blackhead Remover,Warehouse C,30,19,2025-02-25 03:39:00,11
7960,ORD_7961,20219,Triphala Churna,Warehouse B,69,59,2025-02-25 10:21:00,10
7961,ORD_7962,3499,Voglus M 500mg/0.2mg Tablet,Warehouse B,115,97,2025-02-25 04:07:00,18
7962,ORD_7963,37096,Glasit 10 Tablet,Warehouse B,27,16,2025-02-25 15:25:00,11
7963,ORD_7964,13209,"WOW IMAGINE Ultra Slim, Soft Rubberised Back Cover for Redmi A1 Matte with Inner Velvet Fabric Lining (Matte Silicone | Blue)",Warehouse A,77,63,2025-02-25 10:54:00,14
7964,ORD_7965,3248,OpenTech® Tempered Glass Screen Protector Compatible for iPhone 14 Pro with Edge to Edge Coverage and Easy Installation kit,Warehouse B,27,9,2025-02-25 09:33:00,18
7965,ORD_7966,1230,"Casio MJ-120D 150 Steps Check and Correct Desktop Calculator with Tax Keys, Black",Warehouse C,90,74,2025-02-25 03:00:00,16
7966,ORD_7967,27610,"Samvardhan 8.5 Inch LCD WritingTablet/Drawing Board/Doodle Board/Writing Pad Reusable Portable E Writer Educational Toys, ...",Warehouse B,94,80,2025-02-25 07:30:00,14
7967,ORD_7968,2726,Hohem iSteady X - 3-Axis 259g Lightweight Smartphone Gimbal Foldable Handheld Pocket Stabilizer Youtuber Vlogger Live Vide...,Warehouse B,115,96,2025-02-25 16:08:00,19
7968,ORD_7969,31077,Spasdic 10mg/250mg Tablet,Warehouse A,74,68,2025-02-25 23:52:00,6
7969,ORD_7970,14052,"FEDUS Cat6 Ethernet Cable, 20 Meter High Speed 550MHZ / 10 Gigabit Speed UTP LAN Cable, Network Cable Internet Cable RJ45 ...",Warehouse A,101,90,2025-02-25 01:51:00,11
7970,ORD_7971,19557,"HR Study PAD Multipurpose Drawing Board – 16”x 24” - 8mm Thick – Single Side use – for Laptop, Keyboard, Students (Design ...",Warehouse B,38,30,2025-02-25 14:46:00,8
7971,ORD_7972,27326,Serie Expert Citramine Pure Resource Shampoo,Warehouse C,18,5,2025-02-25 02:26:00,13
7972,ORD_7973,6767,Cisakem 10mg Tablet,Warehouse A,80,66,2025-02-25 20:10:00,14
7973,ORD_7974,10672,Essential Souls Moisturizer - Honey Touch 100 ml,Warehouse B,26,15,2025-02-25 06:54:00,11
7974,ORD_7975,24478,"Swiss Beauty Brick Highlighter | Highly-pigmented Powder Highlighter +  Bronzer with Easy-to-blend Formula | Shade- 2, 7g | ",Warehouse A,48,32,2025-02-25 12:38:00,16
7975,ORD_7976,25437,Rabas 10mg Tablet,Warehouse C,38,22,2025-02-25 16:59:00,16
7976,ORD_7977,1976,Averzine 10 Tablet,Warehouse A,11,4,2025-02-25 10:51:00,7
7977,ORD_7978,34981,Cefiden Tablet,Warehouse A,95,86,2025-02-25 06:28:00,9
7978,ORD_7979,5466,Oragil-D Capsule,Warehouse B,46,29,2025-02-25 11:16:00,17
7979,ORD_7980,31024,"Lenovo Calling Tab M8 2nd Gen Tablet (8-inch, 2GB, 32GB, Wi-Fi + 4G LTE + Calling), Iron Grey",Warehouse C,78,66,2025-02-25 01:50:00,12
7980,ORD_7981,13274,Kick Cold Syrup,Warehouse C,51,45,2025-02-25 15:06:00,6
7981,ORD_7982,17386,Nicka K NINE COLOR Eyeshadow PALETTE - SUGAR PLUM 11.7 gm,Warehouse C,105,89,2025-02-25 05:29:00,16
7982,ORD_7983,732,TheGiftKart Genuine Liquid Silicone Back Cover Case for Samsung Galaxy S23 5G | Soft Micro-Fibre Lining Inside | Total Cam...,Warehouse A,18,2,2025-02-25 22:01:00,16
7983,ORD_7984,28907,Herbal Green Tea Aloevera Hair Conditioner - SLS & Paraben Free,Warehouse C,64,56,2025-02-25 06:20:00,8
7984,ORD_7985,23502,Zeoceft 250 Injection,Warehouse B,52,35,2025-02-25 10:11:00,17
7985,ORD_7986,27786,Boya BY-M1DM Dual Lavalier Universal Auxiliary Omnicirectional Microphone with a Single 1/8 Stereo Connector for Smartphon...,Warehouse C,8,1,2025-02-25 21:04:00,7
7986,ORD_7987,6986,"OneAssist 1 Year Extended Warranty for Smartwatch 3001 to 5000 - Email Delivery Within 2 Hours, No Physical Kit",Warehouse B,22,6,2025-02-25 04:30:00,16
7987,ORD_7988,32219,Zolive Lotion,Warehouse B,49,32,2025-02-25 23:09:00,17
7988,ORD_7989,29121,Luliworld 1% Cream,Warehouse C,100,83,2025-02-25 23:06:00,17
7989,ORD_7990,4450,Vosafe 0.2mg Tablet,Warehouse B,88,82,2025-02-25 23:39:00,6
7990,ORD_7991,11941,Acronicol 250mg Tablet,Warehouse C,81,74,2025-02-25 14:24:00,7
7991,ORD_7992,6439,HP 678 2-Pack Black Original Ink Advantage Cartridges,Warehouse A,43,25,2025-02-25 23:09:00,18
7992,ORD_7993,33777,Cameriv 15mg Tablet,Warehouse A,59,51,2025-02-25 03:38:00,8
7993,ORD_7994,36956,"Wayona 20W USB C PD/QC Fast Charging Adapter Compatible for iPhone 14, 14 Pro, 14 Pro Max, 14 Plus, 13, 13 Mini, 13 Pro, 1...",Warehouse B,40,32,2025-02-25 20:13:00,8
7994,ORD_7995,759,"FENTICO DisplayPort (DP) to VGA Adapter, Gold-Plated Display Port to VGA Adapter (Male to Female) Compatible with Compute...",Warehouse C,93,87,2025-02-25 14:33:00,6
7995,ORD_7996,28765,Parker Quink Flow Ball Pen Refill (Blue),Warehouse C,104,87,2025-02-25 23:36:00,17
7996,ORD_7997,31212,Eslate Eye Drops,Warehouse C,56,42,2025-02-25 05:10:00,14
7997,ORD_7998,23984,Seagate Barracuda 2 TB Internal Hard Drive HDD – 8.89 cm (3.5 Inch) SATA 6 Gb/s 5400 RPM 256 MB Cache for Computer Desktop...,Warehouse B,106,98,2025-02-25 16:44:00,8
7998,ORD_7999,23978,"ProElite Smart Flip Case Cover for Apple iPad Air 5th/4th 10.9 inch , Translucent Back, Purple",Warehouse B,57,47,2025-02-25 21:20:00,10
7999,ORD_8000,33806,Apple Lightning to 3.5 mm Headphone Jack Adapter,Warehouse B,107,89,2025-02-25 03:43:00,18
8000,ORD_8001,20121,Flagof Tablet,Warehouse A,27,20,2025-02-25 12:19:00,7
8001,ORD_8002,27940,"Storio Toys LCD Writing Tablet Magic Slates for Kids 8.5Inch E-Note Pad, multicolor",Warehouse C,109,98,2025-02-25 18:47:00,11
8002,ORD_8003,2533,"Verilux® USB C Hub, 6 in 1 Aluminum Multiport Adapter with 4K@30Hz HDMI, PD 87W&USB C Data Transfer, USB 3.0/2.0 Port, SD/...",Warehouse C,105,87,2025-02-25 23:49:00,18
8003,ORD_8004,25186,Sery Hi - Cover Super Coverage Concealer - Ginger 5 ml,Warehouse C,14,3,2025-02-25 02:23:00,11
8004,ORD_8005,25188,"Wayona Type C To Type C 65W/3.25A Nylon Braided Fast Charging Cable Compatible For Laptop, Macbook, Samsung Galaxy M33 M53...",Warehouse C,33,16,2025-02-25 08:16:00,17
8005,ORD_8006,29886,Charmacy Milano Soft Satin Matte Lipstick (Fuzzy Wuzzy) 3.8 gm,Warehouse B,16,10,2025-02-25 12:34:00,6
8006,ORD_8007,7304,Makeup Mania Metallic Shine Glitter Eyeliner (Golden & Silver - 01-02),Warehouse A,17,5,2025-02-25 13:08:00,12
8007,ORD_8008,25017,Monoloc 25mg Injection,Warehouse A,82,77,2025-02-25 04:42:00,5
8008,ORD_8009,17890,"Soulflower Brightening Wand with Liquorice, Niacinamide & Ylang Ylang Oil 15 ml",Warehouse C,9,3,2025-02-25 02:30:00,6
8009,ORD_8010,13130,Butmol 250mg/50mg/325mg Tablet,Warehouse C,34,26,2025-02-25 06:27:00,8
8010,ORD_8011,32323,NEWTECHNO Rugged Armor Cover Case Compatible with Airpods Pro 2 (2022) / Airpods Pro gen-2 - Matte Black,Warehouse B,115,98,2025-02-25 14:05:00,17
8011,ORD_8012,3160,Faces Canada Nail Enamel Remover Transparent-01 30 Ml,Warehouse A,95,86,2025-02-25 16:57:00,9
8012,ORD_8013,4043,Amvibast 20mg Tablet,Warehouse B,27,18,2025-02-25 06:48:00,9
8013,ORD_8014,3246,Nalpamaradi Thailam For Skin Care - 100% Natural,Warehouse C,44,29,2025-02-25 18:00:00,15
8014,ORD_8015,13065,TheGiftKart Transparent Crystal Clear Back Cover Case for Samsung Galaxy M31 Prime / F41 / M31 | Shockproof Soft TPU Case...,Warehouse B,67,52,2025-02-25 19:09:00,15
8015,ORD_8016,17969,"Loofah/Sponge Scrubber/Body Bath - With Handle, Cream, BH-018 CRM",Warehouse A,82,71,2025-02-25 10:26:00,11
8016,ORD_8017,9553,Tough Lee Full Screen Coverage Tempered Glass for Samsung Galaxy M53 5G / M51 / F62 / M52 5G With Easy Installation Kit; P...,Warehouse B,57,51,2025-02-25 14:25:00,6
8017,ORD_8018,6574,"HP 14s, AMD Athlon Silver 3050U, 8GB RAM/256GB SSD 14-inch(35.6 cm) HD,Win 11/AMD Radeon Graphics/MSO 2021/1.41 Kg, 14s-fq...",Warehouse B,92,77,2025-02-25 09:12:00,15
8018,ORD_8019,7384,Arispas 10mg/250mg Tablet,Warehouse C,105,89,2025-02-25 13:05:00,16
8019,ORD_8020,32339,Ajmal Carbon Silver Shade Wisal Deodorant Spray (Pack of 3) 200 ml,Warehouse A,109,93,2025-02-25 06:15:00,16
8020,ORD_8021,13248,"Lakmé Perfecting Liquid Foundation, Marble, Waterproof Full Coverage Long Lasting - Light Oil Free Face Makeup With Vitami...",Warehouse B,61,56,2025-02-25 11:32:00,5
8021,ORD_8022,16203,Neurotic 1500mcg Injection,Warehouse A,60,41,2025-02-25 00:24:00,19
8022,ORD_8023,3338,Cymef Spas Syrup,Warehouse C,86,68,2025-02-25 03:14:00,18
8023,ORD_8024,9469,"Schwarzkopf Professional Osis Magic Anti Frizz Shine Serum, 50ml",Warehouse C,100,84,2025-02-25 13:21:00,16
8024,ORD_8025,10979,Xylanta Suspension,Warehouse A,62,48,2025-02-25 18:07:00,14
8025,ORD_8026,19538,MYSIGA Liquid Lipstick Combo Pack Set of 4 Mini Lipsticks Forever Matte Finish Lip Color Lipsticks for Women's & Girl's / ...,Warehouse A,109,94,2025-02-25 23:47:00,15
8026,ORD_8027,28034,COVER CAPITAL Tablet Tempered Glass Screen Guard for Samsung Galaxy Tab A8 [10.5 inch] 2022 Release (SM-X200/ SM-X205/SM-X...,Warehouse B,58,50,2025-02-25 23:33:00,8
8027,ORD_8028,12779,Refreshing Wet Wipes - Rose,Warehouse B,92,80,2025-02-25 06:33:00,12
8028,ORD_8029,9650,"Buds & Berries Detox and Refresh Body Wash with Bulgarian Rose for Soft, Smooth and Clear Skin | No Soap, No Paraben, No P...",Warehouse A,100,91,2025-02-25 13:38:00,9
8029,ORD_8030,12818,Tearlog Eye Drop,Warehouse C,16,11,2025-02-25 06:01:00,5
8030,ORD_8031,17319,Essence Lash Princess Sculpted Volume Mascara 12 ml,Warehouse B,33,26,2025-02-25 21:52:00,7
8031,ORD_8032,11780,The Original Beauty Blender / Color May Vary - Baby Pink,Warehouse A,25,17,2025-02-25 16:10:00,8
8032,ORD_8033,27825,"realme Buds Q2 Bluetooth Truly Wireless in Ear Earbuds with Mic, Fast Charging & Up to 28Hrs Playtime (Grey)",Warehouse A,69,62,2025-02-25 11:52:00,7
8033,ORD_8034,9986,"Dyazo USB Type C 3.1 /3.0 to USB A Female OTG Adapter Compatible with MacBook Pro / Air 2019 2018 2017, Galaxy S20 S20+ Ul...",Warehouse C,56,47,2025-02-25 23:01:00,9
8034,ORD_8035,11135,Calbloc 5mg Capsule,Warehouse C,75,59,2025-02-25 10:08:00,16
8035,ORD_8036,20000,Miss Claire Glimmersticks For Eyes E-14 Pearl White 1.8 Gm,Warehouse B,79,69,2025-02-25 03:55:00,10
8036,ORD_8037,31594,Verclav 1000 mg/200 mg Injection,Warehouse C,97,90,2025-02-25 14:49:00,7
8037,ORD_8038,29584,Emrse AC Remote Control Compatible for Hitachi Window and Split Air Conditioner (AC 59)(Please Match The Image with Your O...,Warehouse A,41,24,2025-02-25 10:58:00,17
8038,ORD_8039,10767,Natural Hair Gel - For Studio Styling,Warehouse C,89,79,2025-02-25 05:53:00,10
8039,ORD_8040,24290,Spigen Optik Armor Back Cover Case for Samsung Galaxy S23 Ultra (Poly Carbonate + TPU | Black),Warehouse C,34,28,2025-02-25 12:32:00,6
8040,ORD_8041,824,"Mivi Collar 2B Bluetooth Wireless in Ear Earphones, 24 Hours Playtime, IPX7 Water Proof, Booming Bass, Magnetic Buds, Blue...",Warehouse A,46,36,2025-02-25 07:53:00,10
8041,ORD_8042,35036,Root Hair Oil,Warehouse C,57,46,2025-02-25 11:16:00,11
8042,ORD_8043,35847,Telmicad 80mg Tablet,Warehouse C,95,84,2025-02-25 12:50:00,11
8043,ORD_8044,19511,Ajmal Silver Shade EDP Citrus Woody Perfume And Sacred Love Deodorant Floral Musky Fragrance 300 ml,Warehouse B,41,24,2025-02-25 13:08:00,17
8044,ORD_8045,9546,Comet Busters Black Square Bindis (2mm) (BIN1207),Warehouse C,117,98,2025-02-25 13:34:00,19
8045,ORD_8046,2767,Dolospark 100mg/325mg Tablet,Warehouse A,23,8,2025-02-25 14:14:00,15
8046,ORD_8047,17461,Anti-Acne Cream - Clove & Neem Extract,Warehouse B,19,5,2025-02-25 18:07:00,14
8047,ORD_8048,27412,Siloxon 500mg Injection,Warehouse B,49,39,2025-02-25 22:48:00,10
8048,ORD_8049,7322,"Cinthol Lime Soap, 100g (Pack of 5) - 99.9% Germ Protection | Lemony Deo Fragrance | Soaps For Bath | Grade 1 Soap | For A...",Warehouse B,87,76,2025-02-25 16:57:00,11
8049,ORD_8050,3354,BESPRO PRO Rack 150 Wireless 15W Usb Type-C Charging Stand With In-Built Two Coils & Fireproof ABS for Qi-Certified phones...,Warehouse C,66,51,2025-02-25 15:03:00,15
8050,ORD_8051,17922,"Eascan Art Painting Drawing and Sketch Accessories Cotton Medium Grain Pre Stretched Round Painting Canvas Pack of 2, Size...",Warehouse C,56,38,2025-02-25 11:12:00,18
8051,ORD_8052,7328,"True Desire Ultra Premium Microfiber Cleaning Cloth for Mobile Screen, Camera Lenses, Tablets, Monitors, Electronics Etc (...",Warehouse C,53,47,2025-02-25 20:31:00,6
8052,ORD_8053,25229,FEMIFORTE Tablets - A Safe & Effective Approach For Leucorrhoea,Warehouse B,9,2,2025-02-25 03:21:00,7
8053,ORD_8054,36851,"Swiss Beauty 12 Ultra Professional Eyeshadow Palette, Eye Makeup, Multicolor, 12G (Shade-04)",Warehouse B,59,53,2025-02-25 16:15:00,6
8054,ORD_8055,837,SeCro USB 3.0 Super Speed Multi Function Card Reader (Black),Warehouse C,57,38,2025-02-25 00:13:00,19
8055,ORD_8056,25099,"Gift Set - Deodorant + Body Wash, Yellow for Women 8",Warehouse A,46,35,2025-02-25 16:03:00,11
8056,ORD_8057,33732,Nicka K TRUE MATTE LIP COLOR WINE BERRY 3.5 gm,Warehouse A,69,62,2025-02-25 22:51:00,7
8057,ORD_8058,24115,"Fashion Colour Kiss Lip No Transfer Lipstick, 92 Deep Jujuce 2.6 gm",Warehouse B,66,60,2025-02-25 20:24:00,6
8058,ORD_8059,1179,Cefrun S 250mg/125mg Injection,Warehouse C,43,24,2025-02-25 16:42:00,19
8059,ORD_8060,13218,Kafixim 200mg Tablet,Warehouse C,40,30,2025-02-25 08:32:00,10
8060,ORD_8061,36166,Forest Essentials Revitalising Kashmiri Walnut Gel Scrub|Revitalising Exfoliation|Unisex Face Scrub| 50 g,Warehouse A,18,4,2025-02-25 23:22:00,14
8061,ORD_8062,13648,Biolage Smoothproof Smoothing Conditioner,Warehouse C,37,19,2025-02-25 05:02:00,18
8062,ORD_8063,27462,Oxashil OZ 200mg/500mg Tablet,Warehouse C,73,67,2025-02-25 00:39:00,6
8063,ORD_8064,24087,DeHMY 58MMx25Mtr(2Inch) Thermal Paper roll (Set of 10 Rolls) (58MMx25Mtr(2Inch)),Warehouse B,51,45,2025-02-25 13:07:00,6
8064,ORD_8065,440,"FEDUS 4 Meter 13 Feet Long Switch Board Extension | Pack 1 Extension Boards with Switch,Extension Board with Long Wire, Ex...",Warehouse A,13,8,2025-02-25 00:09:00,5
8065,ORD_8066,32305,"SanDisk Extreme Pro microSD UHS I Card 64GB for 4K Video on Smartphones,Action Cams,Drones 200MB/s Read, 90MB/s Write",Warehouse B,48,31,2025-02-25 13:14:00,17
8066,ORD_8067,16050,Sounce Sports Adjustable Xiaomi Mi Band 3/ Mi Band 4 Watch Silicone Strap Band Watch Strap (Not Compatible with Mi Band 1/...,Warehouse B,49,37,2025-02-25 02:39:00,12
8067,ORD_8068,31302,"truke Buds S1 Bluetooth Truly Wireless in Ear Earbuds with mic, Environmental Noise Cancellation(ENC) | Up to 72hrs of Pla...",Warehouse B,89,83,2025-02-25 21:22:00,6
8068,ORD_8069,10820,Mamaearth Tea Tree Face Scrub 100 gm,Warehouse B,107,92,2025-02-25 01:46:00,15
8069,ORD_8070,16094,Encovit 800mg Tablet,Warehouse C,68,50,2025-02-25 15:56:00,18
8070,ORD_8071,31981,Sifalex 125mg Dry Syrup,Warehouse B,25,6,2025-02-25 11:48:00,19
8071,ORD_8072,25068,Intense Nourishing Conditioner,Warehouse B,104,89,2025-02-25 16:44:00,15
8072,ORD_8073,27482,Pilot Hi-Techpoint 05-1Blue + 1Black + 1Green,Warehouse C,53,34,2025-02-25 07:38:00,19
8073,ORD_8074,7176,Flowmet OZ 200mg/500mg Tablet,Warehouse C,22,7,2025-02-25 22:39:00,15
8074,ORD_8075,29031,Xenap 250 Tablet,Warehouse B,64,51,2025-02-25 19:26:00,13
8075,ORD_8076,35767,2-In-1 Hairfall Control Shampoo + Conditioner,Warehouse B,83,75,2025-02-25 18:36:00,8
8076,ORD_8077,758,Cello Finegrip Ball Pen | Blue Ball Pens | Jar of 25 Units | Best Ball Pens for Smooth Writing | Ball Point Pen Set  | Pen...,Warehouse A,22,4,2025-02-25 12:55:00,18
8077,ORD_8078,24199,Cypfed Syrup,Warehouse C,82,68,2025-02-25 05:36:00,14
8078,ORD_8079,33473,Nicomin GB 300mg/500mcg Tablet,Warehouse C,98,91,2025-02-25 12:08:00,7
8079,ORD_8080,24202,Lutin 500mg Injection,Warehouse A,79,69,2025-02-25 13:30:00,10
8080,ORD_8081,1169,Flormar Kiss Me More Lip Tattoo 11 Candy 3.8 gm,Warehouse A,100,89,2025-02-25 10:53:00,11
8081,ORD_8082,16063,Divisol Eye Drop,Warehouse A,34,26,2025-02-25 14:53:00,8
8082,ORD_8083,27477,WOW IMAGINE Back Cover for Samsung Galaxy A23 5G | A23 4G Flexible Crystal Clear TPU Ultra Protective Cushioned Edges Mobi...,Warehouse A,69,62,2025-02-25 16:36:00,7
8083,ORD_8084,35077,Panviv 40 Injection,Warehouse A,117,98,2025-02-25 09:05:00,19
8084,ORD_8085,9433,Seclong DS 1000mg Tablet,Warehouse B,20,3,2025-02-25 19:40:00,17
8085,ORD_8086,25100,Stucef 50mg Dry Syrup Pineapple,Warehouse B,39,32,2025-02-25 05:05:00,7
8086,ORD_8087,35770,Triperidol 0.5mg Tablet,Warehouse C,100,90,2025-02-25 19:49:00,10
8087,ORD_8088,35771,Expred 4mg Tablet,Warehouse C,34,15,2025-02-25 07:12:00,19
8088,ORD_8089,24298,Ajmal Khofooq Concentrated Perfume Oil Woody Oudhy Attar And Aura Concentrated Perfume Oil Floral Fruity Attar 28 ml,Warehouse A,76,71,2025-02-25 16:35:00,5
8089,ORD_8090,7087,Osiclav 625 Tablet,Warehouse A,82,65,2025-02-25 05:42:00,17
8090,ORD_8091,13697,Nutriment Chocolate Mask All Skin Type 300 gm,Warehouse B,51,37,2025-02-25 01:06:00,14
8091,ORD_8092,19285,Doms 0.6 Gl Ball Point Pen - Blue Ink (Pack of 80),Warehouse A,30,16,2025-02-25 16:30:00,14
8092,ORD_8093,36197,"Amazon Basics 10000mAH Lithium Polymer 18W Fast Charging Power Bank | Dual Input and Triple Output Ports | Metallic Body, ...",Warehouse A,40,26,2025-02-25 06:16:00,14
8093,ORD_8094,19818,"1 Minute Manicure, Hand Scrub Grape Fruit Seed Oil, Strawberry Extract & Honey 100% Natural",Warehouse C,65,48,2025-02-25 02:58:00,17
8094,ORD_8095,9551,KABEER ART 3 Sizes Water Brush Pen for Watercolor Calligraphy Drawing Tool Marker,Warehouse C,33,18,2025-02-25 22:39:00,15
8095,ORD_8096,16451,Spigen Rugged Armor Back Cover Case for iPhone 11 (TPU | Matte Black),Warehouse C,89,75,2025-02-25 16:49:00,14
8096,ORD_8097,35029,Ocexim 100mg Tablet,Warehouse A,106,90,2025-02-25 19:48:00,16
8097,ORD_8098,7345,XX Revolutionfine micro brow pencil deep brown 0.1 gm,Warehouse B,69,52,2025-02-25 04:17:00,17
8098,ORD_8099,20161,I AM EYECONIC FINE GLITTER ICE SLAY 4 gm,Warehouse C,63,44,2025-02-25 15:55:00,19
8099,ORD_8100,4484,Ateloc 50mg Tablet,Warehouse B,22,8,2025-02-25 15:15:00,14
8100,ORD_8101,9454,"boAt Airdopes 191G True Wireless in Ear Earbuds with ENx Tech Equipped Quad Mics, Beast Mode(Low Latency- 65ms) for Gamin...",Warehouse A,71,52,2025-02-25 08:14:00,19
8101,ORD_8102,29073,Retoz 120 Tablet,Warehouse A,114,95,2025-02-25 13:51:00,19
8102,ORD_8103,9453,"AGARO 3.5mm Audio Cable Nylon Braided 24K Gold Plated Aux Cord Male to Male Stereo Hi-Fi Sound for Headphone, Car, Home St...",Warehouse A,101,87,2025-02-25 07:09:00,14
8103,ORD_8104,11644,"Vivo Y100 5G (Twilight Gold, 8GB RAM, 128GB Storage) with No Cost EMI/Additional Exchange Offers",Warehouse B,39,27,2025-02-25 20:20:00,12
8104,ORD_8105,13195,Overnight Purifying Lotion,Warehouse A,67,52,2025-02-25 20:24:00,15
8105,ORD_8106,37078,Zentrix 1000mg Injection,Warehouse C,52,35,2025-02-25 16:25:00,17
8106,ORD_8107,10741,Amazon Brand - Solimo Back Cover Case for Realme 3 / Realme 3i | Compatible for Realme 3 / Realme 3i Back Cover Case | 360...,Warehouse B,53,36,2025-02-25 22:19:00,17
8107,ORD_8108,19819,Labocof 4mg/4mg/50mg/5mg/450mg Tablet,Warehouse C,36,30,2025-02-25 13:41:00,6
8108,ORD_8109,37017,"DHRUVPRO Universal Battery Charger Li-ion 3.7V 18650/16340/14500/17670/CR123A, Charger",Warehouse B,84,79,2025-02-25 08:24:00,5
8109,ORD_8110,17780,Dicomox 250mg/250mg Capsule,Warehouse B,20,6,2025-02-25 09:46:00,14
8110,ORD_8111,6582,Soulflower Bio-Collagen Gold Peel-Off Mask 100 gm,Warehouse C,34,24,2025-02-25 17:27:00,10
8111,ORD_8112,9448,"Mars Smudge Proof Long Lasting Matte Lip Crayon - LS14-14,3.5g",Warehouse A,10,5,2025-02-25 18:48:00,5
8112,ORD_8113,4475,Zycet LM 5mg/10mg Tablet,Warehouse C,59,45,2025-02-25 06:24:00,14
8113,ORD_8114,28778,Depof Tablet,Warehouse A,24,7,2025-02-25 23:44:00,17
8114,ORD_8115,24303,Safe Handz Hand Wash - Saffron & Blossom With Coconut Milk,Warehouse A,29,18,2025-02-25 07:57:00,11
8115,ORD_8116,24103,Consistent SSD 256GB (CTSSD256S6),Warehouse C,10,2,2025-02-25 05:37:00,8
8116,ORD_8117,5262,Urban Gabru Beard & Mustache Wax with Vitamin E & Hemp Seed Oil - Classic 50 gm,Warehouse A,50,43,2025-02-24 17:22:00,7
8117,ORD_8118,4534,Deodorant - Just Call Me (For Womens),Warehouse B,68,55,2025-02-24 13:23:00,13
8118,ORD_8119,32707,"AmazonBasics Tie-Out Cable/Leash for Dogs up to 57 Kg, 30 Feet",Warehouse C,91,86,2025-02-24 08:23:00,5
8119,ORD_8120,27544,Vaadi Herbals Skin Whitening Set - Luxurious Saffron 555 gm,Warehouse C,60,43,2025-02-24 01:53:00,17
8120,ORD_8121,27520,Blenior Wax Strips Complete Set Normal Hair 41 Pcs 1's,Warehouse C,37,28,2025-02-24 18:00:00,9
8121,ORD_8122,3412,NutriGlow NATURAL'S Advanced Pro Formula Facial kit 60gm,Warehouse A,29,13,2025-02-24 07:05:00,16
8122,ORD_8123,4704,Truly Essential Essential Oil - Citronella 15 ml,Warehouse A,108,93,2025-02-24 17:28:00,15
8123,ORD_8124,5791,Xpep L 75mg/20mg Capsule SR,Warehouse C,54,44,2025-02-24 07:02:00,10
8124,ORD_8125,5795,"Women's Body Oil - Revitalising, Rose Geranium",Warehouse B,106,95,2025-02-24 11:00:00,11
8125,ORD_8126,33269,Novaglipt M 500mg/50mg Tablet,Warehouse B,107,92,2025-02-24 22:12:00,15
8126,ORD_8127,5732,Careclav 625 Tablet,Warehouse B,70,58,2025-02-24 23:45:00,12
8127,ORD_8128,29443,Robustrion [Anti-Scratch] & [Smudge Proof] [Bubble Free] Premium Tempered Glass Screen Protector for Samsung Tab A7 10.4 i...,Warehouse C,95,90,2025-02-24 14:48:00,5
8128,ORD_8129,27525,"Swiss Beauty HD Concealer Pen | Color Corrector for Natural Finish, Creamy Beige, 4ml",Warehouse A,27,19,2025-02-24 11:09:00,8
8129,ORD_8130,4720,"Zebronics 200HB USB 3.0 4 Port hub with Hi Speed Data Transfer, Aluminum + ABS Body, 15cm Cable, Sleek Design and Plug Pla...",Warehouse C,98,83,2025-02-24 23:35:00,15
8130,ORD_8131,5339,"FACES CANADA Weightless Matte Lipstick - Buff Nude 05 (Brown), 4.5g | Highly Pigmented Lip Color | Smooth One Stroke Glide...",Warehouse C,62,47,2025-02-24 16:52:00,15
8131,ORD_8132,30112,Allizone 500mg Injection,Warehouse C,78,65,2025-02-24 01:13:00,13
8132,ORD_8133,25667,Tarindo Scalp Solution,Warehouse A,50,39,2025-02-24 12:08:00,11
8133,ORD_8134,26241,Yoncef 1000mg/500mg Injection,Warehouse C,52,38,2025-02-24 18:10:00,14
8134,ORD_8135,31354,Flormar Silk Matte Liquid Lipstick 018 Sunny Land 4.5 gm,Warehouse C,19,13,2025-02-24 13:25:00,6
8135,ORD_8136,5263,Maryaj Dynamic EDP Spicy Woody Perfume And Ajmal Avid Homme Deodorant Aquatic Woody Fragrance 300 ml,Warehouse C,96,88,2025-02-24 05:05:00,8
8136,ORD_8137,32390,Relace SP 100mg/325mg/15mg Tablet,Warehouse C,37,24,2025-02-24 14:40:00,13
8137,ORD_8138,26812,Cinaloc T 10mg/40mg Tablet,Warehouse B,40,23,2025-02-24 01:20:00,17
8138,ORD_8139,25650,Bonjour Paris Silk Matte Lipstick-Nude Brown 4.2 gm,Warehouse C,74,63,2025-02-24 07:01:00,11
8139,ORD_8140,4903,Ajmal 3 Nightingale & 1 Distraction Deodorant Pack of 4 Deodorant 200 ml,Warehouse C,102,96,2025-02-24 09:36:00,6
8140,ORD_8141,27514,Forkem 250mg Tablet,Warehouse B,43,29,2025-02-24 15:19:00,14
8141,ORD_8142,32642,"XIRON 2 Pack Paperfeel Screen Protector for iPad Pro 11 inches/iPad Air 5th /iPad Air 4th Generation (2022/2020, 10.9 inch...",Warehouse C,65,58,2025-02-24 23:42:00,7
8142,ORD_8143,25746,Ajmal Sacred Love Pour Femme Parfum Deo 200 Ml,Warehouse B,29,13,2025-02-24 15:13:00,16
8143,ORD_8144,32657,Monzer FX 10mg/120mg Tablet,Warehouse C,35,23,2025-02-24 03:43:00,12
8144,ORD_8145,5796,OpenTech® Tempered Glass Screen Protector Compatible for Redmi 11 PRIME 5G with Edge to Edge Coverage and Easy Installatio...,Warehouse A,106,98,2025-02-24 00:35:00,8
8145,ORD_8146,25747,"Pagaria 2 in 1 Bluetooth 5.0 Transmitter Receiver 3.5mm Stereo Audio Adapter with Mic, Easy Slide Switch Mode, Model: KN330",Warehouse A,75,69,2025-02-24 06:29:00,6
8146,ORD_8147,3743,Myglamm Lit Brow Definer Pencil - Shook 1.08 Gm,Warehouse C,32,24,2025-02-24 09:13:00,8
8147,ORD_8148,32507,L.A Girl Pro Conceal - Iridescent 8 gm,Warehouse B,102,91,2025-02-24 19:37:00,11
8148,ORD_8149,32505,"Card Reader 3-in-1 USB 3.0 USB C Micro USB Card Reader SD, Micro SD, SDXC, SDHC, Micro SDHC, Micro SDXC Memory Card Reader...",Warehouse B,78,73,2025-02-24 08:51:00,5
8149,ORD_8150,25705,Fruit Fever Woman Deodorant,Warehouse B,29,23,2025-02-24 17:17:00,6
8150,ORD_8151,29456,"Syvo S-510 PRO 55-Inch (140CM) Aluminium Tripod, Universal Lightweight Tripod with Carry Bag for All Smart Phones, Gopro, ...",Warehouse A,21,8,2025-02-24 23:04:00,13
8151,ORD_8152,31682,House of Aroma Stress Soother Fragrance Oil 100 ml,Warehouse A,103,95,2025-02-24 06:10:00,8
8152,ORD_8153,31723,"AmazonBasics 24W Phone Charger for Cellular Phones | Fast Charging, Dual Output | Type C and A Adapter (Black)",Warehouse B,81,70,2025-02-24 05:47:00,11
8153,ORD_8154,30473,Pacinova M Oral Suspension,Warehouse C,94,89,2025-02-24 16:04:00,5
8154,ORD_8155,26688,Tongue Cleaner,Warehouse B,71,58,2025-02-24 22:22:00,13
8155,ORD_8156,5790,Nids 100mg Tablet,Warehouse B,80,69,2025-02-24 16:20:00,11
8156,ORD_8157,32970,Mamaearth Nourishing Hair Oil For Babies 100 ml,Warehouse C,59,42,2025-02-24 14:05:00,17
8157,ORD_8158,28879,Mcaffeine Ultimate Dandruff Care Kit 500 gm,Warehouse C,88,72,2025-02-24 06:42:00,16
8158,ORD_8159,28169,Ultrathin Sensitive Toothbrush - Green,Warehouse A,48,35,2025-02-24 08:58:00,13
8159,ORD_8160,28170,Ecin 100mg Injection,Warehouse C,109,94,2025-02-24 01:05:00,15
8160,ORD_8161,6189,Terbikaa 1% Cream,Warehouse B,20,7,2025-02-24 10:14:00,13
8161,ORD_8162,31007,"Honor Magic Watch 2 (46mm, Charcoal Black) 14-Days Battery, SpO2, BT Calling & Music Playback, 100 Workout Modes, AMOLED T...",Warehouse B,71,65,2025-02-24 15:16:00,6
8162,ORD_8163,25938,"TANTRA Mobile Holder for Scooty - Scooty Accessories, Activa Mobile Holder for Scooter, Compatible with All Scooters, Wate...",Warehouse C,75,60,2025-02-24 20:54:00,15
8163,ORD_8164,28173,Gliss Hair Repair Million Gloss Oil Replacement,Warehouse A,14,2,2025-02-24 12:02:00,12
8164,ORD_8165,28176,WOTOFY Stainless Steel Convenient Seed Remover Pineapple Eye Peeler (1 Piece),Warehouse B,96,91,2025-02-24 16:49:00,5
8165,ORD_8166,26306,Chopard Imperiale Iris Malika Eau de Parfum 100ml,Warehouse B,70,54,2025-02-24 14:50:00,16
8166,ORD_8167,27772,"ZEBRONICS Zeb-Warrior II 10 watts 2.0 Multimedia Speaker with RGB Lights, USB Powered, AUX Input, Volume Control Pod for P...",Warehouse A,88,83,2025-02-24 04:32:00,5
8167,ORD_8168,28878,Aacef 1000mg Injection,Warehouse A,56,40,2025-02-24 10:11:00,16
8168,ORD_8169,27769,Scorcid O 1000mg/20mg Syrup,Warehouse B,22,9,2025-02-24 12:58:00,13
8169,ORD_8170,5998,Morning Energy Lemon Fresh Face Wash,Warehouse B,48,41,2025-02-24 15:26:00,7
8170,ORD_8171,26684,Naxim MF 500mg/250mg Tablet,Warehouse C,16,1,2025-02-24 12:41:00,15
8171,ORD_8172,26299,Histapro 20mg Tablet,Warehouse A,32,14,2025-02-24 08:45:00,18
8172,ORD_8173,28200,"AmazonBasics Spike Guard with 4 Universal Sockets, 6A, 1.5m ISI Certified cable, Master Switch",Warehouse A,33,17,2025-02-24 17:40:00,16
8173,ORD_8174,25951,Pantoze-LS Capsule SR,Warehouse B,102,88,2025-02-24 00:26:00,14
8174,ORD_8175,25647,Zevid 400mg Tablet,Warehouse B,94,83,2025-02-24 15:54:00,11
8175,ORD_8176,3792,"SupCares Edge to Edge Tempered Glass for Samsung Galaxy M04, Galaxy A04S, Galaxy A04, Galaxy A04E and Galaxy A04 Core (6.5...",Warehouse C,112,94,2025-02-24 10:30:00,18
8176,ORD_8177,33389,Walnut Scrub 80 Gm,Warehouse B,100,93,2025-02-24 08:16:00,7
8177,ORD_8178,27507,TheGiftKart Smoke Back Cover Case for Redmi Note 11 / Note 11s | Translucent Smoked Matte Back | 360 Degree Protection | P...,Warehouse C,73,63,2025-02-24 12:52:00,10
8178,ORD_8179,31341,(Renewed) boAt Rockerz 510 Bluetooth Wireless On Ear Headphones with Mic (Green),Warehouse A,67,58,2025-02-24 21:01:00,9
8179,ORD_8180,5053,Tryblue 0.8mg Injection,Warehouse A,76,60,2025-02-24 15:44:00,16
8180,ORD_8181,28011,Ajmal Aura Concentrated Perfume Oil Floral Fruity Attar And Mukhallat Raaqi Concentrated Perfume Oil Floral Fruity Attar 20 ml,Warehouse C,82,77,2025-02-24 10:00:00,5
8181,ORD_8182,29520,EARTHMA Universal Remote Control For Samsung 3D Smart LCD LED Tv - Replacement,Warehouse B,72,61,2025-02-24 23:57:00,11
8182,ORD_8183,26364,"TP-Link TL-MR100 300Mbps 2.4GHz Wireless N 4G LTE, Wi-Fi N300, Plug and Play, Parental Controls, Guest Network, with Micro...",Warehouse A,79,62,2025-02-24 13:57:00,17
8183,ORD_8184,33487,Serramet N 100mg/10mg Tablet,Warehouse C,55,44,2025-02-24 21:27:00,11
8184,ORD_8185,28130,Salee CT Lotion,Warehouse B,34,17,2025-02-24 06:08:00,17
8185,ORD_8186,33021,Lavender Surprise Bathing Set,Warehouse A,32,15,2025-02-24 06:33:00,17
8186,ORD_8187,28131,Nitroday 2.5mg Capsule CR,Warehouse A,76,68,2025-02-24 04:33:00,8
8187,ORD_8188,4631,Flormar Pearly Nail Enamel PL386 Golden Beauty 11 ml,Warehouse A,15,6,2025-02-24 13:16:00,9
8188,ORD_8189,29746,Belora Paris Paint & Pout- Lip & Cheek - Macaw Mauve 3 ml,Warehouse B,26,11,2025-02-24 06:27:00,15
8189,ORD_8190,29515,Sony MDR-EX155AP in-Ear Wired Headphones with Mic (Black),Warehouse A,21,7,2025-02-24 00:42:00,14
8190,ORD_8191,31583,Jovees Thyme & Tea Tree Anti Dandruff Shampoo 300 ml,Warehouse C,104,85,2025-02-24 07:43:00,19
8191,ORD_8192,2569,Zotinea 200 Capsule,Warehouse A,20,2,2025-02-24 15:55:00,18
8192,ORD_8193,27987,Clomisur 100mg Tablet,Warehouse C,37,23,2025-02-24 04:58:00,14
8193,ORD_8194,26499,Revlon So Fierce - Chrome Ink Liquid Liner - Bronzage 0.9 gm,Warehouse C,23,14,2025-02-24 21:09:00,9
8194,ORD_8195,31043,TheGiftKart Tough Armor Bumper Back Case Cover for Mi Redmi Note 12 Pro Plus 5G | Ring Holder & Kickstand in-Built | 360 D...,Warehouse C,73,65,2025-02-24 19:33:00,8
8195,ORD_8196,29757,Lacasa 200mg Tablet,Warehouse A,104,88,2025-02-24 09:41:00,16
8196,ORD_8197,28706,Gear Vintage2 28L Faux Leather Water Resistant Anti Theft Laptop Bag/Backpack for Men/Women-Brown,Warehouse A,98,88,2025-02-24 03:14:00,10
8197,ORD_8198,27983,Apsara Writing kit,Warehouse B,13,6,2025-02-24 00:30:00,7
8198,ORD_8199,33016,Amazon Brand - Solimo Back Cover for OnePlus Nord (Silicone | Transparent),Warehouse C,59,42,2025-02-24 04:16:00,17
8199,ORD_8200,2095,Faber-Castell Tempera Paint Set - Pack of 12 (Assorted),Warehouse A,27,14,2025-02-24 19:58:00,13
8200,ORD_8201,28125,Pregazen M 750mcg/75mg Capsule,Warehouse A,19,11,2025-02-24 07:31:00,8
8201,ORD_8202,28119,Bodinex M Ointment,Warehouse A,32,15,2025-02-24 02:55:00,17
8202,ORD_8203,5176,Lenocarb S 1000mg Suspension,Warehouse A,82,77,2025-02-24 15:43:00,5
8203,ORD_8204,3463,"Fashion Colour Proffessional Makeup Kit, Fc2821a - 01 209.3 gm",Warehouse C,69,53,2025-02-24 22:32:00,16
8204,ORD_8205,4233,Global Desi Cosmic Charm Eau De Parfum 50ML & Star Gazer Body Mist 200ML Pack of 2 for Women Crafted by Ajmal,Warehouse A,69,59,2025-02-24 16:28:00,10
8205,ORD_8206,30440,Lemon Hand Wash,Warehouse B,66,51,2025-02-24 06:36:00,15
8206,ORD_8207,6696,"Lakme Sun Expert SPF 24 PA++ Ultra Matte Lotion Sunscreen, Blocks Up to 97% Harmful Sun rays, 100 ml",Warehouse B,39,30,2025-02-24 19:48:00,9
8207,ORD_8208,33477,"Oppo Enco M32 with Mic, 10 Mins Charge 20 Hrs Playtime, 28H Battery Life, Bluetooth 5.0 in Ear Wireless Earphone, Noise Ca...",Warehouse A,64,46,2025-02-24 06:23:00,18
8208,ORD_8209,29882,"I KALL IK44 2.1 Home Theater with Bluetooth, Aux, USB and FM Connectivity (2.1, Black)",Warehouse A,96,86,2025-02-24 05:22:00,10
8209,ORD_8210,26247,Cefitox-O Tablet,Warehouse B,97,84,2025-02-24 12:08:00,13
8210,ORD_8211,5325,Flavomark Tablet,Warehouse B,85,75,2025-02-24 14:44:00,10
8211,ORD_8212,26786,XL OF 200mg/200mg Tablet,Warehouse B,81,67,2025-02-24 23:05:00,14
8212,ORD_8213,3466,"HARRODS Empty Plastic Bottle for Sanitizer, Handwash, Lotion, Oil, Liquid, Dispenser - (Set of 5) 300ml Each",Warehouse B,40,27,2025-02-24 18:16:00,13
8213,ORD_8214,31089,Tough Lee Tempered Glass Screen Guard Protector for Samsung Galaxy M32 (Only 4G) / M32 Prime Edition / F22 / A32 (Only 4G)...,Warehouse B,35,20,2025-02-24 09:03:00,15
8214,ORD_8215,28252,Saregama Carvaan Mini Hindi 2.0 - Bluetooth Speaker (Terracotta Brown),Warehouse A,66,59,2025-02-24 22:47:00,7
8215,ORD_8216,5290,Zanoflox OZ 50mg/125mg Suspension,Warehouse A,116,97,2025-02-24 17:39:00,19
8216,ORD_8217,24928,ALVRIO Eyeshadow Palette 60 Colors Mattes And Shimmers High Pigmented Color Board Palette Long Lasting Makeup Palette With...,Warehouse A,38,30,2025-02-24 04:33:00,8
8217,ORD_8218,28253,Zytil 250mg Tablet,Warehouse A,29,20,2025-02-24 06:43:00,9
8218,ORD_8219,27594,BBlunt Anti-Dandruff Scalp Hair Tonic-50 ml,Warehouse A,35,18,2025-02-24 13:15:00,17
8219,ORD_8220,6545,Beauty People Liquid Illuminator 01 Bronze Bell 25 ml,Warehouse B,43,25,2025-02-24 16:01:00,18
8220,ORD_8221,25685,"Ceptics USA to India Converter Plug, World (USA, UK, China & More) UK to India Adapter Plug - Type D Adapter - Canada to I...",Warehouse B,91,76,2025-02-24 01:56:00,15
8221,ORD_8222,32269,Etobur 90mg Tablet,Warehouse C,80,69,2025-02-24 17:44:00,11
8222,ORD_8223,26258,Pzole 40mg Tablet,Warehouse A,84,78,2025-02-24 16:05:00,6
8223,ORD_8224,4926,Zyser D 50mg/10mg Tablet,Warehouse A,83,74,2025-02-24 01:16:00,9
8224,ORD_8225,3193,"Fire-Boltt Ninja Calling 1.69"" Bluetooth Calling Smart Watch, Dial Pad, Speaker, AI Voice Assistant with 450 NITS Peak Bri...",Warehouse B,56,51,2025-02-24 00:14:00,5
8225,ORD_8226,2739,Recef XP 500mg/500mg Injection,Warehouse A,26,19,2025-02-24 11:02:00,7
8226,ORD_8227,29668,Aranac P 100mg/325mg Tablet,Warehouse A,14,2,2025-02-24 09:33:00,12
8227,ORD_8228,2910,"XP-Pen Deco01 V2 Digital Graphics Drawing Pen Tablet (10"" x 6.25"", 8192 Levels of Pressure Sensitivity, Battery-Free Passi...",Warehouse C,19,11,2025-02-24 20:38:00,8
8228,ORD_8229,29568,Vometon 8mg Tablet MD,Warehouse A,85,70,2025-02-24 13:55:00,15
8229,ORD_8230,31443,Consistent S6 SSD 512GB (CTSSD512S6),Warehouse B,39,29,2025-02-24 13:41:00,10
8230,ORD_8231,25266,Toothbrush - Complete Expert,Warehouse C,78,67,2025-02-24 12:51:00,11
8231,ORD_8232,6325,TheGiftKart Back Cover with Ring Holder and in- Built Kickstand for OnePlus Nord (2020) (Poly Carbonate|Black),Warehouse B,110,96,2025-02-24 23:27:00,14
8232,ORD_8233,23813,TheGiftKart Dual-Color Leather Finish Samsung Galaxy M31 / F41 / M31 Prime Flip Back Cover | Inbuilt Stand & Pockets | Wal...,Warehouse A,22,17,2025-02-24 04:57:00,5
8233,ORD_8234,23276,"Ceptics Adapter to UK, India to UAE, Hong Kong, Dubai, UK Adapter Plug - UK Travel Adapter - Type G Adapter - Perfect for ...",Warehouse C,93,84,2025-02-24 14:29:00,9
8234,ORD_8235,15564,Cefsul 250 mg/125 mg Injection,Warehouse B,69,60,2025-02-24 23:16:00,9
8235,ORD_8236,87,Gxten M 500mg/20mg Tablet,Warehouse A,57,44,2025-02-24 15:56:00,13
8236,ORD_8237,34413,ICONIC LONDON Illuminator (13.5ml) 2.0 Original,Warehouse A,21,14,2025-02-24 02:40:00,7
8237,ORD_8238,14984,Tough Lee Tablet Tempered Glass Screen Guard for Samsung Galaxy Tab S6 Lite 10.4 inch 2020 (SM-P610 / P615) (S Pen Compati...,Warehouse A,80,64,2025-02-24 04:08:00,16
8238,ORD_8239,15974,Canon Pixma MG2577s All-in-One Inkjet Colour Printer (Blue/White),Warehouse A,26,8,2025-02-24 18:51:00,18
8239,ORD_8240,8128,Spigen Ultra Hybrid Back Cover Case for iPhone 12 Pro Max (TPU + Poly Carbonate | Navy Blue),Warehouse B,100,90,2025-02-24 17:43:00,10
8240,ORD_8241,22539,"ProElite Tempered Glass Screen Protector for Apple iPad Air 5th/4th Gen 10.9"" & iPad Pro 11"" 2022/2021/2020 with Auto Alig...",Warehouse A,91,73,2025-02-24 10:11:00,18
8241,ORD_8242,23843,Spigen Ultra Hybrid Back Cover Case Compatible for Google Pixel 7 Pro (TPU + Polycarbonate | Crystal Clear),Warehouse B,23,17,2025-02-24 19:57:00,6
8242,ORD_8243,13076,Ecokast L Tablet,Warehouse C,47,32,2025-02-24 16:53:00,15
8243,ORD_8244,19293,Omevon 20mg Capsule,Warehouse B,69,57,2025-02-24 22:09:00,12
8244,ORD_8245,8125,mobimint 7 Feet Long Tripod Stand for Self Video Shoot|DSLR Camera|You-tubers|Video Shooting Studio Etc.Compatible with Al...,Warehouse C,65,51,2025-02-24 06:11:00,14
8245,ORD_8246,10726,"Adjustable Aluminium Alloy Tripod Stand Holder for Mobile Phones & Camera, 360 mm -1050 mm, 1/4 inch Screw + Mobile Holder...",Warehouse B,66,61,2025-02-24 10:06:00,5
8246,ORD_8247,35519,Hair Nutrient With Egg Oil For Hair Health,Warehouse C,101,94,2025-02-24 03:12:00,7
8247,ORD_8248,10465,"Recode Turning Heads Crayon Gel Eyeliner Pencil cum Kajal Pencil comes with Smudger on other side, longlasting, Water-proo...",Warehouse C,51,38,2025-02-24 00:24:00,13
8248,ORD_8249,11697,Cacef CV Dry Syrup,Warehouse A,80,73,2025-02-24 22:04:00,7
8249,ORD_8250,20939,"DigioCraft Proshot V2 Teleprompter for iPhone, Ipad, Smartphone, DSRL Camera with Remote Control | Software & Pro Video Re...",Warehouse B,37,18,2025-02-24 13:38:00,19
8250,ORD_8251,23291,Duralone 4mg Tablet,Warehouse B,105,90,2025-02-24 15:18:00,15
8251,ORD_8252,23290,Storvas Amf 5mg/10mg Tablet,Warehouse B,97,89,2025-02-24 19:30:00,8
8252,ORD_8253,8418,TP-Link UE200 USB 2.0 to 100 Mbps Ethernet Network Adapter - Plug and Play,Warehouse C,65,54,2025-02-24 16:49:00,11
8253,ORD_8254,1857,Cutihyde XL Cream,Warehouse C,24,8,2025-02-24 21:35:00,16
8254,ORD_8255,19280,Lakme Color Crush Nailart M16 Mint Blue 6 Ml,Warehouse C,98,82,2025-02-24 20:25:00,16
8255,ORD_8256,14451,Clotridep Cream,Warehouse C,70,58,2025-02-24 05:00:00,12
8256,ORD_8257,10325,Domprazole 10mg/20mg Capsule,Warehouse C,39,26,2025-02-24 11:11:00,13
8257,ORD_8258,20948,OpenTech® Tempered Glass Screen Protector Compatible for Samsung Galaxy M53 5G with Edge to Edge Coverage and Easy Install...,Warehouse B,15,1,2025-02-24 09:24:00,14
8258,ORD_8259,20198,DAUGHTER EARTH Eternal Youth Phytonutrient Moisturiser (35 ml),Warehouse A,30,17,2025-02-24 14:19:00,13
8259,ORD_8260,7404,Omzin D 10mg/20mg Capsule,Warehouse A,48,39,2025-02-24 06:41:00,9
8260,ORD_8261,18191,Ayurvedic Methi Powder,Warehouse B,37,23,2025-02-24 10:08:00,14
8261,ORD_8262,16256,"Elitty Long Lasting Liquid Pop Eyeliner, Smudge Proof, Waterproof, Vegan & Cruelty Free - 4ml Metallic Finish Cloud Nine W...",Warehouse B,94,81,2025-02-24 16:49:00,13
8262,ORD_8263,31208,Panzec D 30mg/40mg Capsule PR,Warehouse A,86,68,2025-02-24 17:34:00,18
8263,ORD_8264,10308,Nutrasil Oral Suspension,Warehouse A,51,42,2025-02-24 07:21:00,9
8264,ORD_8265,21032,"CASON Micro USB to 3.5 mm Pin Jack Camera CN10, CS6 Supports 3.5 mm pin TRS Convert Adapter, External mic for Moto vloggin...",Warehouse C,100,91,2025-02-24 08:30:00,9
8265,ORD_8266,11633,AmazonBasics Lightweight Mini Tripod | Maximum Height 19 cm | Maximum Load Up to 500 gm | For Mobiles and Compact Cameras...,Warehouse B,101,90,2025-02-24 14:24:00,11
8266,ORD_8267,35492,House of Aroma Opium Fragrance Oil 10 ml,Warehouse A,78,67,2025-02-24 07:18:00,11
8267,ORD_8268,11853,Cregesic P 37.5mg/325mg Tablet,Warehouse B,13,3,2025-02-24 20:55:00,10
8268,ORD_8269,14656,Streetwear Nail Enamel - Gold Is Gold 8 Ml,Warehouse B,26,21,2025-02-24 02:07:00,5
8269,ORD_8270,33801,SKYFUN (LABEL) Fabric Waterproof Foldable Makeup Cosmetic Cube Wash Toiletry Storage Purpose Pouch Travelling Bag Kit With...,Warehouse C,44,35,2025-02-24 03:51:00,9
8270,ORD_8271,11314,Dompil 20mg Tablet,Warehouse B,62,44,2025-02-24 23:23:00,18
8271,ORD_8272,18675,U Rom 500mg Tablet,Warehouse A,91,75,2025-02-24 04:14:00,16
8272,ORD_8273,13149,"Uniball Air Micro Pen, Set of 4 - Black (UBA 188 M)",Warehouse A,11,4,2025-02-24 15:45:00,7
8273,ORD_8274,34234,Open 400mg Tablet,Warehouse B,90,77,2025-02-24 22:28:00,13
8274,ORD_8275,7751,"Dabur Maha Bhringraj Hair Oil, 200 ml (Pack of 2)",Warehouse C,65,60,2025-02-24 10:37:00,5
8275,ORD_8276,21014,Pantave 40mg Tablet,Warehouse A,70,54,2025-02-24 20:21:00,16
8276,ORD_8277,21864,Doms Neon Rubber Tipped HB/2 Graphite Pencils Box Pack | Non-Toxic | Free Sharpner Inside The Box | Easy & Smooth Sharpeni...,Warehouse B,67,53,2025-02-24 00:57:00,14
8277,ORD_8278,7752,"ESR HaloLock Magnetic Car Phone Mount, Compatible for MagSafe Car Mount, Compatible for iPhone 14/14 Plus/14 Pro/14 Pro Ma...",Warehouse C,37,24,2025-02-24 18:02:00,13
8278,ORD_8279,10634,Glimmer Nail Polish Red Dress 5 ml,Warehouse C,41,36,2025-02-24 06:20:00,5
8279,ORD_8280,439,Allure Classic Makeup Brush (Set of 05) (Face Brushes ACKF1-05) 1's,Warehouse C,105,96,2025-02-24 04:44:00,9
8280,ORD_8281,34460,Flawless Papaya Face Pack,Warehouse B,103,93,2025-02-24 18:55:00,10
8281,ORD_8282,17865,Ajmal Blu & Sacrifice II Him Deo & Neea EDP Pack of 3 20 ml,Warehouse A,17,12,2025-02-24 17:23:00,5
8282,ORD_8283,11410,Portronics Konnect L POR-1403 Fast Charging 3A Type-C Cable 1.2 Meter with Charge & Sync Function for All Type-C Devices (...,Warehouse A,88,80,2025-02-24 08:44:00,8
8283,ORD_8284,17859,Superdrug Essential Facial Cleansing Wipes X25 (For Normal Skin Care) 1's,Warehouse C,104,88,2025-02-24 17:59:00,16
8284,ORD_8285,12823,Gemblue Biocare Vitamin C Face Mask 500 ml,Warehouse A,39,27,2025-02-24 02:37:00,12
8285,ORD_8286,22615,Olay Total Effects Day Cream 50G + Olay Total Effects Night Cream 50G  Slay All Day Pack,Warehouse C,86,71,2025-02-24 09:04:00,15
8286,ORD_8287,14652,Abezin-Plus Tablet,Warehouse C,87,71,2025-02-24 10:58:00,16
8287,ORD_8288,17919,"Xiaomi Wired in-Ear Earphones with Mic, Ultra Deep Bass & Metal Sound Chamber (Blue)",Warehouse B,47,39,2025-02-24 15:14:00,8
8288,ORD_8289,19195,Malarbin 250mg Tablet,Warehouse B,110,96,2025-02-24 08:17:00,14
8289,ORD_8290,16445,Maybelline Lip Crayon Enjoy The View (Matte),Warehouse B,103,87,2025-02-24 14:24:00,16
8290,ORD_8291,20189,boAt BassHeads 900 On-Ear Wired Headphones with Mic (White),Warehouse A,80,63,2025-02-24 17:28:00,17
8291,ORD_8292,11908,"pTron Bassbuds Tango ENC (Environmental Noise Cancellation), Dedicated Movie Mode, 40Hrs Total Playtime, Bluetooth 5.1 Wir...",Warehouse A,112,94,2025-02-24 20:23:00,18
8292,ORD_8293,13919,Bdroxil 500mg Tablet,Warehouse C,50,39,2025-02-24 15:45:00,11
8293,ORD_8294,33860,"Fashion Colour Proffessional Makeup Kit, Fc516a 16.8 gm",Warehouse C,46,37,2025-02-24 05:52:00,9
8294,ORD_8295,9133,Zalome D 10mg/20mg Capsule,Warehouse B,37,20,2025-02-24 17:07:00,17
8295,ORD_8296,10311,Amoclave 500mg/125mg Tablet,Warehouse C,63,53,2025-02-24 19:02:00,10
8296,ORD_8297,9912,"Noctua NT-H1 3.5g, Pro-Grade Thermal Compound Paste.",Warehouse C,35,23,2025-02-24 00:21:00,12
8297,ORD_8298,20176,Blu Dreams EDP Fougere Perfume For Men,Warehouse B,116,98,2025-02-24 05:28:00,18
8298,ORD_8299,1571,Spigen Ultra Hybrid 2 Cover Case for Apple Watch 8/7 (45mm) [Version 2] - Space Crystal (Watch not Included),Warehouse B,94,78,2025-02-24 18:03:00,16
8299,ORD_8300,9451,Toothbrush - Germi Check Flexi (Action Medium),Warehouse B,59,48,2025-02-24 17:09:00,11
8300,ORD_8301,21955,"Ambrane 20000mAh Compact Power Bank, 22.5W Fast Charging, Metallic Body, Triple Output, Type C PD (Input & Output), Li-Pol...",Warehouse B,113,99,2025-02-24 18:04:00,14
8301,ORD_8302,21961,"Mask - Ear Loop Model, BIS Certified, FFP2 S",Warehouse C,100,92,2025-02-24 21:05:00,8
8302,ORD_8303,149,"Amazon Basics Magic Slate 15-inch LCD Writing Tablet with Stylus Pen, for Drawing, Playing, Noting by Kids & Adults, Black",Warehouse B,105,87,2025-02-24 00:14:00,18
8303,ORD_8304,13100,Deborah Milano Extra Precisione Eyeliner - Brown 5 ml,Warehouse B,21,14,2025-02-24 09:48:00,7
8304,ORD_8305,609,DeBelle Gel Nail Lacquer Lemon Tart Lemon Yellow Nail Polish 8 ml,Warehouse B,66,49,2025-02-24 23:52:00,17
8305,ORD_8306,20444,Faces Canada Prime Perfect Foundation Beige 03 30 Ml,Warehouse C,107,94,2025-02-24 15:18:00,13
8306,ORD_8307,15985,Trinetra USB-C Adapter Charger 18W 20W 3D Cartoon Designs Lightning Cable Protector (Brown Mikki) (Cable & chager not Incl...,Warehouse B,109,96,2025-02-24 11:37:00,13
8307,ORD_8308,36343,Snuflox OZ 200mg/500mg Tablet,Warehouse C,13,8,2025-02-24 12:55:00,5
8308,ORD_8309,722,Trum 50mg Injection,Warehouse B,83,67,2025-02-24 14:55:00,16
8309,ORD_8310,10089,"Richfeel Brahmi Jaborandi Hair Oil, 500ml",Warehouse B,17,7,2025-02-24 02:14:00,10
8310,ORD_8311,31473,Fragrance Body Spray - Radiate,Warehouse C,65,56,2025-02-24 22:28:00,9
8311,ORD_8312,3748,"Nokia G21 Android Smartphone, Dual SIM, 3-Day Battery Life, 6GB RAM + 128GB Storage, 50MP Triple AI Camera | Dusk",Warehouse A,22,13,2025-02-24 08:03:00,9
8312,ORD_8313,2363,Revlon ColorStay Look Book Eye Shadow Palette - Dreamer 3.4 gm,Warehouse C,25,20,2025-02-24 06:30:00,5
8313,ORD_8314,2230,KLAM LCD Writing Tablet Screenwriting Toys Board Smart Digital E-Note Pad 8.5 Inch Light Weight Magic Slate for Drawing Pl...,Warehouse C,109,92,2025-02-24 13:35:00,17
8314,ORD_8315,30463,Daily Life Forever52 Star Dust Eyeshadow Glitter Sd013 2.5 gm,Warehouse C,85,68,2025-02-24 18:10:00,17
8315,ORD_8316,26709,Redihope 5mg/12.5mg Tablet,Warehouse C,91,79,2025-02-24 03:44:00,12
8316,ORD_8317,29836,"Oppo Enco M32 Bluetooth Wireless in Ear Earbuds with Mic,10 Mins Charge - 20Hrs Music Fast Charge, 28Hrs Battery Life,10mm...",Warehouse A,61,53,2025-02-24 12:43:00,8
8317,ORD_8318,31509,"Sounce Watch Case for Smartwatches Compatible with Fire-Boltt Dazzle Tempered Glass Screen Protector, HD Clear Touch Sensi...",Warehouse A,98,89,2025-02-24 11:54:00,9
8318,ORD_8319,3920,Bonjour Paris Coat Me Satin Matte Nail Polish - Blue Mood 9 ml,Warehouse B,50,43,2025-02-24 03:29:00,7
8319,ORD_8320,6318,Wildcraft Turnaround Polyester 35 Ltrs Blue Laptop Bag (8903338054702),Warehouse A,72,54,2025-02-24 10:06:00,18
8320,ORD_8321,31510,Hand Wash Lemongrass & Lavender - Anti Bacterial,Warehouse C,109,93,2025-02-24 04:18:00,16
8321,ORD_8322,28915,NT Biocef OF 200mg/200mg Tablet,Warehouse C,82,75,2025-02-24 06:41:00,7
8322,ORD_8323,32954,Rossmet G 1mg/500mg Tablet SR,Warehouse B,36,26,2025-02-24 19:27:00,10
8323,ORD_8324,25962,Spas N 20mg/100mg Tablet,Warehouse A,56,40,2025-02-24 04:35:00,16
8324,ORD_8325,8988,Lakme 9 To 5 Weightless Mousse Lip & Cheek Color Tangerine Fluff 9 Gm,Warehouse A,63,53,2025-02-24 09:03:00,10
8325,ORD_8326,21974,EVM EnSave 256GB Smallest Portable External SSD with 3D NAND Flash Technology Speed of 550/R 500/W MB/s IP55 Rated- Compat...,Warehouse B,98,91,2025-02-24 13:08:00,7
8326,ORD_8327,35514,Etoxib 120 Tablet,Warehouse A,105,92,2025-02-24 23:40:00,13
8327,ORD_8328,12638,Auronim 100mg Tablet,Warehouse B,58,39,2025-02-24 04:41:00,19
8328,ORD_8329,6225,Omfix 100mg  Tablet,Warehouse C,111,94,2025-02-24 00:41:00,17
8329,ORD_8330,22004,Efimox 775mg Tablet ER,Warehouse B,28,17,2025-02-24 12:33:00,11
8330,ORD_8331,12834,"Lava A1 2021(Black Gold), Bluetooth Support, Smart AI Battery, Military Grade Certified,4 Days Battery Backup, Keypad Mobile",Warehouse B,47,39,2025-02-24 09:38:00,8
8331,ORD_8332,23260,"Cezo MFI-Certified Lightning to USB Camera Adapter with Charging Port, Portable Lightning to USB Female OTG Adapter Compat...",Warehouse A,65,52,2025-02-24 01:12:00,13
8332,ORD_8333,36268,"Samsung Galaxy M33 5G (Emerald Brown, 8GB, 128GB Storage) | 6000mAh Battery | 16GB RAM with RAM Plus | Travel Adapter to b...",Warehouse C,43,32,2025-02-24 18:58:00,11
8333,ORD_8334,8114,Golden Wolf Backpack 35L Expandable Travel Backpack for Men and Women Anti-theft Laptop Bag with Lock Water-resistant Conv...,Warehouse A,93,84,2025-02-24 11:07:00,9
8334,ORD_8335,9910,HUMBLE® 360-Degree Cell Phone Holder with Adjustable Clamp Phone Tripod Mount Adapter Compatible with Smartphones & All Ty...,Warehouse C,97,90,2025-02-24 06:01:00,7
8335,ORD_8336,13846,Zincoren Eye/Ear Drops,Warehouse B,31,14,2025-02-24 15:52:00,17
8336,ORD_8337,7347,Neroli Pure Aroma Essential Oil,Warehouse C,92,86,2025-02-24 10:39:00,6
8337,ORD_8338,10746,Ajmal CD 99 Mukhallat Concentrated Perfume Oil Floral Oriental Attar And Mukhallat AL Wafa Concentrated Perfume Oil Oriental Musky Attar 26 ml,Warehouse A,73,62,2025-02-24 17:19:00,11
8338,ORD_8339,9766,Esodus D 30mg/40mg Capsule SR,Warehouse C,75,69,2025-02-24 06:15:00,6
8339,ORD_8340,22560,Zoleban 200mg Oral Suspension,Warehouse B,104,96,2025-02-24 22:26:00,8
8340,ORD_8341,11033,"iQOO Neo 7 5G (Frost Blue, 8GB RAM, 128GB Storage) | Dimensity 8200, only 4nm Processor in The Segment | 50% Charge in 10 ...",Warehouse C,83,71,2025-02-24 10:48:00,12
8341,ORD_8342,1202,Kednim P 100mg/500mg Tablet,Warehouse C,15,7,2025-02-24 12:48:00,8
8342,ORD_8343,11035,Liquid Hand Wash - Skin Care,Warehouse B,81,68,2025-02-24 00:53:00,13
8343,ORD_8344,23919,Spigen EZ Fit Tempered Glass Screen Protector Guard for iPhone 14 Plus / 13 Pro Max - 2 Pack (Privacy),Warehouse A,27,16,2025-02-24 09:51:00,11
8344,ORD_8345,23237,Dri Damage Protect Hair Styling Gel,Warehouse A,25,6,2025-02-24 10:51:00,19
8345,ORD_8346,20980,"GOVO GOBASS 455 in Ear Wired Earphones with HD Mic for Calls, 10mm Dynamic Driver, Noise Cancellation (Platinum Black)",Warehouse C,47,37,2025-02-24 12:38:00,10
8346,ORD_8347,23932,Cypaflam Forte  400mg/500mg Tablet,Warehouse C,56,37,2025-02-24 10:10:00,19
8347,ORD_8348,7326,Sony WF-1000XM4 Industry Leading Active Noise Cancellation Multipoint Connection BT 5.2 TWS Truly Wireless in Ear Earbuds ...,Warehouse C,21,15,2025-02-24 23:48:00,6
8348,ORD_8349,947,Nosore Gel Mint,Warehouse C,64,57,2025-02-24 15:03:00,7
8349,ORD_8350,35874,Met G 1mg/500mg Tablet SR,Warehouse A,59,48,2025-02-24 17:37:00,11
8350,ORD_8351,7714,Soft Silicone Facial Applicator Mask Hairless Brush with Ultra soft Bristles - 4 Pieces (Multicolor),Warehouse C,110,99,2025-02-24 14:07:00,11
8351,ORD_8352,15024,Calvista K2 Tablet,Warehouse C,90,81,2025-02-24 18:13:00,9
8352,ORD_8353,13874,SanDisk ® Ultra Curve USB 3.2 64GB 100MB/s R Green,Warehouse C,105,97,2025-02-24 21:02:00,8
8353,ORD_8354,12832,"Sounce Realme 65W Super Vooc Charge, Data Sync Fast Charging Type-C Cable Compatible for Realme XT, Realme XT 730G, Realme...",Warehouse A,13,7,2025-02-24 11:46:00,6
8354,ORD_8355,25888,Levotrine M 5mg/10mg Tablet,Warehouse A,73,66,2025-02-24 18:29:00,7
8355,ORD_8356,31179,Zytel CH 40mg Tablet,Warehouse A,51,45,2025-02-24 15:36:00,6
8356,ORD_8357,2317,N Met G 1mg/500mg Tablet,Warehouse A,83,76,2025-02-24 06:15:00,7
8357,ORD_8358,28553,SheOak Empty Luxurious Air Cushion Puff Box BB Cream Container Makeup Case Portable A,Warehouse C,71,64,2025-02-24 06:11:00,7
8358,ORD_8359,4321,Oratric 2mg Tablet,Warehouse B,24,18,2025-02-24 16:26:00,6
8359,ORD_8360,4792,"Juarez JRZ250 One Handed Trigger Guitar Metal Capo Quick Change For Ukulele, Electric And Acoustic Guitars, Black",Warehouse A,91,74,2025-02-24 12:26:00,17
8360,ORD_8361,27238,"Telca Case Cover Compatible with Realme Buds Air 3 NEO | ONLY Silicon Cover, NO Bluetooth (Buds Air 3 NEO, Black)",Warehouse B,45,38,2025-02-24 09:08:00,7
8361,ORD_8362,5580,Kerala Blasters Hasta Hand Sanitizer - Yennum Yellow,Warehouse B,83,70,2025-02-24 13:56:00,13
8362,ORD_8363,32185,Swiss Beauty Mini Eyeshadow 9 Colors Palette-Shade06,Warehouse A,98,84,2025-02-24 07:16:00,14
8363,ORD_8364,4795,Pancop 40mg Tablet,Warehouse C,102,84,2025-02-24 04:35:00,18
8364,ORD_8365,5495,"Fire-Boltt INVINCIBLE 1.39"" (3.53cm) AMOLED 454x454 Bluetooth Calling Smartwatch ALWAYS ON, 100 Sports Modes, 100 Inbuilt ...",Warehouse A,35,28,2025-02-24 14:27:00,7
8365,ORD_8366,30298,Traze 50 Tablet,Warehouse C,11,2,2025-02-24 20:27:00,9
8366,ORD_8367,29355,India's No 1 Fluoride Free Toothpaste,Warehouse C,93,83,2025-02-24 18:43:00,10
8367,ORD_8368,29247,BIOBRIX BB GLOW ALL IN ONE SKIN CREAM WITH SPF 35 FOR SKIN GLOW 50 GM Tube,Warehouse A,21,7,2025-02-24 13:52:00,14
8368,ORD_8369,32440,Biocefmix-O Tablet,Warehouse C,107,88,2025-02-24 10:16:00,19
8369,ORD_8370,32437,EGOTUDE Ultra Hybrid Camera Lens Protection [Never Yellowing] Transparent Back Cover Case for iPhone 14 (Black),Warehouse C,100,87,2025-02-24 23:25:00,13
8370,ORD_8371,6443,"Samsung Galaxy M04 Dark Blue, 4GB RAM, 128GB Storage | Upto 8GB RAM with RAM Plus | MediaTek Helio P35 | 5000 mAh Battery",Warehouse A,72,65,2025-02-24 17:12:00,7
8371,ORD_8372,33352,Lav-CV 1000mg/200mg Injection,Warehouse B,105,90,2025-02-24 05:41:00,15
8372,ORD_8373,33559,"CrossBeats Newly launched Opera True Wireless in-Ear Earbuds with AI ENC Noise-Cancelling, mics, 60 hr Playtime, 13 mm Dri...",Warehouse A,106,99,2025-02-24 20:08:00,7
8373,ORD_8374,30828,"Fashion Colour Kiss Lip No Transfer Lipstick, 80 Purplish Red 2.6 gm",Warehouse B,30,17,2025-02-24 01:29:00,13
8374,ORD_8375,31825,Ajmal Nightingale And Persuade For Men & Women And Evoke Silver Edition For Him Deodorants Pack of 3 200 ml,Warehouse A,97,85,2025-02-24 23:28:00,12
8375,ORD_8376,4374,Dove Cream Beauty Bathing Bar - 75g Pack,Warehouse A,20,1,2025-02-24 23:53:00,19
8376,ORD_8377,3315,Gastek-DSR Capsule,Warehouse B,101,90,2025-02-24 12:51:00,11
8377,ORD_8378,32053,"HP v236w USB 2.0 64GB Pen Drive, Metal",Warehouse B,108,94,2025-02-24 17:18:00,14
8378,ORD_8379,28529,IKONIC ME- 3 IN 1 EXPRESS STYLER - COMBINES A CONVENTIONAL BLOW DRYER WITH A VOLUMIZER AND A STYLER (Grey & Black),Warehouse B,83,68,2025-02-24 18:13:00,15
8379,ORD_8380,2157,"Micromax X412 (Blue, Auto Call Recording, 800mAh)",Warehouse A,17,4,2025-02-24 00:38:00,13
8380,ORD_8381,30502,"KYOSEI Dust-Filter Tempered Glass Compatible with iPhone 13/iPhone 13 Pro/iPhone 14(6.1""),with Speaker-Mesh,Edge-to-Edge C...",Warehouse C,33,14,2025-02-24 01:24:00,19
8381,ORD_8382,29585,"Mi Step Out 12 L Mini Backpack (Small Size, Sky Blue, Water Repellant)",Warehouse C,67,58,2025-02-24 12:02:00,9
8382,ORD_8383,4471,Nebivas 2.5mg Tablet,Warehouse B,90,84,2025-02-24 06:39:00,6
8383,ORD_8384,29085,Medimade Charcoal Face Wash (Pack of 2) 1's,Warehouse B,108,94,2025-02-24 00:15:00,14
8384,ORD_8385,31494,Nucalm 0.5mg Tablet,Warehouse C,26,8,2025-02-24 12:17:00,18
8385,ORD_8386,30202,Moroccan Argan Hair Growth Oil For Hair Growth & Silky Hair,Warehouse B,44,29,2025-02-24 02:30:00,15
8386,ORD_8387,27038,Extra Clean Toothbrush Medium,Warehouse C,23,11,2025-02-24 07:35:00,12
8387,ORD_8388,29364,"The Moms Co. Natural Clay Face Wash with Moroccan Lava Clay & Activated Charcoal l Purifies,Detoxes &Glowing l Normal to O...",Warehouse A,108,99,2025-02-24 15:09:00,9
8388,ORD_8389,28450,Klaxone 1000mg Injection,Warehouse C,91,72,2025-02-24 05:14:00,19
8389,ORD_8390,3305,"GM 3206 GOn Mini 2 Pin Extension Cord 2.5 Mtr. with Indicator, Safety Shutter & 2 International Sockets",Warehouse C,90,71,2025-02-24 16:50:00,19
8390,ORD_8391,30862,Original Hand Wash Liquid Pump,Warehouse A,74,62,2025-02-24 01:29:00,12
8391,ORD_8392,31645,Povisol S Cream,Warehouse B,48,32,2025-02-24 20:38:00,16
8392,ORD_8393,5517,Anti Pimple Turmeric Face Wash,Warehouse C,73,63,2025-02-24 02:25:00,10
8393,ORD_8394,3714,Dandruff Control Shampoo,Warehouse C,48,38,2025-02-24 17:26:00,10
8394,ORD_8395,33147,G.SKILL Ripjaws SO-DIMM 8GB (1 * 8GB) DDR4 3200MHz CL22-22-22-52 1.20V Laptop Memory RAM - F4-3200C22S-8GRS,Warehouse B,64,47,2025-02-24 02:40:00,17
8395,ORD_8396,5522,Ozole Capsule,Warehouse C,97,89,2025-02-24 01:19:00,8
8396,ORD_8397,27115,TheGiftKart Ultra-Hybrid Crystal Clear Back Case Cover for Google Pixel 7 | Shockproof Design | Camera Protection Bump | H...,Warehouse C,69,54,2025-02-24 17:01:00,15
8397,ORD_8398,30854,Onsitego 1 Year Extended Warranty for Non Robotic Vacuum Cleaners Rs.5k to 10k Email Delivery,Warehouse C,111,93,2025-02-24 07:03:00,18
8398,ORD_8399,27170,Ajmal Neea EDP & Vibrant Ether EDT Pack of 2 350 ml,Warehouse A,34,15,2025-02-24 02:36:00,19
8399,ORD_8400,30840,"Fur Jaden 15.6 Inch Laptop Backpack 25 LTR Bag for School, College and Office with USB Charging Port",Warehouse B,61,55,2025-02-24 00:51:00,6
8400,ORD_8401,27168,Anti-Dandruff Solutions - Dandruff Clean & Fresh Conditioner,Warehouse B,50,34,2025-02-24 23:47:00,16
8401,ORD_8402,29336,The Maruti Shop Maroon Designer Round Bindi For Women And Girls (Pack of 16 Bindi),Warehouse A,63,52,2025-02-24 01:10:00,11
8402,ORD_8403,27162,"LED USB light USB LED light, pack of 5 for Laptop, USB hub, OTG mobile",Warehouse A,101,92,2025-02-24 10:18:00,9
8403,ORD_8404,24767,Epson EcoTank L3211 All-in-One Ink Tank Printer (Black),Warehouse A,60,53,2025-02-24 05:54:00,7
8404,ORD_8405,25423,Medzole-DSR Capsule,Warehouse B,86,70,2025-02-24 04:57:00,16
8405,ORD_8406,4334,"Elysiann Glorry Double Up V Lifting Mask - Double chin reducer for women, Lifts & Shapes your Face with Face Shaper - Enha...",Warehouse B,49,41,2025-02-24 09:05:00,8
8406,ORD_8407,31474,Nails On Board Handmade Press On Gel Nails- Holographic Lemon Yellow Medium 50 gm,Warehouse B,89,70,2025-02-24 09:29:00,19
8407,ORD_8408,32158,"Absorbent Soft Cotton Wool/Roll - For Makeup Remover, Beauty, Adult & Baby Care Disposable Cotton",Warehouse C,60,47,2025-02-24 19:34:00,13
8408,ORD_8409,5542,Deborah Milano Gel Effect - 64 Fashion Pink Nail Polish 8.5 ml,Warehouse A,15,8,2025-02-24 08:58:00,7
8409,ORD_8410,28454,SUPER TOY Multicolor LCD Graphic Writing Tablet 8.5Inch E-Note Pad Best Birthday Gift for Kids Boys Girls,Warehouse C,103,93,2025-02-24 10:56:00,10
8410,ORD_8411,27111,"Fashion Colour Professional Face & Body Highlighter, Shade 04 35 gm",Warehouse C,21,3,2025-02-24 15:18:00,18
8411,ORD_8412,3306,"Amazon Basics Wired Gaming Mouse, 4000 DPI, Lightweight, 8 Preprogrammed Buttons, 500 IPS High-Speed Tracking, 1.6m Length...",Warehouse C,100,86,2025-02-24 22:16:00,14
8412,ORD_8413,27032,Azrolid 500mg Tablet,Warehouse A,34,21,2025-02-24 08:33:00,13
8413,ORD_8414,33454,"Tabelito Polyester Foam, Nylon Hybrid Laptopss Bag Sleeve Case Cover Pouch for Laptops (15.6 Inches /39.6Cm, Blue)",Warehouse C,77,72,2025-02-24 09:29:00,5
8414,ORD_8415,33305,TheGiftKart Back Cover Case for OnePlus Nord (2020) (Shockproof | Crystal Clear | Hybrid TPU & PC | Transparent Back | Bla...,Warehouse A,25,17,2025-02-24 04:37:00,8
8415,ORD_8416,3329,"Born Good Plant-based Electronics & Gadget Disinfectant & Cleaner Kit | Biodegradable, Non-Toxic, Eco-Friendly | Laptop, S...",Warehouse C,79,68,2025-02-24 15:57:00,11
8416,ORD_8417,31916,Methgo-PG Capsule,Warehouse A,75,59,2025-02-24 10:25:00,16
8417,ORD_8418,29946,Mix Fruit Soap,Warehouse A,59,42,2025-02-24 04:35:00,17
8418,ORD_8419,32488,"DOODLE Beyond The Stars Soft Bound Set of 3 Notebook Diary (B6, 4.7 X 7 Inches, 80 GSM, 160 Ruled Pages & 80 Blank Pages)",Warehouse C,93,88,2025-02-24 05:02:00,5
8419,ORD_8420,29972,"ZEBRONICS 24 Inch (60.4 Cm) Widescreen 1920 X 1080 Pixels LED Monitor, IPS, Ultra Slim, FHD 1920x1080, HDMI, VGA, 250nits,...",Warehouse B,44,28,2025-02-24 14:21:00,16
8420,ORD_8421,26945,Lenovo Casual Laptop Backpack B210 15.6-inch(39.6cm) Water Repellent Black,Warehouse B,90,72,2025-02-24 12:14:00,18
8421,ORD_8422,32764,Vtramic 500mg Injection,Warehouse A,111,93,2025-02-24 08:48:00,18
8422,ORD_8423,28304,Cebalol 100mg Tablet,Warehouse B,55,38,2025-02-24 01:05:00,17
8423,ORD_8424,6828,"Dyazo Laptop Sleeve 15.6 inch Case, Water Repellent Polyester Neoprene Case with Accessory Pocket Compitable for MacBook, ...",Warehouse B,103,96,2025-02-24 12:31:00,7
8424,ORD_8425,4727,Solace MR 250mg/50mg/325mg Tablet,Warehouse B,79,70,2025-02-24 21:03:00,9
8425,ORD_8426,25632,Cefobiz 500mg Injection,Warehouse B,18,13,2025-02-24 02:11:00,5
8426,ORD_8427,5361,Flylax B 5mg Tablet,Warehouse C,62,53,2025-02-24 02:46:00,9
8427,ORD_8428,4894,Omisafe TZ Injection,Warehouse A,78,70,2025-02-24 02:33:00,8
8428,ORD_8429,4451,"S.A.V.I 3D Temporary Tattoo Waterproof Sticker Beautiful Black Big Wolf Face Popular New Designs Size - 21x15cm (43b), Mul...",Warehouse A,90,78,2025-02-24 05:53:00,12
8429,ORD_8430,5703,"HUMBLE Mini Quick Release Plate QR Release Plate Replacement for Tripod Clamps for Sony VCT-60AV, VCT-D580RM, VCT-D680RM, ...",Warehouse A,71,52,2025-02-24 12:47:00,19
8430,ORD_8431,26937,Louric 100mg Tablet,Warehouse B,13,6,2025-02-24 03:30:00,7
8431,ORD_8432,33166,ZEBRONICS Zeb-Tulip Wired in Ear Earphone with Mic (Black),Warehouse B,83,76,2025-02-24 21:53:00,7
8432,ORD_8433,26934,Cipdol Syrup,Warehouse C,29,23,2025-02-24 20:43:00,6
8433,ORD_8434,6635,"L'Occitane Cherry Blossom Hand Cream, 75ml",Warehouse B,90,76,2025-02-24 06:29:00,14
8434,ORD_8435,28588,ENVIE® (ECR 11) Speedster Fast Charger for AA & AAA Rechargeable Batteries (with LCD Display),Warehouse C,71,57,2025-02-24 06:19:00,14
8435,ORD_8436,31387,Universal Remote Control for All LG Smart TV LCD LED OLED UHD HDTV Plasma Magic 3D 4K Webos TVs AKB75095307 AKB75375604 AK...,Warehouse C,60,47,2025-02-24 17:31:00,13
8436,ORD_8437,29574,Veoni Belle Flat Definer Brush,Warehouse B,50,39,2025-02-24 01:57:00,11
8437,ORD_8438,25626,Levomine 250mg Tablet,Warehouse B,53,42,2025-02-24 15:48:00,11
8438,ORD_8439,4012,"Noise Newly Launched Two On-Ear Headphones with 50 Hours Playtime, Low Latency(up to 40ms), 4 Play Modes, Dual Pairing, BT...",Warehouse C,57,48,2025-02-24 21:26:00,9
8439,ORD_8440,2773,Pollution Shield Shampoo,Warehouse B,33,24,2025-02-24 19:19:00,9
8440,ORD_8441,33300,Mebecan-SR Capsule,Warehouse A,42,32,2025-02-24 16:03:00,10
8441,ORD_8442,4901,Ofdex Eye Drop,Warehouse B,81,67,2025-02-24 03:39:00,14
8442,ORD_8443,28522,"Shower Gel - Therapy Morning Tonic, Imported",Warehouse B,25,15,2025-02-24 19:07:00,10
8443,ORD_8444,30355,Ajmal Bastion EDP Woody Aromatic Perfume And Impress Concentrated Perfume Oil Citrus 110 ml,Warehouse C,102,91,2025-02-24 03:45:00,11
8444,ORD_8445,26953,"Enchanteur Body Lotion - Intense Moisture, Cocoa Sensuelle",Warehouse B,100,87,2025-02-24 07:58:00,13
8445,ORD_8446,7242,"Miwings Universal Handlebar Bike Mount Holder Verson 2.0 Metal Body 360 Degree Rotating Mirror Cradle Stand for Bicycle, M...",Warehouse C,102,96,2025-02-24 21:44:00,6
8446,ORD_8447,33168,Mirabelle Korea Saffron Ultra Facial Sheet Mask 25 Ml,Warehouse B,33,24,2025-02-24 22:36:00,9
8447,ORD_8448,4886,Prenuron M 750mcg/75mg Tablet,Warehouse C,78,71,2025-02-24 02:02:00,7
8448,ORD_8449,29961,mobistyle Compatible for iPhone 11 Case 6.1 inch Hybrid PC+TPU Soft Grip Clear Back Panel Enhanced Metal Camera Guard Back...,Warehouse B,52,37,2025-02-24 17:40:00,15
8449,ORD_8450,32903,Itroked 200 Capsule,Warehouse B,95,86,2025-02-24 04:23:00,9
8450,ORD_8451,5415,Domitin 10mg Tablet,Warehouse B,18,5,2025-02-24 23:50:00,13
8451,ORD_8452,32485,Lansotaj 30mg Injection,Warehouse B,75,62,2025-02-24 11:10:00,13
8452,ORD_8453,4761,27W Fast Mobile Charger Compatible for Xiaomi mi with Type-C Fast Charging Data Cable,Warehouse B,106,87,2025-02-24 04:55:00,19
8453,ORD_8454,5366,CAVICIN E KIT,Warehouse B,94,87,2025-02-24 17:38:00,7
8454,ORD_8455,4305,Swiss Image Absolute Radiance Whitening Face Wash 200 ml,Warehouse A,84,76,2025-02-24 14:30:00,8
8455,ORD_8456,28333,Noklot Plus Tablet,Warehouse C,56,41,2025-02-24 17:47:00,15
8456,ORD_8457,2989,Wet N Wild Megaclear Mascara - Clear 8.5 ml,Warehouse B,37,18,2025-02-24 12:47:00,19
8457,ORD_8458,26931,My.Shop Multi Colour Small Bindi Tikka for Girls Women Matching Makeup Bindis Stickers,Warehouse B,18,13,2025-02-24 11:26:00,5
8458,ORD_8459,5670,Spigen Thermoplastic Polyurethane Liquid Air Cover Case Designed for Galaxy Watch 4 Classic (46mm) - Matte Black (Watch no...,Warehouse A,13,3,2025-02-24 15:52:00,10
8459,ORD_8460,25161,Khadi Essentials The Abhyangam Therapy Skin & Hair Massage Oil - Extra Virgin Olive Oil 100 ml,Warehouse A,26,15,2025-02-24 01:34:00,11
8460,ORD_8461,31666,MFTEK 2000 dpi LED Backlit USB Wired Unbreakable ABS Body Gaming Mouse (Black),Warehouse B,59,53,2025-02-24 13:38:00,6
8461,ORD_8462,25609,"Pragati Systems® Genius Melamine (Non-Magnetic) Whiteboard for Office, Home and School (GWB90120), Lightweight Aluminium F...",Warehouse C,26,17,2025-02-24 18:26:00,9
8462,ORD_8463,29407,"iXport™ Headset Replacement Ear Cushion Pads for Audio Technica Posh Ath-M50/M50S, Soundcore Life Q10, JBL 650BTNC",Warehouse A,36,27,2025-02-24 00:11:00,9
8463,ORD_8464,26197,Itroderm-OC Cream,Warehouse A,27,10,2025-02-24 14:59:00,17
8464,ORD_8465,25605,Kuber Industries Rubber Kids Adjustable Shower Cap For Wash Hair (Maroon) 54KM4196,Warehouse C,70,60,2025-02-24 12:22:00,10
8465,ORD_8466,26199,"Gel Bathing Bar - Men, Refreshing Pulse",Warehouse B,101,88,2025-02-24 11:46:00,13
8466,ORD_8467,33542,Creme Soft Soap - For Hands & Body,Warehouse B,80,64,2025-02-24 17:01:00,16
8467,ORD_8468,25613,Electvision Remote Control for led Compatible with Kodak/Thomson Smart led tv (Without Voice) Before Placing Order for ver...,Warehouse A,29,17,2025-02-24 15:43:00,12
8468,ORD_8469,3487,Goustat 40mg Tablet,Warehouse C,28,21,2025-02-24 06:50:00,7
8469,ORD_8470,25367,Quench Botanics Mama Cica Deep Pore Cleansing Micellar Water 145 ml,Warehouse C,40,28,2025-02-24 03:41:00,12
8470,ORD_8471,5674,Pregabid D 75/20 Capsule DR,Warehouse C,90,85,2025-02-24 02:07:00,5
8471,ORD_8472,30564,"Redmi 20000mAh Li-Polymer Power Bank, USB Type C and Micro USB Ports, 18W Fast Charging, Low Power Mode, Black",Warehouse A,31,17,2025-02-24 05:47:00,14
8472,ORD_8473,33174,"RPM Euro Games Gaming Mousepad Speed Type (Size - 350 mm x 250 mm x 4mm), Medium",Warehouse A,31,13,2025-02-24 21:22:00,18
8473,ORD_8474,30103,"MAGICCOLOUR Highlighter Loose Powder for Face Makeup, Highlighter Powder for Face Glow, Highlighting Powder for Women, Lon...",Warehouse A,29,23,2025-02-24 03:13:00,6
8474,ORD_8475,30781,HUMBLE Adjustable Silicone Band Strap Compatible with Oneplus Smart Band & Oppo Smart Band for Boys & Girls (Tracker Not I...,Warehouse A,86,73,2025-02-24 10:35:00,13
8475,ORD_8476,30762,"Professional Makeup Brushes Set of 12 with Storage Box,Make up Brush Set Foundation Face Powder Blush Eyeshadow Brushes Co...",Warehouse C,104,96,2025-02-24 02:08:00,8
8476,ORD_8477,2440,Pearl White Facial Kit 5X10G 10 Gm,Warehouse C,10,5,2025-02-24 19:22:00,5
8477,ORD_8478,3149,Zucaf 200mg Tablet,Warehouse A,84,69,2025-02-24 16:29:00,15
8478,ORD_8479,30449,7 O Click - Permasharp Stainless Blade,Warehouse C,24,17,2025-02-24 17:44:00,7
8479,ORD_8480,24985,ICONIC LONDON Illuminator (13.5ml) 3.0 Glow,Warehouse C,32,13,2025-02-24 08:03:00,19
8480,ORD_8481,5144,Apcon S 100mg/325mg/10mg Tablet,Warehouse C,43,38,2025-02-24 05:19:00,5
8481,ORD_8482,25789,"The Touch Exfoliating Gloves | Moroccan Bathing Hammam Glove Mitt-Latest body scrubber |Visibly Lift Away Dead Skin, Great...",Warehouse A,51,40,2025-02-24 01:07:00,11
8482,ORD_8483,25047,Beniq 8mg Tablet,Warehouse B,36,29,2025-02-24 22:07:00,7
8483,ORD_8484,25827,Tea Tree Targeted Skin Clearing Gel,Warehouse B,19,10,2025-02-24 09:59:00,9
8484,ORD_8485,2546,TheGiftKart Translucent Hybrid Back Cover Case for Samsung Galaxy M33 5G | Smoked Matte Back | 360 Degree Protection | Pro...,Warehouse B,23,9,2025-02-24 16:17:00,14
8485,ORD_8486,3443,Procin 500mg Injection,Warehouse C,82,66,2025-02-24 02:12:00,16
8486,ORD_8487,28832,OneAssist 2 Years Extended Warranty Plan for Headphones 500 to 1000 - Email Delivery Within 2 Hours,Warehouse C,106,87,2025-02-24 10:27:00,19
8487,ORD_8488,30696,Ximef 200mg Tablet,Warehouse B,21,13,2025-02-24 21:25:00,8
8488,ORD_8489,26623,"Nokia 8210 4G Volte keypad Phone with Dual SIM, Big Display, inbuilt MP3 Player & Wireless FM Radio | Red",Warehouse B,88,82,2025-02-24 02:05:00,6
8489,ORD_8490,31787,Zeset 2mg Syrup,Warehouse B,108,98,2025-02-24 15:29:00,10
8490,ORD_8491,2349,Audirab DSR 30mg/20mg Capsule,Warehouse A,61,56,2025-02-24 09:45:00,5
8491,ORD_8492,31409,Brotacef 200mg Tablet,Warehouse A,80,69,2025-02-24 03:40:00,11
8492,ORD_8493,5814,Saypod 50 Oral Suspension,Warehouse C,44,34,2025-02-24 15:02:00,10
8493,ORD_8494,4679,Avof OZ Oral Suspension,Warehouse C,59,54,2025-02-24 13:24:00,5
8494,ORD_8495,30143,Theocox 60mg/4mg Tablet,Warehouse C,23,15,2025-02-24 14:45:00,8
8495,ORD_8496,2303,"Digitek Wireless Microphone System for DSLR, Camcorder, Smartphone & Tablet DWM 101",Warehouse C,77,72,2025-02-24 20:19:00,5
8496,ORD_8497,2304,Ajmal Silver Shade EDP Citrus Woody Perfume And Carbon Homme Deodorant Citrus Spicy Fragrance 300 ml,Warehouse C,39,28,2025-02-24 00:09:00,11
8497,ORD_8498,5855,The Fresh Mask Sheet - Carrot,Warehouse A,38,29,2025-02-24 17:46:00,9
8498,ORD_8499,2335,"Sounce Earphone Case Cover for Boat Airdopes 131, Soft Silicone Skin Case Cover Shock-Absorbing Protective Case with Keych...",Warehouse C,95,86,2025-02-24 08:32:00,9
8499,ORD_8500,30428,Face Shield - Multiuse,Warehouse A,28,16,2025-02-24 22:08:00,12
8500,ORD_8501,31782,"Lapster Caddy for ssd and HDD, Optical Bay 2nd Hard Drive Caddy, Caddy 9.5mm for Laptop",Warehouse B,69,50,2025-02-24 06:10:00,19
8501,ORD_8502,31549,"Faber-Castell Tri-Grip Brush - Round, Pack of 7 (Assorted)",Warehouse A,76,70,2025-02-24 18:03:00,6
8502,ORD_8503,31695,PxIn 14 Inch Privacy Screen Filter - NO Eye Strain | Anti Blue Light + Anti Glare | No Dry Eyes | 3M Hasp | Privacy Screen...,Warehouse A,70,55,2025-02-24 19:39:00,15
8503,ORD_8504,2194,Olantic 2.5mg Tablet,Warehouse A,47,35,2025-02-24 01:06:00,12
8504,ORD_8505,32324,Spigen Tough Armor Back Cover Case Compatible with OnePlus 7 Pro (TPU + PC | Black),Warehouse B,30,20,2025-02-24 18:09:00,10
8505,ORD_8506,2828,"CASE U Upgraded Stylus Pen for Apple iPad (2022-2018), Stylus Pencil, Quick Charge with Power Display, iPad Pencil, Magnet...",Warehouse B,45,35,2025-02-24 00:30:00,10
8506,ORD_8507,25807,Matra Face Mask Brush,Warehouse B,68,63,2025-02-24 19:28:00,5
8507,ORD_8508,28810,Taxcure LB 200mg Tablet DT,Warehouse C,54,45,2025-02-24 10:05:00,9
8508,ORD_8509,31325,Glemin GP 2mg/500mg/15mg Tablet,Warehouse A,62,54,2025-02-24 11:35:00,8
8509,ORD_8510,31021,Tampons - Regular,Warehouse A,76,63,2025-02-24 01:53:00,13
8510,ORD_8511,24968,Ajmal Blu EDP Aquatic Woody Perfume 90ml for Men and Neutron EDP Citrus Fruity Perfume 100ml for Men + 1 Perfume Tester FREE,Warehouse A,97,89,2025-02-24 09:44:00,8
8511,ORD_8512,32567,Bonjour Paris Nail Polish Base Coat Tranparent 9.5 ml,Warehouse C,20,13,2025-02-24 10:53:00,7
8512,ORD_8513,2866,Titech OZ 250mg/500mg Tablet,Warehouse A,99,85,2025-02-24 16:00:00,14
8513,ORD_8514,2320,Lenovo AZ 250mg/250mg Tablet,Warehouse C,58,51,2025-02-24 15:05:00,7
8514,ORD_8515,31490,"Logitech MK235 Wireless Keyboard and Mouse Set for Windows, 2.4 GHz Wireless Unifying USB Receiver, 15 FN Keys, Long Batte...",Warehouse A,94,84,2025-02-24 19:42:00,10
8515,ORD_8516,30452,"Sebamed Anti-Dandruff Shampoo, 200ml",Warehouse B,25,20,2025-02-24 09:50:00,5
8516,ORD_8517,2323,Angil 5mg Tablet,Warehouse C,100,94,2025-02-24 09:14:00,6
8517,ORD_8518,31712,Makeup Revolution Colour Play Blushed Duo Queen 5.8 gm,Warehouse C,98,81,2025-02-24 17:30:00,17
8518,ORD_8519,6598,"Google Pixel 6 Pro 5G (Stromy Black, 12GB RAM, 128GB Storage)",Warehouse B,76,68,2025-02-24 19:04:00,8
8519,ORD_8520,28027,XE610 Boom Bass Wired in-Ear Headphones Compatible with Especially All Vivo Smartphones (White) (White) (Vivo Original Sound),Warehouse A,26,17,2025-02-24 23:38:00,9
8520,ORD_8521,4664,Zebronics BT4440RUCF 4.1 Channel Multimedia Speakers,Warehouse A,28,17,2025-02-24 23:04:00,11
8521,ORD_8522,28048,Eyetex Dazller Nail Glitter - DB27 (Zinc) 12 ml,Warehouse A,40,34,2025-02-24 19:38:00,6
8522,ORD_8523,6711,"Stepwell Otoscope (LED - White Light) Pocket Scope, Auriscope with Battery Handle",Warehouse C,66,53,2025-02-24 21:00:00,13
8523,ORD_8524,28715,Glycap M 80mg/500mg Tablet,Warehouse C,41,27,2025-02-24 15:24:00,14
8524,ORD_8525,28043,Cablide 100mg Tablet MD,Warehouse C,59,42,2025-02-24 17:50:00,17
8525,ORD_8526,3761,"Dyazo Desktop Height Adjustable Foldable Mobile Phone Stand, Stable, Durable Compatible with All Devices Measuring from 4″...",Warehouse C,106,94,2025-02-24 10:31:00,12
8526,ORD_8527,31690,"Wella Professionals Wella Professionals Oil Reflections Luminous Instant Conditioner 200 Ml and Reboost Mask 150 Ml Duo, 2...",Warehouse A,29,10,2025-02-24 05:41:00,19
8527,ORD_8528,33027,Neox OZ 200mg/500mg Tablet,Warehouse B,65,50,2025-02-24 11:03:00,15
8528,ORD_8529,31057,"TP-Link Archer C24 AC750 Mbps Dual-Band, WiFi Wireless Router | Multi Mode | 4 Antennas | Ipv6 Supported | Parental Contro...",Warehouse A,42,23,2025-02-24 13:43:00,19
8529,ORD_8530,32023,"Flat Brush - 6-FB, Colour May Vary",Warehouse A,82,63,2025-02-24 09:09:00,19
8530,ORD_8531,2065,Men Expert Charcoal Black Face Scrub,Warehouse B,49,36,2025-02-24 06:13:00,13
8531,ORD_8532,25208,"boAt Wave Lite Smartwatch with 1.69"" HD Display, Heart Rate & SpO2 Level Monitor, Multiple Watch Faces, Activity Tracker, ...",Warehouse C,59,41,2025-02-24 03:48:00,18
8532,ORD_8533,29705,Pure Hands Hand Sanitizer - Orange,Warehouse A,62,56,2025-02-24 06:46:00,6
8533,ORD_8534,26520,CZARTECH Native Back Cover for iPhone 14 Plus Clear case (TPU + Tough Polycarbonate Back I 6 ft Drop Protection Tested I M...,Warehouse C,19,3,2025-02-24 22:07:00,16
8534,ORD_8535,5152,Voxaking 100mg Tablet ER,Warehouse B,81,64,2025-02-24 06:01:00,17
8535,ORD_8536,4991,Fordcef CV 200mg/125mg Tablet,Warehouse B,104,94,2025-02-24 19:00:00,10
8536,ORD_8537,31598,Trilin Syrup,Warehouse C,63,51,2025-02-24 17:13:00,12
8537,ORD_8538,26581,SupCares Edge to Edge Privacy Tempered Glass for iPhone 14 Pro Max (6.7 Inch) with Easy Self Installation Kit | Black,Warehouse C,34,26,2025-02-24 00:41:00,8
8538,ORD_8539,5842,Acloday-MR Tablet,Warehouse C,92,79,2025-02-24 06:59:00,13
8539,ORD_8540,2554,Rhymestore® 4 Pin USB Fast Charger Magnetic Charging Cable Adapter for Fire-Boltt Thunder Watch & Fire-Boltt Talk Smartwat...,Warehouse A,108,93,2025-02-24 19:09:00,15
8540,ORD_8541,4140,MaxFresh Blue Spicy Fresh Gel Toothpaste - Delhi Capitals Special Edition Pack,Warehouse C,32,23,2025-02-24 16:59:00,9
8541,ORD_8542,3772,Neuromec 1500mcg/75mg Tablet SR,Warehouse B,24,8,2025-02-24 01:31:00,16
8542,ORD_8543,3540,"Brustro Drawing Papers 200 GSM A4, Contains 40+10 Sheets",Warehouse B,91,80,2025-02-24 14:52:00,11
8543,ORD_8544,29767,Pikkme Samsung Galaxy M31 / F41 / M31 Prime Flip Cover Case | Leather flip Back Covers Cases for Samsung Galaxy M31 / F41...,Warehouse A,40,34,2025-02-24 17:44:00,6
8544,ORD_8545,4393,Bennett Khadi and Polyester Drax Laptop Bag Sleeve Case Cover Pouch for 15/15.6 inches Laptop Apple/Dell/Lenovo/ASUS/Hp/Sa...,Warehouse B,85,71,2025-02-24 17:43:00,14
8545,ORD_8546,3971,G1 Cologne - For Women,Warehouse A,94,77,2025-02-24 06:54:00,17
8546,ORD_8547,6850,"Colorbar Hydra White Intense Whitening Night Cream, 25g",Warehouse A,84,70,2025-02-24 00:34:00,14
8547,ORD_8548,6851,DavaIndia Valsartan+Hydrochlorothiazide 80mg/12.5mg Tablet,Warehouse B,102,96,2025-02-24 09:37:00,6
8548,ORD_8549,33159,"Smart Watch for Men | ID116 for Men/Women | 1.3 inches Touchscreen Bluetooth Smart Watches, Heart Rate Activity Tracker, C...",Warehouse C,105,88,2025-02-24 23:33:00,17
8549,ORD_8550,30540,Ajmal Majmua Concentrated Perfume Oil Oriental Attar And Classic Oud Concentrated Perfume Oil Woody Oudh Attar 20 ml,Warehouse C,56,44,2025-02-24 05:17:00,12
8550,ORD_8551,29184,Lilo Tablet,Warehouse B,43,27,2025-02-24 14:03:00,16
8551,ORD_8552,30083,JBL Partybox 110 | Wireless Bluetooth Party Speaker | 160W Monstrous Pro Sound | Dynamic Light Show | Upto 12Hrs Playtime...,Warehouse C,74,61,2025-02-24 03:07:00,13
8552,ORD_8553,31459,Wisartif H 50mg/12.5mg Tablet,Warehouse C,42,25,2025-02-24 04:48:00,17
8553,ORD_8554,29391,Urbane Nights - Eau De Toilette For Men,Warehouse A,60,51,2025-02-24 04:00:00,9
8554,ORD_8555,29388,Itrozen 200mg Capsule,Warehouse C,101,96,2025-02-24 07:53:00,5
8555,ORD_8556,32879,"Printme Silicone Compatible for OnePlus Buds Nord CE Case Cover, Soft Shockproof Protective Case Cover with Metal Keychain...",Warehouse A,54,41,2025-02-24 18:58:00,13
8556,ORD_8557,6383,Aziter 200mg/5ml Suspension,Warehouse C,87,76,2025-02-24 13:03:00,11
8557,ORD_8558,26964,Fluran Plus Tablet,Warehouse A,74,69,2025-02-24 04:48:00,5
8558,ORD_8559,5451,Disfungal IT 200mg Capsule,Warehouse A,107,91,2025-02-24 18:25:00,16
8559,ORD_8560,24826,Stepride 4mg Tablet,Warehouse A,74,68,2025-02-24 12:07:00,6
8560,ORD_8561,31929,Brother HL-L2321D Single-Function Monochrome Laser Printer with Auto Duplex Printing,Warehouse B,73,68,2025-02-24 13:03:00,5
8561,ORD_8562,6835,Meezol-LSR Capsule,Warehouse B,105,94,2025-02-24 21:31:00,11
8562,ORD_8563,25543,Spark Power Series Perfume Spray,Warehouse A,16,7,2025-02-24 06:53:00,9
8563,ORD_8564,30086,"Samsung 253 L 3 Star Inverter Frost-Free Double Door Refrigerator (RT28T3753UV/HL, Blue Wave, Convertible, 2022 Model)",Warehouse A,56,44,2025-02-24 06:15:00,12
8564,ORD_8565,29385,Ajmal Aurum & Sacred Love & Shadow Homme & Avid Deo & Prose EDP Pack of 5 20 ml,Warehouse C,67,56,2025-02-24 02:19:00,11
8565,ORD_8566,5712,Quzar 400mg Tablet,Warehouse B,14,3,2025-02-24 12:07:00,11
8566,ORD_8567,25370,Vega Dressing Comb (HMC - 07) 33 gm,Warehouse A,107,88,2025-02-24 09:37:00,19
8567,ORD_8568,3247,Ditrazol 100mg Capsule,Warehouse C,26,14,2025-02-24 21:25:00,12
8568,ORD_8569,3824,Moxzer 250mg Tablet,Warehouse A,56,50,2025-02-24 18:01:00,6
8569,ORD_8570,5627,Azauk 100mg Syrup,Warehouse C,59,50,2025-02-24 17:16:00,9
8570,ORD_8571,3703,Charcoal Body Wash For Men,Warehouse B,12,2,2025-02-24 09:27:00,10
8571,ORD_8572,27311,Horosis 25mg Injection,Warehouse A,40,23,2025-02-24 11:48:00,17
8572,ORD_8573,26996,Spifen MR 50mg/4mg Tablet,Warehouse B,39,28,2025-02-24 13:56:00,11
8573,ORD_8574,27265,Bro-Zedex  Syrup,Warehouse B,61,56,2025-02-24 17:17:00,5
8574,ORD_8575,4840,Berina A21 Light Grey Hair Color Cream 60 gm,Warehouse C,61,46,2025-02-24 16:08:00,15
8575,ORD_8576,33374,"RangTeq Retractable Oval Badge with Key Chain ID Holder (Black), Pack of 10",Warehouse C,51,38,2025-02-24 06:55:00,13
8576,ORD_8577,29199,The Moms Co. Oily Skin Ctm Regime 250 gm,Warehouse A,66,60,2025-02-24 19:34:00,6
8577,ORD_8578,25797,"Gaiatop USB Desk Fan, Small But Powerful, Portable Quiet 3 Speeds Wind Personal Table Fan, Dual 360° Adjustment Mini Fan f...",Warehouse A,42,29,2025-02-24 19:05:00,13
8578,ORD_8579,3905,Alpred 16 Tablet,Warehouse C,46,37,2025-02-24 00:46:00,9
8579,ORD_8580,5859,Faces Canada Ultime Pro Hd Intense Matte Lips + Primer Lights Out 24 1.4 Gm,Warehouse B,51,41,2025-02-24 21:10:00,10
8580,ORD_8581,3157,TG Act 20mg Tablet,Warehouse A,85,73,2025-02-24 18:29:00,12
8581,ORD_8582,29771,Hybet 8mg Tablet,Warehouse A,40,22,2025-02-24 08:32:00,18
8582,ORD_8583,3084,Fastrack Two Timers Analog Black Dial Men's Watch-NN38042PP01/NP38042PP01,Warehouse A,79,67,2025-02-24 23:46:00,12
8583,ORD_8584,3158,"Camlin Kokuyo Pack of 18 shade bottles 10ml each, 1 palette, 1 brush",Warehouse A,29,14,2025-02-24 05:26:00,15
8584,ORD_8585,30107,United Dreams Live Free Eau De Toilette,Warehouse C,44,32,2025-02-24 08:14:00,12
8585,ORD_8586,31144,"EGOTUDE Designed for iPhone 14 Plus Case, Shockproof Hard Back Cover for iPhone 14 Plus 6.7 inch (Clear)",Warehouse C,14,8,2025-02-24 12:00:00,6
8586,ORD_8587,26823,Waterproof Toilet Seat Cover,Warehouse B,30,21,2025-02-24 02:48:00,9
8587,ORD_8588,3836,Holl O 100mg/100mg Tablet,Warehouse C,48,33,2025-02-24 16:22:00,15
8588,ORD_8589,29190,Flormar Waterproof Eyeliner 102 Smoky Grey 1.14 gm,Warehouse C,26,20,2025-02-24 20:37:00,6
8589,ORD_8590,6411,Skineace beauty makeup 5 in 1 Waterproof Matte Lipstick Set Long Lasting Colorful Lipstick Multicolor (Pack of 1),Warehouse C,67,62,2025-02-24 02:48:00,5
8590,ORD_8591,29224,Kapihung Syrup,Warehouse B,39,30,2025-02-24 05:04:00,9
8591,ORD_8592,24806,Glymox Plus 500mg/500mg Injection,Warehouse A,22,4,2025-02-24 04:15:00,18
8592,ORD_8593,32446,KissBeauty FIT Skin Long Lasting Matte Powder Compact (Shade 02),Warehouse A,108,96,2025-02-24 19:58:00,12
8593,ORD_8594,6070,Swa Itra 100mg Capsule,Warehouse B,62,47,2025-02-24 03:46:00,15
8594,ORD_8595,27287,Color Naturals Creme Riche Sachet,Warehouse A,23,17,2025-02-24 19:15:00,6
8595,ORD_8596,6130,Vantil O 200mg/200mg Tablet,Warehouse C,86,75,2025-02-24 22:11:00,11
8596,ORD_8597,24801,SHOPEE 8 x10.5 FT Black LEKERA Backdrop Photo Light Studio Photography Background,Warehouse A,89,82,2025-02-24 23:23:00,7
8597,ORD_8598,30006,BROTHER BT5000Y Ink Bottle (Yellow),Warehouse C,70,64,2025-02-24 04:31:00,6
8598,ORD_8599,25500,Knead Gel,Warehouse A,72,59,2025-02-24 18:26:00,13
8599,ORD_8600,25378,"iQOO Neo 6 5G (Dark Nova, 8GB RAM, 128GB Storage) | Only Snapdragon 870 in The Segment | 50% Charge in Just 12 Mins | 90 F...",Warehouse A,29,21,2025-02-24 02:01:00,8
8600,ORD_8601,29135,"Luxor 5 Subject Single Ruled Notebook - B5, 70 GSM, 300 pages",Warehouse C,81,73,2025-02-24 20:17:00,8
8601,ORD_8602,2266,Bhumyalakki Tablets,Warehouse B,93,77,2025-02-24 08:09:00,16
8602,ORD_8603,27272,Glimicut M 1mg/500mg Tablet,Warehouse C,16,7,2025-02-24 09:20:00,9
8603,ORD_8604,32871,Ceftril 1gm Injection,Warehouse A,79,72,2025-02-24 17:03:00,7
8604,ORD_8605,17497,Amozo Back Cover Case for iPhone 13 Mini (Polycarbonate|Transparent),Warehouse C,26,9,2025-02-24 12:34:00,17
8605,ORD_8606,12068,"BRUSTRO Artist Drawing Glued Pad, 200 GSM, A4-24 Sheets",Warehouse B,15,2,2025-02-24 00:26:00,13
8606,ORD_8607,17588,"Professional Prominent Hair Dryer - 2000 Watt, Black",Warehouse A,95,78,2025-02-24 18:54:00,17
8607,ORD_8608,35833,Crystoclav 250mg/125mg Tablet,Warehouse B,52,38,2025-02-24 08:24:00,14
8608,ORD_8609,8705,Glimiprime M 3 Forte Tablet,Warehouse A,81,74,2025-02-24 17:04:00,7
8609,ORD_8610,35433,Snizid 10mg Tablet,Warehouse A,65,50,2025-02-24 08:29:00,15
8610,ORD_8611,24511,Etibliss ES 5mg Tablet,Warehouse C,46,31,2025-02-24 10:17:00,15
8611,ORD_8612,12025,Faces Canada Highlighter Fan Brush 1'S,Warehouse C,51,38,2025-02-24 12:37:00,13
8612,ORD_8613,18851,Potlyte 15% Injection,Warehouse A,111,95,2025-02-24 19:00:00,16
8613,ORD_8614,12773,"Fashion Colour Kiss Lip No Transfer Lipstick, 61 Rose Mauve 2.6 gm",Warehouse A,87,74,2025-02-24 23:43:00,13
8614,ORD_8615,1002,Roxn Kid 50mg Tablet,Warehouse A,12,6,2025-02-24 18:13:00,6
8615,ORD_8616,34899,Sylstep 500mg Tablet,Warehouse A,49,40,2025-02-24 13:24:00,9
8616,ORD_8617,16933,Lotion - Almond Moisturising,Warehouse C,18,5,2025-02-24 07:54:00,13
8617,ORD_8618,13,Minsu-MD Tablet,Warehouse B,102,89,2025-02-24 16:31:00,13
8618,ORD_8619,36416,Oil Control Face Wash For Oily Skin - 12hr Oil Control With 10x Vitamin C Effect,Warehouse B,84,73,2025-02-24 19:57:00,11
8619,ORD_8620,36287,Plantas 24 Hours Skin Hydrating Organic Body Lotion (Extra Dry Skin) 100 ml,Warehouse B,37,23,2025-02-24 16:24:00,14
8620,ORD_8621,1464,"tizum Earphone Carrying Case - Multi Purpose Pocket Storage with Carabinr Hook, Travel Organizer for Earphones, Pen Drive...",Warehouse B,26,16,2025-02-24 02:26:00,10
8621,ORD_8622,11365,Maczone XP 250 mg/31.25 mg Injection,Warehouse C,84,70,2025-02-24 02:27:00,14
8622,ORD_8623,16928,Taxipime 1gm Injection,Warehouse B,103,98,2025-02-24 01:51:00,5
8623,ORD_8624,6953,Purifying Tea Tree Facial Foam,Warehouse C,21,4,2025-02-24 08:22:00,17
8624,ORD_8625,18843,Genericart Rosuvastatin 10mg Tablet,Warehouse B,75,66,2025-02-24 21:36:00,9
8625,ORD_8626,10534,Punarnava Astringent,Warehouse B,27,9,2025-02-24 01:00:00,18
8626,ORD_8627,22818,Monotax CV 200mg/125mg Tablet,Warehouse B,52,42,2025-02-24 18:23:00,10
8627,ORD_8628,18844,Nandika Beauty Hair Removal Wax - Charcoal 600 ml,Warehouse B,89,75,2025-02-24 04:57:00,14
8628,ORD_8629,24595,Dalacin C 300mg Injection,Warehouse C,92,73,2025-02-24 04:04:00,19
8629,ORD_8630,21434,Bella Voste Luxe Neon Shade No 276 10 Ml,Warehouse C,60,47,2025-02-24 12:30:00,13
8630,ORD_8631,34602,Olsar-H 40 Tablet,Warehouse B,110,93,2025-02-24 18:47:00,17
8631,ORD_8632,17240,Man Matters Gas Free Non - Transferable Spray | Oil Based Spray | Safe & Effective | 20ml,Warehouse B,101,84,2025-02-24 11:56:00,17
8632,ORD_8633,19727,Electronic Spices - COMBO Of 9v Battery And 9V Battery Connector -Pair Of 5,Warehouse A,22,7,2025-02-24 19:27:00,15
8633,ORD_8634,15297,"Amazon Brand - Solimo Height & Angle Adjustable Tabletop Desk Cellphone Holder for All Mobiles & Tablets, Universal Foldab...",Warehouse B,91,80,2025-02-24 06:02:00,11
8634,ORD_8635,21425,Touchpride M 1mg/500mg Tablet ER,Warehouse B,56,47,2025-02-24 00:23:00,9
8635,ORD_8636,19885,Shirashoolari Vati - 300 mg,Warehouse A,51,37,2025-02-24 18:01:00,14
8636,ORD_8637,22968,Vomiget 4mg Tablet MD,Warehouse B,98,82,2025-02-24 14:42:00,16
8637,ORD_8638,6981,Nanomom-HT Cream,Warehouse A,73,61,2025-02-24 06:17:00,12
8638,ORD_8639,34615,Shikakai Powder,Warehouse C,26,8,2025-02-24 17:16:00,18
8639,ORD_8640,10955,Mamaearth Soothing Massage Oil 100 ml,Warehouse A,63,49,2025-02-24 09:21:00,14
8640,ORD_8641,15141,Evior 6 Body Razor Trial Kit for Women - Twin 3 Blade Design Razor,Warehouse B,97,85,2025-02-24 11:32:00,12
8641,ORD_8642,8956,Erythro 20mg Injection,Warehouse B,24,5,2025-02-24 13:01:00,19
8642,ORD_8643,201,Cefatry 250mg Tablet DT,Warehouse C,46,30,2025-02-24 23:45:00,16
8643,ORD_8644,10929,"Fashion Colour Lip Crayon, Waterproof, Long Lasting, 26 Almond Pink 2.8 gm",Warehouse B,79,70,2025-02-24 07:12:00,9
8644,ORD_8645,1135,"Zitel Case with Screen Protector Compatible for Apple Watch SE 2nd gen 2022 / Series 6/5/4 SE, 44mm Hard PC Cover with Bui...",Warehouse C,108,95,2025-02-24 09:47:00,13
8645,ORD_8646,10138,Hair Logic Kerafused Shampoo 1's,Warehouse C,47,37,2025-02-24 15:12:00,10
8646,ORD_8647,1987,Thyocol 8mg Tablet,Warehouse A,49,31,2025-02-24 09:09:00,18
8647,ORD_8648,24521,Pumpkin Seeds - Premium Raw,Warehouse B,58,53,2025-02-24 12:25:00,5
8648,ORD_8649,24621,Nataraj Wooden Picture Pencils (Pack Of 50 Pencils 5 Sharpener Free),Warehouse C,67,56,2025-02-24 11:14:00,11
8649,ORD_8650,24528,"pTron Bassbuds Wave ENC Bluetooth 5.3 Wireless in-Ear TWS Earbuds with Mic, 40Hrs Total Playtime, Movie Mode & Deep Bass, ...",Warehouse A,109,93,2025-02-24 14:44:00,16
8650,ORD_8651,33602,"SanDisk Ultra SDHC UHS-I Card 32GB 120MB/s R for DSLR Cameras, for Full HD Recording, 10Y Warranty",Warehouse B,28,12,2025-02-24 11:57:00,16
8651,ORD_8652,18819,Bella Voste 4-In-1 Makeup Stick Orange (21) 5.5 Gm,Warehouse C,54,45,2025-02-24 03:36:00,9
8652,ORD_8653,6982,"ZEBRONICS Firestorm Gaming Mouse pad for All Mouse sensors with Micro-Textured Fabric Surface, Anti Slip Rubber Base, 350x...",Warehouse C,17,9,2025-02-24 08:09:00,8
8653,ORD_8654,16159,Green Cucumber Toner,Warehouse B,84,69,2025-02-24 08:47:00,15
8654,ORD_8655,1991,"OGX Thick & Full Biotin & Collagen Volumizing Conditioner | Vitamin B7, Collagen & Hydrolyzed Wheat Protein, For Thicker, ...",Warehouse B,70,60,2025-02-24 14:21:00,10
8655,ORD_8656,11621,Qubo Smart Cam 360 from Hero Group | Made in India | 2MP 1080p Full HD | CCTV Wi-Fi Camera | 360 Degree Coverage| Two Way ...,Warehouse B,95,87,2025-02-24 23:14:00,8
8656,ORD_8657,24539,Oflobest Oral Suspension,Warehouse C,50,35,2025-02-24 04:50:00,15
8657,ORD_8658,15429,"boAt Stone 1450 Portable Wireless Speaker with 40W RMS Signature Sound, RGB LEDs, TWS Feature, Multi-Compatibility Modes, ...",Warehouse A,79,60,2025-02-24 04:32:00,19
8658,ORD_8659,8751,"ESR Camera Lens Protector Compatible with Samsung Galaxy S22 Ultra, Scratch-Resistant Ultra-Thin Tempered Glass with Alumi...",Warehouse C,27,19,2025-02-24 02:49:00,8
8659,ORD_8660,22956,UniqueArt White Stone God Ganesha with Rosewooden Base Car Dashboard Decor Statue | Hindu Idol God Ganesh Ganpati Decor Sc...,Warehouse C,17,10,2025-02-24 11:00:00,7
8660,ORD_8661,10541,Bella Voste Luxe Neon Shade No 273 10 Ml,Warehouse A,75,68,2025-02-24 02:19:00,7
8661,ORD_8662,13508,"ASUS Vivobook 15 (2022), 15.6"" (39.62 cms) FHD, Intel Core i3-1220P 12th Gen, Thin and Light Laptop (8GB/512GB SSD/Iris Xe...",Warehouse B,98,87,2025-02-24 00:49:00,11
8662,ORD_8663,9241,Ranolaz OD Tablet ER,Warehouse C,105,93,2025-02-24 20:02:00,12
8663,ORD_8664,16949,"Sakura Pigma Micron 10 Fineliner pens Black Archival Ink Artist Drawing Sketch pens (003, 005, 01, 02, 03, 04, 05, 08), Gr...",Warehouse A,104,86,2025-02-24 21:09:00,18
8664,ORD_8665,13317,Topiranol 50mg Tablet,Warehouse C,55,43,2025-02-24 17:24:00,12
8665,ORD_8666,11190,"Redmi 10 (Pacific Blue, 4GB RAM, 64GB Storage)",Warehouse C,61,48,2025-02-24 05:15:00,13
8666,ORD_8667,16158,Classmate Octane- Blue Gel Pens (Pack of 10)|Smooth Writing Pens|Water-proof ink for smudge-free writing|Preferred by Stud...,Warehouse A,48,41,2025-02-24 02:00:00,7
8667,ORD_8668,19386,Original H12348 Battery Compatible for Reliance Jio WiFi 4G Router JioFi 2 M2 (2300mAh) - 3 Months Warranty,Warehouse C,97,90,2025-02-24 21:52:00,7
8668,ORD_8669,35595,Alfex 60mg Tablet,Warehouse B,19,2,2025-02-24 21:59:00,17
8669,ORD_8670,34174,Acidcom-DSR 30mg/40mg Capsule,Warehouse A,23,13,2025-02-24 14:17:00,10
8670,ORD_8671,10549,Passion Indulge BATH BAR-ROSE ( PACK OF 3 ) 1's,Warehouse B,94,84,2025-02-24 15:05:00,10
8671,ORD_8672,9793,Hiclav CV 1000mg/200mg Injection,Warehouse A,54,46,2025-02-24 06:24:00,8
8672,ORD_8673,19617,Glopid 100mg Tablet,Warehouse C,92,87,2025-02-24 21:31:00,5
8673,ORD_8674,39,Azolbest 200 Capsule,Warehouse C,19,10,2025-02-24 03:37:00,9
8674,ORD_8675,11683,House of Aroma Patchouli Fragrance Oil 100 ml,Warehouse A,66,48,2025-02-24 21:21:00,18
8675,ORD_8676,10973,"IFB 20 L Grill Microwave Oven (20PG4S, Black & Silver, With Starter Kit)",Warehouse A,58,43,2025-02-24 01:05:00,15
8676,ORD_8677,7055,"Amazon Basics Double Braided Nylon USB Type-C to Type-C 2.0 Cable Smartphone (Dark Grey, 3 feet)",Warehouse C,38,24,2025-02-24 18:14:00,14
8677,ORD_8678,36105,Perfect Radiance - Lightening Light Cream With Sunscreen,Warehouse A,100,95,2025-02-24 19:56:00,5
8678,ORD_8679,18272,"Kadence Heavy-Duty, Double-X, Adjustable Piano Keyboard Stand with Locking Straps (NK13-3kg Dual Braced)",Warehouse C,97,92,2025-02-24 06:41:00,5
8679,ORD_8680,181,"Parker Frontier Matte Black (Gold Nib) GT Fountain Pen, 1 Count (Pack of 1) (9000020642)",Warehouse C,66,52,2025-02-24 08:13:00,14
8680,ORD_8681,9564,Falciryn 150mg Injection,Warehouse A,79,66,2025-02-24 01:17:00,13
8681,ORD_8682,21605,Tosif O Syrup,Warehouse B,85,78,2025-02-24 04:03:00,7
8682,ORD_8683,20539,"AmazonBasics Double Braided Nylon USB Type-C to Type-A 2.0 Male Cable for Laptop (Red, 10 Feet/3 Meters)",Warehouse A,63,58,2025-02-24 03:43:00,5
8683,ORD_8684,14436,Olmovin C 40mg/12.5mg Tablet,Warehouse A,71,59,2025-02-24 16:53:00,12
8684,ORD_8685,35101,Plum Bodylovin Tropical Tango Colada (Gel Lotion) 240 Ml,Warehouse B,108,93,2025-02-24 04:43:00,15
8685,ORD_8686,1153,Britzilam 25 Tablet,Warehouse A,48,30,2025-02-24 00:02:00,18
8686,ORD_8687,1392,G-Gesic-SP Tablet,Warehouse B,68,53,2025-02-24 12:08:00,15
8687,ORD_8688,12314,FEDUS 5.9 Feet 3 Pin AC Laptop Power Cord Cable Notebook Computer Replacement Charger Cord Wire 18AWG Laptop Adapter Power...,Warehouse B,17,12,2025-02-24 17:57:00,5
8688,ORD_8689,18799,"Men's Body Oil - Energising, Ashwagandha",Warehouse A,17,4,2025-02-24 07:21:00,13
8689,ORD_8690,11373,"Fashion Colour Hair Colour Spray, Silver 150 ml",Warehouse B,74,66,2025-02-24 05:37:00,8
8690,ORD_8691,7000,Azafran Organics Aqua Halo Rejuv Conditioner 100 gm,Warehouse B,92,76,2025-02-24 16:16:00,16
8691,ORD_8692,33595,"Klsniur Mount/Tablet Car Backseat Seat Mount/Tablet Headrest Universal 360° Rotating Holder Adjustable for All 6""-10.5"" Ta...",Warehouse C,34,17,2025-02-24 21:41:00,17
8692,ORD_8693,8905,Fixilix OZ 200mg/500mg Tablet,Warehouse A,17,4,2025-02-24 18:47:00,13
8693,ORD_8694,18281,Beauty People Natural HD Matte Lip Crayon Vivid - 102 4 gm,Warehouse A,62,50,2025-02-24 02:48:00,12
8694,ORD_8695,18860,Solopod KID 50mg Tablet DT,Warehouse C,56,41,2025-02-24 03:15:00,15
8695,ORD_8696,22777,"Fashion Colour Lip Crayon, Waterproof, Long Lasting, 10 Dune 2.8 gm",Warehouse A,80,74,2025-02-24 02:51:00,6
8696,ORD_8697,14501,Spigen Thin Fit Back Cover Compatible for Google Pixel 6a (Poly Carbonate | Black),Warehouse A,78,62,2025-02-24 10:24:00,16
8697,ORD_8698,19854,Global Mythical Bloom Eau De Parfum 100ML & Rhytmic Soul Body Mist 200ML Pack of 2 for Women Crafted by Ajmal,Warehouse A,101,84,2025-02-24 16:30:00,17
8698,ORD_8699,24377,Lnbeta 2.5 Tablet,Warehouse C,44,26,2025-02-24 15:14:00,18
8699,ORD_8700,24386,Spigen Ultra Hybrid Back Cover Case Compatible with iPhone 14 Pro (TPU + Poly Carbonate | Deep Purple),Warehouse C,80,61,2025-02-24 23:48:00,19
8700,ORD_8701,1006,Coral 300mg Capsule,Warehouse A,73,66,2025-02-24 10:32:00,7
8701,ORD_8702,9727,Aurcin OZ Tablet,Warehouse C,89,84,2025-02-24 12:14:00,5
8702,ORD_8703,24556,"HAKUHO Telephone Line Cord Telephone Extension Cord 2 Pin, 1 Line Rj11 Male To Male Cable Or Landline, Phone, Modem Or Fax...",Warehouse A,97,80,2025-02-24 17:08:00,17
8703,ORD_8704,9199,Clono 0.5mg Tablet,Warehouse C,66,48,2025-02-24 00:15:00,18
8704,ORD_8705,10535,Setikast LC Syrup,Warehouse B,47,33,2025-02-24 00:41:00,14
8705,ORD_8706,6944,"Jabra Talk 65 Mono Bluetooth Wireless in Ear Premium Wireless Single Ear Earphones - with mic Noise Cancelling, Media Stre...",Warehouse C,69,60,2025-02-24 18:46:00,9
8706,ORD_8707,21469,"Beardo Don Perfume Body Spray, 150ml - Aquatic Woody, Deo For Men (Pack of 1)",Warehouse C,73,66,2025-02-24 02:59:00,7
8707,ORD_8708,18834,Flormar Diamonds Baked Eye Shadow D04 Pink Diamond 5 gm,Warehouse A,102,92,2025-02-24 23:18:00,10
8708,ORD_8709,9228,"TP-Link Archer C64 AC1200 Dual-Band Gigabit Wi-Fi Router, Wireless Speed up to 1200 Mbps, 4×LAN Ports, 1.2 GHz CPU, Advanc...",Warehouse C,48,38,2025-02-24 11:30:00,10
8709,ORD_8710,13495,Amazon Basics RGB Light Gaming Mouse Pad Desk Mat for Computer Laptop | Stitched Embroidery Edges | Non-Slip Rubber Base |...,Warehouse B,61,48,2025-02-24 02:27:00,13
8710,ORD_8711,35946,"HP Deskjet 2723 AIO Printer, Copy, Scan, WiFi, Bluetooth, USB, Simple Setup Smart App, Ideal for Home.",Warehouse A,30,12,2025-02-24 06:19:00,18
8711,ORD_8712,13298,Medimade Pink Rose Body Butter 200 ml,Warehouse A,70,54,2025-02-24 07:32:00,16
8712,ORD_8713,13324,Paralic Plus Oral Suspension,Warehouse C,18,12,2025-02-24 06:00:00,6
8713,ORD_8714,15449,"SanDisk Ultra Dual Drive Go USB 3.0 Type C Flash Drive, Peach, 128GB, 5Y",Warehouse C,44,32,2025-02-24 20:11:00,12
8714,ORD_8715,14441,Invisible Shaving Gel - Beard Grooming,Warehouse B,51,38,2025-02-24 04:05:00,13
8715,ORD_8716,1390,Hair Grown Oil 100ml by KEYA SETH AROMATHERAPY,Warehouse B,16,1,2025-02-24 18:23:00,15
8716,ORD_8717,15476,Lenovo FHD Webcam with Full Stereo Dual Built-in mics | FHD 1080P 2.1 Megapixel Digital CMOS Camera |Wide 95 Lens| 360 Rot...,Warehouse C,20,2,2025-02-24 04:10:00,18
8717,ORD_8718,10970,Digesun Oral Suspension Mint,Warehouse C,84,72,2025-02-24 18:50:00,12
8718,ORD_8719,17281,"Mobilife LED Video Light,Camera Light,Computer Light for Zoom Meeting Photography Lighting 100 LED Beads with Clip and 3 C...",Warehouse C,83,77,2025-02-24 01:59:00,6
8719,ORD_8720,13428,Andy 25mg Injection,Warehouse B,62,57,2025-02-24 14:14:00,5
8720,ORD_8721,16570,Atulya Rose Essential Oil 15 ml,Warehouse B,41,33,2025-02-24 18:02:00,8
8721,ORD_8722,19936,Dinmol SP 50mg/325mg/15mg Tablet,Warehouse A,49,32,2025-02-24 23:01:00,17
8722,ORD_8723,19938,E-Fact 50 Oral Suspension,Warehouse C,44,33,2025-02-24 22:10:00,11
8723,ORD_8724,10210,"Beetel X70 Cordless Landline Phone, 2.4GHz, 2 Way Speakerphone, Volume Adjustment",Warehouse A,101,94,2025-02-24 06:53:00,7
8724,ORD_8725,20544,"Bare Minimum vitamin B5 facewash 150 ml for tanned skin, Helps in Exfoliating and brightening skin face wash for women & men",Warehouse B,88,70,2025-02-24 02:42:00,18
8725,ORD_8726,33589,Oraclam 875mg/125mg Tablet,Warehouse B,110,94,2025-02-24 14:56:00,16
8726,ORD_8727,34550,Ascotus Syrup,Warehouse C,91,80,2025-02-24 07:45:00,11
8727,ORD_8728,35253,Asvbolin 25mg Injection,Warehouse A,37,18,2025-02-24 21:16:00,19
8728,ORD_8729,19347,OFIXO RFID Credit Card Holder Protector Credit Card Wallet Slim RFID Metal Credit Card Case for Women or Men (MATT Black),Warehouse A,91,81,2025-02-24 12:26:00,10
8729,ORD_8730,50,"ZEBRONICS Zeb-Fun 3 W Karaoke Mic Comes with Bluetooth Supporting Speaker, mSD Card, AUX and Media Control(Green)",Warehouse B,54,44,2025-02-24 22:39:00,10
8730,ORD_8731,13208,Wokex 3 450 mg/300 mg/800 mg Kit,Warehouse C,66,49,2025-02-24 08:39:00,17
8731,ORD_8732,11166,Hexpan 40mg Tablet,Warehouse C,80,70,2025-02-24 22:52:00,10
8732,ORD_8733,10974,Vibez by Lifelong Ornate Smartwatch For Women with HD Display|Body Temprature |24x7 Heart Rate & SpO2 Tracking|8 Sports Mo...,Warehouse C,57,48,2025-02-24 19:55:00,9
8733,ORD_8734,6903,"Aromacare Pigmentation & Skin Lightening & Glowing Day Cream For All Skin Type, 60g",Warehouse A,97,78,2025-02-24 00:11:00,19
8734,ORD_8735,17610,Pilot Frixion C3 Roller Ball Pen,Warehouse B,103,92,2025-02-24 07:23:00,11
8735,ORD_8736,984,VKB Tripod Mount Adapter| Tripod Mobile Holder|Tripod Phone Mount| Smartphone Clip Clipper 360 Degree for Taking Magic Vid...,Warehouse B,101,88,2025-02-24 17:30:00,13
8736,ORD_8737,13590,Generic Imported 100 Pcs Microfiber Sunglasses Eyeglasses Glasses Cleaning Cloth Lens Cleaner,Warehouse C,48,34,2025-02-24 03:06:00,14
8737,ORD_8738,17542,VH 3 Vaginal Soft Gelatin Capsule,Warehouse B,61,55,2025-02-24 14:42:00,6
8738,ORD_8739,19734,TheGiftKart Ultra-Hybrid Crystal Clear Back Case Cover for Nothing Phone 1 | Shockproof Design | Camera Protection Bump | ...,Warehouse C,23,14,2025-02-24 10:43:00,9
8739,ORD_8740,17656,"boAt Stone 1200 14W Bluetooth Speaker with Upto 9 Hours Battery, RGB LEDs, IPX7 and TWS Feature((Techno Purple)",Warehouse A,28,13,2025-02-24 14:50:00,15
8740,ORD_8741,33696,Aroma NB128 Grace 24 Hours Playing Time | Deep Bass | Made in India | Neckband Earphone Bluetooth Headset (Green),Warehouse B,75,58,2025-02-24 00:45:00,17
8741,ORD_8742,34886,SUGAR POP Ultra HD Blush-01 Rose (Deep Rose) | Ultra Matte and Super Blendable | Natural Glow | Highly Pigmented | Dramati...,Warehouse C,101,89,2025-02-24 18:52:00,12
8742,ORD_8743,24683,Antiban 75 Tablet,Warehouse C,60,54,2025-02-24 09:26:00,6
8743,ORD_8744,34155,"Teen.Teen Hd Studio Photogenic Flawless Compact Powder, 14 Gm",Warehouse C,54,37,2025-02-24 04:49:00,17
8744,ORD_8745,16177,Medimade Cocoa Butter And Shea Butter Moisturizing Body Lotion 300 ml,Warehouse B,55,42,2025-02-24 17:46:00,13
8745,ORD_8746,12805,Tona 200mg Tablet,Warehouse C,98,87,2025-02-24 07:13:00,11
8746,ORD_8747,14575,Mouth Sore Gel,Warehouse A,15,9,2025-02-24 08:23:00,6
8747,ORD_8748,36263,Segocort 6mg Tablet,Warehouse B,21,2,2025-02-24 16:24:00,19
8748,ORD_8749,287,Passion Indulge MOISTURE - ETERNIA 50 gm,Warehouse A,74,69,2025-02-24 04:22:00,5
8749,ORD_8750,11771,Glimed M 1 Tablet,Warehouse A,35,17,2025-02-24 11:50:00,18
8750,ORD_8751,7814,"Belkin Fast Charging,Universally Compatible Dual USB-C 40W Pd Wall Charger-Power Delivery 3.0 Certified,Each Port Delivers...",Warehouse A,17,5,2025-02-24 03:06:00,12
8751,ORD_8752,11579,"CRUST CS45 Car Bluetooth Device for Music System, FM Transmitter with Call Receiver; (PD 20W + QC3.0) Fast Charger; Real T...",Warehouse B,47,33,2025-02-24 13:30:00,14
8752,ORD_8753,7106,Zitrost 250mg Tablet,Warehouse A,62,50,2025-02-24 01:45:00,12
8753,ORD_8754,33581,Abpex 100mg Capsule,Warehouse B,44,38,2025-02-24 22:41:00,6
8754,ORD_8755,15206,Nasovis Nasal Drops,Warehouse B,38,29,2025-02-24 11:49:00,9
8755,ORD_8756,11730,Glimmer Premium Nail Enamel Navy Blue 10 ml,Warehouse A,44,33,2025-02-24 10:26:00,11
8756,ORD_8757,7821,"Keya Seth Aromatherapy 100% Natural Dust Sindoor Red with Herbs Extracts & Floral Pigments Kumkum, No Side Effects & No Ha...",Warehouse C,78,65,2025-02-24 00:14:00,13
8757,ORD_8758,15791,Pilgrim Korean Salicylic Acid 1% + Glycolic Acid 3% Anti Acne Serum for oily & acne prone skin | All Skin Types | Korean S...,Warehouse A,87,69,2025-02-24 21:02:00,18
8758,ORD_8759,16469,Clinsof 300mg Capsule,Warehouse C,48,42,2025-02-24 10:31:00,6
8759,ORD_8760,13245,HAYMAN 24 CT Gold Plated Roller Pen With Box (P-53),Warehouse A,29,14,2025-02-24 04:04:00,15
8760,ORD_8761,1165,Belora Paris Paint & Pout- Lip & Cheek - Chipmunk Brown 3 ml,Warehouse A,39,23,2025-02-24 09:59:00,16
8761,ORD_8762,11342,Cutiact 4 Cream,Warehouse A,38,31,2025-02-24 19:32:00,7
8762,ORD_8763,12053,Nodosis Tablet,Warehouse C,91,82,2025-02-24 14:51:00,9
8763,ORD_8764,18212,"S.A.V.I 3D Temporary Tattoo Waterproof Sticker Beautiful Black Big Ganesha Face Popular New Designs Size - 21x15cm (226), ...",Warehouse A,55,42,2025-02-24 02:21:00,13
8764,ORD_8765,15187,Stalmox 250mg Capsule,Warehouse B,41,22,2025-02-24 03:33:00,19
8765,ORD_8766,18251,Amptek AT6-4.5 6V 4.5AH SMF/VRLA Battery | Sealed Lead Acid Battery | Strong ABS | Wide Temperature Range | Battery for El...,Warehouse B,109,94,2025-02-24 02:50:00,15
8766,ORD_8767,7120,rts Type C USB C to USB Universal Travel Adapter / International All in One Worldwide Universal Travel Adapters –AC Wall P...,Warehouse A,75,67,2025-02-24 17:03:00,8
8767,ORD_8768,17203,Blaise LS Junior Syrup,Warehouse A,114,97,2025-02-24 17:27:00,17
8768,ORD_8769,19847,Norglim-MF 1 Tablet SR,Warehouse C,87,81,2025-02-24 01:44:00,6
8769,ORD_8770,21699,Acitrip DSR Capsule,Warehouse B,103,87,2025-02-24 17:47:00,16
8770,ORD_8771,16734,Apsara Non Dust Erasers - Pack of 20,Warehouse B,99,93,2025-02-24 11:45:00,6
8771,ORD_8772,9537,Defbert 6 Tablet,Warehouse A,45,35,2025-02-24 10:56:00,10
8772,ORD_8773,11145,Superdry - Sport Re Start Body + Hair Wash 250 ml,Warehouse C,13,3,2025-02-24 14:23:00,10
8773,ORD_8774,24605,Covaz Tablet,Warehouse C,95,88,2025-02-24 05:47:00,7
8774,ORD_8775,19743,Endoworm Syrup,Warehouse B,99,94,2025-02-24 05:11:00,5
8775,ORD_8776,11711,"boAt Matrix Smart Watch with 1.65” AMOLED Display, Always On Mode, Slim Premium Design, Heart Rate & SpO2 Monitoring, Heal...",Warehouse C,35,20,2025-02-24 05:55:00,15
8776,ORD_8777,14594,Levotrig 5mg Tablet,Warehouse A,71,60,2025-02-24 11:41:00,11
8777,ORD_8778,19957,JBL New Live Free 2 TWS | True Adaptive Noise Cancelling In Ear Earbuds | Adjustable EQ | 35Hrs Playtime | IPX5 | 6 Mics f...,Warehouse C,18,13,2025-02-24 21:48:00,5
8778,ORD_8779,1427,"AMOSFIA Green Gel Lipstick Long-Lasting Natural Color Change GREEN APPLE (Pack of: 1, 3.7 g)",Warehouse B,29,10,2025-02-24 11:15:00,19
8779,ORD_8780,23081,B BOSS 9 Inch Android Car Accessories Navigation or Music System Stereo Touch Screen Guard,Warehouse A,33,26,2025-02-24 14:56:00,7
8780,ORD_8781,35927,Neodol K 50mg Tablet,Warehouse A,54,45,2025-02-24 02:50:00,9
8781,ORD_8782,13645,Eumosone-M Cream,Warehouse B,48,30,2025-02-24 20:22:00,18
8782,ORD_8783,13417,"QERINKLE Marble Pattern Makeup Brushes Cosmetic Makeup Brush Set for Foundation, Blush, Eye shadow, Eyelash, Lip and Brow,...",Warehouse B,108,96,2025-02-24 16:14:00,12
8783,ORD_8784,13348,Greatcef 200 Tablet,Warehouse A,74,68,2025-02-24 22:38:00,6
8784,ORD_8785,21330,Revlon Color N Care Permanent Hair Color Cream- Natural Black 1N 40 Gm,Warehouse B,92,76,2025-02-24 04:30:00,16
8785,ORD_8786,12186,"STRIFF Invisible and Foldable Mobile Stand for Phone, Ultra-Light Phone Card Holder, The Thinnest Vertical Phone Wallet(Bl...",Warehouse A,73,62,2025-02-24 20:28:00,11
8786,ORD_8787,36231,"Casio CT-S300 Casiotone 61-Key Touch Sensitive Portable Keyboard with Piano tones, Black",Warehouse A,113,94,2025-02-24 05:09:00,19
8787,ORD_8788,11744,"KZ EDX PRO Earphones Headphones with 1DD, Yinyoo EDX PRO Wired in Ear Earbuds HiFi Deep Bass Sound with 1DD New 10mm Dynam...",Warehouse B,68,59,2025-02-24 12:20:00,9
8788,ORD_8789,21084,Beauty People Sheer Color Lipstick - Just - Orange - 601 3.8 gm,Warehouse C,90,77,2025-02-24 13:53:00,13
8789,ORD_8790,35853,TOPRONICS JIO M2S WiFi Hotspot Data Card 150MBPS Dual Band Router Black Colour,Warehouse B,17,3,2025-02-24 15:13:00,14
8790,ORD_8791,15479,Spigen Polyurethane Thermoplastic Polyurethane Rugged Armor Pro Cover Case Designed for Samsung Galaxy Tab S8 | S7 (5G/LT...,Warehouse A,60,48,2025-02-24 15:58:00,12
8791,ORD_8792,17199,Allure Classic Ack-07 (Pack Of 7) Makeup Brush 1's,Warehouse A,64,51,2025-02-24 05:29:00,13
8792,ORD_8793,8601,"Tenda F3 300Mbps Wireless Wi-Fi Router (White, Single_Band Not a Modem, 300 megabits_per_Second)",Warehouse B,69,51,2025-02-24 18:24:00,18
8793,ORD_8794,23109,Hbmol 10mg/ml Infusion,Warehouse B,98,80,2025-02-24 08:22:00,18
8794,ORD_8795,9825,Alril Tablet,Warehouse A,81,73,2025-02-24 12:33:00,8
8795,ORD_8796,17814,The Moms Co. Natural Daily Face Toner With Vitamin C 200 ml,Warehouse C,76,58,2025-02-24 06:03:00,18
8796,ORD_8797,24732,Faces Canada Ultime Pro Hd Deep Black One Stroke Kajal 1.4 Gm,Warehouse C,85,80,2025-02-24 09:26:00,5
8797,ORD_8798,8037,Maryaj Wild Speed EDP Citrus Spicy Perfume And Maryaj Dynamic EDP Spicy Woody Perfume 200 ml,Warehouse C,27,17,2025-02-24 11:36:00,10
8798,ORD_8799,7187,Pro Health Sensitive Toothbrush Soft,Warehouse C,70,55,2025-02-24 17:22:00,15
8799,ORD_8800,1523,"Patzy USB Personal Mini Portable Air Conditioner, Mini Cooler Arctic Ultra Air Cooler with 3-SpeedAdjustable 3 Fan Speeds ...",Warehouse A,58,43,2025-02-24 07:28:00,15
8800,ORD_8801,1275,EYUVAA LABEL Universal Monopod Holder Clip for Mobile Camera & Tripod Mount Holder Adjustable Smartphone Clip Clipper Comp...,Warehouse C,61,42,2025-02-24 20:44:00,19
8801,ORD_8802,36428,Vozwa Eyeshadow Gradient Chunky Glitter (Multicolor) - 24 Pieces Glossy Finish,Warehouse A,28,13,2025-02-24 18:06:00,15
8802,ORD_8803,34090,WOW IMAGINE Shock Proof Clear Back Cover Case Mobile Cover for 1+ OnePlus Nord CE 2 Lite 5G (Hard | Hybrid PC + TPU | Full...,Warehouse A,80,66,2025-02-24 03:22:00,14
8803,ORD_8804,33740,"BB Glow Treatment Kit Foundation BB Glow Kit(Mix-6 Serum,6 Cream)",Warehouse C,31,15,2025-02-24 07:28:00,16
8804,ORD_8805,7163,Coldles LS Syrup,Warehouse C,10,1,2025-02-24 19:19:00,9
8805,ORD_8806,18727,Kelfer 250 Capsule,Warehouse C,97,81,2025-02-24 03:40:00,16
8806,ORD_8807,13344,Spigen Rugged Armor Back Cover Case Compatible with Xiaomi 13 Pro (TPU | Matte Black),Warehouse B,19,13,2025-02-24 22:08:00,6
8807,ORD_8808,21784,BB Cream Light Shade Rcm 30g 2 Packs,Warehouse B,75,70,2025-02-24 17:19:00,5
8808,ORD_8809,1146,Honey & Rose Body & Face Scrub,Warehouse B,64,55,2025-02-24 21:40:00,9
8809,ORD_8810,19106,Cefdic 50mg Tablet,Warehouse C,109,98,2025-02-24 13:57:00,11
8810,ORD_8811,24714,WildHorn Leather 14 inch Laptop Messenger Bag for Men I Padded Laptop Compartment with Adjustable Strap I Extra Zip Compar...,Warehouse C,16,9,2025-02-24 10:44:00,7
8811,ORD_8812,11834,OpenTech® Tempered Glass Screen Protector Compatible for Samsung Galaxy M31s / A51 / A52 / A52s / A52 5G with Easy Install...,Warehouse A,81,69,2025-02-24 22:40:00,12
8812,ORD_8813,13667,ProElite Ultra Sleek Smart Flip Case Cover for Lenovo Tab M10 FHD Plus X606V / TB-X606F / TB-X606X 10.3 inch Tablet (Dark ...,Warehouse C,55,45,2025-02-24 18:42:00,10
8813,ORD_8814,1924,Glipy Met 500 SR Tablet,Warehouse A,20,6,2025-02-24 09:50:00,14
8814,ORD_8815,9674,"L'Oréal Paris Anti-Aging and Whitening Cream, With SPF 21 PA+++, Day Cream, For Users Over 40, Skin Perfect 40+, 50g",Warehouse A,89,75,2025-02-24 13:19:00,14
8815,ORD_8816,9699,(Renewed) Google Pixel 5 5G 128GB - Just Black,Warehouse A,65,54,2025-02-24 00:41:00,11
8816,ORD_8817,17252,"Anchor by Panasonic Spike Guard 4-Way Socket with Single Switch (White), 240 V, 1440 Watt",Warehouse C,60,54,2025-02-24 18:23:00,6
8817,ORD_8818,11490,Cipdose DX Eye/Ear Drops,Warehouse A,30,19,2025-02-24 04:50:00,11
8818,ORD_8819,36062,"Cosmic Byte CB-EP-03 Gaming Wired Earphone with Detachable Microphone for PC, PS4, Mobiles, Tablets (Black, Pack Of 1)",Warehouse A,80,64,2025-02-24 08:21:00,16
8819,ORD_8820,17314,Glimter PM 2mg/500mg/15mg Tablet SR,Warehouse B,58,53,2025-02-24 17:28:00,5
8820,ORD_8821,15703,"Firestick Remote (Alexa Voice Featured Remote Compatible with fire tv Stick, Firetv 4K)",Warehouse A,74,65,2025-02-24 15:04:00,9
8821,ORD_8822,15127,Fashion Colour Intimate Wipes 1's,Warehouse C,77,59,2025-02-24 09:29:00,18
8822,ORD_8823,13397,Godox SB-GUE80 80cm / 32 Inch Portable Octagon Honeycomb Grid Umbrella Speedlite Softbox with Bowens Mount,Warehouse B,61,45,2025-02-24 13:50:00,16
8823,ORD_8824,9510,Safexim Dry Syrup,Warehouse C,94,79,2025-02-24 15:53:00,15
8824,ORD_8825,21768,"SWISS BEAUTY Makeup Primer Oil Free Mattifying Long Lasting Base, 30 ml - Face Primer, Smooth and Long Lasting, Makeup Pri...",Warehouse C,112,93,2025-02-24 17:01:00,19
8825,ORD_8826,21766,Lizowish 600mg Tablet,Warehouse B,61,55,2025-02-24 20:07:00,6
8826,ORD_8827,20029,Allure Eyebrow Brush - (321) 1's,Warehouse C,22,13,2025-02-24 05:07:00,9
8827,ORD_8828,33760,Methercip 0.125mg Tablet,Warehouse A,102,93,2025-02-24 23:05:00,9
8828,ORD_8829,20027,TheGiftKart Flip Back Cover Case for Samsung Galaxy S20 FE / S20 FE 5G | Genuine Leather Finish | Designer Button | Inbuil...,Warehouse C,10,5,2025-02-24 00:58:00,5
8829,ORD_8830,33759,Saffron Cream - Fairness & Anti-Blemish Formula,Warehouse C,97,83,2025-02-24 06:08:00,14
8830,ORD_8831,37133,Azafran Active Botanicals Licorice & Saffron Skin Brigh Bath Bar 100 gm,Warehouse A,39,30,2025-02-24 04:18:00,9
8831,ORD_8832,19835,Camel 20-Shade Soft Pastel Set,Warehouse B,116,99,2025-02-24 12:05:00,17
8832,ORD_8833,21315,Fit Me Concealer,Warehouse A,57,52,2025-02-24 00:35:00,5
8833,ORD_8834,1917,Hand Sanitizer Liquid,Warehouse C,53,40,2025-02-24 15:50:00,13
8834,ORD_8835,15403,"Body Lotion For Very Dry Skin, Nourishing Body Milk With 2x Almond Oil, For Men & Women",Warehouse B,27,22,2025-02-24 21:06:00,5
8835,ORD_8836,18893,Etoridac P 400mg/325mg Tablet,Warehouse B,46,37,2025-02-24 08:28:00,9
8836,ORD_8837,7213,"Elv Wall Mount Mobile Holder, Mobile Stand for All Smartphones with Strong Adhesive Strips, Compatible with iPhone, Smartp...",Warehouse B,75,59,2025-02-24 22:02:00,16
8837,ORD_8838,19744,Kuff Q NF Tablet,Warehouse A,86,73,2025-02-24 19:45:00,13
8838,ORD_8839,19823,SupCares Edge to Edge Tempered Glass for Google Pixel 6A (6.1 Inch) with Easy Self Installation Kit | Black,Warehouse B,104,97,2025-02-24 06:44:00,7
8839,ORD_8840,9284,Activate Pre Workout Effervescent Tablets - Orange Flavour,Warehouse A,19,8,2025-02-24 18:01:00,11
8840,ORD_8841,16055,Fashion Colour Hair Serum 100 ml,Warehouse B,72,54,2025-02-24 17:14:00,18
8841,ORD_8842,10926,COLORS QUEEN Color Correcting 12-Hour Smoothing eye Primer - 2.3 ml (skin color),Warehouse B,70,62,2025-02-24 00:55:00,8
8842,ORD_8843,21043,"EGate i9 Pro 1080p HD 720p Native 2400 Lumens 210 ANSI Portable Projector, 120"" max Screen (3.04 m) 1280 x 720 | VGA, AV, ...",Warehouse C,107,91,2025-02-24 08:30:00,16
8843,ORD_8844,714,Livon Syrup - Strengthens & Detoxifies The Liver,Warehouse C,59,50,2025-02-24 07:07:00,9
8844,ORD_8845,16504,"Fashion Colour Lip Crayon, Waterproof, Long Lasting, 3 Strawberry Flip 2.8 gm",Warehouse A,83,64,2025-02-24 15:21:00,19
8845,ORD_8846,21787,"ADS Foundation and Concealer with Sketch Pen Eyeliner, Multicolour, 3 Piece Set",Warehouse B,90,76,2025-02-24 03:36:00,14
8846,ORD_8847,15813,Manish Malhotra Beauty By MyGlamm Tamarind & Cardamom Revitalizing Sheet Mask 25 ml,Warehouse B,87,74,2025-02-24 08:29:00,13
8847,ORD_8848,15392,Acigol D 10mg/20mg Capsule,Warehouse C,97,82,2025-02-24 17:30:00,15
8848,ORD_8849,7177,Ontek 4mg Tablet MD,Warehouse A,79,61,2025-02-24 05:09:00,18
8849,ORD_8850,6932,Ajmal Silver Shade Wisal Dahab Wisal Dahab Deodorant Spray (Pack of 3) 200 ml,Warehouse C,79,60,2025-02-24 05:28:00,19
8850,ORD_8851,8249,Glimrox MP 1mg/500mg/15mg Tablet SR,Warehouse C,29,18,2025-02-24 03:52:00,11
8851,ORD_8852,8271,"moha: Scrub Soap With Walnut, Almond Oil & Honey For Soft, Hydrate & Nourished Skin, Face, Unisex Bathing Bar - 100gm (Pac...",Warehouse B,94,78,2025-02-24 16:40:00,16
8852,ORD_8853,23405,Anti Hairfall Shampoo,Warehouse A,72,53,2025-02-24 14:57:00,19
8853,ORD_8854,729,Amazon Brand - Solimo Acrylic Transparent Case (Hard Back & Soft Bumper Cover with Cushioned Edges) for Apple iPhone XR,Warehouse B,44,26,2025-02-24 22:04:00,18
8854,ORD_8855,9715,Vega Luxury Flower Back Sponge (BA - 2/4) 135 gm,Warehouse A,112,94,2025-02-24 10:28:00,18
8855,ORD_8856,8281,Medimade Mango Body Butter 200 ml,Warehouse B,54,44,2025-02-24 00:37:00,10
8856,ORD_8857,881,Chymosoft Tablet,Warehouse B,89,82,2025-02-24 14:19:00,7
8857,ORD_8858,10411,The Moms Co. Natural Green Tea Night Gel 50 gm,Warehouse A,23,17,2025-02-24 21:59:00,6
8858,ORD_8859,22446,Xifomox Tablet,Warehouse B,43,27,2025-02-24 23:32:00,16
8859,ORD_8860,18072,"JBL Tune 760NC, Over Ear ANC Wireless Headphones with Mic, up to 50 Hours Playtime, Pure Bass, Google Fast Pair, Dual Pair...",Warehouse C,8,2,2025-02-24 09:59:00,6
8860,ORD_8861,34297,Flexilace SP 100mg/325mg/15mg Tablet,Warehouse A,78,61,2025-02-24 19:26:00,17
8861,ORD_8862,11519,"Fashion Colour 2 - In - 1 Face Powder, Shade 05 20 gm",Warehouse A,10,3,2025-02-24 10:24:00,7
8862,ORD_8863,12966,Cosmic Byte ARES Wireless Controller for PC (Black),Warehouse B,15,8,2025-02-24 14:51:00,7
8863,ORD_8864,15609,Olmax-CH 40mg/6.25mg Tablet,Warehouse B,34,25,2025-02-24 00:34:00,9
8864,ORD_8865,18524,Superdry - Sport Re Charge Body + Hair Wash 250 ml,Warehouse C,20,6,2025-02-24 03:44:00,14
8865,ORD_8866,8240,Hair Logic Reparative Shampoo 1's,Warehouse A,31,18,2025-02-24 19:48:00,13
8866,ORD_8867,1633,Genie Flamenco2 Casual Backpacks for Women,Warehouse B,15,5,2025-02-24 22:49:00,10
8867,ORD_8868,7618,Agent Jane For Women,Warehouse C,54,40,2025-02-24 06:42:00,14
8868,ORD_8869,23510,"Conditioner - Coconut Milk, Nourishing",Warehouse A,43,37,2025-02-24 00:19:00,6
8869,ORD_8870,14864,Cefsar CV 200mg/125mg Tablet,Warehouse B,73,63,2025-02-24 16:42:00,10
8870,ORD_8871,33985,Kroton MF 80mg/250mg Tablet,Warehouse B,87,70,2025-02-24 11:38:00,17
8871,ORD_8872,7624,"Maybelline Unstoppable Eyeliner, Espresso, 0.01 oz.",Warehouse B,89,84,2025-02-24 18:23:00,5
8872,ORD_8873,20383,Eyetex Dazller Nail Glitter - DM18 (Hot Sauco) 12 ml,Warehouse B,31,24,2025-02-24 08:03:00,7
8873,ORD_8874,22318,"Logitech MK850 Multi-Device Wireless Keyboard and Mouse Combo, 2.4GHz Wireless & Bluetooth, Curved Keyframe , 12 Programma...",Warehouse B,25,11,2025-02-24 19:33:00,14
8874,ORD_8875,22311,"Anti Dandruff Conditioner - With Tea Tree & Ginger Oil, For Dandruff Free Hair",Warehouse A,39,30,2025-02-24 22:51:00,9
8875,ORD_8876,17108,L'Oreal Paris Rouge Signature Matte Liquid Lipstick 130 I Amaze 7 Gm,Warehouse B,94,84,2025-02-24 23:51:00,10
8876,ORD_8877,689,Smart Watch id-116 Men Women Fitness Tracker Blood Pressure Heart Rate Monitor for Girls & Boys with HT1 Wireless Bluetoot...,Warehouse C,76,71,2025-02-24 15:23:00,5
8877,ORD_8878,14129,"Amazon Basics Bluetooth Speaker, 5W Sound, TWS Mode, Powerful Bass, IPX6 Waterproof, Up to 19 hrs Playtime*, MicroSD Card,...",Warehouse C,31,15,2025-02-24 20:54:00,16
8878,ORD_8879,22309,IQOO Neo 7 Mobile Camera Lens Protector (Camera Lens Protect from The Scratches) (Pack of 2),Warehouse C,68,56,2025-02-24 06:10:00,12
8879,ORD_8880,23554,Cystop-A Tablet,Warehouse A,103,90,2025-02-24 20:12:00,13
8880,ORD_8881,10068,TCL 80.04 cm (32 inches) Bezel-Less S Series HD Ready Smart Android LED TV 32S5400A (Black),Warehouse A,73,58,2025-02-24 07:52:00,15
8881,ORD_8882,8268,Torner Gold 2500mcg Injection,Warehouse C,26,17,2025-02-24 23:44:00,9
8882,ORD_8883,8205,SAFWE – SM-02 - Speaker Wall Mount Stand - Bracket 2 Nos for 5 mm & 6.35mm (¼ inch) Thread Hole/Keyhole Speakers Universal...,Warehouse A,104,85,2025-02-24 13:42:00,19
8883,ORD_8884,7613,"Ambrane Unbreakable 60W / 3A Fast Charging 1.5m Braided Micro USB Cable for Smartphones, Tablets, Laptops & Other Micro US...",Warehouse A,103,98,2025-02-24 19:39:00,5
8884,ORD_8885,12107,Cilvoryl M 1mg Tablet,Warehouse B,80,73,2025-02-24 01:24:00,7
8885,ORD_8886,12942,Xyclav 1000 mg/200 mg Injection,Warehouse C,29,13,2025-02-24 21:43:00,16
8886,ORD_8887,12901,D Drox 25mg Tablet,Warehouse C,94,85,2025-02-24 01:09:00,9
8887,ORD_8888,867,"OnePlus Nord 2T 5G (Jade Fog, 12GB RAM, 256GB Storage)",Warehouse B,9,2,2025-02-24 20:28:00,7
8888,ORD_8889,20360,"HP Laserjet 136nw WiFi Printer, Print Copy Scan, Compact Design, Reliable and Fast Printing, Network Support",Warehouse C,112,95,2025-02-24 13:37:00,17
8889,ORD_8890,1133,Gliclastar-M 60 Tablet,Warehouse A,20,2,2025-02-24 09:31:00,18
8890,ORD_8891,34312,Sero P 100mg/325mg Tablet,Warehouse C,101,92,2025-02-24 15:08:00,9
8891,ORD_8892,9104,"Ancho Lean - Weight-Loss, 1000mg",Warehouse B,35,25,2025-02-24 22:51:00,10
8892,ORD_8893,18122,Maryaj Direction East EDP Citrus Spicy Perfume And Ajmal Sacrifice II For Him Deodorant Fruity Aromatic Fragrance 300 ml,Warehouse B,62,54,2025-02-24 09:27:00,8
8893,ORD_8894,35314,"Aster EX3008 3 Universal Multi Plug Wall Point Socket Extension Board with Two 2.8 Amp Fast Charging USB Ports , ON/Off Sw...",Warehouse C,57,45,2025-02-24 16:51:00,12
8894,ORD_8895,16681,Amentoclav 125mg/25mg Injection,Warehouse A,85,66,2025-02-24 21:38:00,19
8895,ORD_8896,18116,Lakme Absolute Mattereal Mousse Concealer 04 Caramel 9 Gm,Warehouse C,88,73,2025-02-24 00:47:00,15
8896,ORD_8897,34307,mCaffeine Anti Pollution Kit 200 gm,Warehouse C,96,88,2025-02-24 22:52:00,8
8897,ORD_8898,20310,Gear Vintage2 28L Faux Leather Water Resistant Anti Theft Laptop Bag/Backpack for Men/Women-Black,Warehouse B,74,56,2025-02-24 15:46:00,18
8898,ORD_8899,23460,Nature's Essence Lightening Face Wash Gel - Orange & Lime 65 ml,Warehouse B,41,29,2025-02-24 05:14:00,12
8899,ORD_8900,35668,Daily Life Forever52 Velvet Rose Matte Lipstick Rs018 2.5 gm,Warehouse C,55,36,2025-02-24 15:38:00,19
8900,ORD_8901,17127,CGX-Dsp Capsule SR,Warehouse C,110,95,2025-02-24 12:59:00,15
8901,ORD_8902,691,Breathe Yogue - Antiviral Mask Drops For Respiratory Wellness,Warehouse C,63,46,2025-02-24 03:28:00,17
8902,ORD_8903,20350,FLAIR CARBONIX BALL PEN (50 PCS STAND),Warehouse C,38,33,2025-02-24 14:51:00,5
8903,ORD_8904,16812,Youpod CV 200mg/125mg Tablet,Warehouse A,86,72,2025-02-24 16:51:00,14
8904,ORD_8905,8202,"OUXUS XM-06 Super Bass Wireless Bluetooth Headphones, Headset with Mic and Sound Button Earphone for M i Note 5/6/7 Pro, 6...",Warehouse A,67,59,2025-02-24 17:30:00,8
8905,ORD_8906,36449,Moxilis 400mg Tablet,Warehouse C,59,44,2025-02-24 21:12:00,15
8906,ORD_8907,15621,"Lenovo V15 AMD Ryzen 5 5500U 15.6"" FHD 250 nits Antiglare Thin and Light Laptop (8GB/512GB SSD/Windows 11 Home/1 Year Onsi...",Warehouse B,28,22,2025-02-24 11:12:00,6
8907,ORD_8908,23578,Acibitor I 20mg/150mg Capsule,Warehouse B,39,34,2025-02-24 15:43:00,5
8908,ORD_8909,17137,Biorab 20mg Injection,Warehouse A,75,61,2025-02-24 21:38:00,14
8909,ORD_8910,7562,Sandrot-M Tablet,Warehouse A,91,82,2025-02-24 09:06:00,9
8910,ORD_8911,20311,"realme narzo 50A Prime (Flash Blue, 4GB RAM+128GB Storage) FHD+ Display | 50MP AI Triple Camera| Charger Included",Warehouse B,27,16,2025-02-24 05:41:00,11
8911,ORD_8912,36917,Moxicheck 0.2 Tablet,Warehouse B,86,78,2025-02-24 21:43:00,8
8912,ORD_8913,8263,Apsara Platinum Pencils Value Pack - Pack of 20,Warehouse A,56,43,2025-02-24 19:23:00,13
8913,ORD_8914,20375,Telsicap A 40mg/5mg Tablet,Warehouse B,14,4,2025-02-24 00:49:00,10
8914,ORD_8915,22285,Tobreb 80mg Injection,Warehouse C,84,70,2025-02-24 19:22:00,14
8915,ORD_8916,605,Blue Heaven Super Gentle Cleansing Milk 125 ml,Warehouse C,104,87,2025-02-24 17:28:00,17
8916,ORD_8917,17029,Rabsidom-SR Capsule,Warehouse A,99,93,2025-02-24 19:32:00,6
8917,ORD_8918,34243,"Canon Pixma TS307 Single Function Wireless Inkjet Colour Printer (Black), Standard",Warehouse C,114,98,2025-02-24 04:29:00,16
8918,ORD_8919,10293,Complete Starter Pack - Yellow,Warehouse A,30,12,2025-02-24 06:39:00,18
8919,ORD_8920,8494,Spigen Liquid Air Back Cover Case for iPhone 11 (TPU | Matte Black),Warehouse C,46,28,2025-02-24 23:54:00,18
8920,ORD_8921,13816,Bathing Bar Soap - Skincare,Warehouse A,78,59,2025-02-24 19:18:00,19
8921,ORD_8922,21900,Moxocard 0.3 Tablet,Warehouse B,93,78,2025-02-24 11:44:00,15
8922,ORD_8923,35324,CP PLUS 3MP Full HD Smart Wi-fi CCTV Home Security Camera | 360° View | 2 Way Talk | Cloud Monitor | Motion Detect | Night...,Warehouse A,67,54,2025-02-24 21:12:00,13
8923,ORD_8924,17896,Trajectory 100% Vegan Leather 16 Inch Laptop Office Messenger bag for all laptop like Apple MacBook with 2 Years Warranty ...,Warehouse B,23,10,2025-02-24 22:48:00,13
8924,ORD_8925,13126,Sandal & Almond Milk Soap 125g (Buy 4 Get 1 Free) + Sandal & Turmeric Soap 100g,Warehouse A,39,21,2025-02-24 10:10:00,18
8925,ORD_8926,436,The Beauty Co. Dwine Face Wash Gel 100 ml,Warehouse B,81,62,2025-02-24 21:16:00,19
8926,ORD_8927,18411,AC Suspension,Warehouse A,48,33,2025-02-24 02:52:00,15
8927,ORD_8928,17181,Shabase Plus - Sandalwood Protective Cover,Warehouse C,25,11,2025-02-24 05:39:00,14
8928,ORD_8929,16362,Trumex Syrup,Warehouse A,23,4,2025-02-24 23:34:00,19
8929,ORD_8930,20710,"QHOHQ Polycarbonate Tempered Glass, 2 Pack Hard PC Case for Smartwatches Compatible with Apple Watch Series 8 45mm & Serie...",Warehouse B,97,86,2025-02-24 00:16:00,11
8930,ORD_8931,20705,"Aroma® NB119 Belief Bluetooth Wireless In Ear Neckband with Long Lasting Playtime 48 Hrs, Smart Voice Assistant, Ultra Ric...",Warehouse C,72,66,2025-02-24 07:19:00,6
8931,ORD_8932,20072,"Ultra Eco Sanitary Napkin - XL, Night Use",Warehouse B,110,92,2025-02-24 19:35:00,18
8932,ORD_8933,37039,"Forest Essentials Travel Size Facial Cleanser Rosewater, Honey Lemon, 50ml & Forest Essentials Hair Cleanser Bhringraj and...",Warehouse B,42,31,2025-02-24 03:39:00,11
8933,ORD_8934,21840,"Kozicare Plus Skin Tone Lightening Serum with Kojic Acid 2.5%, Arbutin 1.5%, Glutathione 1%, Vitamin C 20%, Vitamin A 2%, ...",Warehouse C,41,27,2025-02-24 04:37:00,14
8934,ORD_8935,21836,NIHARA Wood Smart Multipurpose Foldable Laptop Table with Cup Holder Ergonomic & Rounded Edges (Black),Warehouse A,48,37,2025-02-24 03:23:00,11
8935,ORD_8936,34071,Sony ICD-PX470 4GB Digital Voice Recorder -Black,Warehouse C,85,67,2025-02-24 20:53:00,18
8936,ORD_8937,11216,Fusion Proglide - Flexball Manual Shaving Razor,Warehouse B,91,86,2025-02-24 18:32:00,5
8937,ORD_8938,35060,"Activated Charcoal 3-In-1 Clay Mask With Vitamin C, Menthol and Charcoal",Warehouse B,44,34,2025-02-24 15:19:00,10
8938,ORD_8939,21828,Philips Audio SHE1525BK/94 Upbeat Wired in Ear Earphone with Mic (Black),Warehouse C,107,91,2025-02-24 08:47:00,16
8939,ORD_8940,20064,"Kama Ayurveda Turmeric and Myrrh Skin Brightening Soap, 125g & Kama Ayurveda Nalpamaradi Thailam Skin Brightening Treatmen...",Warehouse B,84,68,2025-02-24 22:59:00,16
8940,ORD_8941,35358,JB SUPER M3 Colorful Wireless Bluetooth Speakers 3D Mini Electroplating Round Steel Speaker (Random Color),Warehouse A,93,76,2025-02-24 23:45:00,17
8941,ORD_8942,21819,Acefile SP 100mg/325mg/10mg Tablet,Warehouse B,25,17,2025-02-24 15:33:00,8
8942,ORD_8943,35232,Organic Harvest Onion Hair Oil for Strong & Healthy Hair 150 ml,Warehouse A,112,96,2025-02-24 01:54:00,16
8943,ORD_8944,1310,Panzomen 40mg Tablet,Warehouse C,84,70,2025-02-24 13:09:00,14
8944,ORD_8945,34051,Iclaben Cream,Warehouse C,65,52,2025-02-24 01:27:00,13
8945,ORD_8946,8972,"Infinity (JBL) Sonic B200WL, 160W Soundbar with Wireless Subwoofer, 2.1 Channel Home Theatre with Remote, Bluetooth, Optic...",Warehouse B,14,4,2025-02-24 02:13:00,10
8946,ORD_8947,16823,Vega Cushion Brush (E4 - CB) 153 gm,Warehouse B,39,30,2025-02-24 20:34:00,9
8947,ORD_8948,14686,Vega Tail Comb (HMC - 10) 27 gm,Warehouse C,34,17,2025-02-24 10:14:00,17
8948,ORD_8949,9428,"Crucial X8 1TB Portable SSD – Up to 1050MB/s – USB 3.2 – External Solid State Drive, USB-C, USB-A – CT1000X8SSD9",Warehouse C,43,28,2025-02-24 13:04:00,15
8949,ORD_8950,1669,Difen P 50mg/500mg Tablet,Warehouse B,107,89,2025-02-24 00:07:00,18
8950,ORD_8951,21003,Levirab DSR 30mg/20mg Capsule,Warehouse C,21,4,2025-02-24 11:02:00,17
8951,ORD_8952,15537,Digpod-IV  Injection,Warehouse C,93,76,2025-02-24 06:27:00,17
8952,ORD_8953,9908,L-Cetriver Syrup,Warehouse C,48,31,2025-02-24 05:29:00,17
8953,ORD_8954,20996,Wesley office Laptop Bag briefcase notebook professional business 15.6 Inch Briefcase messenger sling Water resistant Lapt...,Warehouse B,66,52,2025-02-24 03:45:00,14
8954,ORD_8955,16329,Ducray anaphase plus shampoo pack of 2,Warehouse B,31,24,2025-02-24 19:36:00,7
8955,ORD_8956,34058,"Samsung Galaxy Tab A8 26.69 cm (10.5 inch) Display, RAM 3 GB, ROM 32 GB Expandable, Wi-Fi Tablet, Silver, (SM-X200NZSAINU)",Warehouse C,41,24,2025-02-24 18:57:00,17
8956,ORD_8957,22586,Colossal Kajal - Super Black,Warehouse C,47,35,2025-02-24 10:53:00,12
8957,ORD_8958,20998,"SKADIOO Universal Travel Adapter, Adapter, Travel Adapter, Universal Adapter, Adapter Charger, International Adapter All i...",Warehouse B,85,69,2025-02-24 09:41:00,16
8958,ORD_8959,156,Apple Cider Vinegar Shampoo,Warehouse A,10,4,2025-02-24 04:33:00,6
8959,ORD_8960,23943,"MAKE UP FOR LIFE 12 Hr Liquid Lip Gloss-114, Mauve, 5 g",Warehouse C,24,5,2025-02-24 11:32:00,19
8960,ORD_8961,7294,Ranidom D 30 mg/40 mg Capsule SR,Warehouse C,55,38,2025-02-24 11:21:00,17
8961,ORD_8962,19448,EGOTUDE Ultra Hybrid Camera Lens Protection [Never Yellowing] Back Cover Case for iPhone 14 Plus (Black),Warehouse A,62,54,2025-02-24 22:39:00,8
8962,ORD_8963,17489,Hanucef 1gm Injection,Warehouse C,32,19,2025-02-24 04:03:00,13
8963,ORD_8964,9898,DeBelle Gel Nail Polish Woody Chocolate (Light Chocolate Brown Nail Paint)|Non UV - Gel Finish |Chip Resistant | Seaweed E...,Warehouse A,37,29,2025-02-24 02:07:00,8
8964,ORD_8965,17336,"Sounce Universal Phone Mount for Car [Solid & Durable] Car Mobile Phone Holder Mount for Dashboard 360° Rotational, Strong...",Warehouse A,100,88,2025-02-24 01:18:00,12
8965,ORD_8966,14310,Vaadi Herbals Handmade Soap - Divine Sandal 75 gm,Warehouse A,88,82,2025-02-24 05:18:00,6
8966,ORD_8967,20109,Nari Sakhi Capsule,Warehouse A,24,13,2025-02-24 05:38:00,11
8967,ORD_8968,1189,Scozone S 1000mg/500mg Injection,Warehouse A,26,13,2025-02-24 17:28:00,13
8968,ORD_8969,33809,Decant AP 50mg/325mg Tablet,Warehouse C,56,41,2025-02-24 17:24:00,15
8969,ORD_8970,11306,Macpod CV 50mg/31.25mg Tablet DT,Warehouse A,25,6,2025-02-24 01:07:00,19
8970,ORD_8971,658,"Tribit StormBox 24W Bluetooth Wireless Speakers,360°Surround Sound,Enhanced Bass-Independent XBass Button,Wireless Dual Pa...",Warehouse B,16,2,2025-02-24 08:05:00,14
8971,ORD_8972,35037,HP 103AD 2-Pack Toner Reload Kit (Black),Warehouse C,58,40,2025-02-24 23:59:00,18
8972,ORD_8973,12940,The Man Company Eau De Toilette - Blanc 100 ml,Warehouse C,11,3,2025-02-24 17:31:00,8
8973,ORD_8974,35752,"Storite 4 in 1 Professional Screen Cleaning Kit (100ML) for Laptops, Mobiles, LCD, LED, Computers, TV KCL-1025 (Includes C...",Warehouse C,16,3,2025-02-24 17:15:00,13
8974,ORD_8975,23498,OpenTech® Tempered Glass Screen Protector Compatible for iPhone 14 Pro Max with Edge to Edge Coverage and Easy Installatio...,Warehouse C,26,15,2025-02-24 03:15:00,11
8975,ORD_8976,13000,Microgen Citrasafe-HC Solution Orange,Warehouse C,87,81,2025-02-24 08:11:00,6
8976,ORD_8977,12874,Tocef 100mg/5ml Suspension,Warehouse A,100,86,2025-02-24 19:17:00,14
8977,ORD_8978,22163,Shryoan Set of 30 Colorful Shimmer Eyeshadow |3 Highlighter Makeup Palette/Kit for Glittery Look for Women & Girls| Multic...,Warehouse A,93,88,2025-02-24 18:55:00,5
8978,ORD_8979,22158,Nitrokin 2.6 Tablet,Warehouse C,30,13,2025-02-24 08:15:00,17
8979,ORD_8980,19024,"Fashion Colour Non - Transfer Matt Waterproof Lipstick, 67 Chocochip 2.6 gm",Warehouse A,22,12,2025-02-24 12:05:00,10
8980,ORD_8981,11073,"Portronics C-Konnect, 3-in-1 USB Type C Adapter to Project Screen of Your USB Type-C Enabled Device on a Large Screen of A...",Warehouse B,23,4,2025-02-24 06:21:00,19
8981,ORD_8982,17345,"Face Wash - Bio Pineapple, Oil Balancing, for Oily Skin",Warehouse C,75,60,2025-02-24 07:45:00,15
8982,ORD_8983,14902,Himalayan Organics Moroccan Argan Oil Conditioner With Extracts Of Moringa & Bhringraj | No Parabens & No Sulphate | Hydra...,Warehouse A,101,94,2025-02-24 01:26:00,7
8983,ORD_8984,1123,"Maybelline New York Color Sensational Creamy Matte Lipstick, 656 Clay Crush 3.9 gm",Warehouse C,35,26,2025-02-24 12:36:00,9
8984,ORD_8985,1830,Bio Almond Under Eye Cream 15 Gm,Warehouse B,58,41,2025-02-24 20:48:00,17
8985,ORD_8986,35989,Ginlocid Syrup,Warehouse A,107,97,2025-02-24 20:41:00,10
8986,ORD_8987,20877,Qupidox 200mg Tablet,Warehouse A,42,36,2025-02-24 05:54:00,6
8987,ORD_8988,8294,Ondimak 4mg Injection,Warehouse A,60,50,2025-02-24 05:26:00,10
8988,ORD_8989,738,Fairgest 200mg Injection,Warehouse A,112,93,2025-02-24 18:22:00,19
8989,ORD_8990,11600,Terbest Dusting Powder,Warehouse C,98,90,2025-02-24 10:23:00,8
8990,ORD_8991,12968,Triglimiprex 2mg/500mg/7.5mg Tablet,Warehouse B,82,75,2025-02-24 22:38:00,7
8991,ORD_8992,12591,L.A Girl Beauty Brick Eyeshadow Nudes 12 gm,Warehouse B,63,46,2025-02-24 18:19:00,17
8992,ORD_8993,36070,Double Lips Combo of 3 Cream for face SSkin Shine 15 gm each,Warehouse C,96,90,2025-02-24 22:40:00,6
8993,ORD_8994,11076,Pantofit D Tablet,Warehouse B,76,59,2025-02-24 16:40:00,17
8994,ORD_8995,1323,"SanDisk Ultra® microSDXC™ UHS-I Card, 128GB, 140MB/s R, 10 Y Warranty, for Smartphones",Warehouse B,38,21,2025-02-24 04:57:00,17
8995,ORD_8996,15659,"Logitech G213 Prodigy Gaming Keyboard, LIGHTSYNC RGB Backlit Keys, Spill-Resistant, Customizable Keys, Dedicated Multi-Med...",Warehouse B,22,16,2025-02-24 18:13:00,6
8996,ORD_8997,18057,Face Wash - Fairness Facial,Warehouse C,35,18,2025-02-24 06:46:00,17
8997,ORD_8998,15923,Ultramycin Eye Drop,Warehouse C,72,65,2025-02-24 05:15:00,7
8998,ORD_8999,12536,Ajmal Mercurial Thunder Edt Of 2 & Nightingale Deodorant Pack of 2 450 ml,Warehouse C,99,89,2025-02-24 09:01:00,10
8999,ORD_9000,19462,"Razer BlackShark V2 X Wired Gaming On Ear Headset - Black|7.1 Surround Sound-50mm Drivers-Memory Foam Cushion-for PC,PS4,P...",Warehouse B,46,28,2025-02-24 22:52:00,18
9000,ORD_9001,20292,Jovees Face Peel Powder - Veg Oat 100 gm,Warehouse C,58,50,2025-02-24 22:15:00,8
9001,ORD_9002,22225,Focus 6mg Tablet,Warehouse A,76,59,2025-02-24 02:38:00,17
9002,ORD_9003,23622,Belora Paris Leave No Evidence Liquid Matte Lipstick Rusty Orange 4.5 gm,Warehouse A,86,74,2025-02-24 07:52:00,12
9003,ORD_9004,15662,Mikapoz 100mg Injection,Warehouse C,85,71,2025-02-24 22:54:00,14
9004,ORD_9005,7512,Revlon So Fierce Big Bad Lash Mascara - Black 10 ml,Warehouse C,66,48,2025-02-24 08:44:00,18
9005,ORD_9006,16796,Panasonic Rechargable Ni-MH AAA Rechargable Battery For Cordless Phone And Toys (Pack Of 2 Pcs),Warehouse B,17,4,2025-02-24 16:28:00,13
9006,ORD_9007,18043,"SanDisk Ultra Eco USB Flash Drive USB 3.2 Gen 1 64GB, Upto 100MB/s R, 5Y Warranty",Warehouse C,80,63,2025-02-24 16:00:00,17
9007,ORD_9008,22172,Comzid M 80 mg/500 mg Tablet,Warehouse A,44,26,2025-02-24 03:41:00,18
9008,ORD_9009,13549,Garnier Bright Complete Vitamin C BB Cream 9g,Warehouse A,21,8,2025-02-24 15:09:00,13
9009,ORD_9010,1490,Meg Karela Jamun Ras,Warehouse A,97,91,2025-02-24 12:56:00,6
9010,ORD_9011,17661,Fluty 150mg Tablet,Warehouse A,114,99,2025-02-24 22:17:00,15
9011,ORD_9012,36830,"Acer Nitro VG240YS 23.8 Inch (60.45 Cm) IPS Full HD 1920 X 1080 Pixels, Gaming LCD Monitor with LED Backlight I AMD Freesy...",Warehouse A,23,16,2025-02-24 06:42:00,7
9012,ORD_9013,7847,"ETZIN RCA to HDMI Converter, AV to HDMI Video Audio Converter Adapter Compatible with VHS VCR Camera DVD, Support PAL/NTSC...",Warehouse A,62,52,2025-02-24 00:55:00,10
9013,ORD_9014,36049,Divahair Shampoo,Warehouse A,53,34,2025-02-24 03:16:00,19
9014,ORD_9015,21576,"ZEBRONICS Zeb Sonic BAR 100-120W RMS Soundbar with Subwoofer, RGB LED, HDMI ARC, BT v5.0, AUX, Type C + Dual 3.5mm Audio P...",Warehouse A,108,94,2025-02-24 05:04:00,14
9015,ORD_9016,12042,Khus Soap,Warehouse B,32,19,2025-02-24 12:02:00,13
9016,ORD_9017,14537,Oltha R 20mg Tablet,Warehouse C,66,48,2025-02-24 12:32:00,18
9017,ORD_9018,16482,"Wooum Document Organizer Bag / Pouch for iPad 11 Pro Sleeve / Case / Pouch 9.7, 10.5, 10.9"" Tablet Pouch / Tablet Sleeve /...",Warehouse C,114,96,2025-02-24 22:03:00,18
9018,ORD_9019,13264,Oxyglim VG 2mg/500mg/0.2mg Tablet,Warehouse C,25,10,2025-02-24 07:32:00,15
9019,ORD_9020,37092,Soulflower Ocean Blue Bath Salt 500 gm,Warehouse C,11,5,2025-02-24 18:11:00,6
9020,ORD_9021,22913,Enzobert-D Tablet,Warehouse B,61,53,2025-02-24 23:16:00,8
9021,ORD_9022,24459,IRONFIX® (Pack of 8) Cable Protector Data Cable Saver Charging Cord Protective Cable Cover (8 PC),Warehouse C,12,3,2025-02-24 15:01:00,9
9022,ORD_9023,23652,"Wqaoo Soft Adjustable Visor Hat Safe Shampoo Shower Bathing Protection Bath Cap for Toddler, Baby, Kids, Children (Multi C...",Warehouse A,44,35,2025-02-24 04:24:00,9
9023,ORD_9024,15259,R Mol LS 75mg/20mg Capsule SR,Warehouse A,38,30,2025-02-24 15:45:00,8
9024,ORD_9025,11180,"Lakmé Perfect Radiance Compact, Golden Medium 03, 8g (Pack of 2)",Warehouse A,47,42,2025-02-24 22:03:00,5
9025,ORD_9026,36557,Ajmal Blu Dreams EDP And Mukhallat Al Wafa CP & Neea EDP Pack of 3 20 ml,Warehouse A,67,60,2025-02-24 01:31:00,7
9026,ORD_9027,11261,"Samsung 324 L 3 Star Inverter Frost Free Double Door Refrigerator (RT34T4513S8/HL, Convertible 5In 1, Elegant Inox)",Warehouse C,62,54,2025-02-24 17:52:00,8
9027,ORD_9028,18705,Rosawal Gold 75mg/20mg/75mg Capsule,Warehouse C,54,43,2025-02-24 02:07:00,11
9028,ORD_9029,24084,Vlx 25mg Tablet,Warehouse B,13,7,2025-02-24 21:53:00,6
9029,ORD_9030,9039,"Ajmal 1 Distraction, 1 Blu Homme And 1 Raindrops Femme Deodorants Pack of 3 200 ml",Warehouse A,95,86,2025-02-24 06:35:00,9
9030,ORD_9031,8325,MI Power Bank 3i 20000mAh Lithium Polymer 18W Fast Power Delivery Charging | Input- Type C | Micro USB| Triple Output | Sa...,Warehouse A,108,99,2025-02-24 12:22:00,9
9031,ORD_9032,9033,C Podoxy 200mg Tablet,Warehouse A,16,10,2025-02-24 05:51:00,6
9032,ORD_9033,35560,Belora Paris Leave No Evidence Liquid Matte Lipstick Ruby Crush 4.5 ml,Warehouse A,34,20,2025-02-24 20:48:00,14
9033,ORD_9034,535,Miss Rose 2 In 1 Creamy Matte Lipstick Spanish Pink 7102 - 001M 06 2.1 gm,Warehouse C,17,10,2025-02-24 03:26:00,7
9034,ORD_9035,1221,"BKN® Mini Tripod with 360 Degree Mobile Attachment Lightweight Portable for Vlog, Video Shooting, Photography, YouTube etc",Warehouse B,58,40,2025-02-24 09:45:00,18
9035,ORD_9036,13266,Yesnec-SP Tablet,Warehouse A,33,24,2025-02-24 19:28:00,9
9036,ORD_9037,35383,Faces Canada No Transfer Matte Lipstick Grammar Nazi 12 3.5 Ml,Warehouse A,55,39,2025-02-24 08:53:00,16
9037,ORD_9038,11542,Esoglaz-D Capsule SR,Warehouse C,65,50,2025-02-24 15:28:00,15
9038,ORD_9039,18442,Ajmal Mizyaan Concentrated Perfume Oil Oriental Musky And Aurum Femme Deodorant Fruity Floral Fragrance 214 ml,Warehouse B,63,55,2025-02-24 03:05:00,8
9039,ORD_9040,14005,Riscon 4 Tablet,Warehouse B,97,87,2025-02-24 17:34:00,10
9040,ORD_9041,22100,Ormium 20mg Capsule,Warehouse B,69,51,2025-02-24 12:30:00,18
9041,ORD_9042,11929,Gliptor M 500mg/20mg Tablet,Warehouse B,101,83,2025-02-24 17:40:00,18
9042,ORD_9043,14916,The Skin Story Facewash - Shea Butter & Blueberry 100 ml,Warehouse C,68,55,2025-02-24 12:59:00,13
9043,ORD_9044,7443,Cobaroz 2500mcg Injection,Warehouse C,16,9,2025-02-24 21:46:00,7
9044,ORD_9045,23743,Sounce Gold Plated 3.5 mm Headphone Splitter for Computer 2 Male to 1 Female 3.5mm Headphone Mic Audio Y Splitter Cable Sm...,Warehouse B,31,18,2025-02-24 14:45:00,13
9045,ORD_9046,1357,Gentle Exfoliating Nourishing Body Wash,Warehouse C,100,82,2025-02-24 16:05:00,18
9046,ORD_9047,12537,Rozfirst 5mg Tablet,Warehouse A,60,52,2025-02-24 01:24:00,8
9047,ORD_9048,9373,Lohasavam,Warehouse C,93,82,2025-02-24 22:21:00,11
9048,ORD_9049,15628,VLCC Honey Moisturiser 100 gm,Warehouse B,62,56,2025-02-24 09:42:00,6
9049,ORD_9050,9936,"EDYELL Upgrade C15 Wireless Earbuds, Over Ear Headphone with HD Mic, 48Hrs Playtime, Noise Cancelling, Bluetooth V5.3 EarH...",Warehouse B,104,92,2025-02-24 05:18:00,12
9050,ORD_9051,14834,2PCS Powder Puff Cotton Cosmetic Powder Makeup Puffs Pads Makeup with Ribbon Face Powder Puffs for Loose and Foundation 3....,Warehouse A,58,43,2025-02-24 18:27:00,15
9051,ORD_9052,20817,Diclokem Plus 50mg/325mg Tablet,Warehouse C,24,9,2025-02-24 17:46:00,15
9052,ORD_9053,14842,Almond Oil,Warehouse A,77,69,2025-02-24 10:44:00,8
9053,ORD_9054,18517,Halosten 1.5mg Tablet,Warehouse C,18,5,2025-02-24 14:36:00,13
9054,ORD_9055,23489,BabyChakra Natural Strengthening Baby Shampoo 200 gm,Warehouse C,32,13,2025-02-24 13:34:00,19
9055,ORD_9056,15626,MANCODE Skin Corrector Facial serum 50 ml,Warehouse B,52,37,2025-02-24 05:35:00,15
9056,ORD_9057,1651,Street Wear Lip2Last Matte Liquid Lipstick - Fleek Rust 5 ml,Warehouse A,39,22,2025-02-24 02:21:00,17
9057,ORD_9058,15623,Cough BM Syrup,Warehouse C,59,51,2025-02-24 21:18:00,8
9058,ORD_9059,35907,D-Valprax 250 ER Tablet,Warehouse A,76,65,2025-02-24 14:48:00,11
9059,ORD_9060,22355,"Boult Audio ProBass Ranger Over-Ear Wireless Bluetooth Headphones with Microphone, Headset with Long Battery Life",Warehouse C,94,89,2025-02-24 22:49:00,5
9060,ORD_9061,14170,Fevacross Suspension,Warehouse C,52,40,2025-02-24 09:55:00,12
9061,ORD_9062,17368,Purearth Sitara Crème Strobelighter - 8 Gm,Warehouse B,33,28,2025-02-24 00:29:00,5
9062,ORD_9063,14025,"ASUS Vivobook 16X (2022), 16.0-inch (40.64 cms) FHD+ 16:10, AMD Ryzen 5 5600H, Thin and Laptop (8GB/512GB SSD/Integrated G...",Warehouse A,58,49,2025-02-24 04:22:00,9
9063,ORD_9064,19567,Mefagan Spas Tablet,Warehouse C,47,38,2025-02-24 16:17:00,9
9064,ORD_9065,230,"ZEBRONICS Zeb-Yoga 90 Pro Wireless Bluetooth in Ear Neckband Earphone with Rapid Charge,Dual Pairing,Magnetic earpiece,Spl...",Warehouse C,82,66,2025-02-24 11:49:00,16
9065,ORD_9066,8373,Clopinate S Ointment,Warehouse C,77,66,2025-02-24 18:26:00,11
9066,ORD_9067,22047,Huda Professional Sponge Makeup Puff,Warehouse B,31,18,2025-02-24 15:25:00,13
9067,ORD_9068,23713,ANM Remote Compatible for Lloyd AC Remote (Exactly Same Remote Will ONLY Work) - with Complementary Batteries,Warehouse B,82,68,2025-02-24 02:39:00,14
9068,ORD_9069,11277,WildCard India 35mm Aluminum Tattoo Machine Handle Grip Tube Adjustable For Cartridge Tattoo Needle Rotary & Coil Tattoo M...,Warehouse C,66,47,2025-02-24 08:29:00,19
9069,ORD_9070,1033,"Paddle Hair Brush - PBP0001, Colour May Vary",Warehouse C,74,61,2025-02-24 23:16:00,13
9070,ORD_9071,11689,EGOTUDE Shock Proof Hard Back Crystal Clear Hybrid Soft Bumper Anti Scratch Cover Case for iPhone 11 (Transparent),Warehouse A,64,54,2025-02-24 14:19:00,10
9071,ORD_9072,22072,Rolay-DSR 30mg/20mg Capsule,Warehouse A,100,92,2025-02-24 10:22:00,8
9072,ORD_9073,1359,VLCC Natural Sciences Hair Fall Control Hair Oil 200 ml - Onion & Fenugreek,Warehouse B,20,10,2025-02-24 02:47:00,10
9073,ORD_9074,23304,Skin Toner Cream,Warehouse C,90,78,2025-02-24 19:48:00,12
9074,ORD_9075,680,Melozine 100mg Tablet,Warehouse C,54,48,2025-02-24 09:02:00,6
9075,ORD_9076,20238,Herbal Aloevera Neem & Basil Facial Massage Gel,Warehouse B,87,74,2025-02-24 18:42:00,13
9076,ORD_9077,19550,Tough Lee Silicone Back Cover for Mi 11X 5G / Mi 11X Pro 5G (Transparent),Warehouse C,96,80,2025-02-24 23:10:00,16
9077,ORD_9078,20211,Beauty People Metallic Glitter Eyeliner Tangy Turquoise 1's,Warehouse A,39,34,2025-02-24 21:57:00,5
9078,ORD_9079,14952,LA French DESIRE Perfume for Women 100 ml,Warehouse C,79,72,2025-02-24 00:45:00,7
9079,ORD_9080,22057,"truke Buds F1 Bluetooth 5.3 Truly Wireless in Ear Earbuds with mic, 48H Playtime, Instant Paring, Exceptional Sound with A...",Warehouse B,98,80,2025-02-24 20:36:00,18
9080,ORD_9081,19463,Glimiwel Plus 1mg/500mg Tablet,Warehouse B,108,97,2025-02-24 18:40:00,11
9081,ORD_9082,35563,Brocin 500mg Tablet,Warehouse A,97,86,2025-02-24 23:13:00,11
9082,ORD_9083,13035,Sounce Spiral Charger Cable Protector Data Cable Saver Charging Cord Protective Cable Cover Headphone MacBook Laptop Earph...,Warehouse C,28,17,2025-02-24 03:29:00,11
9083,ORD_9084,14722,TheGiftKart Tough Armor Samsung Galaxy M33 5G Bumper Back Case Cover | Ring Holder & Kickstand in-Built | 360 Degree Prote...,Warehouse A,70,58,2025-02-24 10:48:00,12
9084,ORD_9085,36727,TheGiftKart Sleek Back Cover Case for Google Pixel 6A | Slim Fit Protective Design | Ultra Matte Finish | Camera Protectio...,Warehouse A,88,78,2025-02-24 14:05:00,10
9085,ORD_9086,10699,Portronics Adapto 62 POR-1062 USB Wall Adapter with 2.4A Fast Charging Single USB Port Without Cable for All iOS & Android...,Warehouse A,107,90,2025-02-24 02:57:00,17
9086,ORD_9087,12089,Bathing Soap - Coconut & Neem,Warehouse A,81,76,2025-02-24 08:42:00,5
9087,ORD_9088,22501,"ZEBRONICS Zeb-VITA Wireless Bluetooth 10W Portable Bar Speaker with Supporting USB, SD Card, AUX, FM, TWS & Call Function....",Warehouse B,49,30,2025-02-24 13:30:00,19
9088,ORD_9089,12872,Parker Quink Ink Cartridges - Fountain Pen - Black- Pack of 3,Warehouse A,78,64,2025-02-24 15:34:00,14
9089,ORD_9090,18006,Fulgest 100mg Capsule SR,Warehouse A,80,69,2025-02-24 06:43:00,11
9090,ORD_9091,11417,Maryaj Pebble Shine EDP Floral Fruity Perfume And Ajmal Aurum Femme Deodorant Fruity Floral Fragrance 300 ml,Warehouse C,71,66,2025-02-24 07:51:00,5
9091,ORD_9092,36464,Suruchi bindi red size -4(pack of 12 leeaflets) for women and girls,Warehouse B,44,29,2025-02-24 02:02:00,15
9092,ORD_9093,35642,Drupen 40mg Tablet,Warehouse B,83,73,2025-02-24 07:55:00,10
9093,ORD_9094,22043,Losanorm 50-H Tablet,Warehouse C,88,83,2025-02-24 18:13:00,5
9094,ORD_9095,12598,"Beauté Secrets Callus remover for feet, Corn Shaver, Hard Skin Remover Stainless Steel Handle 10 Blades, Silver",Warehouse B,26,14,2025-02-23 19:59:00,12
9095,ORD_9096,28078,"GUBB Soft Bristle Round Eye Shadow Brush and Synthetic Bristle Slant Eye Shadow Brush - Red, 2 Pieces along with Slant Tip...",Warehouse A,82,64,2025-02-23 22:48:00,18
9096,ORD_9097,36934,Coligyl 12.5mg Dry Syrup,Warehouse A,75,56,2025-02-23 07:55:00,19
9097,ORD_9098,26409,Ajmal Prose EDP & Wild Waters EDT Pack of 2 350 ml,Warehouse C,10,5,2025-02-23 02:45:00,5
9098,ORD_9099,21920,"Blaupunkt SBA20 16W Bluetooth Soundbar for TV with Bluetooth/SD Card/Aux, Mini Sound/Audio System for TV Speakers, Mobile,...",Warehouse C,81,70,2025-02-23 02:03:00,11
9099,ORD_9100,4999,Faces Canada Splash Nail Enamel Marooned 401 8 Ml,Warehouse B,96,87,2025-02-23 09:28:00,9
9100,ORD_9101,8569,Epishine Advanced Skin Whitening and Brightening Face Wash (70ml) : Pack of 1,Warehouse A,82,68,2025-02-23 16:25:00,14
9101,ORD_9102,30691,Sunaina Bridal Collection Mix Size Golden Stone Bindis for Women [SBCGS101],Warehouse A,53,34,2025-02-23 23:50:00,19
9102,ORD_9103,3137,"Raktashodhini Vati - Blood Purifier, 500 mg",Warehouse B,42,24,2025-02-23 00:28:00,18
9103,ORD_9104,21590,Nutriment Papaya gel All Skin Type 250 gm,Warehouse C,90,85,2025-02-23 10:53:00,5
9104,ORD_9105,26608,Zolapin 10mg Tablet MD,Warehouse B,35,24,2025-02-23 20:20:00,11
9105,ORD_9106,14795,Aggarwals international Geru mitti Lal mitti powder Red ocher powder 2 kg,Warehouse B,82,77,2025-02-23 19:18:00,5
9106,ORD_9107,21951,Ubtan Facial Cleanser - Amla & Aloe Vera,Warehouse B,47,31,2025-02-23 22:09:00,16
9107,ORD_9108,21902,Nady 25mg Injection,Warehouse B,53,48,2025-02-23 03:34:00,5
9108,ORD_9109,21909,Quantum QHM6660 4 Port Hi-Speed USB Hub with Power Switch (Multicolor),Warehouse C,51,32,2025-02-23 09:40:00,19
9109,ORD_9110,10042,"Dell Pro Backpack, 15 - PO1520P (Fits Most Laptops Up to 38.1 cm (15""), Black)",Warehouse A,46,28,2025-02-23 15:50:00,18
9110,ORD_9111,19071,Aceclodol P 100mg/500mg Tablet,Warehouse A,93,81,2025-02-23 08:44:00,12
9111,ORD_9112,19060,"Zebronics Zeb Smart Cam 100 Smart Home Automation WiFi Camera with Remote Monitoring, Advanced Motion Detection, Day/Night...",Warehouse C,25,13,2025-02-23 22:26:00,12
9112,ORD_9113,1546,"CEDO Tempered Glass for iPad 7, 8, 9 Gen - 10.2 inch | Screen Protector Tempered Glass for iPad Tab 7th / 8th / 9th Genera...",Warehouse C,26,14,2025-02-23 09:01:00,12
9113,ORD_9114,35368,"Tukzer Universal Car Mount Mobile Holder Stand| Strong Suction Cup, Double Shift Locking for Dashboard Windshield| Quick T...",Warehouse A,92,76,2025-02-23 01:03:00,16
9114,ORD_9115,12982,Amozo Camera Protection Soft Back Case Cover for OnePlus Nord 2 5G / OnePlus Nord 2 5G Pac-Man Edition (Soft Silicon | Black),Warehouse B,9,2,2025-02-23 20:33:00,7
9115,ORD_9116,8463,Larimentin 500mg/125mg Tablet,Warehouse A,18,11,2025-02-23 19:14:00,7
9116,ORD_9117,2586,"OREI Worldwide Universal Travel Adapter with Dual USB Ports (2.1A Smart Plug Charging) - All-in-One, 100V-250V Plug - Inte...",Warehouse A,68,59,2025-02-23 09:24:00,9
9117,ORD_9118,21950,Spigen Essential Sand Blast Back Cover Case Compatible For Samsung Galaxy F23 5G and M23 5G (TPU | Matte Black),Warehouse A,43,28,2025-02-23 01:32:00,15
9118,ORD_9119,31013,"Philips Audio Tws Tat1215 Bluetooth Truly Wireless In Ear Earbuds With Mic With 18 Hr Playtime - 6+12, Ipx4, Voice Assista...",Warehouse B,99,86,2025-02-23 10:54:00,13
9119,ORD_9120,5091,Aceden-P Oral Suspension,Warehouse A,64,56,2025-02-23 12:00:00,8
9120,ORD_9121,26627,DELL Original 11.4V 3C 42WHR BATTERY-3500mAH Lith SDI New (WDX0R) INSPIRON 13 5368 5378 15 5565 5567,Warehouse B,84,75,2025-02-23 02:12:00,9
9121,ORD_9122,5172,Polyemoise Eye Drop,Warehouse C,36,24,2025-02-23 14:29:00,12
9122,ORD_9123,35382,Rabiluc-D Capsule SR,Warehouse A,69,51,2025-02-23 11:01:00,18
9123,ORD_9124,35288,"Sivanna Colors Bronze & Contour and Highlighter, 14g (3)",Warehouse C,74,62,2025-02-23 07:18:00,12
9124,ORD_9125,19291,"TECH8 USA, Undetectable USB Mouse Jiggler, Works in Background, Keeps Teams, Skype, Lync and PC Active, No Software, Plug-...",Warehouse C,24,9,2025-02-23 14:12:00,15
9125,ORD_9126,36921,Flexase P 100mg/500mg Tablet,Warehouse C,80,65,2025-02-23 20:11:00,15
9126,ORD_9127,3432,iEDS Premium Sticky Lens Guard for Insta360 One X3 Action Camera Lens Guard,Warehouse A,93,82,2025-02-23 02:00:00,11
9127,ORD_9128,1061,Megamox-CV Duo Dry Syrup,Warehouse B,42,33,2025-02-23 18:19:00,9
9128,ORD_9129,19256,Rosuvax CV 10mg/75mg Tablet,Warehouse C,87,69,2025-02-23 23:40:00,18
9129,ORD_9130,12612,Nitroin Tablet SR,Warehouse B,113,94,2025-02-23 03:14:00,19
9130,ORD_9131,21638,Amazon Brand - Solimo Silicone Back Cover for Samsung Galaxy M12 - Transparent,Warehouse C,77,64,2025-02-23 21:40:00,13
9131,ORD_9132,12963,"Ordershock Birds, Believe,Smile, Happy Tattoo Waterproof For Girls Boys Temporary Body Tattoo",Warehouse C,71,59,2025-02-23 03:32:00,12
9132,ORD_9133,31010,Ctrisana-SB Injection,Warehouse A,33,15,2025-02-23 00:26:00,18
9133,ORD_9134,27773,Nuflex MR 100mg/325mg/250mg Tablet,Warehouse C,105,98,2025-02-23 15:57:00,7
9134,ORD_9135,27788,Mefatis-P Oral Suspension,Warehouse A,14,3,2025-02-23 05:33:00,11
9135,ORD_9136,206,Nortigo-Plus Tablet,Warehouse C,82,64,2025-02-23 02:37:00,18
9136,ORD_9137,36896,Dily Young Age BB Blemish Balm 60g,Warehouse A,55,48,2025-02-23 11:54:00,7
9137,ORD_9138,26662,"Fashion Colour 2 - In - 1 Face Powder, Shade 01 20 gm",Warehouse A,105,89,2025-02-23 03:20:00,16
9138,ORD_9139,2353,Glipacure M 1000mg/50mg Tablet,Warehouse B,36,21,2025-02-23 21:57:00,15
9139,ORD_9140,19536,Sefxim 100mg Tablet,Warehouse A,63,53,2025-02-23 21:07:00,10
9140,ORD_9141,21519,Samsung 146 cm (58 inches) Crystal 4K Pro Series Ultra HD Smart LED TV UA58AUE70AKLXL (Black),Warehouse C,100,85,2025-02-23 00:00:00,15
9141,ORD_9142,19531,"TP-Link UH400 USB 3.0 4-Port Portable Data Hub for Mac, iMac, MacBook Pro Air, Ultrabooks, Tablet, Laptop and Any PC, Wind...",Warehouse C,70,62,2025-02-23 02:48:00,8
9142,ORD_9143,27807,Rosloy Asp 10/75 Capsule,Warehouse A,109,99,2025-02-23 17:04:00,10
9143,ORD_9144,9774,"ProElite Smart Flip Case Cover for Apple iPad Air 5th/4th Generation 10.9 inch , Translucent Back, Dark Blue",Warehouse A,27,14,2025-02-23 15:23:00,13
9144,ORD_9145,19412,"Amazon Basics Wired Keyboard for Windows, USB 2.0 Interface, for PC, Computer, Laptop, Mac (Black)",Warehouse A,31,14,2025-02-23 06:18:00,17
9145,ORD_9146,9783,Azilup 200mg/5ml Suspension,Warehouse C,33,28,2025-02-23 07:02:00,5
9146,ORD_9147,5175,Sildoease 4 Capsule,Warehouse C,22,3,2025-02-23 00:20:00,19
9147,ORD_9148,8448,Revila Dsr Capsule,Warehouse C,81,75,2025-02-23 00:05:00,6
9148,ORD_9149,5026,Emimox 500mg Tablet,Warehouse C,39,31,2025-02-23 05:42:00,8
9149,ORD_9150,10082,Wet N Wild Color Icon Kohl Liner Pencil - Baby'S Got Black 1.4 gm,Warehouse A,45,30,2025-02-23 22:17:00,15
9150,ORD_9151,10085,WOW IMAGINE Shock Proof Clear Protective Back Case for Samsung Galaxy M04 | F04 | A04e - AirEDGE Technology | 360 Degree C...,Warehouse B,91,76,2025-02-23 05:19:00,15
9151,ORD_9152,11758,"AGARO 3.1 A Dual Port Lightning, USB Smart Car Charger for All Smartphones & Tablets- Black",Warehouse C,15,10,2025-02-23 10:35:00,5
9152,ORD_9153,25288,Betaniza AM 5mg/50mg Tablet ER,Warehouse B,54,41,2025-02-23 18:48:00,13
9153,ORD_9154,6734,Inefable ( 12 Pcs ) Multicoloured Protection Spiral Cable & Wire Protectors Spring Wire for All Wired Accessories for USB ...,Warehouse B,77,64,2025-02-23 12:39:00,13
9154,ORD_9155,7081,Crysendo Headphone Cushion Pad Compatible with Mi Super Bass Wireless Headphones | 75mm X 60mm Replacement Headset Ear Cus...,Warehouse B,92,84,2025-02-23 18:54:00,8
9155,ORD_9156,13459,"Apple Watch Ultra [GPS + Cellular 49 mm] Smart Watch w/Rugged Titanium Case & Midnight Ocean Band. Fitness Tracker, Precis...",Warehouse C,104,87,2025-02-23 13:35:00,17
9156,ORD_9157,16214,"Gizga Essentials Laptop Bag Sleeve Case Cover Pouch for 15.6 Inch Laptop/MacBook, Office/ College Laptop Bag for Men & Wom...",Warehouse B,65,48,2025-02-23 12:03:00,17
9157,ORD_9158,36276,Vomizen 2mg Injection,Warehouse A,110,97,2025-02-23 00:24:00,13
9158,ORD_9159,33857,Nylep Syrup,Warehouse B,77,72,2025-02-23 09:29:00,5
9159,ORD_9160,15568,"Amazon Basics High-Speed HDMI Cable, 6 Feet - Supports Ethernet, 3D, 4K video,Black",Warehouse C,97,89,2025-02-23 08:23:00,8
9160,ORD_9161,23815,Coldgard-Plus Tablet,Warehouse B,14,3,2025-02-23 22:18:00,11
9161,ORD_9162,16197,"Parag Fragrances Long Lasting, Non-Alcoholic & Grade-1 Attar 25ml (Sandalwood)",Warehouse B,85,68,2025-02-23 16:40:00,17
9162,ORD_9163,16807,Vega Moustache Comb (HMBC - 194) 15 gm,Warehouse A,82,69,2025-02-23 04:47:00,13
9163,ORD_9164,11441,Domsin-LA 10mg/30mg Capsule,Warehouse A,36,21,2025-02-23 12:17:00,15
9164,ORD_9165,24358,Genotriz LM 5mg/10mg Tablet,Warehouse B,85,68,2025-02-23 08:45:00,17
9165,ORD_9166,13455,"Active Salt Toothpaste - Saver Pack 300 g + Mouthwash - Plax, Active Salt 250 ml",Warehouse B,85,73,2025-02-23 05:34:00,12
9166,ORD_9167,36083,House Of Makeup Good On You Hydra Matte Lipstick - Mon Cherry 3.5 gm,Warehouse B,17,10,2025-02-23 13:02:00,7
9167,ORD_9168,16820,HP 103A Blk Neverstop Toner Reload Kit (Black),Warehouse C,16,7,2025-02-23 13:02:00,9
9168,ORD_9169,23801,Criss Cross Toothbrush with Neem Extract - Soft,Warehouse C,46,30,2025-02-23 01:23:00,16
9169,ORD_9170,25303,Amozo Designed for iPhone 14 Cover | Ultra Hybrid Drop and Camera Protection Back Cover Case for iPhone 14 (TPU + Polycarb...,Warehouse C,54,38,2025-02-23 10:14:00,16
9170,ORD_9171,6745,Minuslide P Suspension,Warehouse A,73,54,2025-02-23 04:33:00,19
9171,ORD_9172,6548,Belle-De-Oud Roll-On,Warehouse A,104,87,2025-02-23 14:53:00,17
9172,ORD_9173,31428,Syska HT900 Corded & Cordless Fully Waterproof Beard Trimmer with Fast Charging Battery Indicator 120 min run time - 40 le...,Warehouse A,62,47,2025-02-23 13:42:00,15
9173,ORD_9174,30146,Plantas Extra Nourishment & Protection Organic Shampoo 200 ml,Warehouse B,111,92,2025-02-23 08:02:00,19
9174,ORD_9175,2885,"Fashion Colour Satin Smooth Lip Definer, 1 Purple Beauty 1.41 gm",Warehouse B,94,77,2025-02-23 20:19:00,17
9175,ORD_9176,6564,"Nokia 6310 Dual SIM Keypad Phone with a 2.8” Screen, Wireless FM Radio and Rear Camera with Flash | Black",Warehouse A,66,49,2025-02-23 17:21:00,17
9176,ORD_9177,37110,Emoxin 250mg/250mg Capsule,Warehouse C,78,69,2025-02-23 01:30:00,9
9177,ORD_9178,36271,GOCART WITH G LOGO Laptop Backpack Casual Daypacks Briefcase Convertible Business Travel Rucksack with USB Charging Port L...,Warehouse C,34,18,2025-02-23 22:44:00,16
9178,ORD_9179,12616,Aridic Plus 50mg/325mg Tablet,Warehouse C,24,19,2025-02-23 20:21:00,5
9179,ORD_9180,16921,Deflek 6mg Tablet,Warehouse B,57,39,2025-02-23 03:33:00,18
9180,ORD_9181,27356,Neuropin 50mg Tablet,Warehouse B,59,46,2025-02-23 17:50:00,13
9181,ORD_9182,28133,"Gush - Dual Ended Kajal & Felt-Tip Liner, Matte Finish Waterproof 2 in 1 Long-Lasting and Weightless, 0.65g - Black",Warehouse B,48,38,2025-02-23 16:40:00,10
9182,ORD_9183,34449,Glycurb Forte 5 mg/500 mg Tablet,Warehouse A,44,25,2025-02-23 11:00:00,19
9183,ORD_9184,19114,Alecta Plus 325mg/37.5mg Tablet,Warehouse A,100,95,2025-02-23 21:37:00,5
9184,ORD_9185,12595,"Deltoid Lite Face Masks In Rose, Pink & Aqua Knit Fabrics With Bindings - Assorted, 3C2001, XL",Warehouse C,78,63,2025-02-23 07:31:00,15
9185,ORD_9186,9979,HEALLILY Forefoot Pad 4 Pairs Honeycomb Fabric Metatarsal Pads Forefoot Cushioning Shoe Support Toe Socks Foot Cushions Su...,Warehouse A,94,78,2025-02-23 23:23:00,16
9186,ORD_9187,21791,LOHAYA Remote Compatible for Onida Split/Window AC Remote Control (Onida AC Remote Control) (AC-18),Warehouse C,64,45,2025-02-23 22:35:00,19
9187,ORD_9188,9954,Protect Handwash Liquid With Lavender Fragrance,Warehouse C,60,55,2025-02-23 09:16:00,5
9188,ORD_9189,28006,"LINC Pentonic Extra Dark Premium Pencil, Pack of 10",Warehouse A,118,99,2025-02-23 21:42:00,19
9189,ORD_9190,3076,Daily Life Forever52 Butter Blush Ibb04 11 Gm,Warehouse C,110,95,2025-02-23 22:21:00,15
9190,ORD_9191,14094,Azbact 250mg Tablet DT,Warehouse A,49,32,2025-02-23 14:27:00,17
9191,ORD_9192,5912,Xetra T 1000mg/125mg Injection,Warehouse A,64,55,2025-02-23 21:13:00,9
9192,ORD_9193,28012,Turfine 250mg Tablet,Warehouse C,23,6,2025-02-23 01:51:00,17
9193,ORD_9194,8546,"moha: Nail Care Cream for Dryness (Dry Skin) 100 g | For Cuticle Care, Nail Growth & Strength With Goodness of Almond Oil...",Warehouse B,29,16,2025-02-23 14:05:00,13
9194,ORD_9195,3073,Streetwear Nail Enamel (Pretty Girl Collection) - I Flirt 8 Ml,Warehouse B,112,96,2025-02-23 14:05:00,16
9195,ORD_9196,25410,"Boult Audio AirBass Propods X Bluetooth Truly Wireless in Ear Earbuds, 32H Playtime, Fast Charging Type-C, IPX5 Water Resi...",Warehouse A,99,81,2025-02-23 17:28:00,18
9196,ORD_9197,14768,Itromax 1% Gel,Warehouse C,80,63,2025-02-23 06:22:00,17
9197,ORD_9198,14088,Spigen Ultra Hybrid Back Cover Case for iPhone 13 (TPU + Poly Carbonate | Crystal Clear),Warehouse B,103,86,2025-02-23 20:40:00,17
9198,ORD_9199,28067,RA Quin 200mg Tablet,Warehouse B,104,85,2025-02-23 19:48:00,19
9199,ORD_9200,9989,Dicpacer P 50mg/500mg Tablet,Warehouse C,68,63,2025-02-23 04:34:00,5
9200,ORD_9201,12972,JTS TK-600 Cardioid Dynamic Microphone Without Cable.,Warehouse B,13,4,2025-02-23 06:55:00,9
9201,ORD_9202,14775,"Noise ColorFit Ultra Smart Watch with 1.75"" HD Display, Aluminium Alloy Body, 60 Sports Modes, Spo2, Lightweight, Stock Ma...",Warehouse C,104,92,2025-02-23 14:54:00,12
9202,ORD_9203,28041,Pre-Shave Scrub With Black Sand & Vitamin E For Dead Skin Removal,Warehouse B,35,28,2025-02-23 08:43:00,7
9203,ORD_9204,5923,Grape Seed & Sea Buckthorn Light stay Day Cream SPF30,Warehouse A,41,34,2025-02-23 09:02:00,7
9204,ORD_9205,19150,"Amazon Basics High-Speed HDMI Cable, 6 Feet (2-Pack),Black",Warehouse B,57,46,2025-02-23 20:31:00,11
9205,ORD_9206,3656,Revlon Colorstay Full Cover Foundation - Natural Ochre 30 ml,Warehouse C,79,69,2025-02-23 23:01:00,10
9206,ORD_9207,21867,Perfume Body Spray - Turquoise,Warehouse A,27,20,2025-02-23 12:06:00,7
9207,ORD_9208,8509,Lapster Speedo Type Non-Slip Rubber Base Mouse Pad with Antifray Stitched Embroidery Edges for Laptop PC - (240mm x 200mm ...,Warehouse A,90,78,2025-02-23 08:26:00,12
9208,ORD_9209,14727,Optimox Plus 125mg Tablet,Warehouse A,9,2,2025-02-23 11:52:00,7
9209,ORD_9210,114,"SWAPKART 2 in 1 OTG Adapter Type c OTG ,Micro USB OTG Micro USB + c c Type ,Converter Adapter Type c and USB 2.0 Male to F...",Warehouse A,44,32,2025-02-23 17:01:00,12
9210,ORD_9211,14932,Whitening & UV Protection Body Lotion,Warehouse C,108,91,2025-02-23 12:42:00,17
9211,ORD_9212,8423,Prexol 0.5mg Tablet SR,Warehouse A,107,88,2025-02-23 17:12:00,19
9212,ORD_9213,5988,Grandem 1 Tablet,Warehouse A,32,20,2025-02-23 23:27:00,12
9213,ORD_9214,26328,Sweet Heart Day Rommance Eau De Parfum 100 ml,Warehouse C,29,17,2025-02-23 02:34:00,12
9214,ORD_9215,18965,Crovix 50mg Dry Syrup,Warehouse A,77,71,2025-02-23 02:50:00,6
9215,ORD_9216,18960,Electvision Television TV Remote Control Compatible with Mi Smart LED TV 4A (Please Verify Before Placing Order) (Without ...,Warehouse B,109,90,2025-02-23 04:38:00,19
9216,ORD_9217,26317,"Amazon Basics Mfi Certified Usb-C To Lightning Cable Cord For Smartphone (1-Ft, White)",Warehouse A,25,17,2025-02-23 10:47:00,8
9217,ORD_9218,22036,"Logitech Lift Vertical Ergonomic Mouse, Wireless, Bluetooth or Logi Bolt USB Receiver, Quiet clicks, 4 Buttons, Compatible...",Warehouse A,12,6,2025-02-23 00:25:00,6
9218,ORD_9219,22040,Trypdol 100mg/325mg Tablet,Warehouse B,88,71,2025-02-23 20:17:00,17
9219,ORD_9220,26301,Junior Lgerd 15mg Tablet DT,Warehouse A,84,73,2025-02-23 12:56:00,11
9220,ORD_9221,35432,Soap Strips - Jasmine,Warehouse A,34,21,2025-02-23 01:24:00,13
9221,ORD_9222,31082,Medogesic SP 100mg/325mg/15mg Tablet,Warehouse B,79,63,2025-02-23 21:13:00,16
9222,ORD_9223,14840,"FEDUS 3 in 1 Laptop Screen Guard, Keyboard Protector and Laptop Skin for All 15.6INCH Laptops Laptop Accessories Combo Kit",Warehouse C,65,54,2025-02-23 01:33:00,11
9223,ORD_9224,22080,Cyclotin 10 Tablet,Warehouse C,77,59,2025-02-23 02:40:00,18
9224,ORD_9225,34385,GO SHOPS Noise_Colorfit Smart Watch Charger 2 Pin USB Fast Charger Magnetic Charging Cable Adapter (Smart Watch Charger 2 ...,Warehouse A,72,63,2025-02-23 16:20:00,9
9225,ORD_9226,33085,Duopil HS 1mg/850mg Tablet,Warehouse B,22,13,2025-02-23 13:48:00,9
9226,ORD_9227,36689,"Anti-Dandruff Hair Oil - Castor, Olive, Rosemary, Bhringraj, Neem & Tea Tree",Warehouse B,109,91,2025-02-23 06:34:00,18
9227,ORD_9228,14845,Mahagesic Gel,Warehouse C,76,60,2025-02-23 17:27:00,16
9228,ORD_9229,30610,Osaka OS 550 Tripod 55 Inches (140 cm) with Mobile Holder and Carry Case for Smartphone & DSLR Camera Portable Lightweight...,Warehouse A,25,18,2025-02-23 15:42:00,7
9229,ORD_9230,14038,Moxsta-DX 250mg/250mg Capsule,Warehouse A,24,14,2025-02-23 09:33:00,10
9230,ORD_9231,14850,Zoxlon 50mg Injection,Warehouse B,42,33,2025-02-23 08:05:00,9
9231,ORD_9232,14012,Uncle Tony Shower Gel - Ginger Root Extract 200 ml,Warehouse B,88,77,2025-02-23 06:14:00,11
9232,ORD_9233,2633,Canon GI-70 BK Ink Bottle (Black),Warehouse B,68,59,2025-02-23 03:22:00,9
9233,ORD_9234,28326,Cellumox 0.5% Eye Drop,Warehouse C,101,86,2025-02-23 03:07:00,15
9234,ORD_9235,90,Manish Malhotra Beauty By MyGlamm Saffron & Sandalwood Brightening Sheet Mask 25 ml,Warehouse A,51,41,2025-02-23 16:03:00,10
9235,ORD_9236,14923,Thiodem A 100mg/4mg Tablet,Warehouse B,39,27,2025-02-23 21:13:00,12
9236,ORD_9237,33083,realme Buds Wireless 2 Neo Bluetooth in Ear Earphones with Mic (Green),Warehouse B,67,54,2025-02-23 20:56:00,13
9237,ORD_9238,2290,"L'Oreal Paris Casting Creme Gloss Small Pack, 300 Darkest Brown 45 Gm",Warehouse B,101,87,2025-02-23 04:09:00,14
9238,ORD_9239,22118,"L'Oreal Paris Rouge Signature Matte Liquid Lipstick, 151 I Insist 7 Gm",Warehouse A,58,44,2025-02-23 05:29:00,14
9239,ORD_9240,28275,Ceftyl 200mg Tablet,Warehouse A,43,33,2025-02-23 21:41:00,10
9240,ORD_9241,8716,Biotique Himalayan Plum Refreshing Body Soap 150 gm,Warehouse B,78,62,2025-02-23 15:27:00,16
9241,ORD_9242,14659,Memoxil 500mg Capsule,Warehouse C,62,57,2025-02-23 12:43:00,5
9242,ORD_9243,27770,Oflosar-M Oral Suspension,Warehouse C,37,29,2025-02-23 13:00:00,8
9243,ORD_9244,12540,Insight Cosmetics Color Rich Lipstick - Nude Mauve 4.2 gm,Warehouse B,97,80,2025-02-23 03:29:00,17
9244,ORD_9245,22123,FATMUG Laptop Bag For Men - Convertible Backpack For Office And Travel (Light Grey Oxford Fabric),Warehouse B,67,48,2025-02-23 10:15:00,19
9245,ORD_9246,10176,Milixim 50mg Suspension,Warehouse C,44,28,2025-02-23 23:07:00,16
9246,ORD_9247,31090,"Arrow Birthday Gift Paper Bags, 28 cm x 20 cm x 7.5 cm (Pack of 10)Multicolor",Warehouse B,103,96,2025-02-23 11:46:00,7
9247,ORD_9248,14029,Boult Audio BassBuds X1 in-Ear Wired Earphones with 10mm Extra Bass Driver and HD Sound with mic(Blue),Warehouse A,67,58,2025-02-23 23:04:00,9
9248,ORD_9249,10191,"Binatone Trend 1 Digital Corded Landline Phone with Dedicated Flash Button, Wall Mounted Supported, alphanumerical keypad,...",Warehouse C,107,98,2025-02-23 14:28:00,9
9249,ORD_9250,4925,Monlevo Junior 2.5mg/4mg Tablet,Warehouse A,99,83,2025-02-23 13:40:00,16
9250,ORD_9251,31730,Medimade Charcoal With Tea Tree Oil 3 In 1 Mud Mask 100 gm,Warehouse C,77,63,2025-02-23 17:37:00,14
9251,ORD_9252,10221,Svsera D 50mg/10mg Tablet,Warehouse A,109,95,2025-02-23 13:32:00,14
9252,ORD_9253,14881,Acer 80 cm (32 inches) S Series HD Ready Android Smart LED TV AR32AR2841HDSB (Black),Warehouse A,42,33,2025-02-23 00:20:00,9
9253,ORD_9254,17039,DZert Clasy Laptop Bag College Bag for Boys Girls 21 L Black,Warehouse B,46,34,2025-02-23 03:11:00,12
9254,ORD_9255,18750,"Urvija Neem and Basil Cleanser - Essential oil based Handmade soap - No Sulphates, Anti acne, Anti rash, Improves skin tex...",Warehouse B,26,12,2025-02-23 03:19:00,14
9255,ORD_9256,22187,"GoRogue Foldable Wooden Mini Laptop Table for Bed, Study Table with Drawer, Tablet/Mobile Holder for Kids & Adults (Black)",Warehouse B,44,33,2025-02-23 13:51:00,11
9256,ORD_9257,33103,"Nicka K 21 Color Eyehadow Palette - Spiced Up, Multicolor, 21.5 g",Warehouse B,73,59,2025-02-23 04:58:00,14
9257,ORD_9258,28278,"Parker Frontier Matte Black GT Roller Ball Pen, Golden color, 1 Count (Pack of 1) (9000020439)",Warehouse B,59,45,2025-02-23 10:45:00,14
9258,ORD_9259,10243,Oflosar Oral Suspension,Warehouse B,100,84,2025-02-23 02:03:00,16
9259,ORD_9260,10245,"Sounce 65W OnePlus Dash Warp Charge Cable, 6.5A Type-C to USB C PD Data Sync Fast Charging Cable Compatible with One Plus ...",Warehouse A,96,78,2025-02-23 02:46:00,18
9260,ORD_9261,22220,AEIDESS Tempered Glass Screen Protector Compatible For Google Pixel 6 with Edge to Edge Coverage and Easy Installation Kit,Warehouse B,70,56,2025-02-23 08:06:00,14
9261,ORD_9262,977,Patchouli Essential Oil For Glowing Radiant Skin & Healthy Hair,Warehouse B,62,51,2025-02-23 01:10:00,11
9262,ORD_9263,6034,Mapperz Pencil Eyeliner/ Waterproof Black Eyeliner pencil | 3 Water Proof Perfect Eyeliner Combo - Black,Warehouse C,54,39,2025-02-23 11:04:00,15
9263,ORD_9264,18692,Stbotanica Pure Geranium Essential Oil 15 ml,Warehouse B,63,51,2025-02-23 08:19:00,12
9264,ORD_9265,6039,Active Charcoal Face Scrub,Warehouse B,13,7,2025-02-23 16:06:00,6
9265,ORD_9266,12505,"L.A. COLORS Auto Eyeliner, Black/Brown Matte Finish",Warehouse C,94,82,2025-02-23 05:43:00,12
9266,ORD_9267,14933,Itzhh Capsule,Warehouse A,58,39,2025-02-23 21:03:00,19
9267,ORD_9268,9893,"Anker Usb C, 20W Pd Fast Powerport Iii Charger For Cellular Phones,Tablets,Smartwatches (Iphone 12/12 Mini/12 Pro/12 Pro M...",Warehouse B,78,68,2025-02-23 11:39:00,10
9268,ORD_9269,16762,"Photography Mobile Holder Tripod 3110 Camera Mobile Stand for Vlogging, Video Shooting, YouTube etc Compatible with All Mo...",Warehouse A,71,63,2025-02-23 02:21:00,8
9269,ORD_9270,26186,Vermiflam Tablet,Warehouse A,21,11,2025-02-23 05:47:00,10
9270,ORD_9271,32468,"Logitech H110 Wired On Ear Headphones With Mic, Stereo With Noise-Cancelling,3.5-Mm Dual Audio Jack, Pc/Mac/Laptop- Black",Warehouse B,77,64,2025-02-23 01:49:00,13
9271,ORD_9272,22294,Voxipod 50mg Dry Syrup,Warehouse A,101,90,2025-02-23 06:12:00,11
9272,ORD_9273,13999,Suhagra 100 Tablet,Warehouse C,38,30,2025-02-23 23:21:00,8
9273,ORD_9274,18618,Esomep D 30mg/40mg Capsule SR,Warehouse A,72,55,2025-02-23 19:52:00,17
9274,ORD_9275,14911,Ogit Suspension,Warehouse B,53,35,2025-02-23 21:24:00,18
9275,ORD_9276,28361,LINLO Back Camera Tempered Glass Lens Protector Compatible for Apple iPhone 13/13 Mini with Edge to Edge Coverage and Easy...,Warehouse A,68,55,2025-02-23 23:01:00,13
9276,ORD_9277,8248,"CHIPTRONEX Titan X Mid Tower ATX Gaming Cabinet USB 3.0 with Bottom PSU Mount Gaming case, Computer case, Cabinet for pc, ...",Warehouse A,28,21,2025-02-23 21:34:00,7
9277,ORD_9278,8246,Nilpain Tablet,Warehouse C,87,74,2025-02-23 23:28:00,13
9278,ORD_9279,18608,D'Addario EXL120 Nickel Wound 9-42 Super Light Electric Guitar Strings (Nickel),Warehouse A,68,63,2025-02-23 13:27:00,5
9279,ORD_9280,36954,Soulflower TeaTree Essential Oil 15 ml,Warehouse B,35,16,2025-02-23 22:48:00,19
9280,ORD_9281,18606,Zolve 500mg Tablet,Warehouse C,30,15,2025-02-23 11:55:00,15
9281,ORD_9282,10309,"W WADRO - Built with Passion 40W Trigger Feed Leak Proof Gun (Random Gun Color, 28 Sticks)",Warehouse C,21,4,2025-02-23 13:36:00,17
9282,ORD_9283,966,OneAssist 3Yrs Total Protection Plan for TV (Price Range 30001-35000)-Digital Delivery in 2 Hours,Warehouse B,40,32,2025-02-23 09:26:00,8
9283,ORD_9284,26335,Leecef 1000mg Injection,Warehouse A,23,17,2025-02-23 02:59:00,6
9284,ORD_9285,21989,Vitamin C Brightening Peel Off Mask,Warehouse A,17,9,2025-02-23 02:04:00,8
9285,ORD_9286,2306,Ajmal Blu & Silver Shade & Evoke silver Edition Homme & Shadow Homme Deo & Aretha EDP Pack of 5 20 ml,Warehouse C,97,83,2025-02-23 13:34:00,14
9286,ORD_9287,26540,Bufrix 250mg Tablet,Warehouse A,78,67,2025-02-23 00:30:00,11
9287,ORD_9288,215,Dolvex Oral Suspension,Warehouse A,71,60,2025-02-23 04:59:00,11
9288,ORD_9289,32991,Allure Foundation Brush (angle Foundation C-26 ) 1's,Warehouse B,60,54,2025-02-23 02:49:00,6
9289,ORD_9290,9876,Nyc TZ 400mg/600mg Tablet,Warehouse B,99,88,2025-02-23 09:49:00,11
9290,ORD_9291,27936,Casecandy® - (2 Pack Screen Protector Guard For Apple Watch Series 8 41mm | HD Screen Guard For Apple Watch Series 8 41mm ...,Warehouse C,98,83,2025-02-23 10:19:00,15
9291,ORD_9292,27943,OnePlus 138 cm (55 inches) Y Series 4K Ultra HD Smart Android LED TV 55Y1S Pro (Black),Warehouse B,56,51,2025-02-23 13:29:00,5
9292,ORD_9293,3625,Oflatoon DS 200mg Suspension,Warehouse B,48,39,2025-02-23 07:12:00,9
9293,ORD_9294,5097,Quess Care Extended Warranty Plan for 2 Year for TV Between 10001 to 15000 (Email Delivery),Warehouse A,53,38,2025-02-23 19:41:00,15
9294,ORD_9295,5096,"Mi Portable Bluetooth Speaker with 16W Hi-Quality Speaker, Type C Charging, Upto 13hrs of Playback Time & IPX7 Waterproof...",Warehouse C,56,47,2025-02-23 16:14:00,9
9295,ORD_9296,19334,Zvd 100mg Tablet,Warehouse A,13,1,2025-02-23 11:14:00,12
9296,ORD_9297,31036,"POPIO Tempered Glass Screen Protector for Samsung Galaxy Watch 4 / Samsung Galaxy Watch 5 (40mm) (1.2"" inch), Pack of 2",Warehouse A,88,82,2025-02-23 04:51:00,6
9297,ORD_9298,35510,La French Happiness Perfume | Eau De Parfum | Premium Long Lasting Fragrance Spray | Mood Enhancing | Ideal Gift Men & Wom...,Warehouse A,16,10,2025-02-23 07:02:00,6
9298,ORD_9299,1622,"Carolina Herrera 212 VIP Eau de Parfum For Women, 80ml",Warehouse A,84,67,2025-02-23 23:06:00,17
9299,ORD_9300,30555,Zabby 500mg Tablet,Warehouse C,72,53,2025-02-23 16:56:00,19
9300,ORD_9301,8188,Reynolds TRIMAX 5 PENS POUCH Gel Pen I Lightweight Gel Pen With Comfortable Grip for Extra Smooth Writing I School and Off...,Warehouse B,37,22,2025-02-23 00:51:00,15
9301,ORD_9302,10366,Yestimadhu Tablets,Warehouse A,44,36,2025-02-23 02:42:00,8
9302,ORD_9303,10372,TWC Day & Night Sanitary Pad Pack of 12 180 gm,Warehouse A,30,21,2025-02-23 17:53:00,9
9303,ORD_9304,8204,Indian Rose Face Gel,Warehouse B,44,28,2025-02-23 08:38:00,16
9304,ORD_9305,22390,Moxikind-CV 1000mg/200mg Injection,Warehouse A,96,80,2025-02-23 22:15:00,16
9305,ORD_9306,26140,Benic Cream,Warehouse A,99,88,2025-02-23 09:25:00,11
9306,ORD_9307,28424,Ramace 1.25 Tablet,Warehouse C,103,98,2025-02-23 06:51:00,5
9307,ORD_9308,3398,Glavid 200mg Tablet,Warehouse C,39,33,2025-02-23 10:17:00,6
9308,ORD_9309,3702,Mamaearth Breathe Easy Vapour Roll - On 40 ml,Warehouse B,37,18,2025-02-23 13:21:00,19
9309,ORD_9310,18508,Condoms - Extra Time,Warehouse A,33,21,2025-02-23 19:15:00,12
9310,ORD_9311,6098,Anthems Study Table/Bed Table/Foldable and Portable Wooden/Writing Desk for Office/Home/School (Black MAXX),Warehouse B,54,43,2025-02-23 13:50:00,11
9311,ORD_9312,33140,Ajmal Mukhallat Raaqi Concentrated Perfume Oil Floral Fruity And Sacrifice II For Him Deodorant Fruity Aromatic Fragrance 210 ml,Warehouse B,72,54,2025-02-23 17:20:00,18
9312,ORD_9313,6104,Woman - Sweet Emotion Eau De Toilette,Warehouse B,84,72,2025-02-23 22:25:00,12
9313,ORD_9314,18495,Linzolix 600mg Tablet,Warehouse B,83,66,2025-02-23 10:01:00,17
9314,ORD_9315,22430,TVS Electronics Speed 40 Plus Ribbon Cartridge | for Passbook Printers |Multiple Interface|Close & Compact| Cutshort Print...,Warehouse B,51,43,2025-02-23 21:17:00,8
9315,ORD_9316,22283,"OUXUS New Version-Car Phone Holder Mount, Rearview Mirror Phone Holder for Car, 360°Rotatable and Retractable Car Phone Ho...",Warehouse B,87,68,2025-02-23 06:49:00,19
9316,ORD_9317,22434,"EzLife International Multipurpose Travel Adapter All in One US, AUS, UK, EU, NZ, Europe, North/South America & 150+ Countr...",Warehouse B,54,43,2025-02-23 20:55:00,11
9317,ORD_9318,6109,Ajmal Bombay Dreams EDP Floral Fruity Perfume And Aurum Femme Deodorant Fruity Floral Fragrance 300 ml,Warehouse C,80,61,2025-02-23 19:04:00,19
9318,ORD_9319,4809,Komox 500mg Capsule,Warehouse C,47,35,2025-02-23 19:23:00,12
9319,ORD_9320,28390,Polypod O Tablet DT,Warehouse B,76,60,2025-02-23 11:36:00,16
9320,ORD_9321,22326,Matra Age Defense Formula Serum - Rosehip 15 ml,Warehouse A,51,39,2025-02-23 02:01:00,12
9321,ORD_9322,22264,Orgasmax 4-In-1 Condoms,Warehouse C,32,19,2025-02-23 17:36:00,13
9322,ORD_9323,18626,CROSSVOLT Tough Rugged TPU Cover Case for Airpods Pro (2019) - Matte Black,Warehouse A,56,45,2025-02-23 04:01:00,11
9323,ORD_9324,4880,Oftus 200mg Tablet,Warehouse C,11,3,2025-02-23 12:06:00,8
9324,ORD_9325,35500,"VKB 7.5 Foot Professional Metal Tripod Stand for Mobile, Smartphone, Camera, Ringlight, Video Shooting, Photography, Live ...",Warehouse B,42,33,2025-02-23 11:13:00,9
9325,ORD_9326,6052,"Printme Compatible for Boat Airdopes Atom 81 Case Cover Silicone, Soft, Anti Scratch, Anti Fall, with Hook [Earbuds Not In...",Warehouse C,116,98,2025-02-23 13:04:00,18
9326,ORD_9327,1215,Dvgra 50mg Tablet,Warehouse A,99,91,2025-02-23 21:18:00,8
9327,ORD_9328,33713,Osia Osia White Musk 125 gm,Warehouse C,94,81,2025-02-23 07:22:00,13
9328,ORD_9329,6626,Unotrip 15mg Tablet,Warehouse C,32,13,2025-02-23 01:05:00,19
9329,ORD_9330,16368,Rabimed-LSR Capsule,Warehouse A,38,25,2025-02-23 10:14:00,13
9330,ORD_9331,33425,Ceflim 200 Tablet,Warehouse B,52,41,2025-02-23 11:28:00,11
9331,ORD_9332,16414,Xolycef 1000mg Injection,Warehouse B,25,9,2025-02-23 21:46:00,16
9332,ORD_9333,13521,Sweet Almond Pure Coldpressed Oil,Warehouse A,57,50,2025-02-23 02:54:00,7
9333,ORD_9334,25226,Joypan D  10mg/40mg Tablet,Warehouse A,55,50,2025-02-23 16:43:00,5
9334,ORD_9335,25087,Trugin Tablet,Warehouse C,64,48,2025-02-23 04:39:00,16
9335,ORD_9336,24142,Nature'S Cell Golden Age Repair Concentrate Bxl Saffron Cream 50 Gm,Warehouse C,70,62,2025-02-23 05:06:00,8
9336,ORD_9337,7196,Alivox 500mg Tablet,Warehouse A,100,93,2025-02-23 10:15:00,7
9337,ORD_9338,7344,"Simply Inked Butterfly and Sunflower Temporary Tattoo, Designer Tattoo for Girls Boys Men Women waterproof Sticker Size: ...",Warehouse B,74,58,2025-02-23 06:25:00,16
9338,ORD_9339,25231,Naprox 250 D Tablet,Warehouse A,12,2,2025-02-23 00:19:00,10
9339,ORD_9340,23912,Merlion Naturals Organic Indigo Leaves Powder 227 gm,Warehouse B,104,89,2025-02-23 06:36:00,15
9340,ORD_9341,11662,Kplol 50mg Tablet XL,Warehouse A,11,3,2025-02-23 06:02:00,8
9341,ORD_9342,31395,Onsitego 1 Year Extended Warranty for Small Household Appliances from Rs. 6001-7000 (Email Delivery - No Physical Kit),Warehouse C,87,71,2025-02-23 16:41:00,16
9342,ORD_9343,29667,"L'Oreal Paris Infallible Ultra Matte Liquid Lipstick, Les Macarons, 824 Guava Gush 5 Gm",Warehouse B,60,53,2025-02-23 13:36:00,7
9343,ORD_9344,24197,Samsung EVO Plus 64GB microSDXC UHS-I U1 130MB/s Full HD & 4K UHD Memory Card with Adapter (MB-MC64KA),Warehouse C,106,90,2025-02-23 04:30:00,16
9344,ORD_9345,6673,Clinrose 5mg Tablet,Warehouse C,56,47,2025-02-23 23:33:00,9
9345,ORD_9346,16412,Oflacid-O Oral Suspension,Warehouse C,76,67,2025-02-23 10:49:00,9
9346,ORD_9347,11502,MOBITUSSION Liquid Silicone Microfiber Lining with Camera Protection Back Cover Compatible for iPhone XR (Black),Warehouse C,42,28,2025-02-23 02:16:00,14
9347,ORD_9348,24179,Shunti Powder,Warehouse B,91,81,2025-02-23 02:51:00,10
9348,ORD_9349,2974,Pinerva NP 75mg/10mg/1500mcg Tablet,Warehouse C,58,42,2025-02-23 14:23:00,16
9349,ORD_9350,12273,Cello Aqua Blue Gel Pen Jar of 25 Units || Gel Pens Blue | Jar of 25 Units | Gel Pens Set for Students | Pens for Office U...,Warehouse C,47,32,2025-02-23 07:40:00,15
9350,ORD_9351,33746,Befuro 250mg Tablet,Warehouse C,35,19,2025-02-23 03:10:00,16
9351,ORD_9352,29682,POPIO Tempered Glass Screen Protector Compatible For iPhone XR/iPhone 11 with Edge to Edge Coverage and Easy Installation ...,Warehouse A,57,40,2025-02-23 01:40:00,17
9352,ORD_9353,31403,Camel Student Water Color Cakes - 24 Shades,Warehouse C,26,17,2025-02-23 18:56:00,9
9353,ORD_9354,33743,"ACESHLEY 20MM Soft Silicone Smartwatch Band with Black Metal Buckle Strap for Noise X-Fit 1, Evolve 2, Noise ColorFit Bri...",Warehouse A,19,4,2025-02-23 19:07:00,15
9354,ORD_9355,33478,Pindara Eyeshadow Palette 75.7 g (Multicolor),Warehouse B,100,91,2025-02-23 07:30:00,9
9355,ORD_9356,29919,Sounce Pack of 3 Belts/Straps Compatible for Fitbit Charge2 Bands Wristband Straps (3 Units) Large,Warehouse B,19,2,2025-02-23 01:54:00,17
9356,ORD_9357,11718,Charmacy Milano Sketch Eyeliner Black 0.6 ml,Warehouse B,86,79,2025-02-23 12:08:00,7
9357,ORD_9358,25026,AmazonBasics Magnetic Wireless Charger | 15W Fast Charging Circular Pad|Compatible with iPhone 13/13 Pro/13 Mini/13 ProMa...,Warehouse B,22,6,2025-02-23 15:21:00,16
9358,ORD_9359,16302,Moms Jasmine Soap,Warehouse B,47,28,2025-02-23 12:43:00,19
9359,ORD_9360,25245,Medimade Coffee De 100 gm,Warehouse C,26,8,2025-02-23 15:26:00,18
9360,ORD_9361,11594,T.O.G. Portable False Fake Eyelash Applicator Eye Makeup Cosmetic Tools Holder,Warehouse C,46,29,2025-02-23 16:58:00,17
9361,ORD_9362,16532,"Germ Protection Kit - Soap, Handwash, Hand Sanitizer & Germ Kill Spray",Warehouse A,93,78,2025-02-23 16:28:00,15
9362,ORD_9363,31345,Zapcase Back Case Cover for iPhone 11 | Compatible for iPhone 11 Back Case Cover | Matte Soft Flexible Silicon | Liquid Si...,Warehouse A,100,83,2025-02-23 05:43:00,17
9363,ORD_9364,566,VMBS A1 Smart Watch Mobile Inbuild Camera Supporting 4G/5G Sim Smartwatch for Phone,Warehouse A,82,66,2025-02-23 18:48:00,16
9364,ORD_9365,32050,Cbdol-AP Tablet,Warehouse B,84,71,2025-02-23 11:48:00,13
9365,ORD_9366,23924,"D2Q branded Original for VIVO Handsfree, Smart Phones, Headphones, Wired In Ear Earphones",Warehouse B,75,70,2025-02-23 23:20:00,5
9366,ORD_9367,2102,Amozo Back Case Cover for iPhone 13 Pro Max (Polycarbonate|Blue),Warehouse B,13,3,2025-02-23 23:38:00,10
9367,ORD_9368,30169,RAEGR MagFix Arc M1400 | 3 in 1| 15W Mag-Safe Compatible Wireless Charging Station |Made in India| |with 2 Type-C PD Cable...,Warehouse B,52,47,2025-02-23 03:16:00,5
9368,ORD_9369,23891,Charmacy Milano Insane Shifters Liquid Eye Shadow 2.6 ml,Warehouse B,85,74,2025-02-23 11:30:00,11
9369,ORD_9370,33742,"Lifealthy Universal Flat Screen Cleaning Kit Combo with Extra Large Micro Fibre Cloth | For Laptop and HDTV, 4K, LCD, LED,...",Warehouse B,95,85,2025-02-23 13:25:00,10
9370,ORD_9371,31866,Reotax 500mg Injection,Warehouse C,41,31,2025-02-23 22:19:00,10
9371,ORD_9372,16730,D'Addario Bronze Acoustic Guitar Strings_{.010-.050_Extra Light Gauge}_Stainless Steel Material,Warehouse C,99,82,2025-02-23 23:20:00,17
9372,ORD_9373,15428,Nempect B Oral Drops,Warehouse A,100,89,2025-02-23 10:35:00,11
9373,ORD_9374,11715,"Big Bazaar Combo - Nivea Body Lotion Express Hydration, 400ml (Pack of 2) Promo Pack",Warehouse A,82,67,2025-02-23 14:34:00,15
9374,ORD_9375,7162,Nimosara 100mg/325mg Tablet,Warehouse B,86,78,2025-02-23 12:31:00,8
9375,ORD_9376,1931,Thiobit E 60mg/4mg Tablet,Warehouse B,64,46,2025-02-23 07:40:00,18
9376,ORD_9377,16341,Getdol-P Tablet,Warehouse B,67,54,2025-02-23 09:53:00,13
9377,ORD_9378,7153,V-Dom 2mg/5ml Drop,Warehouse B,117,99,2025-02-23 02:37:00,18
9378,ORD_9379,509,Amiojust 200mg Tablet,Warehouse C,22,4,2025-02-23 00:50:00,18
9379,ORD_9380,24200,Rabepra-D Capsule SR,Warehouse C,22,5,2025-02-23 12:28:00,17
9380,ORD_9381,11702,Manotam 250mg Tablet,Warehouse A,20,6,2025-02-23 20:12:00,14
9381,ORD_9382,16316,Onion Hair Serum For Silky & Smooth Hair - With Onion & Biotin,Warehouse A,71,52,2025-02-23 08:31:00,19
9382,ORD_9383,32106,BBlunt Hair Fall Control Scalp Hair Tonic - 50 ml,Warehouse B,55,41,2025-02-23 05:32:00,14
9383,ORD_9384,37104,PP Cold Drop,Warehouse A,65,47,2025-02-23 16:29:00,18
9384,ORD_9385,3267,Pears Moisturising Bathing Bar Soap with Glycerine Pure & Gentle For Golden Glow (125g x 3),Warehouse B,24,16,2025-02-23 13:57:00,8
9385,ORD_9386,16312,Axepine 2mg Tablet MD,Warehouse C,89,73,2025-02-23 08:49:00,16
9386,ORD_9387,6740,"Dell WM118 Wireless Mouse, 2.4 Ghz with USB Nano Receiver, Optical Tracking, 12-Months Battery Life, Ambidextrous, Pc/Mac/...",Warehouse B,87,78,2025-02-23 20:35:00,9
9387,ORD_9388,2945,L-Zinross 5mg Tablet,Warehouse C,107,88,2025-02-23 13:45:00,19
9388,ORD_9389,6577,Wild Stone Code Platinum Deo (Pack Of 2),Warehouse A,44,38,2025-02-23 23:18:00,6
9389,ORD_9390,3979,Ketoz 200mg Tablet,Warehouse A,96,78,2025-02-23 19:18:00,18
9390,ORD_9391,15665,Helpotus-LS Plus Syrup Cherry,Warehouse C,101,92,2025-02-23 02:39:00,9
9391,ORD_9392,15918,The Woman's Company Sanitary Napkins - Night Pad 12's,Warehouse B,60,41,2025-02-23 15:14:00,19
9392,ORD_9393,11353,"ZEBRONICS Zeb-Thunder PRO On-Ear Wireless Headphone with BTv5.0, Up to 21 Hours Playback, 40mm Drivers with Deep Bass, Wir...",Warehouse B,54,35,2025-02-23 13:17:00,19
9393,ORD_9394,29335,Flukamep 150mg Tablet,Warehouse B,89,84,2025-02-23 18:43:00,5
9394,ORD_9395,24670,Lecherous Fit Me Powder Pore-less Oil Control Compact Powder- All Day Matte Finish Face -Fit Me Matte- Waterproof Compact ...,Warehouse C,59,54,2025-02-23 12:50:00,5
9395,ORD_9396,1828,"Noise Fit Halo with Textured Strap, Bluetooth Calling Round Dial Smart Watch, 1.43"" AMOLED Display, Premium Metallic Buil...",Warehouse B,16,5,2025-02-23 04:56:00,11
9396,ORD_9397,6898,Sercab 50 Tablet,Warehouse B,17,5,2025-02-23 03:24:00,12
9397,ORD_9398,12073,Ofbend 200mg Suspension,Warehouse A,95,85,2025-02-23 07:03:00,10
9398,ORD_9399,3963,Lapster Power Charger for Mi Band 3 USB Adapter Charging Cable Dock Charger Compatible for Xiaomi Mi Band 4/3 /3i Smart Br...,Warehouse C,51,40,2025-02-23 00:21:00,11
9399,ORD_9400,13215,Von Set 2mg Syrup,Warehouse B,32,21,2025-02-23 21:23:00,11
9400,ORD_9401,2045,Detoxie Anti-Pollution SPF 30 PA+++ Sunscreen Lotion 100 ml,Warehouse C,33,17,2025-02-23 11:12:00,16
9401,ORD_9402,6476,Manish Malhotra Glitter Eyeliner - Dazzle 1.2 Gm,Warehouse C,25,15,2025-02-23 22:29:00,10
9402,ORD_9403,11956,Vabrab-DSR Capsule,Warehouse C,42,33,2025-02-23 05:43:00,9
9403,ORD_9404,24613,"Logitech K380 Wireless Multi-Device Keyboard for Windows, Apple iOS, Apple Tv Android Or Chrome, Bluetooth, Compact Space-...",Warehouse A,66,55,2025-02-23 14:15:00,11
9404,ORD_9405,24567,"Kadence Music Stand, Portable Folding Music Note Sheet, Notation Stand with Carrying Bag NK06",Warehouse B,21,15,2025-02-23 09:55:00,6
9405,ORD_9406,15832,PRD 30mg/40mg Capsule,Warehouse B,27,18,2025-02-23 16:51:00,9
9406,ORD_9407,33367,LOHAYA EN2BX27V Remote Replacement for VU FHD HD Android Smart TV Remote Control Model No :- 32US 43US 32GA 43GA [ Compati...,Warehouse B,92,74,2025-02-23 04:14:00,18
9407,ORD_9408,645,Sun Lotion SPF 50 With UVA & UVB Protection - Water Resistant Sunscreen For Men & Women,Warehouse A,68,56,2025-02-23 06:33:00,12
9408,ORD_9409,6867,Clovumin 50mg Tablet,Warehouse C,19,13,2025-02-23 18:36:00,6
9409,ORD_9410,6852,"Hammonds Flycatcher Genuine Leather Laptop Bag for Men/Office Bag for Men, Brown | Fits Upto 16 Inch Laptop/MacBook| Leath...",Warehouse B,94,87,2025-02-23 03:00:00,7
9410,ORD_9411,29993,"Noise Newly Launched Evolve 2 Play AMOLED Display Smart Watch with Fast Charging, Always On Display, 50 Sports Modes, Hind...",Warehouse B,92,76,2025-02-23 09:22:00,16
9411,ORD_9412,29999,Lavender Try Me Personal Care Gift Set,Warehouse A,61,47,2025-02-23 08:11:00,14
9412,ORD_9413,4320,Khadi swati Herbal Castor Oil for Hair Growth - 100ml (Pack of 2),Warehouse A,43,32,2025-02-23 05:06:00,11
9413,ORD_9414,29958,"Spigen TPU Liquid Air Case Cover Designed for Samsung Galaxy Watch 5 / 4 - 44mm, 2022 / 2021 - (Matte Black) (Watch not In...",Warehouse A,27,18,2025-02-23 00:42:00,9
9414,ORD_9415,33910,Amazon Brand - Solimo Back Cover for Samsung Galaxy M21 / M30s / M21 2021 Edition (Silicone | Clear),Warehouse B,89,71,2025-02-23 00:26:00,18
9415,ORD_9416,2131,Azukon MR 60 Tablet,Warehouse C,34,23,2025-02-23 13:44:00,11
9416,ORD_9417,24593,Wet N Wild Color Icon Brow Pencil - Brunettes Do It Better 0.7 gm,Warehouse C,28,16,2025-02-23 07:36:00,12
9417,ORD_9418,24723,"Adult Diapers - Super Breathable, Small",Warehouse C,50,36,2025-02-23 18:58:00,14
9418,ORD_9419,29350,Blemfree Anti Blemish Cream,Warehouse A,53,48,2025-02-23 13:06:00,5
9419,ORD_9420,399,DVTECH® (Pack of 02 Best Fit clear premium Smartwatch screen protector for Fire-Boltt Invincible (Not a Tempered glass),Warehouse A,98,80,2025-02-23 05:41:00,18
9420,ORD_9421,24824,Faces Canada Ultime Pro Blendfinity Stick Make Me Shine 01 10 Gm,Warehouse A,34,23,2025-02-23 02:30:00,11
9421,ORD_9422,25403,"TONSY Men's and Women's Universal Watch Battery Cells 364A, 376, 377A, SR626SW, LR626, 377, LR626, AG4, 1.5V Alkaline Butt...",Warehouse B,71,60,2025-02-23 20:26:00,11
9422,ORD_9423,12080,"Seagate Expansion 1TB External HDD - USB 3.0 for Windows and Mac with 3 yr Data Recovery Services, Portable Hard Drive (ST...",Warehouse A,42,35,2025-02-23 12:28:00,7
9423,ORD_9424,31928,"Reynolds 045 CARBURE 25 PENS JAR, 16 BLUE, 6 BLACK & 3 RED Ball Pen I Lightweight Ball Pen With Comfortable Grip for Extra...",Warehouse B,76,58,2025-02-23 20:20:00,18
9424,ORD_9425,7472,Nervglo 750 mcg/75 mg Capsule,Warehouse B,85,71,2025-02-23 10:25:00,14
9425,ORD_9426,24771,"SanDisk Ultra Flair 128GB USB 3.0 Pen Drive, Silver Black",Warehouse A,46,37,2025-02-23 03:00:00,9
9426,ORD_9427,29378,Advanced Hair Fall Solution Shampoo - Total Damage Care,Warehouse C,102,97,2025-02-23 22:49:00,5
9427,ORD_9428,3934,Rabigin DSR 30mg/20mg Capsule,Warehouse C,72,54,2025-02-23 14:19:00,18
9428,ORD_9429,24617,XX1 Cologne - For Men,Warehouse A,90,77,2025-02-23 06:43:00,13
9429,ORD_9430,650,"Sony WH-1000XM4 Industry Leading Wireless Noise Cancellation Bluetooth Over Ear Headphones with Mic for Phone Calls, 30 Ho...",Warehouse A,106,87,2025-02-23 00:57:00,19
9430,ORD_9431,29990,Lenphor Timeless Eye Liner So Green 01 1.2 Gm,Warehouse A,25,16,2025-02-23 12:55:00,9
9431,ORD_9432,11323,Qxone S 250mg/125mg Injection,Warehouse B,54,49,2025-02-23 18:20:00,5
9432,ORD_9433,6816,Atorko 10 Tablet,Warehouse A,92,87,2025-02-23 09:49:00,5
9433,ORD_9434,15362,Pikkme Bumper Back Cover for iPhone 13 (TPU | Black),Warehouse A,70,52,2025-02-23 21:45:00,18
9434,ORD_9435,32145,Sebclav 250mg/125mg Tablet,Warehouse C,98,88,2025-02-23 00:38:00,10
9435,ORD_9436,23661,Redmi Note 12 5G Mystique Blue 4GB RAM 128GB ROM | 1st Phone with 120Hz Super AMOLED and Snapdragon® 4 Gen 1 | 48MP AI Tri...,Warehouse C,89,80,2025-02-23 23:41:00,9
9436,ORD_9437,30081,Emvon Drop,Warehouse B,93,84,2025-02-23 06:32:00,9
9437,ORD_9438,16953,Rabeq 20mg Tablet,Warehouse A,102,91,2025-02-23 17:11:00,11
9438,ORD_9439,31891,Green Storm Eau De Toilette Deodorant,Warehouse C,53,42,2025-02-23 20:48:00,11
9439,ORD_9440,6888,Reequil Dandruff Control Shampoo 250 ml,Warehouse C,100,82,2025-02-23 23:29:00,18
9440,ORD_9441,36400,Simclox 250mg/250mg Injection,Warehouse A,78,69,2025-02-23 15:37:00,9
9441,ORD_9442,23684,Plant Based Greens Super Food With Multi-Vitamin & Mineral - Lime Flavour,Warehouse A,77,67,2025-02-23 05:08:00,10
9442,ORD_9443,13398,Blenior Body Strips 12 Pcs - Thick & Dense Hair 1's,Warehouse B,48,34,2025-02-23 13:51:00,14
9443,ORD_9444,1842,Quikace P Oral Suspension,Warehouse A,64,47,2025-02-23 18:05:00,17
9444,ORD_9445,15855,Medimade Papaya Premium Soap 100 gm,Warehouse B,62,54,2025-02-23 07:58:00,8
9445,ORD_9446,16946,Dilnip M 10mg/25mg Tablet PR,Warehouse B,39,32,2025-02-23 06:25:00,7
9446,ORD_9447,31368,Dexokof Syrup,Warehouse C,24,9,2025-02-23 06:21:00,15
9447,ORD_9448,16626,Presidio 75mg/60mg Tablet,Warehouse C,26,17,2025-02-23 18:07:00,9
9448,ORD_9449,33447,Ameto G Forte 4mg/1000mg Tablet,Warehouse B,110,91,2025-02-23 12:22:00,19
9449,ORD_9450,23730,Ozone Complexion Brightening Face Wash 100 ml,Warehouse C,88,75,2025-02-23 11:40:00,13
9450,ORD_9451,16048,Vega Lip Liner (PV - 24) 6.6 gm,Warehouse C,60,52,2025-02-23 23:11:00,8
9451,ORD_9452,31970,Cefiboon LB 200mg Tablet,Warehouse A,92,75,2025-02-23 11:55:00,17
9452,ORD_9453,4045,Fetpan D 10mg/40mg Tablet,Warehouse B,56,47,2025-02-23 19:05:00,9
9453,ORD_9454,11870,Verdinir 125mg Dry Syrup,Warehouse C,39,27,2025-02-23 19:39:00,12
9454,ORD_9455,29857,Amazon Brand - Solimo Rubber Soft & Flexible Hybrid Back Phone Case for Samsung Galaxy A50 (Black),Warehouse C,98,84,2025-02-23 00:24:00,14
9455,ORD_9456,16013,Amway G&H Nourish Body Lotion (250 Ml),Warehouse A,61,50,2025-02-23 07:03:00,11
9456,ORD_9457,3214,App CV 500mg/125mg Tablet,Warehouse A,47,42,2025-02-23 21:06:00,5
9457,ORD_9458,25355,Kenace 2.5mg Tablet,Warehouse B,75,60,2025-02-23 12:14:00,15
9458,ORD_9459,25358,Dex Z Powder,Warehouse C,92,73,2025-02-23 20:08:00,19
9459,ORD_9460,4041,"LUNAGARIYA®, Protective Case Compatible with JIO Settop Box Remote Control,PU Leather Cover Holder (Before Placing Order,P...",Warehouse A,25,20,2025-02-23 11:11:00,5
9460,ORD_9461,11382,Good Morning Grooming Kit For The Elite,Warehouse B,67,58,2025-02-23 07:19:00,9
9461,ORD_9462,31477,Minimalist SPF 40 Water Resistant Invisible Sunscreen | Ultra Light Gel | No White Cast | Sweat Resistant | PA+++ | With T...,Warehouse B,47,30,2025-02-23 16:13:00,17
9462,ORD_9463,4307,Anti-Pollution Gel Face Wash,Warehouse B,53,35,2025-02-23 07:09:00,18
9463,ORD_9464,7464,Elpicef 100mg/5ml Suspension,Warehouse C,83,69,2025-02-23 00:40:00,14
9464,ORD_9465,33655,Betadus 8mg Tablet,Warehouse A,30,21,2025-02-23 06:09:00,9
9465,ORD_9466,33657,DeBelle Top & Base Coat 15 ml,Warehouse B,51,44,2025-02-23 07:27:00,7
9466,ORD_9467,24390,Choco Butter Lip Balm,Warehouse A,52,42,2025-02-23 03:08:00,10
9467,ORD_9468,12133,Fantasmo Eau De Toilette For Men,Warehouse B,101,85,2025-02-23 23:28:00,16
9468,ORD_9469,30145,"Tecno Spark 9 (Infinity Black, 6GB RAM,128GB Storage) | 11GB Expandable RAM | Helio G37 Gaming Processor",Warehouse A,20,15,2025-02-23 00:13:00,5
9469,ORD_9470,13233,Amazon Brand-Solimo TPU Basic Case for Samsung Galaxy M53 5G - Clear,Warehouse C,72,53,2025-02-23 02:31:00,19
9470,ORD_9471,29799,Evorcoxib 120mg Tablet,Warehouse C,64,55,2025-02-23 16:44:00,9
9471,ORD_9472,33869,Vometil 5mg Tablet MD,Warehouse C,30,14,2025-02-23 02:36:00,16
9472,ORD_9473,32127,"Moschino I Love Love Eau De Toilette, For Her, 50Ml",Warehouse A,53,44,2025-02-23 08:37:00,9
9473,ORD_9474,36071,Impress Concentrated Perfume Free From Alcohol For Male,Warehouse C,32,14,2025-02-23 01:47:00,18
9474,ORD_9475,16145,Almond & Honey Nourishing Foaming Face Wash,Warehouse A,34,28,2025-02-23 04:37:00,6
9475,ORD_9476,29811,Silagra 25 Tablet,Warehouse B,27,10,2025-02-23 12:12:00,17
9476,ORD_9477,16049,Norerg 5mg Tablet,Warehouse A,51,46,2025-02-23 20:35:00,5
9477,ORD_9478,25352,"CASON (DEVICE OF C) Professional 8 X 40 HD Folding Lens 8 X Zoom Prism Binocular Telescope with Pouch for Long Distance, B...",Warehouse B,12,5,2025-02-23 15:59:00,7
9478,ORD_9479,33651,OpenTech® Tempered Glass Screen Protector Compatible for Samsung Galaxy M51 / M52 / M62 / F62 / A71 (Transparent) Full Scr...,Warehouse A,65,56,2025-02-23 02:01:00,9
9479,ORD_9480,4256,Stbotanica Rose & Cardamom Body Wash With Shea & Vitamin E 250 ml,Warehouse C,94,83,2025-02-23 16:54:00,11
9480,ORD_9481,16294,5 Flowers Cleansing Foam,Warehouse A,16,8,2025-02-23 21:33:00,8
9481,ORD_9482,1946,Amozo Back Case Cover for iPhone 11 - (Polycarbonate | Translucent Black),Warehouse C,28,23,2025-02-23 11:13:00,5
9482,ORD_9483,16286,Teltrust 40mg Tablet,Warehouse A,61,56,2025-02-23 07:17:00,5
9483,ORD_9484,36101,"PiBOX India, USB 3.0 Hard Drive Docking Station (USB to SATA Docking Station) with 10TB+ Drive Support for 2.5 Inch & 3.5 ...",Warehouse C,98,86,2025-02-23 16:47:00,12
9484,ORD_9485,16285,The Skin Story Hydrating and Pore Minimizing Toner - Witch Hazel 100 ml,Warehouse A,76,61,2025-02-23 10:53:00,15
9485,ORD_9486,29727,Lupitrix S 500mg/250mg Injection,Warehouse B,107,96,2025-02-23 11:03:00,11
9486,ORD_9487,13476,"OREI India Europe Travel Adapter, India to Europe (Schuko) Plug, Type E/F European Plug Adapter - 2 in 1 - Perfect for Lap...",Warehouse A,28,13,2025-02-23 11:43:00,15
9487,ORD_9488,33849,Mard 100 Tablet,Warehouse C,38,20,2025-02-23 14:46:00,18
9488,ORD_9489,36096,Glitaray M 3mg/500mg Tablet SR,Warehouse A,22,3,2025-02-23 17:03:00,19
9489,ORD_9490,16235,Roximol 50mg Tablet,Warehouse C,23,9,2025-02-23 09:48:00,14
9490,ORD_9491,13472,Iridie-M Tablet,Warehouse C,68,59,2025-02-23 03:09:00,9
9491,ORD_9492,13614,"Redmi Note 9 Pro (Interstellar Black, 4GB RAM, 64GB Storage)- Latest 8nm Snapdragon 720G & Alexa Hands-Free Capable",Warehouse A,102,85,2025-02-23 01:56:00,17
9492,ORD_9493,36266,Jyotam 0.4mg Tablet,Warehouse B,99,89,2025-02-23 06:29:00,10
9493,ORD_9494,23740,House of Beauty Peach Oil 30 ml,Warehouse C,97,88,2025-02-23 15:50:00,9
9494,ORD_9495,4116,"Meyaar Cute Silicone Case Cover with Keychain, 360° Protective Case Compatible with Apple Airpods 2 &1 (Starbucks Coffee -...",Warehouse C,21,14,2025-02-23 06:08:00,7
9495,ORD_9496,6725,Kancold Syrup,Warehouse B,13,8,2025-02-23 03:58:00,5
9496,ORD_9497,7091,Miss Rose 12 Color Ultra Base Concealer Palette 7601 - 040N 12 gm,Warehouse C,91,82,2025-02-23 23:41:00,9
9497,ORD_9498,24320,Divalrex 500mg Tablet,Warehouse C,65,49,2025-02-23 05:15:00,16
9498,ORD_9499,4258,Exporm 400mg Suspension,Warehouse C,107,97,2025-02-23 13:08:00,10
9499,ORD_9500,16172,Amla Hair Repair Hot Oil Treatment,Warehouse C,75,70,2025-02-23 07:43:00,5
9500,ORD_9501,7045,RSC POWER+ Compatible Dash/Warp Data Sync Fast Charging Cable Supported for all C Type Devices (Red and White),Warehouse C,61,54,2025-02-23 08:03:00,7
9501,ORD_9502,2956,UNITOCIN INJECTION,Warehouse C,74,65,2025-02-23 05:30:00,9
9502,ORD_9503,11849,Zyfix 100 LB Tablet DT Strawberry,Warehouse A,24,7,2025-02-23 09:04:00,17
9503,ORD_9504,24936,Nanoset 50 Injection,Warehouse B,78,66,2025-02-23 06:26:00,12
9504,ORD_9505,2057,Kleral Kit Duo Olio Di Macadamia (Hydrating Shampoo + Silky Mask) 300 ml,Warehouse C,75,56,2025-02-23 18:57:00,19
9505,ORD_9506,11426,Beard & Moustache Wax For Ultra Strong Hold - Cedarwood & Mandarin,Warehouse C,19,7,2025-02-23 23:52:00,12
9506,ORD_9507,16139,Thank OD Tablet,Warehouse A,85,77,2025-02-23 03:28:00,8
9507,ORD_9508,36307,Vertipress 8 Tablet,Warehouse B,67,54,2025-02-23 17:59:00,13
9508,ORD_9509,7286,ZEBRONICS Zeb-Vibe Portable Speaker Comes with Full-Range 20.32cm Dual Drivers Along with a 2.54cm Tweeter That Delivers P...,Warehouse C,33,24,2025-02-23 04:59:00,9
9509,ORD_9510,41,URBANMAC 5 Pieces Eyelashes with Eyelash Glue (Black),Warehouse A,33,19,2025-02-23 14:09:00,14
9510,ORD_9511,11629,Natural Shaving Gel - Witch Hazel & Aloe Vera,Warehouse B,75,56,2025-02-23 07:07:00,19
9511,ORD_9512,36143,Gemblue Biocare Mango cream 500 ml,Warehouse C,54,38,2025-02-23 17:22:00,16
9512,ORD_9513,16676,Sure Clav Dry Syrup,Warehouse B,18,8,2025-02-23 20:05:00,10
9513,ORD_9514,16454,Supercef 250 Tablet,Warehouse A,82,73,2025-02-23 04:59:00,9
9514,ORD_9515,6667,Spigen Ultra Hybrid Back Cover Case for iPhone 11 Pro (TPU + Poly Carbonate | Crystal Clear),Warehouse C,40,35,2025-02-23 16:51:00,5
9515,ORD_9516,32052,Prodol 125mg/5ml Syrup,Warehouse A,64,47,2025-02-23 00:22:00,17
9516,ORD_9517,30211,"Sounce Earphone Cleaning Pen Compatible with AirPods Cleaner Kit, 3-in-1 Earbuds Cleaning kit for AirPods Earphones, Earph...",Warehouse A,65,53,2025-02-23 23:43:00,12
9517,ORD_9518,2078,Cotton Swabs In Round,Warehouse A,47,28,2025-02-23 05:39:00,19
9518,ORD_9519,12220,Ultranim 200mg Tablet,Warehouse A,73,66,2025-02-23 00:30:00,7
9519,ORD_9520,13556,"WeCool Earphone Carrying Case or Multi-Purpose Carry Pouch for Carrying Earphones, Headset, Pen Drives, SD Cards , with An...",Warehouse A,54,42,2025-02-23 04:56:00,12
9520,ORD_9521,15465,"Sounce Earphone Case Cover for Boat Airdopes 161, Soft Silicone Skin Case Cover Shock-Absorbing Protective Case with Keych...",Warehouse A,116,99,2025-02-23 22:29:00,17
9521,ORD_9522,11555,Kiss Beauty Lotus Hot and Soft Matte Lipstick Intense Color Long Lasting Moisturizer Lip Gloss Lipstick Women Lip Care Cos...,Warehouse C,77,61,2025-02-23 05:13:00,16
9522,ORD_9523,25204,"boAt Rockerz 450 Pro Bluetooth On Ear Headphones with Mic with 70 Hours Battery, 40Mm Drivers, Bluetooth V5.0 Padded Ear C...",Warehouse B,99,93,2025-02-23 02:07:00,6
9523,ORD_9524,25173,Ajmal 2 Wisal Dhahab And 2 Persuade Deodorants Pack of 4 200 ml,Warehouse C,76,61,2025-02-23 10:33:00,15
9524,ORD_9525,24013,Bio Quince Seed Cream 175 Gm,Warehouse A,10,2,2025-02-23 09:52:00,8
9525,ORD_9526,24018,MaxFresh Orange Spicy Fresh Gel Toothpaste - Sunrisers Hyderabad Special Edition Pack,Warehouse A,25,9,2025-02-23 01:31:00,16
9526,ORD_9527,6637,"Hp Pavilion Gaming 15-Amd Ryzen 5 15.6 Inches Micro-Edge, Ips, Anti-Glare, Fhd Display (8Gb Ram/512 Gb Ssd/144 Hz/ Rtx 305...",Warehouse C,114,98,2025-02-23 14:22:00,16
9527,ORD_9528,1897,Z-Met 50mg Tablet,Warehouse A,55,40,2025-02-23 01:32:00,15
9528,ORD_9529,33443,Sariom-D 10mg/20mg Capsule,Warehouse A,70,58,2025-02-23 06:50:00,12
9529,ORD_9530,12201,"BHARATGAURAV - Hair Accessories Multi Type Black Butterfly Bits Hair Clutch Clips for Women Girls - Set of 30, Small",Warehouse B,38,21,2025-02-23 11:08:00,17
9530,ORD_9531,36499,"Bioderma Photoderm Aquafluide SPF 50+ Neutre, 40ml",Warehouse C,56,48,2025-02-23 20:42:00,8
9531,ORD_9532,16525,Bio Renew Argan Oil Of Morocco Conditioner,Warehouse C,61,52,2025-02-23 17:10:00,9
9532,ORD_9533,16563,"Loofah/Sponge Scrubber/Body Bath - Hangable, Black With Stripes, BH-036 BLK",Warehouse C,24,11,2025-02-23 21:53:00,13
9533,ORD_9534,16562,Zifi 200 Tablet,Warehouse B,92,85,2025-02-23 01:25:00,7
9534,ORD_9535,2851,"FEDUS 10 Meter 32.8 Feet Long Switch Board Extension | Pack 1 Extension Boards with Switch,Extension Board with Long Wire,...",Warehouse C,52,47,2025-02-23 08:10:00,5
9535,ORD_9536,29543,Cavity Defense 123 Black Toothbrush - Soft,Warehouse A,111,95,2025-02-23 19:21:00,16
9536,ORD_9537,36462,Vardine Ointment,Warehouse C,88,75,2025-02-23 09:09:00,13
9537,ORD_9538,4246,"Vonzee Camera Lens Screen Protector For iPhone 14 6.1'' & iPhone 14 Plus 6.7'' Camera Lens Protector,[Anti-Scratch] Premiu...",Warehouse C,97,90,2025-02-23 19:42:00,7
9538,ORD_9539,16073,Lip Scrub Fruit Punch,Warehouse B,91,79,2025-02-23 10:50:00,12
9539,ORD_9540,25329,"Brillar Multiplug Extension Board with 3 Sockets, Individual Switches and Led Indicators (Three Pin Plug, 6 Amp)",Warehouse B,33,19,2025-02-23 17:18:00,14
9540,ORD_9541,11421,Ocral Syrup,Warehouse A,106,93,2025-02-23 23:15:00,13
9541,ORD_9542,33667,Portronics MPORT 31 4 Ports USB Hub (USB A to 4 USB-A Ports 4 in 1 Connector USB HUB(Grey),Warehouse A,108,99,2025-02-23 08:06:00,9
9542,ORD_9543,30134,Bakers Badam Drink Mix,Warehouse C,14,6,2025-02-23 06:30:00,8
9543,ORD_9544,6764,Neem & Turmeric Soap Value Pack,Warehouse A,62,45,2025-02-23 11:21:00,17
9544,ORD_9545,33879,"LAKMÃ‰ Combo Of Eyeliner And Eyebrow, Black, Matte Finish",Warehouse A,100,90,2025-02-23 16:20:00,10
9545,ORD_9546,29431,Parawel 650mg Tablet,Warehouse C,98,81,2025-02-23 16:51:00,17
9546,ORD_9547,7014,Ajmal Aurum And Aurum Deo & Ascend EDP Pack of 3 20 ml,Warehouse A,33,28,2025-02-23 06:20:00,5
9547,ORD_9548,12246,"Redmi 9A Sport (Coral Green, 2GB RAM, 32GB Storage) | 2GHz Octa-core Helio G25 Processor | 5000 mAh Battery",Warehouse A,60,43,2025-02-23 13:07:00,17
9548,ORD_9549,36316,Peptinex DP Tablet,Warehouse A,64,45,2025-02-23 22:13:00,19
9549,ORD_9550,31884,Mep 4mg Tablet,Warehouse C,105,97,2025-02-23 18:54:00,8
9550,ORD_9551,6708,INEFABLE Mi Band 5 and 6 Strap Original Band Strap M5/M6 - Pack of 1 - Wine - (Device Not Included - Not Compatible with M...,Warehouse C,34,16,2025-02-23 13:20:00,18
9551,ORD_9552,33715,Cetnix 5mg Tablet,Warehouse A,25,19,2025-02-23 01:30:00,6
9552,ORD_9553,32064,Axipin 5mg Tablet,Warehouse B,32,15,2025-02-23 15:14:00,17
9553,ORD_9554,13578,Canon Pixma E477 All-in-One Wireless Ink Efficient Colour Printer (White/Blue),Warehouse B,63,58,2025-02-23 14:38:00,5
9554,ORD_9555,36154,Cefika AZ 200mg/250mg Tablet,Warehouse A,52,39,2025-02-23 02:39:00,13
9555,ORD_9556,7247,Qpraz 40mg Tablet,Warehouse A,65,60,2025-02-23 10:29:00,5
9556,ORD_9557,3878,Calcium Leucovorin 15mg Injection,Warehouse B,19,3,2025-02-23 21:19:00,16
9557,ORD_9558,36194,"Rene Furterer Triphasic Stimulating Shampoo for Hair Loss, 200ml",Warehouse B,38,28,2025-02-23 04:01:00,10
9558,ORD_9559,24076,Kentryp Plus Tablet,Warehouse C,74,57,2025-02-23 02:50:00,17
9559,ORD_9560,16648,Arata Hydration Boost Aloe Vera Gel Combo With Aloe Vera Face Gel (100 ML) & Under Eye Gel (10 ML 110 ml,Warehouse A,46,32,2025-02-23 22:02:00,14
9560,ORD_9561,4188,Kuber Industries Black Women's Mobile Cover With Purse Pocket And Sari Hook (KUBERBGH72),Warehouse B,102,97,2025-02-23 18:57:00,5
9561,ORD_9562,31858,"TP-Link AC1750 Mbps Smart WiFi Gaming Dual_Band Gigabit Wireless Internet Router for Home, for Alexa, VPN Server, Parental...",Warehouse B,64,55,2025-02-23 18:31:00,9
9562,ORD_9563,24082,Etazip 0.5mg Tablet MD,Warehouse C,54,41,2025-02-23 23:59:00,13
9563,ORD_9564,11619,Pinfix-LB 200 Tablet,Warehouse B,59,44,2025-02-23 23:25:00,15
9564,ORD_9565,37095,AJM 360 Protection Shockproof Design Soft Rubberised Case with Keychain for Boat Airdopes 141 (Only Case) Black headphone,Warehouse C,84,74,2025-02-23 03:31:00,10
9565,ORD_9566,25108,"Lenovo V15 Intel Core i5 1035G1 15.6-inch FHD IPS (8GB/512GB SSD/DOS/Integrated Intel UHD Graphics/Iron Grey/1.85Kg), 82C5...",Warehouse A,61,48,2025-02-23 17:34:00,13
9566,ORD_9567,8723,Ajmal Zeal EDP Aquatic Woody Perfume And Mukhallat Al Wafa Concentrated Perfume Oil Oriental Musky 112 ml,Warehouse A,27,14,2025-02-23 13:04:00,13
9567,ORD_9568,30258,TVS Electronics Champ Wired Keyboard (Black),Warehouse B,28,23,2025-02-23 17:15:00,5
9568,ORD_9569,34771,Tabac Original Beard Oil 50 ml,Warehouse B,31,19,2025-02-23 21:32:00,12
9569,ORD_9570,7758,Grycet 5mg Tablet,Warehouse C,51,36,2025-02-23 02:02:00,15
9570,ORD_9571,17071,Swafizz D 50mg/10mg Tablet,Warehouse C,108,99,2025-02-23 18:15:00,9
9571,ORD_9572,23594,SupCares Edge to Edge Privacy Tempered Glass for iPhone 12 and iPhone 12 Pro (6.1 Inch) with Easy Self Installation Kit | ...,Warehouse C,57,49,2025-02-23 08:48:00,8
9572,ORD_9573,31278,ProElite Smart Case for iPad Pro 12.9 inch 2022/2021 6th/5th Generation [Auto Sleep/Wake Cover] [Pencil Holder] [Soft Flex...,Warehouse A,73,62,2025-02-23 00:51:00,11
9573,ORD_9574,23496,Organic Olive Oil,Warehouse C,32,14,2025-02-23 01:42:00,18
9574,ORD_9575,705,Lemongrass Oil For Acne & Blemish-Free Skin,Warehouse C,83,73,2025-02-23 19:21:00,10
9575,ORD_9576,17192,Mcaffeine Naked & Raw Cappuccino Coffee Shampoo 250 ml,Warehouse C,64,47,2025-02-23 07:27:00,17
9576,ORD_9577,25491,"Spigen NeoFlex Screen Guard Protector for Pixel 7 Pro - 2 Pack, Transparent",Warehouse C,104,99,2025-02-23 02:12:00,5
9577,ORD_9578,35913,Electronic Spices PACK OF 2 DC Power Y Splitter Cable 1 Female to 2 Male Plug Adapter CCTV Camera,Warehouse A,89,80,2025-02-23 18:20:00,9
9578,ORD_9579,35917,Chyawan Fit - Natural & Sugarless Immunity Booster,Warehouse C,73,66,2025-02-23 19:09:00,7
9579,ORD_9580,7627,VU 164 cm (65 inches) The GloLED Series 4K Smart LED Google TV 65GloLED (Grey),Warehouse A,37,30,2025-02-23 17:21:00,7
9580,ORD_9581,17331,Bio Seaweed Eye Gel 15 Gm,Warehouse C,82,76,2025-02-23 20:35:00,6
9581,ORD_9582,31527,BP Tel H 40 mg/12.5 mg Tablet,Warehouse B,96,85,2025-02-23 00:50:00,11
9582,ORD_9583,17328,CARE CASE®USB A Male to 2 x PS2 Female Converter Cable for Keyboard & Mouse,Warehouse B,14,7,2025-02-23 14:16:00,7
9583,ORD_9584,4420,Espiloc D 30mg/40mg Capsule SR,Warehouse C,78,71,2025-02-23 05:49:00,7
9584,ORD_9585,6390,Nutriment Lemon Cream All Skin Type 250 gm,Warehouse C,91,78,2025-02-23 03:46:00,13
9585,ORD_9586,6394,Depot 404 Soothing Shaving Soap Cream (For Brush) 30 ml,Warehouse B,54,36,2025-02-23 01:08:00,18
9586,ORD_9587,2783,"UBON Bluetooth Earphone with Mic, Quick Charging in Ear Wireless Neckband with Up to 40 Hours Playtime, Hi-Fi Music & Bas...",Warehouse C,89,75,2025-02-23 23:18:00,14
9587,ORD_9588,3831,Astrocef 100mg Tablet DT,Warehouse A,66,47,2025-02-23 02:57:00,19
9588,ORD_9589,29175,"TheGiftKart Back Cover for OnePlus 9R 5G (TPU, Poly Carbonate | Transparent | Black Bumper)",Warehouse A,85,79,2025-02-23 23:09:00,6
9589,ORD_9590,17273,Oil Formula 1 With 25 cc,Warehouse B,81,68,2025-02-23 15:18:00,13
9590,ORD_9591,17272,Foloup 200mg Tablet,Warehouse B,87,75,2025-02-23 11:42:00,12
9591,ORD_9592,35945,"AmazonBasics Wireless Mouse, 2.4 GHz with USB Nano Receiver, Optical Tracking, for PC/Mac/Laptop/Tablet (Black)",Warehouse B,77,69,2025-02-23 18:41:00,8
9592,ORD_9593,1804,Lakme True Wear Nail Color Shade 506 9 Ml,Warehouse C,110,93,2025-02-23 23:33:00,17
9593,ORD_9594,29208,"Ayuga 1% Chandanam Skin Brightening Face Wash, with Sandalwood, Turmeric & 26 Precious Herbs| Facial cleanser | Deep Skin ...",Warehouse B,46,33,2025-02-23 23:13:00,13
9594,ORD_9595,15295,Spigen Liquid Air Back Cover Case Compatible with iPhone 14 Pro (TPU | Matte Black),Warehouse C,102,86,2025-02-23 07:16:00,16
9595,ORD_9596,3308,Flormar Wet&Dry Compact Powder W07 Caramel Peach 10 gm,Warehouse B,77,72,2025-02-23 11:15:00,5
9596,ORD_9597,31262,Stbotanica Aventus Black Pepper Body Wash - With Shea & Vitamin E 250 ml,Warehouse C,39,29,2025-02-23 01:10:00,10
9597,ORD_9598,4530,Rotane 75mg Tablet,Warehouse A,45,33,2025-02-23 14:03:00,12
9598,ORD_9599,32167,Miss Claire Eyelash Glue Clear Tone 5 Gm,Warehouse A,25,10,2025-02-23 00:08:00,15
9599,ORD_9600,29288,Natural Clay Face Wash,Warehouse A,93,77,2025-02-23 10:23:00,16
9600,ORD_9601,31263,Boltove® White Wrinkle Free Decoration Backdrop Curtain Drapes White Backdrop Panels Background for Photography Wedding Pa...,Warehouse A,111,97,2025-02-23 14:48:00,14
9601,ORD_9602,4516,DeBelle Gel Nail Lacquer Tahiti Teal Teal Green Nail Polish 8 ml,Warehouse B,75,69,2025-02-23 03:21:00,6
9602,ORD_9603,35842,"SupCares Aluminium 7 Height Adjustable, Ventilated, Foldable, Portable Laptop Stand for Desk & Table Mount Upto 15.6 inch ...",Warehouse C,20,2,2025-02-23 05:34:00,18
9603,ORD_9604,23241,"Lotus Herbals White Glow Skin Whitening And Brightening Gel Cream, 40g",Warehouse C,49,34,2025-02-23 15:24:00,15
9604,ORD_9605,25629,Angelie Heart Shape False-Fake Eyelashes With Glue Set Natural (Pair of 6),Warehouse C,93,86,2025-02-23 09:10:00,7
9605,ORD_9606,17510,POPIO Tempered Glass Compatible for Xiaomi Redmi 11 Prime/Redmi 9A / 9A Sport/Redmi 9i / 9i Sport/Redmi 10 5G / Redmi 10A...,Warehouse C,59,45,2025-02-23 02:47:00,14
9606,ORD_9607,32248,"TP-Link Archer MR200 AC750 2.4GHz 750Mbps Dual Band 4G LTE Mobile Wi-Fi, SIM Slot Unlocked, No Configuration Required, Rem...",Warehouse B,55,48,2025-02-23 07:39:00,7
9607,ORD_9608,15215,Oblivion Hair Scalp Massager Brush | Silicone Head Body Massager Brush | Scalp Shower Hair Brush | Hair Washing Massager B...,Warehouse A,95,90,2025-02-23 12:53:00,5
9608,ORD_9609,29041,Povicid MA Ointment,Warehouse B,25,9,2025-02-23 04:08:00,16
9609,ORD_9610,7702,Swiss Beauty Professional Makeup Brush (Set of 20) - Transparent,Warehouse A,58,39,2025-02-23 12:40:00,19
9610,ORD_9611,31808,Amozo Frameless Ultra Slim Flexible Back Case Cover for iPhone 12 / iPhone 12 Pro (Polycarbonate | Black),Warehouse C,68,60,2025-02-23 07:40:00,8
9611,ORD_9612,13742,Ant Esports VS400L 400 Watt Non-Modular Continuous Power Gaming Power Supply/PSU for PC,Warehouse A,27,8,2025-02-23 08:03:00,19
9612,ORD_9613,29131,"WeCool G1 Gimbal for Smartphone with Wireless Remote, Extendable Bluetooth Selfie Stick and Tripod, Auto Balance for Vlog ...",Warehouse C,82,72,2025-02-23 00:26:00,10
9613,ORD_9614,25443,Polonex 20mg Tablet DT,Warehouse A,39,22,2025-02-23 21:13:00,17
9614,ORD_9615,17183,House Of Makeup Nail Lacquer - Thai Tea 12 ml,Warehouse A,18,12,2025-02-23 23:43:00,6
9615,ORD_9616,17104,Ajmal Aristocrat EDP Citrus Woody Perfume 75ml for Men and Raindrops EDP Floral Chypre Perfume 50ml for Women +1 Perfume T...,Warehouse B,95,89,2025-02-23 17:56:00,6
9616,ORD_9617,15306,Storite 45CM High Speed Micro USB 3.0 Cable A to Micro B for External & Desktop Hard Drives Black,Warehouse C,46,34,2025-02-23 13:26:00,12
9617,ORD_9618,704,"Night Light Bluetooth Speaker Wireless - RAGZAN Portable Smart Touch Control Bedside Table Lamp with Colorful Led, Best Gi...",Warehouse B,90,79,2025-02-23 17:59:00,11
9618,ORD_9619,29246,"JBL Go 2, Wireless Portable Bluetooth Speaker with Mic, Signature Sound, Vibrant Color Options with IPX7 Waterproof & AUX...",Warehouse C,88,73,2025-02-23 07:30:00,15
9619,ORD_9620,17155,Ajmal Primitive - Forests Edt 250 Ml,Warehouse B,71,52,2025-02-23 10:50:00,19
9620,ORD_9621,23532,Zayn & Myza Bravo No Alcohol Body Spray For Men 150 ml,Warehouse A,19,13,2025-02-23 08:51:00,6
9621,ORD_9622,700,Pro-Clinical 150 Battery Powered Toothbrush,Warehouse B,55,36,2025-02-23 11:13:00,19
9622,ORD_9623,35978,Onsitego 1 Year Extended Warranty for Small Household Appliances from Rs. 2501-3000 (Email Delivery - No Physical Kit),Warehouse B,42,29,2025-02-23 04:52:00,13
9623,ORD_9624,23558,"SanDisk Ultra Dual Drive Luxe USB Type-C 512GB, Metal Pendrive for Mobile (Silver)",Warehouse C,77,65,2025-02-23 23:24:00,12
9624,ORD_9625,33992,Sister Hair Flexi Rods | PACK OF 20 | Curlers | Flexible Rods Set | Bendy rollers | For Girls Women Ladies Kids | Soft Foa...,Warehouse C,96,84,2025-02-23 08:39:00,12
9625,ORD_9626,30282,Olpit 200mg Tablet,Warehouse B,16,9,2025-02-23 00:52:00,7
9626,ORD_9627,15331,"Oraimo Cordless Hair Trimmer for Men,150 Mins Run Time,Professional Beard Trimmer for men,Hair Clippers for men,Power adap...",Warehouse C,80,63,2025-02-23 03:49:00,17
9627,ORD_9628,3300,Rabibest D 30mg/20mg Capsule SR,Warehouse B,63,47,2025-02-23 08:23:00,16
9628,ORD_9629,35823,Soulflower Onion Biotin Shampoo 300 ml,Warehouse A,40,22,2025-02-23 05:53:00,18
9629,ORD_9630,17860,Daypera S 1000mg/500mg Injection,Warehouse A,19,9,2025-02-23 23:26:00,10
9630,ORD_9631,13804,Jovees Onion Oil & Bampoo Strengthening Shampoo 250 ml,Warehouse B,69,58,2025-02-23 14:51:00,11
9631,ORD_9632,25841,"Portronics Bubble Multimedia Wireless Keyboard 2.4 GHz & Bluetooth 5.0 Connectivity, Noiseless Experience, Compact Size, S...",Warehouse C,45,29,2025-02-23 05:28:00,16
9632,ORD_9633,34170,"Ant Esports H530 Wired Over Ear Headphones with mic (Black, Red)",Warehouse A,63,44,2025-02-23 20:58:00,19
9633,ORD_9634,25873,Face Pack - Activated Bamboo Charcoal,Warehouse B,22,14,2025-02-23 16:35:00,8
9634,ORD_9635,13880,Insight Cosmetics 3 In 1 Long Lasting Primer 30 ml,Warehouse C,49,35,2025-02-23 03:52:00,14
9635,ORD_9636,35703,Nazoport Oral Suspension,Warehouse C,79,60,2025-02-23 12:44:00,19
9636,ORD_9637,4644,HP F6V97AA#ACJ External USB DVD-RW Drive,Warehouse A,14,4,2025-02-23 22:20:00,10
9637,ORD_9638,25869,NOOCET 400MG TABLET,Warehouse B,42,32,2025-02-23 12:14:00,10
9638,ORD_9639,13873,TP-Link USB WiFi Dongle 300Mbps High Gain Wireless Network Wi-Fi Adapter for PC Desktop and Laptops. Supports Win10/8.1/8/...,Warehouse A,31,19,2025-02-23 14:22:00,12
9639,ORD_9640,22846,Dell K257C 1 Port 240V 3 Pin Power Chord for Laptops - Black,Warehouse B,101,92,2025-02-23 12:37:00,9
9640,ORD_9641,2205,"03+ Volcano Scrub For Exfoliation, Deep Cleansing, Blackhead Removal And Pore Minimization (50G)",Warehouse C,47,37,2025-02-23 17:38:00,10
9641,ORD_9642,17990,Wella Professionals Wella Professionals Nutricurls Sulphate Free Shampoo 250ml and Detangling Conditioner 200ml Duo For Wa...,Warehouse C,53,42,2025-02-23 12:10:00,11
9642,ORD_9643,10716,"Fashion Colour Non - Transfer Matt Waterproof Lipstick, 19 Coral Orange 2.6 gm",Warehouse C,89,72,2025-02-23 01:59:00,17
9643,ORD_9644,36611,Oculy 100ml (Pack of 2) Spray Spectacle & Camera Lens Cleaner with Japanese Microfiber Cloth & Mini Screwdriver | Professi...,Warehouse B,107,89,2025-02-23 19:38:00,18
9644,ORD_9645,7929,Tetan Trio Tablet,Warehouse B,32,20,2025-02-23 00:20:00,12
9645,ORD_9646,2698,Xpocen Syrup,Warehouse C,41,32,2025-02-23 07:15:00,9
9646,ORD_9647,2711,Nature Sure Mind Shakti Tablet 60's,Warehouse B,46,27,2025-02-23 19:58:00,19
9647,ORD_9648,17792,Passion Indulge E OILS-LAVENDER 10 ml,Warehouse C,42,32,2025-02-23 17:03:00,10
9648,ORD_9649,30375,Street Wear Playfull Matte Lip Crayon - Dope Cherry 2.9 gm,Warehouse A,54,37,2025-02-23 00:30:00,17
9649,ORD_9650,10900,Spantra Tea tree Conditioner 300 ml,Warehouse B,48,38,2025-02-23 11:21:00,10
9650,ORD_9651,23104,"OLAID Original New Series 7 D20 Bluetooth Wireless Smart Watch, Fitness Band for Boys, Girls, Men, Women & Kids | Sports W...",Warehouse B,51,42,2025-02-23 22:52:00,9
9651,ORD_9652,25706,CEDO Tempered Glass for iPad Pro 10.5 inch (2017) / iPad Air 3 (2019) | Screen Protector Tempered Glass for iPad Pro Tab 1...,Warehouse C,38,31,2025-02-23 01:39:00,7
9652,ORD_9653,30384,House of Aroma Peach Fragrance Oil 10 ml,Warehouse A,106,91,2025-02-23 01:44:00,15
9653,ORD_9654,6331,Mamira Khaas surma (Surma for eyes) Pack of 2,Warehouse B,47,37,2025-02-23 17:05:00,10
9654,ORD_9655,1756,Tenlipure 20mg Tablet,Warehouse B,27,14,2025-02-23 10:03:00,13
9655,ORD_9656,17675,ZOUK Black Solid Handmade Vegan Leather Women's Office Bag for 15.6 inch Laptop - Jet Black,Warehouse A,78,67,2025-02-23 14:37:00,11
9656,ORD_9657,7786,"BigPassport 1080P/30fps 5P lens Full HD Webcam with Tripod & Inbuilt Microphone, Advanced Human Face Detection, Laptop Des...",Warehouse A,9,1,2025-02-23 15:39:00,8
9657,ORD_9658,23129,Amozo Ultra Slim Soft Silicone Flexible Camera Protection Back Cover for iPhone 12/12 Pro (Blue),Warehouse B,104,90,2025-02-23 08:52:00,14
9658,ORD_9659,7784,Arata Night Repair Combo With Purifying Face Wash (150 ML) & Vitamin C Night Repair Gel (50 ML) 200 ml,Warehouse A,88,80,2025-02-23 02:43:00,8
9659,ORD_9660,17667,Acloris SP 100mg/325mg/15mg Tablet,Warehouse C,70,59,2025-02-23 17:27:00,11
9660,ORD_9661,18014,Teluzine 5 mg/10 mg Tablet,Warehouse B,41,35,2025-02-23 12:59:00,6
9661,ORD_9662,28737,"Taft Looks - Wet Power Gel, Extra Hold 3",Warehouse A,97,90,2025-02-23 12:08:00,7
9662,ORD_9663,10803,"COLORESSENCE Shimmer Highlighter Multi-Purpose Intense Pigment Eye Makeup Formula, Golden With FREE Eyeshadow Brush",Warehouse B,89,79,2025-02-23 14:14:00,10
9663,ORD_9664,10742,Nimnik SP 100mg/325mg/15mg Tablet,Warehouse C,22,15,2025-02-23 17:15:00,7
9664,ORD_9665,17923,"boAt Aavante Bar 553 Portable Bluetooth Speaker, Soundbar with 16W RMS Stereo Sound, Dual EQ Modes, Multi-Compatibility, ...",Warehouse C,75,62,2025-02-23 06:11:00,13
9665,ORD_9666,6256,Amozo Ultra Hybrid Series Back Cover Case for iPhone 13 Pro (Polycarbonate|Blue),Warehouse A,101,92,2025-02-23 23:49:00,9
9666,ORD_9667,827,Men Monoi Beard Oil,Warehouse B,96,79,2025-02-23 01:53:00,17
9667,ORD_9668,30429,Doxoril 100mg Syrup,Warehouse C,84,76,2025-02-23 13:17:00,8
9668,ORD_9669,10758,India Grooming Club Royale Nourishing Bodywash 100 ml,Warehouse A,25,17,2025-02-23 10:12:00,8
9669,ORD_9670,25821,ADS Good Choice India Color Series Crystal Makeup kit with Eyeshadow,Warehouse C,99,87,2025-02-23 05:13:00,12
9670,ORD_9671,17873,"Ginkgo Biloba - Memory, Focus & Clarity",Warehouse C,99,90,2025-02-23 18:57:00,9
9671,ORD_9672,4612,Allure Professional Makeup Brush (Set of 04) (Travel Friendly Brush Set SGK-04) 1's,Warehouse B,96,83,2025-02-23 05:30:00,13
9672,ORD_9673,25795,Eyetex Dazller Classique Compact Powder- 8009 Pink Dew 9 gm,Warehouse C,59,42,2025-02-23 02:01:00,17
9673,ORD_9674,10819,Telmi-Hct Tablet,Warehouse C,36,22,2025-02-23 08:51:00,14
9674,ORD_9675,3774,Natural Body Butter,Warehouse C,61,48,2025-02-23 04:27:00,13
9675,ORD_9676,28823,MC SID Razz Harry Potter Pack of 6 Magnetic Bookmarks | Gift for Readers and Book Lovers| Girl Friends/boy Friends/License...,Warehouse B,41,27,2025-02-23 02:52:00,14
9676,ORD_9677,7862,"Zebronics CU3100V Fast charging Type C cable with QC 18W support, 3A max capacity, 1 meter braided cable, Data transfer an...",Warehouse B,99,89,2025-02-23 21:49:00,10
9677,ORD_9678,28736,Nazokas 5mg/500mg/5mg Tablet,Warehouse C,116,97,2025-02-23 17:00:00,19
9678,ORD_9679,32310,Global Desi Dreamy Daze Eau De Parfum 50ML & Star Gazer Body Mist 200ML Pack of 2 for Women Crafted by Ajmal,Warehouse A,75,60,2025-02-23 06:01:00,15
9679,ORD_9680,25776,Miss Claire Mega Matte Lipstick - 10 3.5 Gm,Warehouse C,80,71,2025-02-23 13:05:00,9
9680,ORD_9681,22992,"wooum Polyester iPad 11 Pro Sleeve / Case / Pouch 9.7, 10.5, 10.9"" Tablet Pouch / Tablet Sleeve / Tablet Bag / iPad Cover...",Warehouse C,36,26,2025-02-23 07:05:00,10
9681,ORD_9682,7851,Febuzest 40mg Tablet,Warehouse C,65,56,2025-02-23 02:47:00,9
9682,ORD_9683,834,"NEWTECHNO Rugged Armor Cover Case for Samsung Galaxy Buds Pro(2021) ,Galaxy Buds 2,Galaxy Buds Live (2020)--Oil-Resistant,...",Warehouse B,107,96,2025-02-23 18:37:00,11
9683,ORD_9684,17955,Burpease 40mg Injection,Warehouse C,61,56,2025-02-23 23:59:00,5
9684,ORD_9685,7925,Portronics Adapto 20 Type C 20W Fast PD/Type C Adapter Charger with Fast Charging for iPhone 12/12 Pro/12 Mini/12 Pro Max/...,Warehouse A,82,64,2025-02-23 12:40:00,18
9685,ORD_9686,3368,Solvin 2mg/10mg Tablet,Warehouse B,112,95,2025-02-23 09:19:00,17
9686,ORD_9687,22793,Bonjour Paris Photo Match Concealer Stick cum Primer - Honey 3.2 gm,Warehouse A,82,73,2025-02-23 20:44:00,9
9687,ORD_9688,32350,"Amozo Liquid Silicon Shockproof, Camera Protection, with Fabric Lining Back Case Cover for OnePlus Nord CE 5G (Silicon | B...",Warehouse C,38,30,2025-02-23 15:40:00,8
9688,ORD_9689,846,Repsia 20mg Tablet,Warehouse C,25,10,2025-02-23 19:14:00,15
9689,ORD_9690,4519,Velze 500mg Tablet,Warehouse A,24,13,2025-02-23 13:07:00,11
9690,ORD_9691,31805,Lakme Absolute Infinity Eye Shadow Palette Pink Paradise 12 Gm,Warehouse C,109,94,2025-02-23 19:13:00,15
9691,ORD_9692,17550,Tea Tree Skin Purifying Cream,Warehouse C,39,31,2025-02-23 07:21:00,8
9692,ORD_9693,13781,Amalfi Deo For Men,Warehouse B,30,17,2025-02-23 17:32:00,13
9693,ORD_9694,10532,Ornabend 400mg Tablet,Warehouse B,98,89,2025-02-23 08:37:00,9
9694,ORD_9695,26077,Meftastar-DS Oral Suspension,Warehouse B,108,94,2025-02-23 00:48:00,14
9695,ORD_9696,36969,Red Square Facial Bleach Face Mask Mixing Bowl Set for Parlor Use (Assorted),Warehouse A,87,78,2025-02-23 08:35:00,9
9696,ORD_9697,13903,Doubledicestore Tempered Glass Screen Protector Compatible for iPhone XR / 11 with Edge to Edge Coverage and Easy Installa...,Warehouse B,77,61,2025-02-23 22:18:00,16
9697,ORD_9698,2253,"HP 15s, 12th Gen Intel Core i5 8GB RAM/512GB SSD 15.6""(39.6 cm) FHD Laptop/Intel Iris Xe Graphics/Alexa/Win 11/MSO 2021/1....",Warehouse C,9,4,2025-02-23 15:49:00,5
9698,ORD_9699,13073,Zortaz 2% Cream,Warehouse C,97,81,2025-02-23 20:49:00,16
9699,ORD_9700,15061,Lauliki 75mg/20mg Capsule,Warehouse B,22,9,2025-02-23 18:46:00,13
9700,ORD_9701,31756,Ajmal Distraction & Magnetize & Persuade Deo & Aretha EDP Pack of 3 20 ml,Warehouse C,31,13,2025-02-23 15:57:00,18
9701,ORD_9702,18120,Cello Technotip Ball Pen Set | Pack of 10 | Blue Ball Pens | Lightweight Ball Pens for Pressure Free and Fine Writing | Pe...,Warehouse C,12,4,2025-02-23 12:03:00,8
9702,ORD_9703,26055,Ozpex 5 Scored Tablet,Warehouse A,79,70,2025-02-23 02:06:00,9
9703,ORD_9704,2224,Sunsilk Long And Healthy Growth Shampoo 360 ml,Warehouse B,43,27,2025-02-23 00:36:00,16
9704,ORD_9705,28526,Evitam 400mg Tablet,Warehouse B,113,99,2025-02-23 15:42:00,14
9705,ORD_9706,22687,"ProElite 360 Rotatable Smart Flip Case Cover for Apple iPad 10.2 inch 9th/8th/7th Generation with Stylus Pen, Black",Warehouse C,89,82,2025-02-23 11:47:00,7
9706,ORD_9707,22522,Gicid 40mg Tablet,Warehouse C,14,8,2025-02-23 19:26:00,6
9707,ORD_9708,22672,Duomentin 500mg/125mg Tablet,Warehouse B,30,18,2025-02-23 21:27:00,12
9708,ORD_9709,10489,Essential Souls Hair Oil - Advanced Bhringa 100 ml,Warehouse C,81,71,2025-02-23 19:19:00,10
9709,ORD_9710,18132,"HUDACRUSH BEAUTY Makeup Kit for Girls, Lipstick Combo Set Fab 5 in 1 Red Edition Matte Finish Lipsticks with 18 Shades Nud...",Warehouse C,92,87,2025-02-23 21:06:00,5
9710,ORD_9711,22691,"HP Laserjet 138fnw Monochrome Compact Wi-Fi Printer with Network Support for Reliable, Fast Printing (Print, Copy, Scan, Fax)",Warehouse C,69,64,2025-02-23 10:47:00,5
9711,ORD_9712,10490,Batiste Dry Hair Shampoo - Coconut & Exotic Tropical 50 ml + Fruity & Cheeky Cherry 50 ml,Warehouse C,114,99,2025-02-23 19:25:00,15
9712,ORD_9713,4687,"12 Piece Hawaiian Flower Hair Clips, Plumeria Foam Hair Accessories Clip for Women, Hawaii Tropical Party Decorations, Bea...",Warehouse C,28,17,2025-02-23 14:22:00,11
9713,ORD_9714,22693,Dynotrek Arrival 14-15 Inch Laptop Sleeve Case Cover with Handle Compatible for Mackbook Flex Yoga ideaPad Pavilion EliteB...,Warehouse C,81,63,2025-02-23 20:37:00,18
9714,ORD_9715,6186,"Vrachos Bluetooth Extendable Selfie Stick with Wireless Remote, Adjustable and Rotatable Design Portable and Compatible fo...",Warehouse C,42,25,2025-02-23 22:43:00,17
9715,ORD_9716,2677,The Moms Co. Stretch Oil 100 ml,Warehouse C,104,98,2025-02-23 18:49:00,6
9716,ORD_9717,30461,Swiss Beauty High Coverage Foundation-02,Warehouse A,114,97,2025-02-23 02:27:00,17
9717,ORD_9718,26045,Gemblue Biocare Charcoal Scrub 500 ml,Warehouse B,92,78,2025-02-23 08:00:00,14
9718,ORD_9719,18380,Vdpod 100mg Tablet DT,Warehouse A,105,90,2025-02-23 13:43:00,15
9719,ORD_9720,8012,Supratel H 40mg/12.5mg Tablet,Warehouse C,41,23,2025-02-23 08:26:00,18
9720,ORD_9721,22669,CZARTECH Native Back Cover for iPhone 14 Clear case (TPU + Tough Polycarbonate Back I 5ft Drop Protection Tested I Transpa...,Warehouse B,41,36,2025-02-23 17:58:00,5
9721,ORD_9722,4780,OpenTech® Tempered Glass Screen Protector Compatible for Oneplus 10R 5G with Edge to Edge Coverage and Easy Installation kit,Warehouse A,24,13,2025-02-23 03:31:00,11
9722,ORD_9723,2686,Sytop 40mg Injection,Warehouse A,63,57,2025-02-23 15:33:00,6
9723,ORD_9724,10431,Metsurge GP 2 mg/500 mg Tablet,Warehouse A,39,20,2025-02-23 02:41:00,19
9724,ORD_9725,10429,"Lecherous Beauty Full Coverage 12 Shades Supracolor Flawless Super Blendable, Waterproof, Long Lasting Mousse Foundation P...",Warehouse A,40,27,2025-02-23 15:00:00,13
9725,ORD_9726,164,Face Mask 5 Layer In Multicolor Without Valve,Warehouse A,27,13,2025-02-23 17:50:00,14
9726,ORD_9727,22786,Peiroks Dash/Warp Charging Type C Cable Compatible for OnePlus Nord CE/ 10 Pro/ 9RT/ 9 Pro/ 9/ 9R/ Nord 2/ Nord/ 8 Pro/ 8...,Warehouse B,69,61,2025-02-23 10:24:00,8
9727,ORD_9728,22456,Spigen Liquid Air Back Cover Case for iPhone 13 Pro (TPU | Navy Blue),Warehouse A,92,86,2025-02-23 00:19:00,6
9728,ORD_9729,18274,"typecase Edge Magic Style Keyboard for iPad Air 5th/4th(2022,2020) & New iPad Pro 11 (4th,3rd,2nd Gen), touchpad Keyboard ...",Warehouse C,30,13,2025-02-23 13:10:00,17
9729,ORD_9730,18074,"Fashion Colour Vivid Matte Lipstick, 18 Red Iron 3.8 gm",Warehouse A,69,63,2025-02-23 17:58:00,6
9730,ORD_9731,12436,Philips Hair Dryer Bhc017/00 Thermoprotect 1200 Watts with Air Concentrator + Diffuser Attachment - Pink,Warehouse C,81,73,2025-02-23 23:25:00,8
9731,ORD_9732,3381,CP PLUS 2MP Full HD Wi-fi CCTV Camera | 360°View PT Camera | Human Detection & Motion Tracking | Cloud Monitoring | 2-Way ...,Warehouse B,97,84,2025-02-23 08:37:00,13
9732,ORD_9733,6204,Sheabutter Coffee Face Scrub 200 gm (Nilgiri Aromas),Warehouse B,53,37,2025-02-23 09:10:00,16
9733,ORD_9734,3395,Roliptin 10 Tablet,Warehouse B,62,46,2025-02-23 11:32:00,16
9734,ORD_9735,4661,M Lowpril 5mg Tablet,Warehouse B,90,78,2025-02-23 13:44:00,12
9735,ORD_9736,6202,"STRIFF Webcam Cover Slide, Ultra Thin Laptop Camera Cover Slide Blocker for Computer MacBook Pro iMac PC Tablet (Pack of ...",Warehouse C,89,72,2025-02-23 17:06:00,17
9736,ORD_9737,3721,Endopain SP Tablet,Warehouse A,76,67,2025-02-23 14:55:00,9
9737,ORD_9738,18456,Doxway 400mg Tablet,Warehouse C,52,43,2025-02-23 19:56:00,9
9738,ORD_9739,6118,Panasonic CR-2016/5BE Lithium Coin Battery - Pack of 5,Warehouse B,15,5,2025-02-23 17:11:00,10
9739,ORD_9740,6207,HS 100mg Powder for Injection,Warehouse B,33,15,2025-02-23 13:40:00,18
9740,ORD_9741,1702,"L.A GIRL HD Pro Light + BB Cream, Lightweight, Blendable, Long Lasting Natural Finish Skin, Intensely Hydrating, 30ml",Warehouse A,60,48,2025-02-23 08:49:00,12
9741,ORD_9742,31140,Alexia-CL 625 Tablet,Warehouse C,92,75,2025-02-23 01:32:00,17
9742,ORD_9743,22618,Actirox 50mg Tablet,Warehouse A,69,57,2025-02-23 16:25:00,12
9743,ORD_9744,4666,Nymtoss Cold Tablet,Warehouse B,91,77,2025-02-23 16:50:00,14
9744,ORD_9745,13081,"Rose Geranium Aroma Bath Salt for Moisturised - Soft Skin, Controls Acne",Warehouse A,86,80,2025-02-23 03:12:00,6
9745,ORD_9746,2687,"FINICKY-WORLD 360 Degree Wireless Panoramic Bulb 360° IP Camera with Night Vision, Hidden Camera, 2-Way Audio and Micro 12...",Warehouse B,106,96,2025-02-23 02:20:00,10
9746,ORD_9747,36972,Pregabid-D 50/20 Capsule DR,Warehouse A,47,31,2025-02-23 18:39:00,16
9747,ORD_9748,13894,Hello Zone Exclusive Matte Finish Soft Back Case Cover for Motorola Moto G62 5G - Black,Warehouse A,89,71,2025-02-23 22:13:00,18
9748,ORD_9749,2236,"AYL Waterproof D-20 Touch Screen Smart Watch Bluetooth Smartwatch with Blood Pressure Tracking, Heart Rate Sensor and Basi...",Warehouse B,96,81,2025-02-23 12:51:00,15
9749,ORD_9750,1682,Mirafenac P 100mg/325mg Tablet,Warehouse C,43,29,2025-02-23 11:47:00,14
9750,ORD_9751,35623,Beetel M71 Corded Landline Phone Black,Warehouse B,53,46,2025-02-23 11:44:00,7
9751,ORD_9752,18330,"Pilot 30ml Ink Bottle, Blue",Warehouse C,41,23,2025-02-23 15:21:00,18
9752,ORD_9753,11088,Revlon Powder Blush - Ravishing Rose 5 Gm,Warehouse B,103,98,2025-02-23 21:45:00,5
9753,ORD_9754,23324,Ajmal Aura Concentrated Perfume Oil Floral Fruity Attar And Khofooq Concentrated Perfume Oil Woody Oudhy Attar 28 ml,Warehouse B,102,87,2025-02-23 01:14:00,15
9754,ORD_9755,11053,Olmefast-H 40 Tablet,Warehouse B,67,54,2025-02-23 12:27:00,13
9755,ORD_9756,34013,Vrikast LC Syrup,Warehouse C,87,81,2025-02-23 17:15:00,6
9756,ORD_9757,29089,Casio MJ-12VCb-WE 300 Steps Check & Correct Colourful Desktop Calculator (White),Warehouse C,100,81,2025-02-23 21:01:00,19
9757,ORD_9758,11072,Peach Milk Moisturiser - SPF 24 PA++,Warehouse A,42,28,2025-02-23 20:53:00,14
9758,ORD_9759,753,Fujifilm Instax Mini 11 Instant Camera (Sky Blue),Warehouse B,28,17,2025-02-23 01:53:00,11
9759,ORD_9760,23346,"ESR Clear Case Compatible For iPhone 14 and iPhone 13 Case, Shockproof Thin Silicone Cover, Yellowing-Resistant Slim Trans...",Warehouse C,45,28,2025-02-23 18:22:00,17
9760,ORD_9761,17404,Rosycap 5mg Tablet,Warehouse A,96,84,2025-02-23 11:58:00,12
9761,ORD_9762,13754,Hydit 100 Capsule,Warehouse A,22,3,2025-02-23 20:44:00,19
9762,ORD_9763,25569,Pentas 400 Tablet,Warehouse C,48,34,2025-02-23 21:31:00,14
9763,ORD_9764,13751,OpenTech® Tempered Glass Screen Protector Compatible with iQOO Neo 6 5G with Edge to Edge Coverage and Easy Installation k...,Warehouse B,52,43,2025-02-23 00:24:00,9
9764,ORD_9765,35896,"Comet Busters Gold, Silver and White Eyeliner Stickers (EYE057)",Warehouse C,103,85,2025-02-23 08:02:00,18
9765,ORD_9766,29107,Manish Malhotra Beauty By MyGlamm Cinnamon & Turmeric Repairing Sheet Mask 25 ml,Warehouse C,97,88,2025-02-23 23:29:00,9
9766,ORD_9767,32218,"Kiss Beauty, Facefinity All Day Primer and Foundation SPF 20 for Women (Off-White)",Warehouse A,96,88,2025-02-23 16:48:00,8
9767,ORD_9768,11052,"Fire-Boltt Dynamite Bluetooth Calling Smartwatch with Industry's Largest 1.81"" Display, 120+ Sports Mode, IP68 Rating, Fas...",Warehouse B,58,49,2025-02-23 12:54:00,9
9768,ORD_9769,3318,Gear Classic 20L Faux Leather Water Resistant Anti Theft Laptop Bag/Backpack for Men/Women-Brown,Warehouse B,61,43,2025-02-23 21:39:00,18
9769,ORD_9770,25612,"BenQ GW2283, 22 inch (55 cm) 1920x1080 Pixels IPS, Full HD Bezel-Less Monitor- Eye Care, Anti-Glare, Low Blue Light, Brigh...",Warehouse B,71,63,2025-02-23 00:57:00,8
9770,ORD_9771,29051,Oil - Neem,Warehouse C,32,14,2025-02-23 09:41:00,18
9771,ORD_9772,13887,Cefdyne 500mg Injection,Warehouse C,67,55,2025-02-23 07:47:00,12
9772,ORD_9773,34050,POPIO Tempered Glass Screen Protector Compatible for iPhone X/iPhone XS/iPhone 11 Pro with Edge to Edge Coverage and Easy ...,Warehouse B,96,84,2025-02-23 04:36:00,12
9773,ORD_9774,10942,"Real Techniques Seamless Complexion Makeup Brush, For Foundation, Primer and Moisurizer, 1 Count",Warehouse A,47,30,2025-02-23 00:30:00,17
9774,ORD_9775,17594,OpenTech® Tempered Glass Screen Protector Compatible for Samsung Galaxy S20 FE 5G (Transparent) Full Screen Coverage (Exce...,Warehouse C,104,97,2025-02-23 13:21:00,7
9775,ORD_9776,7747,House of Aroma Alive Fragrance Oil 100 ml,Warehouse A,57,41,2025-02-23 19:18:00,16
9776,ORD_9777,23195,LOHAYA Remote Compatible for Tata Sky HD/SD Set Top Box Remote Control | tata Sky Remote|,Warehouse C,65,52,2025-02-23 12:38:00,13
9777,ORD_9778,35831,"Syoss - Renew 7 Complete Repair, 02 Conditioner",Warehouse B,105,95,2025-02-23 07:14:00,10
9778,ORD_9779,25663,"Brustro Artists Watercolour Paper 300 GSM A3-25% Cotton, Cold Pressed (Contains 9+3 Sheet)",Warehouse C,17,3,2025-02-23 01:11:00,14
9779,ORD_9780,30368,Femidol 500 mg/250 mg Tablet,Warehouse B,37,22,2025-02-23 10:54:00,15
9780,ORD_9781,17446,Dizomik 500mg Injection,Warehouse B,35,21,2025-02-23 08:21:00,14
9781,ORD_9782,34280,The Man Company Charcoal Cleansing Gel - Black Pepper & Bergamot 100 ml,Warehouse A,52,42,2025-02-23 13:13:00,10
9782,ORD_9783,30474,"URBN Beat 600 Bluetooth *Newly Launched* True Wireless (TWS) in Earbuds with 13MM Driver, HQ Mic, 20H Playtime, Type C Fas...",Warehouse B,35,24,2025-02-23 15:03:00,11
9783,ORD_9784,267,Bitadip Cream,Warehouse C,87,70,2025-02-23 07:44:00,17
9784,ORD_9785,8154,Glimiprex MF 1/500 Tablet PR,Warehouse A,66,55,2025-02-23 20:48:00,11
9785,ORD_9786,30497,"OnePlus 10R 5G (Forest Green, 12GB RAM, 256GB Storage, 80W SuperVOOC)",Warehouse A,28,13,2025-02-23 18:18:00,15
9786,ORD_9787,22492,Superdrug Essential Facial Cleansing Wipes X25 (For Combination Skin Care) 1's,Warehouse B,74,57,2025-02-23 11:42:00,17
9787,ORD_9788,18093,LIRAMARK Shockproof Protective Silicone 360° Cover Case with Buckle Designed for JBL Tune 230NC TWS (Midnight Blue),Warehouse A,97,91,2025-02-23 09:54:00,6
9788,ORD_9789,4712,DeBelle Gel Nail Lacquer Mint Amour Mint Blue Nail Polish 8 ml,Warehouse A,33,17,2025-02-23 22:12:00,16
9789,ORD_9790,22500,"Redgear GC-100 Keyboard and Mouse Set with 3 Mixed LEDs, Windows Keylock, Floating Keycaps, RGB Mode, Upto 3200 dpi and Ga...",Warehouse A,33,16,2025-02-23 18:42:00,17
9790,ORD_9791,22655,Qazi 500mg Tablet,Warehouse A,21,7,2025-02-23 22:39:00,14
9791,ORD_9792,13043,Ometic 2mg Tablet DT,Warehouse C,14,8,2025-02-23 21:26:00,6
9792,ORD_9793,22510,Idozid 1000mg Injection,Warehouse B,84,74,2025-02-23 14:15:00,10
9793,ORD_9794,10590,Color Fever Eye Bomb Metallic Eye Pencil cum Eye Shadow Water Proof - Quick Silver 1.8 gm,Warehouse B,80,71,2025-02-23 19:20:00,9
9794,ORD_9795,10481,Nova Blue Ultra Hold Long Lasting Hair Spray 250 ml,Warehouse B,101,95,2025-02-23 05:52:00,6
9795,ORD_9796,15037,"Acer HA270 27 Inch (68.58 cm) Full HD IPS LCD Monitor with LED Back Light technology I Ultra Slim, 6.6mm Thick Frameless D...",Warehouse C,70,58,2025-02-23 09:56:00,12
9796,ORD_9797,1677,Fragrance Body Spray - Paradise 150 ml + Fragrance Body Spray - Napoleon 150 ml,Warehouse A,40,29,2025-02-23 09:56:00,11
9797,ORD_9798,917,"amaron quanta 12V 7Ah SMF UPS-Emergency Battery Ideal for Use in UPS/Solar and More Instruments (VRLA 12-07/ 12V, 7AH C20)",Warehouse C,21,12,2025-02-23 20:49:00,9
9798,ORD_9799,3754,Ceftozect 500mg Injection,Warehouse A,88,72,2025-02-23 16:44:00,16
9799,ORD_9800,32364,Insta Glow Multivitamins Face Wash - For Bright Skin,Warehouse C,23,4,2025-02-23 15:59:00,19
9800,ORD_9801,34250,"Pilot Frixion Roller Ball Pen, Blue, (9000019672)",Warehouse B,39,28,2025-02-23 11:28:00,11
9801,ORD_9802,34255,TheGiftKart Ultra-Hybrid Crystal Clear Back Case Cover for iPhone 14 Back Cover Case | Slim Fit Shockproof Design | Camera...,Warehouse B,74,55,2025-02-23 05:32:00,19
9802,ORD_9803,36981,"Amkette EvoFox X-Team Fireblade USB Gaming Keyboard and Mouse Set with Space-Saving TKL Design, Breathing LED Effects, Ant...",Warehouse B,75,67,2025-02-23 17:31:00,8
9803,ORD_9804,34181,Pierre Cardin Paris - Studio Nails 46,Warehouse C,109,99,2025-02-23 15:56:00,10
9804,ORD_9805,6298,Trson D Tablet,Warehouse C,80,69,2025-02-23 22:09:00,11
9805,ORD_9806,853,Metoprime 25mg Tablet XL,Warehouse A,55,37,2025-02-23 18:28:00,18
9806,ORD_9807,12324,Saniola Hand Sani Passion Fruit 38 ml,Warehouse B,98,84,2025-02-23 18:48:00,14
9807,ORD_9808,17482,Revlon Touch and Glow Advanced Fairness Cream (75g),Warehouse C,22,10,2025-02-23 17:02:00,12
9808,ORD_9809,752,Calock Plus 5mg/50mg Tablet,Warehouse A,88,76,2025-02-23 15:32:00,12
9809,ORD_9810,34113,And Crafted By Ajmal Chic Connect Fragrance Mist 200 Ml,Warehouse A,62,57,2025-02-23 02:10:00,5
9810,ORD_9811,17555,Voglitor R 1/0.3 Tablet,Warehouse B,44,35,2025-02-23 07:42:00,9
9811,ORD_9812,13803,"Sounce 20mm Stainless Steel Watch Straps/ Watch Band Compatible for Amazfit GTS 2 Mini, Amazfit Bip/ Bip U/ Bip U Pro/ Bip...",Warehouse C,32,27,2025-02-23 09:34:00,5
9812,ORD_9813,9162,"Fashion Colour Kiss Lip No Transfer Lipstick, 94 Bordeaux 2.6 gm",Warehouse C,75,64,2025-02-23 17:42:00,11
9813,ORD_9814,27254,MADES Hair Care Repair Expert Detangler Spray Root Awakening 200 ml,Warehouse C,96,86,2025-02-23 21:38:00,10
9814,ORD_9815,20399,Vantil 200mg Tablet DT,Warehouse B,21,4,2025-02-23 15:49:00,17
9815,ORD_9816,3515,Cypohale Syrup,Warehouse C,15,5,2025-02-23 22:02:00,10
9816,ORD_9817,1332,Medimade Red Onion Black Seed Oil Hair Mask 200 gm,Warehouse C,86,67,2025-02-23 08:17:00,19
9817,ORD_9818,1252,"Amazon Basics Micro Usb Fast Charging Cable For Android Smartphone,Personal Computer,Printer With Gold Plated Connectors (...",Warehouse B,16,9,2025-02-23 11:44:00,7
9818,ORD_9819,20380,Moxirel-P Eye Drop,Warehouse B,74,60,2025-02-23 22:01:00,14
9819,ORD_9820,20806,DailyObjects Turf Desk Mat for Work from Home/Office/Gaming | Premium Vegan Leather Large Laptop mat | Extended Mouse pad ...,Warehouse B,65,53,2025-02-23 16:11:00,12
9820,ORD_9821,20808,Glimmer Nail Polish Dark Red 5 ml,Warehouse B,45,37,2025-02-23 17:49:00,8
9821,ORD_9822,2450,"ENVIE® AAA Rechargeable Batteries, High-Capacity Ni-MH 1100 mAh, Low Self Discharge, Pre-Charged (Pack of 2) (AAA11002PL)",Warehouse B,22,17,2025-02-23 07:29:00,5
9822,ORD_9823,20353,Podmon 50 Dry Syrup,Warehouse C,82,71,2025-02-23 10:50:00,11
9823,ORD_9824,5614,"HUDA GIRL BEAUTY Professional 9 Shade Crystal Diamond Eyeshadow Palette, Highly Pigmented Eye Shadow Makeup Kit For Girls...",Warehouse C,109,96,2025-02-23 17:44:00,13
9824,ORD_9825,27011,Novacuf-AG Syrup,Warehouse C,62,47,2025-02-23 01:04:00,15
9825,ORD_9826,9135,"realme narzo 50 5G (Hyper Black, 4GB RAM+64GB Storage) Dimensity 810 5G Processor | 48MP Ultra HD Camera",Warehouse B,7,2,2025-02-23 00:53:00,5
9826,ORD_9827,20721,Naprosyn 125mg Suspension,Warehouse B,108,97,2025-02-23 03:22:00,11
9827,ORD_9828,14443,CEDO Samsung Tab A7 10.4 (2020) SM-T500/T505 Flip Cover | Leather Finish | 360 Degree Rotate Flip Cover | Shockproof Style...,Warehouse C,35,30,2025-02-23 04:51:00,5
9828,ORD_9829,5552,MOSHKING Back Cover for Samsung Galaxy A73 5G with Slide Camera || Heavy Duty Military Grade Protection Mobile Phone Case ...,Warehouse C,108,99,2025-02-23 11:08:00,9
9829,ORD_9830,5544,Faber-Castell 379024 CS Acrylic Colours 9ML Set of 24,Warehouse A,89,81,2025-02-23 18:04:00,8
9830,ORD_9831,20591,Sotagard 80mg Tablet,Warehouse A,28,17,2025-02-23 06:26:00,11
9831,ORD_9832,9220,Parker Frontier Stainless Steel CT Fountain Pen,Warehouse B,78,60,2025-02-23 09:51:00,18
9832,ORD_9833,20583,"MODERN IN Tabletop Cell Phone Holder, Lazy Bracket Mobile Phone Stand - Clip-on Stand Holder - Grip Flexible Long Arm Goos...",Warehouse B,22,6,2025-02-23 09:50:00,16
9833,ORD_9834,32828,Texox 40mg Tablet SR,Warehouse C,71,52,2025-02-23 11:16:00,19
9834,ORD_9835,20573,Efiplat 5mg Tablet,Warehouse C,33,23,2025-02-23 23:46:00,10
9835,ORD_9836,34876,Zypocet M 5mg/10mg Tablet,Warehouse B,73,61,2025-02-23 03:56:00,12
9836,ORD_9837,9237,"pTron Solero MB301 3A Micro USB Data & Charging Cable, Made in India, 480Mbps Data Sync, Strong & Durable 1.5-Meter Nylon ...",Warehouse C,79,65,2025-02-23 23:08:00,14
9837,ORD_9838,30852,CLAVIER Neo Wired in Ear Earphone with Mic (Neo Grey),Warehouse A,72,61,2025-02-23 05:07:00,11
9838,ORD_9839,9181,WIFFY Stay Long lasting makeup Fixer setting Spray Prime ,Warehouse A,18,6,2025-02-23 12:57:00,12
9839,ORD_9840,31650,"realme narzo 50A Prime (Flash Black, 4GB RAM+64GB Storage) Full High Definition+ Display |50MP AI Triple Camera| Charger I...",Warehouse B,33,22,2025-02-23 09:32:00,11
9840,ORD_9841,32799,"Doodle Writing Tomorrow Today Small PU Leather Soft Cover Pocket Size Corporate Executive Diary Notebook (80 GSM, 192 Sing...",Warehouse B,95,81,2025-02-23 01:15:00,14
9841,ORD_9842,5594,CEDO Samsung Tab A 8.0 (2019) Tempered Glass | Screen Protector Tempered Glass for Samsung Galaxy Tab A 8.0 inch (2019) (S...,Warehouse B,65,49,2025-02-23 01:40:00,16
9842,ORD_9843,31680,Unicort 100mg Injection,Warehouse B,75,66,2025-02-23 18:23:00,9
9843,ORD_9844,21254,"Foxin FTC 88A/CC388A Black Laser Toner Cartridge Compatible for HP Laserjet Printer M1136, MFP, P1007, P1106, P1108, P100...",Warehouse A,101,87,2025-02-23 12:04:00,14
9844,ORD_9845,21272,VLCC Activated Bamboo Charcoal Facial Kit 60GM,Warehouse B,71,64,2025-02-23 19:27:00,7
9845,ORD_9846,9689,House of Beauty Paraffin Wax Socks Lavender 1's,Warehouse C,60,55,2025-02-23 11:49:00,5
9846,ORD_9847,21282,Funcan 150mg Tablet,Warehouse A,63,47,2025-02-23 07:44:00,16
9847,ORD_9848,19779,Vipul Enterprise Multi-Purpose Wall Holder Stand for Charging Mobile Just Fit in Socket and Hang Pack of 1 (Mutlicolor),Warehouse B,38,25,2025-02-23 06:56:00,13
9848,ORD_9849,9653,Doxma 400mg Tablet,Warehouse C,93,80,2025-02-23 07:10:00,13
9849,ORD_9850,9669,Dr.Sheth's Pure Olive Squalane Facial Oil 25 ml,Warehouse A,72,54,2025-02-23 04:01:00,18
9850,ORD_9851,5253,"Honor PAD 8 30.48 cm (12 inch) 2K Display, Qualcomm Snapdragon 680, 4GB RAM, 128GB Storage, 8 Speakers, Android 12, Tuv Ce...",Warehouse A,84,70,2025-02-23 20:45:00,14
9851,ORD_9852,27674,"The Body Shop Vegan Shea Shower Cream, 250 Ml",Warehouse C,117,99,2025-02-23 17:25:00,18
9852,ORD_9853,27675,"Portronics Konnect L 1.2M Fast Charging 3A 8 Pin USB Cable with Charge & Sync Function for iPhone, iPad (Grey)",Warehouse A,52,33,2025-02-23 00:37:00,19
9853,ORD_9854,26740,Nurolone Plus Injection,Warehouse C,48,38,2025-02-23 15:09:00,10
9854,ORD_9855,30819,Onsitego 2 Year Extended Warranty for Small Household Appliances from Rs. 6001-7000 (Email Delivery - No Physical Kit),Warehouse A,29,17,2025-02-23 03:25:00,12
9855,ORD_9856,19704,Zeeon Suspension,Warehouse C,99,93,2025-02-23 20:45:00,6
9856,ORD_9857,20128,"Famous Quality® SD Card Reader USB Type C, USB 3.0 and Micro USB OTG Memory Card Adapter Portable 1 Slots for TF, SD, Micr...",Warehouse B,23,17,2025-02-23 21:34:00,6
9857,ORD_9858,22445,"LAKMÉ 9 to 5 Weightless Mousse Lip & Cheek Color, Plum Feather, Long Lasting Lip and Cheek Tint, 2 in 1 Matte Liquid Lipst...",Warehouse B,82,64,2025-02-23 07:41:00,18
9858,ORD_9859,9471,YellowInc Case Cover Compatible with OnePlus Buds Z2 (Earbuds Not Included) (Midnight Blue),Warehouse B,82,65,2025-02-23 20:57:00,17
9859,ORD_9860,27216,"L'Oreal Paris Color Riche Moist Matte Lipstick, 232 Beige Couture 3.7 Gm",Warehouse B,110,93,2025-02-23 13:37:00,17
9860,ORD_9861,27218,Tramy 325mg/37.5mg Tablet,Warehouse A,61,48,2025-02-23 17:16:00,13
9861,ORD_9862,9298,Doflex Gel,Warehouse B,67,58,2025-02-23 14:09:00,9
9862,ORD_9863,34929,"SanDisk Extreme Pro microSD UHS I Card 256GB for 4K Video on Smartphones,Action Cams,Drones 200MB/s Read, 140MB/s Write",Warehouse A,86,78,2025-02-23 12:44:00,8
9863,ORD_9864,27231,Ofqub 200mg Tablet,Warehouse B,78,65,2025-02-23 21:11:00,13
9864,ORD_9865,1320,Fujifilm Instax Mini Pink Lemonade Film- 10 Exposures,Warehouse C,67,52,2025-02-23 07:56:00,15
9865,ORD_9866,9310,Truly Essential Essential Oil - Teatree 15 ml,Warehouse A,62,46,2025-02-23 23:20:00,16
9866,ORD_9867,27044,Electronic Spices 4CH RC Remote Control 27mhz Circuit Pcb Transmitter & Receiver Board With Antenna Radio System for Toy C...,Warehouse B,57,48,2025-02-23 13:01:00,9
9867,ORD_9868,12757,POPIO Tempered Glass Screen Protector Compatible for Redmi 9/9 Power / 9 Prime / 9A Full Screen Coverage (except edges),Warehouse B,104,93,2025-02-23 01:40:00,11
9868,ORD_9869,2433,Herbal Multi Care Sensitive Toothpaste,Warehouse B,71,52,2025-02-23 11:40:00,19
9869,ORD_9870,21247,Rizet FX Tablet,Warehouse C,25,6,2025-02-23 05:58:00,19
9870,ORD_9871,9275,Fashion Colour Sensitive Skin Body Wax Strips 1's,Warehouse C,25,7,2025-02-23 10:45:00,18
9871,ORD_9872,8979,Flormar Nail Enamel 321 Red Flag 11 ml,Warehouse A,40,35,2025-02-23 17:44:00,5
9872,ORD_9873,27420,Ceflexon Injection,Warehouse B,40,35,2025-02-23 02:17:00,5
9873,ORD_9874,20139,Body Deodorant - Hydra Energy,Warehouse B,63,53,2025-02-23 03:51:00,10
9874,ORD_9875,20931,Lipox Plus Tablet,Warehouse B,39,32,2025-02-23 07:26:00,7
9875,ORD_9876,20241,Arteo 75mg Injection,Warehouse C,10,1,2025-02-23 09:31:00,9
9876,ORD_9877,27317,"OPPO A74 5G (Fluid Black, 6GB RAM, 128GB Storage) with No Cost EMI/Additional Exchange Offers",Warehouse B,80,67,2025-02-23 19:16:00,13
9877,ORD_9878,27288,Enzytotal-D Tablet,Warehouse A,69,62,2025-02-23 18:29:00,7
9878,ORD_9879,5616,Balm - Ultra Power,Warehouse B,27,20,2025-02-23 22:55:00,7
9879,ORD_9880,34973,"COSLUXE O TWO O Velvet Liquid Blush,Face Blusher,Long-lasting Makeup Blush,15g (03-ROSE BENGAL)",Warehouse A,79,67,2025-02-23 02:18:00,12
9880,ORD_9881,12735,"DIGITEK® (DTR 260 GT) Gorilla Tripod/Mini 33 CM (13 Inch) Tripod for Mobile Phone with Phone Mount & Remote, Flexible Gori...",Warehouse B,88,78,2025-02-23 01:19:00,10
9881,ORD_9882,20330,Tracona 100 Capsule,Warehouse B,62,45,2025-02-23 04:46:00,17
9882,ORD_9883,9069,"Anchor by Panasonic 4 Socket with Single Switch (22048) (4M) 4 Socket Extension Boards  (White, 4 m)",Warehouse C,84,79,2025-02-23 11:13:00,5
9883,ORD_9884,9068,"QAKVI Facial Bowl, Bowl and brush for girls and women's, wooden brush and transparent bowl for facial (Pack of 3)",Warehouse A,53,44,2025-02-23 16:34:00,9
9884,ORD_9885,14477,Telpride 20mg Tablet,Warehouse B,103,87,2025-02-23 16:44:00,16
9885,ORD_9886,20309,Rosunext 10 Tablet,Warehouse C,85,79,2025-02-23 10:57:00,6
9886,ORD_9887,9059,Garnier Hair Color Raspberry Red (55ml + 50g) + Loreal Paris Shampoo 75ml,Warehouse C,38,28,2025-02-23 18:27:00,10
9887,ORD_9888,20304,"Vadda Bai Universal Adapter 2 Pin India to USA, Japan, Canada, Philippines & More Travel Conversion Plug (Pack of 2) White",Warehouse C,46,39,2025-02-23 07:07:00,7
9888,ORD_9889,20301,"JBL A352HI 350W 6 1/2"" Coaxial Speakers",Warehouse B,117,99,2025-02-23 02:13:00,18
9889,ORD_9890,35005,Lefday 20mg Tablet,Warehouse B,25,18,2025-02-23 18:19:00,7
9890,ORD_9891,20871,DC 4 U Exclusive For Men,Warehouse A,76,69,2025-02-23 11:00:00,7
9891,ORD_9892,20297,Vitorine 8mg Tablet,Warehouse A,42,29,2025-02-23 11:01:00,13
9892,ORD_9893,9038,Tramafab P Capsule,Warehouse A,58,40,2025-02-23 04:25:00,18
9893,ORD_9894,14481,Ajmal Aurum Carbon Raindrops Deodorant Spray (Pack of 3) 200 ml,Warehouse A,109,99,2025-02-23 09:11:00,10
9894,ORD_9895,26979,Clofirst 150mg Tablet,Warehouse B,23,10,2025-02-23 07:50:00,13
9895,ORD_9896,9379,Epry D 150mg/100mg Capsule SR,Warehouse A,31,20,2025-02-23 03:53:00,11
9896,ORD_9897,14338,Divsez-OD 250 Tablet ER,Warehouse B,92,79,2025-02-23 23:31:00,13
9897,ORD_9898,20896,F&D E200 3W 2.0 Channel Wired Soundbar - Black,Warehouse A,21,5,2025-02-23 09:57:00,16
9898,ORD_9899,28943,Adalcef 1500mg Injection,Warehouse B,62,57,2025-02-23 08:37:00,5
9899,ORD_9900,27413,TP-Link Tapo 4MP 2K QHD (2560x1440) Outdoor CCTV Security Wi-Fi Smart Camera -Alexa Enabled -Weatherproof -Full Color Star...,Warehouse C,98,93,2025-02-23 18:00:00,5
9900,ORD_9901,26917,Sery Colorflirt Nail Paint Orange Punch 10 ml,Warehouse C,77,66,2025-02-23 13:49:00,11
9901,ORD_9902,20221,"Belkin Apple Certified Lightning to USB Charge and Sync Cable for iPhone, iPad, Air Pods, 3.3 feet (1 meters) – White",Warehouse C,85,74,2025-02-23 21:10:00,11
9902,ORD_9903,12789,Clovcef 1000mg Injection,Warehouse A,91,76,2025-02-23 05:05:00,15
9903,ORD_9904,32845,Onsitego 1 Year Extended Warranty for Small Household Appliances from Rs. 501-1000 (Email Delivery - No Physical Kit),Warehouse C,50,42,2025-02-23 23:32:00,8
9904,ORD_9905,14379,"HAKUHO Telephone Extension Cord 2 Pin, 1 Line Rj11 Male To Male Cable Line Or Landline, Phone, Modem Or Fax Machine (Blac...",Warehouse B,96,79,2025-02-23 01:42:00,17
9905,ORD_9906,27207,Bonjour Paris Photo Match Concealer Stick cum Primer - Rose Fair 3.2 gm,Warehouse B,82,71,2025-02-23 03:25:00,11
9906,ORD_9907,20702,Hepatitis B Vaccine Pediatric,Warehouse C,103,89,2025-02-23 11:01:00,14
9907,ORD_9908,20483,Cbzone 1gm Injection,Warehouse C,21,12,2025-02-23 17:30:00,9
9908,ORD_9909,32852,Acer 109 cm (43 inches) I Series 4K Ultra HD Android Smart LED TV AR43AR2851UDFL (Black),Warehouse A,84,77,2025-02-23 16:28:00,7
9909,ORD_9910,20345,"realme Buds Air 3S Bluetooth Truly Wireless in Ear Earbuds, 11mm Triple Titanium Driver, with Mic AI ENC for Calls, Dual D...",Warehouse A,37,28,2025-02-23 15:19:00,9
9910,ORD_9911,9075,Ajmal Aurum Carbon Wisal Deodorant Spray (Pack of 3) 200 ml,Warehouse A,104,92,2025-02-23 12:21:00,12
9911,ORD_9912,27009,Ajmal 4 Nightingale Deo & Ascend EDP Pack of 3 20 ml,Warehouse A,46,27,2025-02-23 03:37:00,19
9912,ORD_9913,32751,"Primitive Forests Eau De Toilette Green Perfume - Party Wear, Unisex",Warehouse C,23,5,2025-02-23 16:06:00,18
9913,ORD_9914,12056,KOSHIN Maroon Tilak Shape Size (Per Bindi Height 1.4 cm x Width 4 mm) Forehead Traditional Bindis For Girls Women Ladies -...,Warehouse B,15,4,2025-02-23 12:18:00,11
9914,ORD_9915,35011,"5V 10W USB Charging Cable for Mi Trimmer, Shavers, Body Groomers & Multi Grooming Models (Replacement for Mi Chargers) (RV...",Warehouse C,99,81,2025-02-23 18:16:00,18
9915,ORD_9916,2463,Ajmal Majmua Concentrated Perfume Oil Oriental Attar And Mukhallat AL Wafa Concentrated Perfume Oil Oriental Musky Attar 22 ml,Warehouse A,25,7,2025-02-23 13:04:00,18
9916,ORD_9917,30790,"Seagate One Touch 1TB External HDD with Password Protection – Red, for Windows and Mac, with 3 yr Data Recovery Services, ...",Warehouse B,40,27,2025-02-23 18:13:00,13
9917,ORD_9918,20218,Coldsin A Syrup,Warehouse A,58,43,2025-02-23 09:02:00,15
9918,ORD_9919,3498,Ajmal Nightingale And Magnetize For Men & Women And Shadow Him Deodorants Pack of 3 200 ml,Warehouse B,97,81,2025-02-23 06:57:00,16
9919,ORD_9920,5428,Ajmal Blu Homme & Wisal Dhahab Deo & Yearn EDP Pack of 3 20 ml,Warehouse A,24,5,2025-02-23 07:58:00,19
9920,ORD_9921,3552,"boAt Aavante Bar Orion Soundbar with 160W RMS Signature Sound, 2.1 CH, BT v5.3, Multi-Compatibility Modes, Wired Subwoofe...",Warehouse A,29,22,2025-02-23 20:11:00,7
9921,ORD_9922,27387,"Canon PIXMA E4570 All-in-One, Wireless, Mono/Colour, Print, Scan, Copy, Fax, Duplex Printing, 5.2 cm LCD",Warehouse C,92,82,2025-02-23 08:03:00,10
9922,ORD_9923,20969,Bakwel 4mg Capsule,Warehouse A,106,88,2025-02-23 11:45:00,18
9923,ORD_9924,34750,Pulse Deodorant,Warehouse A,72,64,2025-02-23 11:45:00,8
9924,ORD_9925,3554,R2 5 Tablet,Warehouse C,74,59,2025-02-23 19:35:00,15
9925,ORD_9926,2462,Rabz 20mg Tablet,Warehouse A,67,54,2025-02-23 15:49:00,13
9926,ORD_9927,2405,URBN Type-C to Type-C | 65W Super Fast Charging Adapter Cable | Unbreakable Nylon Braided Rugged Cable | Power Delivery (P...,Warehouse C,18,2,2025-02-23 14:18:00,16
9927,ORD_9928,27399,Flormar Dewy Lip Glaze 16 Cherry Blossom 4.5 ml,Warehouse B,85,68,2025-02-23 20:56:00,17
9928,ORD_9929,9447,"JUICE Matte Lipstick, 100% Veg, Heavily Pigmented, With goodness of Oryza Sativa Oil, Shea Butter, Olive Oil & Vitamin E, ...",Warehouse B,51,40,2025-02-23 06:17:00,11
9929,ORD_9930,5653,Encelin M 50/500 Tablet,Warehouse C,83,75,2025-02-23 05:49:00,8
9930,ORD_9931,14244,Allure Contour Brush (c-12 ) 1's,Warehouse C,63,47,2025-02-23 12:50:00,16
9931,ORD_9932,14424,"pTron Bassbuds Tango ENC, Dedicated Movie Mode, 40Hrs Total Playtime, Bluetooth 5.1 Truly Wireless in Ear Earbuds with Mi...",Warehouse A,82,68,2025-02-23 22:18:00,14
9932,ORD_9933,35136,Acil OD 250mg Tablet,Warehouse B,19,4,2025-02-23 15:58:00,15
9933,ORD_9934,19997,Storite High Speed HDMI Male to Female Extension Cable HDMI Extender Compatible for TV stick (HDMI Extender Cable-10cm) - ...,Warehouse C,87,74,2025-02-23 03:05:00,13
9934,ORD_9935,26270,Silk & Keratin Hair Protein Cream,Warehouse A,70,55,2025-02-23 17:31:00,15
9935,ORD_9936,28460,DavaIndia Pregabalin 150mg Tablet SR,Warehouse A,96,91,2025-02-23 17:45:00,5
9936,ORD_9937,5666,Aloe Vera Juice - 100% Ayurvedic,Warehouse A,28,21,2025-02-23 01:50:00,7
9937,ORD_9938,35093,OFIXO 100 Pieces A4 Color Paper Handmade Origami Embossed Multi Color Paper Thin Scrapbook Paper 10 Colors Sent at Random,Warehouse C,99,86,2025-02-23 07:31:00,13
9938,ORD_9939,19966,Under The Ocean Lotion,Warehouse C,113,95,2025-02-23 01:23:00,18
9939,ORD_9940,21139,URBN 10000 mAh Lithium_ion Premium Black Edition Nano Power Bank | 20W Fast Charging | Smallest Power Bank | Type C PD (In...,Warehouse A,73,61,2025-02-23 01:24:00,12
9940,ORD_9941,30755,"iQOO Z6 5G by vivo (Chromatic Blue, 4GB RAM, 128GB Storage) | Snapdragon 695-6nm Processor | 120Hz FHD+ Display | 5000mAh ...",Warehouse C,43,29,2025-02-23 14:49:00,14
9941,ORD_9942,5718,Pre Shave Foam - Classic Regular Skin,Warehouse A,105,91,2025-02-23 21:03:00,14
9942,ORD_9943,3094,"Teen.Teen BB Cream Foundation for Face Make-up Fair Cream for Complexion Enhancer, Skin Hydration (WARM BEIGE)",Warehouse B,67,60,2025-02-23 21:25:00,7
9943,ORD_9944,196,"LAPSTER 12pcs Spiral Cable Protectors for Charger, Wires, Data Charger Cable Protector for Computers, Cell Phones etc.(Grey)",Warehouse C,41,32,2025-02-23 14:20:00,9
9944,ORD_9945,8901,"HP Deskjet 2331 Colour Printer, Scanner and Copier for Home/Small Office, Compact Size, Reliable, Easy Set-Up Through HP S...",Warehouse C,94,87,2025-02-23 09:17:00,7
9945,ORD_9946,21160,"Philips BT50B Portable Wireless Bluetooth Speaker, Black",Warehouse C,79,72,2025-02-23 01:13:00,7
9946,ORD_9947,36868,Amkette iGrip Easy View One Touch Car Mount for Dashboard and Windshield | 360 Degree Rotation | Compact Design | Re-usabl...,Warehouse C,45,31,2025-02-23 19:57:00,14
9947,ORD_9948,34697,Medimade Moroccan Argan Oil Face Wash 160 ml,Warehouse B,72,60,2025-02-23 14:37:00,12
9948,ORD_9949,21167,Nutriment Aloevera Mask All Skin Type 300 gm,Warehouse A,82,77,2025-02-23 11:05:00,5
9949,ORD_9950,36871,"Teen Teen Non Transfer Water Proof Long Lasting Matte Lipstick Combo (Plumful Cheer, Rich Deep Red)",Warehouse B,45,29,2025-02-23 02:39:00,16
9950,ORD_9951,21179,Parker Vector Mettalix Fountain Pen (Blue) with Free Blue Quink Ink Bottle,Warehouse C,52,37,2025-02-23 15:11:00,15
9951,ORD_9952,30948,Parnac 100mg/500mg Tablet,Warehouse C,96,78,2025-02-23 11:54:00,18
9952,ORD_9953,34690,Rachet 2.5 mg/12.5 mg Tablet,Warehouse B,22,12,2025-02-23 16:14:00,10
9953,ORD_9954,9581,"MI Cordless Beard Trimmer 1C, with 20 length settings, 60 MInutes of usage, & USB Fast charging, black",Warehouse C,76,64,2025-02-23 02:42:00,12
9954,ORD_9955,14584,Niricef Dry Syrup,Warehouse B,104,95,2025-02-23 12:18:00,9
9955,ORD_9956,19909,Flormar Waterproof Lipliner 211 Classical Brown 1.14 gm,Warehouse C,85,72,2025-02-23 11:59:00,13
9956,ORD_9957,35111,Revcold Syrup,Warehouse B,24,5,2025-02-23 05:04:00,19
9957,ORD_9958,27541,Zacin O 200 mg/500 mg Tablet,Warehouse C,85,71,2025-02-23 22:08:00,14
9958,ORD_9959,21206,s.Oliver So Pure Man Refreshing Shower Gel & Shave Shampoo 150 ml,Warehouse A,79,61,2025-02-23 08:04:00,18
9959,ORD_9960,9598,"truke BTG Alpha True Gaming In Ear Earbuds with 40ms Low Latency Gaming Mode, 7 RGB LEDs, Instant Pairing, AAC Codec, Upto...",Warehouse A,99,88,2025-02-23 07:28:00,11
9960,ORD_9961,19879,Chyawanprash - Herbal Immunity Booster,Warehouse C,94,79,2025-02-23 17:27:00,15
9961,ORD_9962,19971,HP 678 Tri-Color Ink Cartridge,Warehouse A,89,73,2025-02-23 20:38:00,16
9962,ORD_9963,4560,Telmiget 40mg Tablet,Warehouse A,74,55,2025-02-23 10:05:00,19
9963,ORD_9964,787,E-Fresh 1% Eye Drop,Warehouse C,70,52,2025-02-23 03:06:00,18
9964,ORD_9965,17730,Tamsurid D 0.4mg/0.5mg Tablet MR,Warehouse A,51,35,2025-02-23 08:22:00,16
9965,ORD_9966,28859,Ricobix-TH Tablet,Warehouse B,55,37,2025-02-23 08:36:00,18
9966,ORD_9967,15172,"Nokia 3310 Dual SIM Feature Phone with MP3 Player, Wireless FM Radio and Rear Camera, Dark Blue",Warehouse A,80,61,2025-02-23 03:59:00,19
9967,ORD_9968,17655,Krd-LSR Capsule,Warehouse C,10,2,2025-02-23 08:10:00,8
9968,ORD_9969,13131,Gentleman Talc - For Men,Warehouse B,72,53,2025-02-23 00:29:00,19
9969,ORD_9970,37016,Spigen Ultra Hybrid Back Cover Case for iPhone Xs | iPhone X (TPU + Poly Carbonate | Matte Black),Warehouse A,58,50,2025-02-23 23:11:00,8
9970,ORD_9971,28953,Boujee Beauty Blush Brush B104 135 gm,Warehouse A,46,30,2025-02-23 02:22:00,16
9971,ORD_9972,7765,Prigabit 750mcg/75mg Capsule,Warehouse A,80,61,2025-02-23 10:14:00,19
9972,ORD_9973,28963,LORENZ Casual Grey Wallet for Men|Wallet for Boys WL-15,Warehouse B,48,41,2025-02-23 09:29:00,7
9973,ORD_9974,10885,Izra 20 Tablet,Warehouse C,15,4,2025-02-23 12:31:00,11
9974,ORD_9975,25714,Mombio 1% Cream,Warehouse C,80,63,2025-02-23 07:22:00,17
9975,ORD_9976,7805,The Face Shop Smart Peeling White Jewel Gentle Exfoliator Face Scrub with Pearl Powder extracts for Brightening| Removes T...,Warehouse A,58,39,2025-02-23 09:25:00,19
9976,ORD_9977,783,Oceglow Luminous Bright Eye Cream 15 ml,Warehouse C,45,38,2025-02-23 15:01:00,7
9977,ORD_9978,34112,Orispas-D Tablet,Warehouse B,103,90,2025-02-23 08:38:00,13
9978,ORD_9979,2184,"CHAMBOR Extreme Wear Transfer proofMatte Liquid Lipstick (Effortless Pink No.402, 6 ml)",Warehouse B,48,36,2025-02-23 15:10:00,12
9979,ORD_9980,7839,Epson 003 65ml Ink Bottle (Magenta);Compatible with :L3110 /L3101/ L3150 / L4150 / L4160 / L6160 / L6170 / L6190 Printer M...,Warehouse C,42,26,2025-02-23 14:44:00,16
9980,ORD_9981,31203,"NGEL Crack Cotton Foot Protector Moisturizing Socks with Spa Gel ,Heel Pain Relief Silicone Gel Pad Heel Protector Socks w...",Warehouse C,113,95,2025-02-23 18:17:00,18
9981,ORD_9982,22449,Gabort N 300mg/10mg Tablet,Warehouse B,90,77,2025-02-23 14:21:00,13
9982,ORD_9983,28877,Eenac P Tablet,Warehouse A,66,59,2025-02-23 16:11:00,7
9983,ORD_9984,4583,Alfuzosin Tablet,Warehouse A,75,57,2025-02-23 09:35:00,18
9984,ORD_9985,23040,Anvifix-O Dry Syrup Orange,Warehouse A,63,45,2025-02-23 13:38:00,18
9985,ORD_9986,35783,"Western Digital WD Blue SA510 SATA 250GB, Up to 550MB/s, 2.5 Inch/7 mm, 5Y Warranty, Internal Solid State Drive (SSD) (WDS...",Warehouse C,108,91,2025-02-23 04:02:00,17
9986,ORD_9987,23044,Cute Heart Shape Lip Gloss Moisturize Lip Oil Multicolour (Pack of 4),Warehouse C,72,58,2025-02-23 11:28:00,14
9987,ORD_9988,15150,BhringAmla Hair Mask With Bhringraj & Amla For Intense Hair Treatment,Warehouse A,80,63,2025-02-23 08:03:00,17
9988,ORD_9989,28893,Oxywiz 450mg Tablet,Warehouse A,8,3,2025-02-23 15:53:00,5
9989,ORD_9990,23057,"Fire-Boltt Rage Full Touch 1.28"" Display & 60 Sports Modes with IP68 Rating Smartwatch, Sp02 Tracking, Over 100 Cloud Base...",Warehouse A,42,30,2025-02-23 04:42:00,12
9990,ORD_9991,17743,Bella Voste Eyeshadow Caramel Spice 07 2.6 gm,Warehouse C,17,8,2025-02-23 08:32:00,9
9991,ORD_9992,15152,Posh HDMI to VGA Gold Plated High-Speed 1080P Active HDTV HDMI to VGA Adapter Converter Male to Female with Audio and Micr...,Warehouse A,23,12,2025-02-23 17:01:00,11
9992,ORD_9993,28908,"Casio SA-78 44 Mini Keys Mini Keyboard, Black Without Geometry Box",Warehouse C,107,89,2025-02-23 16:28:00,18
9993,ORD_9994,35084,GadgetBite Headphone Vinyl Carrying Case Earpads Storage Bag Headphone Pouch Portable Anti-Pressure Compatible for Boat 55...,Warehouse B,102,84,2025-02-23 00:39:00,18
9994,ORD_9995,32426,Anticlav 500 mg/125 mg Tablet,Warehouse C,86,77,2025-02-23 20:16:00,9
9995,ORD_9996,19608,Odom 10 mg/20 mg Capsule,Warehouse C,16,11,2025-02-23 05:49:00,5
9996,ORD_9997,19674,NISHTECH Computer Power Cable Cord for Desktops PC and Printers/Monitor SMPS Power Cable IEC Mains Power Cable (1.5M- Black),Warehouse A,102,96,2025-02-23 02:16:00,6
9997,ORD_9998,32952,Maryaj Goldie EDP Fruity Floral Perfume And Ajmal Wisal Deodorant Floral Musky Fragrance 300 ml,Warehouse C,54,39,2025-02-23 15:22:00,15
9998,ORD_9999,26716,Kridol-D3 Injection,Warehouse A,34,29,2025-02-23 19:33:00,5
9999,ORD_10000,5234,Daily Perfume Hand Cream Real Peach,Warehouse C,62,45,2025-02-23 02:32:00,17
10000,ORD_10001,8760,"Amazon Basics 256GB microSDXC Memory Card with Full Size Adapter, 100MB/s, U3",Warehouse A,90,72,2025-02-23 04:11:00,18
10001,ORD_10002,9714,Ajmal Carbon & Silvershade Deo & Ascend EDP Pack of 3 20 ml,Warehouse B,101,89,2025-02-23 21:28:00,12
10002,ORD_10003,5775,LETOV 2.5MG TABLET,Warehouse C,66,57,2025-02-23 03:26:00,9
10003,ORD_10004,21424,Drogard Plus 20mg/250mg Tablet,Warehouse C,89,84,2025-02-23 02:11:00,5
10004,ORD_10005,21350,Acefem MR 100mg/325mg/250mg Tablet,Warehouse C,26,18,2025-02-23 13:38:00,8
10005,ORD_10006,26694,Winble Back Cover for OnePlus Nord CE 2 Lite 5G Back Cover Camera Protection Soft Silicone Protective Back Cover Designed ...,Warehouse C,98,82,2025-02-23 03:48:00,16
10006,ORD_10007,30998,Starzin M 5mg/10mg Tablet,Warehouse C,78,67,2025-02-23 01:53:00,11
10007,ORD_10008,8735,Daily Life Forever52 Angled Shading Brush Nx015 1's,Warehouse C,23,5,2025-02-23 01:06:00,18
10008,ORD_10009,35204,Handwash - Tempting Whisper,Warehouse B,84,68,2025-02-23 10:02:00,16
10009,ORD_10010,34589,Gentrol 2.5 Tablet ER,Warehouse A,78,63,2025-02-23 12:05:00,15
10010,ORD_10011,21468,Ant Esports GM50 USB Optical Gaming Mouse,Warehouse A,75,62,2025-02-23 12:13:00,13
10011,ORD_10012,3607,Intensive Care Aloe Fresh Body Lotion,Warehouse B,79,67,2025-02-23 12:16:00,12
10012,ORD_10013,14653,Spantra Bhringraj Shampoo 300 ml,Warehouse A,66,52,2025-02-23 19:40:00,14
10013,ORD_10014,9740,Glimefine M 2mg/500mg Tablet,Warehouse B,87,75,2025-02-23 14:19:00,12
10014,ORD_10015,19677,Mi 2-in-1 USB Cable 100cm Black|Multipurpose Cable which Supports Both Type C & Type B/Micro USB Devices|480Mbps Speed|Com...,Warehouse A,26,17,2025-02-23 22:26:00,9
10015,ORD_10016,5764,Mistol 200mcg Tablet,Warehouse B,76,57,2025-02-23 15:52:00,19
10016,ORD_10017,19851,Acetus-S Tablet,Warehouse C,60,53,2025-02-23 05:42:00,7
10017,ORD_10018,9637,Apple Cider Vinegar Imperfection Daily Solution,Warehouse A,20,6,2025-02-23 08:00:00,14
10018,ORD_10019,1402,"OpenTech ® Tempered Glass Screen Protector Compatible for Samsung Galaxy Watch 4 Classic (46mm, Pack of 2) with Easy Insta...",Warehouse C,63,50,2025-02-23 12:18:00,13
10019,ORD_10020,8858,Alice Bronze Acoustic Guitar Strings GS-01_Phosphor Bronze_(Pack of 1),Warehouse C,102,86,2025-02-23 21:46:00,16
10020,ORD_10021,14605,Dexona Tablet,Warehouse A,103,84,2025-02-23 21:53:00,19
10021,ORD_10022,26863,Pikkme Samsung Galaxy M21 2021 / M30s / M21 Flip Case | Vintage Leather Finish | Inside TPU | Wallet Stand | Magnetic Clos...,Warehouse B,41,31,2025-02-23 07:18:00,10
10022,ORD_10023,21244,10WeRun 10 Watt Wireless Bluetooth Portable Outdoor Speaker Projection Clock (Black),Warehouse C,30,18,2025-02-23 07:29:00,12
10023,ORD_10024,2524,Ethafy 250mg Injection,Warehouse C,99,85,2025-02-23 20:09:00,14
10024,ORD_10025,19654,Metbin D 50mg/400mg Tablet,Warehouse B,54,47,2025-02-23 14:09:00,7
10025,ORD_10026,20090,Fashionury Shockproof Crystal Clear OnePlus Nord 2T 5G Back Cover Case | 360 Degree Protection | Transparent Back Cover Ca...,Warehouse B,81,74,2025-02-23 21:18:00,7
10026,ORD_10027,8942,Apcute Mehandi Design for hand Set of - 2 Piece | Mehndi Design for hands | Henna Tattoo Stencils for Women and Girls | De...,Warehouse A,91,75,2025-02-23 14:54:00,16
10027,ORD_10028,21027,"Hoss® Type c Female to Micro USB Male Adapter, Converter USB C to Micro USB, Charger Connector Works with Smartphones,Tabl...",Warehouse A,23,9,2025-02-23 22:35:00,14
10028,ORD_10029,21033,"Makeup/Cosmetic Brush Set - Blue, BB1207",Warehouse B,95,79,2025-02-23 12:41:00,16
10029,ORD_10030,27430,WOW IMAGINE Shockproof Crystal Clear Back Case Cover for Samsung Galaxy M13 5G | 360 Degree Protection | Protective Design...,Warehouse C,32,13,2025-02-23 07:15:00,19
10030,ORD_10031,36859,Lariago 64.5mg Injection,Warehouse C,98,86,2025-02-23 17:52:00,12
10031,ORD_10032,26880,Godnac TH 100mg/8mg Tablet,Warehouse C,14,3,2025-02-23 07:51:00,11
10032,ORD_10033,5677,C Bactam 1000mg/500mg Injection,Warehouse B,98,88,2025-02-23 21:03:00,10
10033,ORD_10034,27437,Marjoram Essential Oil - 100% Pure & Natural,Warehouse B,20,13,2025-02-23 15:36:00,7
10034,ORD_10035,26724,Folletro Tablet,Warehouse C,104,85,2025-02-23 08:37:00,19
10035,ORD_10036,20085,Essence Long Lasting Eye Pencil 01 0.28 gm,Warehouse A,80,69,2025-02-23 04:33:00,11
10036,ORD_10037,14564,TheGiftKart Tough Armor Bumper Back Cover Case for Mi Redmi Note 11 / Note 11s | Ring Holder & Kickstand in-Built | 360 De...,Warehouse A,48,39,2025-02-23 14:19:00,9
10037,ORD_10038,21083,"Wet n Wild Eyeshadow & Highlightling Powder Combo (Nude Awakening, Precious Petals), Multicolor, 2 Pieces Matte Finish",Warehouse B,95,90,2025-02-23 14:26:00,5
10038,ORD_10039,21093,Samyak Combo of 4 Trendy Crystal Colors Butterfly Plastic Hair Barrette Clip Large Claw Clutcher Jaw Clamp Hair Accessorie...,Warehouse B,31,22,2025-02-23 09:01:00,9
10039,ORD_10040,27480,Bonjour Paris Coat Me Pearly Shine Nail Polish - 3D Glitter Finish - Gold 9 ml,Warehouse A,28,10,2025-02-23 06:33:00,18
10040,ORD_10041,21422,Party Glow Facial Kit,Warehouse B,87,77,2025-02-23 22:50:00,10
10041,ORD_10042,26784,"Fashion Colour Kiss Lip No Transfer Lipstick, 58 Agate Red 2.6 gm",Warehouse B,92,73,2025-02-23 23:39:00,19
10042,ORD_10043,21215,"Proffisy Toner Cartridge 88A CC388A Compatible with HP Laserjet Printers P1007,P1106,P1108,P1008,M1213nf MFP,M1136 MFP,M12...",Warehouse B,56,42,2025-02-23 01:29:00,14
10043,ORD_10044,8936,Definate 60mg Injection,Warehouse C,51,41,2025-02-23 20:04:00,10
10044,ORD_10045,36863,Faber-Castell White Glue - 250ml (White),Warehouse C,38,30,2025-02-23 08:24:00,8
10045,ORD_10046,21104,Pikkme Mi Redmi 10A / Redmi 9 / Redmi 9 Activ / 9C / Poco C31 Flip Case Leather Finish | Inside TPU with Card Pockets | Wa...,Warehouse B,93,79,2025-02-23 11:09:00,14
10046,ORD_10047,20017,Metallic Temporary Tattoos Golden Silver Color Ancient For Women Girls Size-19x15cm- 1PC.,Warehouse C,104,91,2025-02-23 00:57:00,13
10047,ORD_10048,35340,Soulflower Herbal Vitamin C Micro Polish Face Wash 120 ml,Warehouse C,56,37,2025-02-22 00:42:00,19
10048,ORD_10049,11351,"Fashion Colour Kiss Lip No Transfer Lipstick, 11 Rose Blush 2.6 gm",Warehouse B,94,78,2025-02-22 20:25:00,16
10049,ORD_10050,10943,Mevit 1000mg Injection,Warehouse C,80,62,2025-02-22 04:35:00,18
10050,ORD_10051,33209,TANTRA Twist Universal Car Mobile Holder for Dashboard 360 with One Touch Technology - Expandable & Rotatable & Double Shi...,Warehouse B,16,8,2025-02-22 14:10:00,8
10051,ORD_10052,25918,Ahuja Head band Microphone can be connected to the amplifier directly,Warehouse B,109,99,2025-02-22 21:53:00,10
10052,ORD_10053,28917,Maryaj Grey Stone EDP Aromatic Woody Perfume For Me And Ajmal Avid Homme Deodorant Aquatic Woody Fragrance 300 ml,Warehouse A,29,16,2025-02-22 13:28:00,13
10053,ORD_10054,510,Hand Sanitiz+,Warehouse A,20,5,2025-02-22 15:49:00,15
10054,ORD_10055,24977,Pikkme Vivo Y12 / Y15 / Y17 / U10 Cover Protective Shockproof Matte Hard Back Case Cover for Vivo Y12 / Y15 / Y17 / U10 (B...,Warehouse A,42,34,2025-02-22 15:51:00,8
10055,ORD_10056,9845,Spigen Optik Tempered Glass Camera Lens Protector Guard for iPhone 13 Pro and iPhone 13 Pro Max (Clear) - 2 Pack,Warehouse C,106,87,2025-02-22 20:41:00,19
10056,ORD_10057,24979,Charmacy Milano Insane Shifters Eyeshadow 504 1.8 gm,Warehouse B,6,1,2025-02-22 22:02:00,5
10057,ORD_10058,19405,"Hair Bun Clutcher (Black, Pack of 1) For Women and Girls || Artificial Bun Juda with Clutcher || Hairstyling Tool and Acce...",Warehouse A,13,7,2025-02-22 06:20:00,6
10058,ORD_10059,5852,L’Oréal Professionnel Scalp Advanced Anti-Dandruff Dermo-Clarifier Shampoo 300 Ml & L'Oreal Professionnel Metal Dx Anti-De...,Warehouse C,10,1,2025-02-22 14:47:00,9
10059,ORD_10060,6742,Belora Paris World Matte Vit C Popsicles - 023 Persian Red 4.2 gm,Warehouse A,93,74,2025-02-22 01:02:00,19
10060,ORD_10061,28849,"Rapidotzz Mi Band Straps - 2 Pcs ( Camouflage Grey and Blue, Unisex) | Removable Straps ONLY for MI Band 3 and 4 | MultiCo...",Warehouse B,20,13,2025-02-22 01:13:00,7
10061,ORD_10062,4668,Archies Parfum DREAM BOYZ PARFUM ORIGINAL 50 ml,Warehouse A,69,56,2025-02-22 15:19:00,13
10062,ORD_10063,6738,DeBelle Gel Nail Lacquer Toffee Rose Choco Brown Nail Polish 8 ml,Warehouse A,34,18,2025-02-22 22:30:00,16
10063,ORD_10064,17411,Androsure 40mg Capsule,Warehouse A,25,16,2025-02-22 01:40:00,9
10064,ORD_10065,7886,Nutriment Apple cider CreamAll Skin Type 250 gm,Warehouse A,34,16,2025-02-22 18:48:00,18
10065,ORD_10066,13133,Endcef Dry Syrup,Warehouse B,79,69,2025-02-22 23:55:00,10
10066,ORD_10067,25811,Apple iPhone 14 Pro Max (256 GB) - Deep Purple,Warehouse B,42,34,2025-02-22 16:59:00,8
10067,ORD_10068,33873,Stevo 250mg Tablet,Warehouse B,30,24,2025-02-22 02:05:00,6
10068,ORD_10069,22740,Daily Life Forever52 Blending Brush Nx020 1's,Warehouse C,77,58,2025-02-22 05:43:00,19
10069,ORD_10070,35892,"Soap - Glycerine, Pureglo",Warehouse C,48,42,2025-02-22 11:53:00,6
10070,ORD_10071,34065,Glimee M 1mg/500mg Tablet PR,Warehouse A,15,4,2025-02-22 05:57:00,11
10071,ORD_10072,25265,Zox APT Tablet,Warehouse A,74,55,2025-02-22 23:36:00,19
10072,ORD_10073,32146,SUGAR Cosmetics Goddess Of Flawless SPF30+ BB Cream - 07 Vanilla Latte (Fair) 25 ml,Warehouse B,22,5,2025-02-22 16:01:00,17
10073,ORD_10074,5840,Lip Butter - Strawberry,Warehouse C,111,99,2025-02-22 10:02:00,12
10074,ORD_10075,33830,Onoff Injection,Warehouse C,69,63,2025-02-22 03:52:00,6
10075,ORD_10076,19418,Ctgone Syrup,Warehouse A,71,60,2025-02-22 09:52:00,11
10076,ORD_10077,12084,"Western Digital WD 4TB My Passport Portable Hard Disk Drive,Compatible with Windows and Mac, External HDD-Black",Warehouse A,20,12,2025-02-22 12:09:00,8
10077,ORD_10078,3616,Etoward-T 60mg/4mg Tablet,Warehouse B,103,94,2025-02-22 14:15:00,9
10078,ORD_10079,13161,Fixcott 200mg Tablet,Warehouse C,37,29,2025-02-22 21:54:00,8
10079,ORD_10080,9019,Amozo Designed for iPhone 14 Pro Case | Ultra Hybrid Drop and Camera Protection Back Cover Case for iPhone 14 PRO (TPU + P...,Warehouse B,82,77,2025-02-22 10:04:00,5
10080,ORD_10081,19379,"EVM 2.5"" 256GB SATA SSD Next-gen 3D TLC NAND Internal SSD, Flash Fast Performance Ultra Low Power Consumption (EVM25, Black)",Warehouse A,41,29,2025-02-22 12:42:00,12
10081,ORD_10082,27351,Tommy Hilfiger Orlean Plus Unisex Polyester Overnighter with 15 Inch Laptop Pocket Dark Black,Warehouse B,92,75,2025-02-22 06:31:00,17
10082,ORD_10083,8624,Cidexin 250mg Tablet DT,Warehouse A,93,82,2025-02-22 01:36:00,11
10083,ORD_10084,20923,"Hilary Rhoda Bold Non Transfer Matt Lipstick foe Women, Long lasting Smudge Proof Lip Crayon Lipstick Waterproof (Nude Mouve)",Warehouse A,44,27,2025-02-22 23:21:00,17
10084,ORD_10085,14710,"Logitech MX Master 3S - Wireless Performance Mouse with Ultra-Fast Scrolling, Ergo, 8K DPI, Track on Glass, Quiet Clicks, ...",Warehouse A,64,59,2025-02-22 15:11:00,5
10085,ORD_10086,36730,Azeemust 500mg Tablet,Warehouse B,113,98,2025-02-22 17:47:00,15
10086,ORD_10087,7067,VLCC Orange Oil Pore Cleansing Face Wash Trio Pack (150g*3) (Pack of 3),Warehouse B,59,54,2025-02-22 20:15:00,5
10087,ORD_10088,21664,"GEAR GUARD - GIVE LIFE TO YOUR DEVICE Hyundai New Creta 2020, SX SX O Auto, Accessories Infotainment System Unbreakable Sc...",Warehouse A,86,79,2025-02-22 13:32:00,7
10088,ORD_10089,21666,Dr. Jain's Aloe Vera Gel Hair & Skin Care Gel 100,Warehouse B,43,38,2025-02-22 19:51:00,5
10089,ORD_10090,2563,Soulflower Coldpressed Castor Oil For Hair & Skin 225 ml,Warehouse B,17,5,2025-02-22 14:36:00,12
10090,ORD_10091,9878,Protecting Gel Face Wash,Warehouse C,42,29,2025-02-22 13:09:00,13
10091,ORD_10092,21671,Lulijet 1% Cream,Warehouse A,97,79,2025-02-22 17:40:00,18
10092,ORD_10093,27931,Quinoten 50mg Tablet,Warehouse B,60,44,2025-02-22 08:33:00,16
10093,ORD_10094,32995,Azulix 3 MF Forte Tablet PR,Warehouse B,79,68,2025-02-22 23:10:00,11
10094,ORD_10095,9860,Rosuboon 20 Tablet,Warehouse C,105,88,2025-02-22 14:47:00,17
10095,ORD_10096,4730,"Coal Clean Beauty , Vitamin C & Orange Soap 100 ml",Warehouse A,95,87,2025-02-22 04:40:00,8
10096,ORD_10097,29785,"Menstrual Cup - Wings, Fuschia",Warehouse A,110,91,2025-02-22 13:41:00,19
10097,ORD_10098,14702,HB PLUS Heavy Quality Foldable Aluminium Laptop Stand | Foldable Metal Laptop Stand | Dynamic Folding Metal Laptop Stand |...,Warehouse C,23,9,2025-02-22 20:06:00,14
10098,ORD_10099,34548,Diurator 20mg Tablet,Warehouse C,72,53,2025-02-22 16:01:00,19
10099,ORD_10100,9822,SanDisk Extreme SD UHS I 64GB Card for 4K Video for DSLR and Mirrorless Cameras 170MB/s Read & 80MB/s Write,Warehouse C,116,97,2025-02-22 13:14:00,19
10100,ORD_10101,27874,Vovegel Gel,Warehouse B,106,95,2025-02-22 06:01:00,11
10101,ORD_10102,27879,TheGiftKart Best Camera Protection Back Cover Case for OnePlus 11R 5G | Ultra Clear Soft Case | Inbuilt Dust Plugs & Anti-...,Warehouse C,105,96,2025-02-22 19:48:00,9
10102,ORD_10103,15877,Amazon Basics Laptop Cooling Pad with 7-Cool RGB LED Lighting Effects | USB Powered Gaming Laptop Cooler Stand | Quiet 6 F...,Warehouse A,74,65,2025-02-22 23:04:00,9
10103,ORD_10104,26597,Ferheam Injection,Warehouse A,84,78,2025-02-22 02:36:00,6
10104,ORD_10105,16188,Perfume Spray - Trance,Warehouse C,100,90,2025-02-22 20:32:00,10
10105,ORD_10106,10928,Nodon H Tablet,Warehouse A,90,81,2025-02-22 17:41:00,9
10106,ORD_10107,1700,"boAt WCDV 20W Wall Charger with Fast Charging for PD Devices, Smart IC Protection, Auto Detection and Corrosion Resistant ...",Warehouse A,89,83,2025-02-22 05:01:00,6
10107,ORD_10108,17202,Godrej Protekt Germ Fighter Handwash Refill Pack | Lime & Eucalyptus | Germ Protection & Soft on Hands - 1500 ml,Warehouse C,66,56,2025-02-22 00:49:00,10
10108,ORD_10109,16649,Starvis Pearl Hair Accessories 3 Pc Hair Clips For Women Stone For Girls Women Wedding Mini Ponytail Claw Butterfly Hair M...,Warehouse C,89,72,2025-02-22 02:46:00,17
10109,ORD_10110,35663,"Amazon Basics 18W Dual Port USB Type C and USB Type A Fast Charging Wall Charger for Cellular Phones, Game Consoles, Headp...",Warehouse A,74,62,2025-02-22 17:17:00,12
10110,ORD_10111,17182,Aequimox 500mg Capsule,Warehouse C,62,53,2025-02-22 03:25:00,9
10111,ORD_10112,2228,Face & Body Mist - Jasmine Rose,Warehouse C,33,19,2025-02-22 15:32:00,14
10112,ORD_10113,22713,Anthems Study Table/Bed Table/Foldable and Portable Wooden/Writing Desk for Office/Home/School (Black),Warehouse B,21,8,2025-02-22 15:19:00,13
10113,ORD_10114,776,"The Derma Co 2% Vitamin E Daily Hydrating Body Serum-Lotion with Vitamin E, Lactic Acid & Oat Extract - 250 ml",Warehouse A,54,39,2025-02-22 00:06:00,15
10114,ORD_10115,13255,Gedopan I/V Injection,Warehouse A,71,54,2025-02-22 15:14:00,17
10115,ORD_10116,36095,Dyazo 6 Angles Adjustable Aluminum Ergonomic Foldable Portable Tabletop Laptop/Desktop Riser Stand Holder Compatible for M...,Warehouse A,105,92,2025-02-22 21:16:00,13
10116,ORD_10117,25762,Rinomik 500mg Injection,Warehouse C,23,5,2025-02-22 04:16:00,18
10117,ORD_10118,33396,Vaadi Herbals 100% Pure Essential Oil - Natural Radiance Night Serum with Aloe Vera 10 ml,Warehouse B,97,84,2025-02-22 12:08:00,13
10118,ORD_10119,28868,Zodox 10mg Injection,Warehouse B,50,41,2025-02-22 13:59:00,9
10119,ORD_10120,28962,Tocid 25mg Injection,Warehouse A,65,49,2025-02-22 23:22:00,16
10120,ORD_10121,3868,"Yearwin 15 Months Warranty 200W Car Power Inverter with 220V Output AC Stocket, 27W PD & 3 USB Charging Port, Extra Cigare...",Warehouse B,20,6,2025-02-22 05:17:00,14
10121,ORD_10122,30214,"uhuru Computer Speaker, UGS-02 Gaming Speaker for PC, TV, Desktop and Laptop, USB Mini Soundbar with RGB Light, Volume Con...",Warehouse B,78,63,2025-02-22 09:31:00,15
10122,ORD_10123,32228,Ylang Ylang Flavoured & Scented Lubes,Warehouse A,41,24,2025-02-22 03:45:00,17
10123,ORD_10124,35956,"Camel Camlin Kokuyo Student Water Color Tube - 5ml Each, 12 Shades",Warehouse B,44,31,2025-02-22 12:16:00,13
10124,ORD_10125,822,Afdiloc 300mg Tablet,Warehouse A,34,22,2025-02-22 17:09:00,12
10125,ORD_10126,17508,"Wecool Nylon Braided Multifunction Fast Charging Cable For Android Smartphone, Ios And Type C Usb Devices, 3 In 1 Charging...",Warehouse C,54,35,2025-02-22 23:03:00,19
10126,ORD_10127,33369,9 to 5 Complexion Care Cream - Beige,Warehouse A,43,32,2025-02-22 16:58:00,11
10127,ORD_10128,35670,Vogliwok 0.2mg Tablet,Warehouse A,14,4,2025-02-22 18:47:00,10
10128,ORD_10129,16969,Oilcure Castor Oil Cold Pressed Edible 100 ml - Pack of 3 (300 ml),Warehouse B,52,35,2025-02-22 15:10:00,17
10129,ORD_10130,10717,Cefo Plus 100 mg/100 mg Tablet,Warehouse B,112,95,2025-02-22 12:18:00,17
10130,ORD_10131,37046,Seapan D 10mg/40mg Tablet,Warehouse B,19,3,2025-02-22 08:05:00,16
10131,ORD_10132,29032,Roptin 20mg Tablet,Warehouse B,106,87,2025-02-22 16:47:00,19
10132,ORD_10133,2196,"Swiss Beauty Cover Studio Ultra Base Cream Concealer Palette, 16g Matte Finish",Warehouse A,72,54,2025-02-22 13:30:00,18
10133,ORD_10134,17795,Maxoril AM Plus Oral Suspension,Warehouse B,77,66,2025-02-22 23:59:00,11
10134,ORD_10135,607,Anti Wrinkle Mask,Warehouse B,83,73,2025-02-22 14:05:00,10
10135,ORD_10136,5640,Trixytin 5mg Tablet,Warehouse A,54,36,2025-02-22 06:08:00,18
10136,ORD_10137,17378,Acceclomax-MR Tablet,Warehouse A,111,99,2025-02-22 19:34:00,12
10137,ORD_10138,23958,OpenTech® Tempered Glass Screen Protector Compatible for Samsung Galaxy S20 FE 5G (Matte) Full Screen Coverage (Except Edg...,Warehouse B,12,5,2025-02-22 09:20:00,7
10138,ORD_10139,36592,Pimol 500mg Tablet,Warehouse B,114,98,2025-02-22 21:17:00,16
10139,ORD_10140,33957,"Tygot 10 Inches Big LED Ring Light for Camera, Phone tiktok YouTube Video Shooting and Makeup, 10"" inch Ring Light with 7 ...",Warehouse B,79,72,2025-02-22 01:31:00,7
10140,ORD_10141,17596,Bella Voste Sand Holo Nail Paints Aquamarine - 405 10 ml,Warehouse B,41,31,2025-02-22 20:30:00,10
10141,ORD_10142,32144,Snoforcold Plus Syrup,Warehouse A,62,53,2025-02-22 03:06:00,9
10142,ORD_10143,11164,Body Wash Luminous Oils Invigorating Shower Gel With 100% Natural Macadamia Oil & Peony Extracts,Warehouse B,38,31,2025-02-22 18:14:00,7
10143,ORD_10144,30401,Depel 15mg Tablet,Warehouse C,100,88,2025-02-22 14:48:00,12
10144,ORD_10145,15398,Neev Kesar Gulab Soap For a Radiant and Smooth Skin (100 gms),Warehouse B,102,91,2025-02-22 14:53:00,11
10145,ORD_10146,34118,TheGiftKart Ultra-Hybrid Back Case Cover for Samsung Galaxy S21 FE 5G | Crystal Clear Hard Back | Shockproof Design | Came...,Warehouse B,51,38,2025-02-22 10:13:00,13
10146,ORD_10147,11465,RO ON 20mg Tablet,Warehouse B,61,50,2025-02-22 02:05:00,11
10147,ORD_10148,7995,Miss Claire Pearl Eyeliner For Eye Makeup Shade 12 (Silver) Satin Finish,Warehouse B,41,22,2025-02-22 20:45:00,19
10148,ORD_10149,23454,"Keya Seth Aromatherapy, Neem Wooden Comb Wide Tooth for Hair Growth for Men & Women All Purpose Small Size.",Warehouse A,90,79,2025-02-22 15:25:00,11
10149,ORD_10150,16661,Sirona Feminine Pain Relief Patches 5's,Warehouse C,59,49,2025-02-22 06:40:00,10
10150,ORD_10151,4249,Viscosin Syrup,Warehouse A,80,75,2025-02-22 10:50:00,5
10151,ORD_10152,28846,REALCASE Vivo V25 Pro 5G Back Cover Case | Stylish Frameless Matte Hard Skin | Soft TPU Shock Proof Bumper Back Cover Case...,Warehouse C,60,47,2025-02-22 09:51:00,13
10152,ORD_10153,1803,"Plant Based Kadha Ayurvedic Goodness - Remedy For Cold & Cough, Immunity Booster",Warehouse B,47,34,2025-02-22 12:15:00,13
10153,ORD_10154,23736,SUGAR Cosmetics Goddess Of Flawless SPF30+ BB Cream - 32 Cortado (Medium) 25 ml,Warehouse A,87,75,2025-02-22 10:54:00,12
10154,ORD_10155,859,Casio MJ-120GST GST Calculator (Black),Warehouse C,25,17,2025-02-22 16:53:00,8
10155,ORD_10156,32226,Rabosec DSR Capsule,Warehouse C,100,95,2025-02-22 21:59:00,5
10156,ORD_10157,32261,Oil - The Classic Beard & Hair Fragrance,Warehouse B,57,40,2025-02-22 14:10:00,17
10157,ORD_10158,37022,Azipen 100mg Readymix,Warehouse C,32,16,2025-02-22 22:50:00,16
10158,ORD_10159,22753,"HEMBERSTAR Laptop Bed Tray Table, Laptop Desk for Bed,Foldable Lap Desk Stand Notebook Desk Adjustable Laptop Table for Be...",Warehouse A,18,11,2025-02-22 09:25:00,7
10159,ORD_10160,17811,Citimed CD Tablet,Warehouse B,30,19,2025-02-22 05:28:00,11
10160,ORD_10161,23004,Zeltum 500mg Tablet,Warehouse A,21,15,2025-02-22 06:46:00,6
10161,ORD_10162,29427,"Boult Audio Maverick Truly Wireless in Ear Earbuds with 35H Playtime, Quad Mic ENC, 45ms Xtreme Low Latency, Gaming LEDs, ...",Warehouse B,90,79,2025-02-22 16:42:00,11
10162,ORD_10163,35734,Nature's Essence Protecting Gel Face Wash - Neem & Aloe 100 ml,Warehouse B,93,74,2025-02-22 23:12:00,19
10163,ORD_10164,11388,Insight Cosmetics Non Transfer Matte Lipstick - Dirsty Money 4.2 gm,Warehouse C,88,77,2025-02-22 13:20:00,11
10164,ORD_10165,1744,Cefpra S 1000 mg/500 mg Injection,Warehouse C,46,36,2025-02-22 16:27:00,10
10165,ORD_10166,30212,Cefwell 1000mg/500mg Injection,Warehouse A,38,23,2025-02-22 17:08:00,15
10166,ORD_10167,33381,Alergard 120mg Tablet,Warehouse B,87,75,2025-02-22 01:55:00,12
10167,ORD_10168,23327,Matra Aloe Vera Glow Gel - Green Tea and Peppermint Extracts 100 gm,Warehouse B,29,11,2025-02-22 10:55:00,18
10168,ORD_10169,1506,Rosimox CV Dry Syrup,Warehouse C,98,83,2025-02-22 19:27:00,15
10169,ORD_10170,14142,"BlueRigger High Speed HDMI Cable with Ethernet - Supports 3D, 4K 60Hz, Audio Return - Latest Version (6.6 Feet / 2 Meters)",Warehouse C,41,25,2025-02-22 07:44:00,16
10170,ORD_10171,13392,Zgpod 200mg Tablet,Warehouse C,107,94,2025-02-22 05:27:00,13
10171,ORD_10172,19302,Faber-Castell 48 Triangular Colour Pencils,Warehouse B,75,70,2025-02-22 03:45:00,5
10172,ORD_10173,30677,Realone S 1000mg/500mg Injection,Warehouse B,24,13,2025-02-22 02:05:00,11
10173,ORD_10174,20891,"Fashion Colour Terra Cotta Blusher, Shade 10 16 gm",Warehouse A,51,43,2025-02-22 04:55:00,8
10174,ORD_10175,32773,UT Bluetooth FM USB AUX Card MP3 Stereo Audio Player Decoder Module Kit with Remote for Audio Amplifier DIY Free IC LM7805,Warehouse A,111,92,2025-02-22 00:36:00,19
10175,ORD_10176,31656,Shower Gel - Green Tea,Warehouse C,63,55,2025-02-22 20:02:00,8
10176,ORD_10177,10003,Deodorant Body Spary - Bronze,Warehouse A,56,40,2025-02-22 12:08:00,16
10177,ORD_10178,12157,"Gizga Essentials Laptop Bag Sleeve Case Cover Pouch with Handle for 13.3 Inch Laptop for Men & Women, Padded Laptop Compar...",Warehouse B,32,26,2025-02-22 01:43:00,6
10178,ORD_10179,28044,BSPS Ac Remote Compatible with Lloyd/Blue Star/Voltas/Godrej Ac Remote Control - (Any Query Pls Whatsapp @ Nine Eight 7363...,Warehouse C,68,61,2025-02-22 17:49:00,7
10179,ORD_10180,25015,HP Wings Backpack for 15.6'' Inch (39.6 cm) Laptop/Chromebook/Mac (Black) 1D0M4PA,Warehouse C,96,78,2025-02-22 18:06:00,18
10180,ORD_10181,5030,"boAt Rockerz 450 Superman Edition Bluetooth On Ear Headphones with Mic, Upto 15 Hours Playback, 40MM Drivers, Padded Ear C...",Warehouse C,87,74,2025-02-22 17:37:00,13
10181,ORD_10182,406,MAPPERZ Mascara Eyelash Wands Brush for Eyelash Extension Eyebrow and Makeup Color/ Makeup Brush Eyebrow Eyelash Comb Wand...,Warehouse B,89,76,2025-02-22 06:22:00,13
10182,ORD_10183,20079,"Passion, Vanilla Shower Gel With Skin Conditioners",Warehouse C,79,64,2025-02-22 02:44:00,15
10183,ORD_10184,12581,Fashion Colour Sun Block Cream Spf 40 60 gm,Warehouse A,20,14,2025-02-22 12:15:00,6
10184,ORD_10185,19137,Telflag H 40mg/12.5mg Tablet,Warehouse B,18,4,2025-02-22 11:43:00,14
10185,ORD_10186,3500,Phy Vitamin C Face Wash | Foaming face wash that brightens skin & reduces dark spots | Adds a natural glow | SLS & Paraben...,Warehouse C,84,75,2025-02-22 02:55:00,9
10186,ORD_10187,25021,Idapride PM 2mg/500mg/15mg Tablet,Warehouse A,94,79,2025-02-22 01:58:00,15
10187,ORD_10188,24279,Ultralights Highlighting Kit - Soft Red,Warehouse C,50,40,2025-02-22 19:06:00,10
10188,ORD_10189,28064,"Shower To Shower Prickly Heat Powder, Mint,Pack of 150g",Warehouse B,72,58,2025-02-22 23:08:00,14
10189,ORD_10190,12579,Calicef 1000mg Injection,Warehouse C,65,57,2025-02-22 23:58:00,8
10190,ORD_10191,16290,SanDisk Ultra Dual SDDD3-128G-I35 USB 3.0 128GB Flash Drive (Dual Micro-USB and USB 3.0 connectors),Warehouse B,94,80,2025-02-22 19:59:00,14
10191,ORD_10192,19120,Voglilarm G 2mg/500mg/0.2mg Tablet,Warehouse C,61,50,2025-02-22 07:36:00,11
10192,ORD_10193,8506,Sarbet N Cream,Warehouse A,71,65,2025-02-22 20:51:00,6
10193,ORD_10194,37129,"Lotus Organics+ Precious Brightening Cream | For Dark Spots, Blemishes & Pigmentation | SPF 20 Moisturiser | 30g",Warehouse C,30,19,2025-02-22 15:58:00,11
10194,ORD_10195,20298,AND Mystique Elegance Eau De Parfum 50ML & Dainty Glam Body Mist 200ML Pack of 2 for Women Crafted by Ajmal,Warehouse A,29,14,2025-02-22 05:50:00,15
10195,ORD_10196,35327,Soulflower Deodorizing Charcoal Soap 150 gm,Warehouse C,56,39,2025-02-22 16:10:00,17
10196,ORD_10197,19240,"Havells USB Star- Braided Type A to Type C Data Cable 65W, 6A (AHNREHB000)",Warehouse B,109,94,2025-02-22 08:14:00,15
10197,ORD_10198,19181,MAYCREATE® 1 Pair Reusable 3D False Eyelashes Natural Look Self-Adhesive Eyelashes Waterproof For Women,Warehouse C,41,28,2025-02-22 10:52:00,13
10198,ORD_10199,106,"Oppo F21s Pro 5G (Starlight Black, 8GB RAM, 128 Storage) with No Cost EMI/Additional Exchange Offers",Warehouse C,25,6,2025-02-22 19:34:00,19
10199,ORD_10200,19304,GLUN HOT MELT Transparent Glue Sticks for Glue Gun (11MM - 25 Sticks),Warehouse B,48,38,2025-02-22 16:00:00,10
10200,ORD_10201,1070,"Redmi Note 11 Pro (Phantom White, 8GB RAM, 128GB Storage)| 67W Turbo Charge | 120Hz Super AMOLED Display | Charger Include...",Warehouse C,88,83,2025-02-22 12:04:00,5
10201,ORD_10202,14728,Mamaearth Vitamin C Face Mask with Vitamin C and Kaolin Clay for Skin Illumination and Reduces Dark Spots (100 g),Warehouse B,35,22,2025-02-22 00:08:00,13
10202,ORD_10203,36274,Tempest Concentrated Floral Perfume Free From Alcohol For Unisex,Warehouse A,40,22,2025-02-22 19:32:00,18
10203,ORD_10204,23010,"Fashion Colour Pro Matte Liquid Foundation, Buff 30 ml",Warehouse B,52,44,2025-02-22 19:30:00,8
10204,ORD_10205,27338,Genoflam SP 100mg/325mg/15mg Tablet,Warehouse B,11,4,2025-02-22 12:27:00,7
10205,ORD_10206,8579,Bath & Body Oil - Jasmine & Mogra,Warehouse A,65,58,2025-02-22 23:49:00,7
10206,ORD_10207,20897,Yves Rocher Sensual Body Lotion Bourbon Vanilla 200 ml,Warehouse A,104,89,2025-02-22 05:29:00,15
10207,ORD_10208,4114,"PTron Bassbuds Plus in Ear True Wireless Stereo Earbuds with Mic, Deep Bass, Voice Assistance, IPX4 Sweat & Water Resistan...",Warehouse C,65,46,2025-02-22 16:24:00,19
10208,ORD_10209,14743,Felix 200mg Tablet,Warehouse A,107,93,2025-02-22 00:38:00,14
10209,ORD_10210,21764,Flormar Kiss Me More Lip Tattoo 15 Violetta 3.8 gm,Warehouse A,55,36,2025-02-22 07:12:00,19
10210,ORD_10211,26971,Spigen PC2000 CarCharger Arc.SA Black,Warehouse C,71,59,2025-02-22 19:53:00,12
10211,ORD_10212,5900,"Artis AR-45W-MG2 45 Watts MG2 Laptop Adapter/Charger Compatible with MB Air 13” & MB Air 11” (14.5 V, 3.1 A) Connector: MG...",Warehouse C,50,39,2025-02-22 02:41:00,11
10212,ORD_10213,5069,Ofloris NZ Oral Suspension,Warehouse A,56,42,2025-02-22 20:47:00,14
10213,ORD_10214,5068,Ketromox Eye/Ear Drops,Warehouse A,103,85,2025-02-22 01:00:00,18
10214,ORD_10215,31701,Beardhood Fermented Rice Water Shampoo 200 ml,Warehouse C,112,93,2025-02-22 06:56:00,19
10215,ORD_10216,9925,Mangowhite Cleansing Foam,Warehouse B,75,66,2025-02-22 04:23:00,9
10216,ORD_10217,26514,Zebronics Zeb-Alex Wired USB Optical Mouse with 3 Buttons,Warehouse A,105,88,2025-02-22 08:36:00,17
10217,ORD_10218,27978,"pTron Bassbuds Rush Bluetooth True Wireless In Ear Earbuds with Mic, Gaming 40ms Low Latency, 35Hrs Playtime, Deep Bass, E...",Warehouse A,91,83,2025-02-22 18:13:00,8
10218,ORD_10219,11981,"King Shine (USB Data Sync & Charger Cable for Apple iPhone 4/4s, 3G iPhone, iPod Nano USB Cable Set of 1)",Warehouse C,67,62,2025-02-22 16:08:00,5
10219,ORD_10220,5106,"Parker Classic Matte Black CT Ball Pen, 1 Count (Pack of 1) (9000013840)",Warehouse C,86,73,2025-02-22 14:28:00,13
10220,ORD_10221,5102,VISHWATEJ ENTERPRISES Loose Powder Puff Pad Washable Velour Smooth Bath Body Powder Puff With Ribbon Band Handle for Women...,Warehouse A,17,8,2025-02-22 22:14:00,9
10221,ORD_10222,35274,Green Apple Lip Balm,Warehouse C,34,15,2025-02-22 00:48:00,19
10222,ORD_10223,24986,"Sery Colorflirt Nail Paint Olive Thrill, Green 10 ml",Warehouse B,82,76,2025-02-22 08:34:00,6
10223,ORD_10224,27342,Restpride 200 Tablet,Warehouse C,56,38,2025-02-22 16:05:00,18
10224,ORD_10225,8610,"2 Pack Face Scrubber,JEXCULL Soft Silicone Facial Cleansing Brush Face Exfoliator Blackhead Acne Pore Pad Cradle Cap Face ...",Warehouse C,101,89,2025-02-22 09:42:00,12
10225,ORD_10226,3434,Granspas Oral Suspension,Warehouse C,23,13,2025-02-22 19:48:00,10
10226,ORD_10227,36275,"Tygot Adjustable Aluminium Alloy Tripod Stand Holder for Mobile Phones & Camera, 360 mm -1060 mm (42 Inch), 1/4 inch Screw...",Warehouse C,68,50,2025-02-22 05:30:00,18
10227,ORD_10228,1216,Streetwear Nail Enamel (Pretty Girl Collection) - I Boss 8 Ml,Warehouse B,86,75,2025-02-22 14:45:00,11
10228,ORD_10229,3201,Ajmal Impress Concentrated Perfume Oil Citrus And Carbon Homme Deodorant Citrus Spicy Fragrance 210 ml,Warehouse A,64,53,2025-02-22 12:09:00,11
10229,ORD_10230,2568,Fenpan-D Capsule SR,Warehouse C,87,76,2025-02-22 15:54:00,11
10230,ORD_10231,112,Play Lube- Massage 2 In 1 Stimulating,Warehouse C,109,92,2025-02-22 01:36:00,17
10231,ORD_10232,3632,Tricowor Oral Solution,Warehouse A,72,60,2025-02-22 04:46:00,12
10232,ORD_10233,26616,Diplostate 10mg Tablet,Warehouse B,22,4,2025-02-22 14:42:00,18
10233,ORD_10234,2544,Lemon & Pine Foaming Body Wash,Warehouse C,30,13,2025-02-22 18:20:00,17
10234,ORD_10235,27859,"Fashion Colour Vivid Matte Lipstick, 12 Modena 3.8 gm",Warehouse B,84,77,2025-02-22 03:23:00,7
10235,ORD_10236,24966,HUDA BB HD Waterproof Bridal Makeup Combo Kits For Girls & Women All Beauty Products In 1 Kit Set Of -19,Warehouse C,30,21,2025-02-22 09:36:00,9
10236,ORD_10237,19465,Dolosen 500mg Tablet,Warehouse A,61,50,2025-02-22 16:19:00,11
10237,ORD_10238,36295,Daily Life Forever52 Two Way Cake Compact Powder A010 12 Gm,Warehouse C,59,53,2025-02-22 10:47:00,6
10238,ORD_10239,1957,"Midas Glitter Neon Colour Glitter for Face, Body Art-€“ Pack of 6",Warehouse A,87,76,2025-02-22 15:25:00,11
10239,ORD_10240,3442,Pure Coconut Oil,Warehouse B,72,56,2025-02-22 10:11:00,16
10240,ORD_10241,9004,"Portronics Konnect Dash 2 Type C Cable with 65W Super VOOC Flash Charge, 6.5A Output, Nylon Braided, Fast Data Sync, 1M Le...",Warehouse A,23,8,2025-02-22 05:32:00,15
10241,ORD_10242,29962,Tmt 20mg Tablet,Warehouse A,58,44,2025-02-22 13:49:00,14
10242,ORD_10243,27392,Coffact-D Syrup,Warehouse A,28,21,2025-02-22 07:41:00,7
10243,ORD_10244,21497,Mothercare Quick Absorb Diaper Pants (L) 58's,Warehouse C,108,97,2025-02-22 17:53:00,11
10244,ORD_10245,19559,"Ceptics UK Adapter for Indian Pins, India to UAE, Hong Kong, Dubai, UK Adapter Plug - Type G Adapter - Perfect for Laptop,...",Warehouse A,63,48,2025-02-22 06:46:00,15
10245,ORD_10246,13329,TheGiftKart Shockproof Crystal Clear Back Cover Case for iQOO 11 5G | 360 Degree Protection | Protective Design | Transpar...,Warehouse A,64,57,2025-02-22 11:13:00,7
10246,ORD_10247,24846,Oftec-M 200mg/400mg Tablet,Warehouse C,39,25,2025-02-22 08:46:00,14
10247,ORD_10248,36897,Zoxiclav Dry Syrup,Warehouse C,47,42,2025-02-22 13:34:00,5
10248,ORD_10249,7036,Coal Clean Beauty 100% Natural Anti Hair Fall Oil with Vitamin E & Root Bio Tec 100 ml,Warehouse C,89,79,2025-02-22 18:45:00,10
10249,ORD_10250,31994,Fleminol MR Tablet,Warehouse C,49,36,2025-02-22 00:39:00,13
10250,ORD_10251,30707,Flosun 400mg Tablet,Warehouse A,59,50,2025-02-22 12:12:00,9
10251,ORD_10252,34752,Pantoder L 75mg/40mg Capsule,Warehouse C,35,24,2025-02-22 06:34:00,11
10252,ORD_10253,2469,C Cort 6mg Tablet,Warehouse C,25,8,2025-02-22 18:10:00,17
10253,ORD_10254,19540,Rosycap-Gold 10/75 Capsule,Warehouse A,26,9,2025-02-22 01:49:00,17
10254,ORD_10255,26659,Fogg Fragrance Deo Men Marco 150 Ml,Warehouse A,35,21,2025-02-22 06:39:00,14
10255,ORD_10256,1473,SNDIA Business Card Holder 2 Tiers Acrylic Visiting Card Stand Organizer Clear Card Holder Display for Office (Transparent),Warehouse C,35,27,2025-02-22 22:23:00,8
10256,ORD_10257,21520,Skin Cottage Shower Gel (Ocean) 1000 ml,Warehouse A,21,2,2025-02-22 04:08:00,19
10257,ORD_10258,35227,Glycifit V 500mg/0.3mg Tablet,Warehouse C,76,67,2025-02-22 21:28:00,9
10258,ORD_10259,14503,Bio Morning Nectar Flawless Skin Cream 175 Gm,Warehouse A,31,17,2025-02-22 03:46:00,14
10259,ORD_10260,5431,"The Body Shop Peppermint Intensive Cooling Foot Rescue, 100ml",Warehouse C,84,68,2025-02-22 05:16:00,16
10260,ORD_10261,27855,TheGiftKart Ultra-Hybrid Crystal Clear Back Case Cover for Google Pixel 6A | Shockproof Design | Camera Protection Bump | ...,Warehouse C,26,19,2025-02-22 04:14:00,7
10261,ORD_10262,5157,Flax 200mg Tablet,Warehouse A,56,47,2025-02-22 01:32:00,9
10262,ORD_10263,35308,"TANZILIGHT® Fariy Lights Batteries 30 Pcs LR44/AG13, 1.5V Alkaline Button Coin Cell Electronics Solutions LR44 Battery (Pa...",Warehouse B,82,72,2025-02-22 23:45:00,10
10263,ORD_10264,12817,"CASENED Tempered Glass Camera Lens Protector For Iphone 13/13 Mini, 9H Premium Tempered Glass Camera Lens Protection [99.9...",Warehouse C,48,31,2025-02-22 12:31:00,17
10264,ORD_10265,13394,Soothing Face Mask,Warehouse B,99,94,2025-02-22 03:03:00,5
10265,ORD_10266,32574,HEROZ Hammer Unisex Nylon 45 L Travel Laptop Backpack Water Resistant Slim Durable Fits Up to 17.3 Inch Laptop Notebook (A...,Warehouse A,24,7,2025-02-22 04:05:00,17
10266,ORD_10267,1055,Flormar Quick Dry Nail Enamel QD07 Cherry Dessert 11 ml,Warehouse B,45,36,2025-02-22 16:02:00,9
10267,ORD_10268,33501,Nicoflox TZ Tablet,Warehouse A,66,57,2025-02-22 19:28:00,9
10268,ORD_10269,24307,Valium 10mg Tablet,Warehouse B,42,23,2025-02-22 01:30:00,19
10269,ORD_10270,24644,Atarap 2mg Tablet,Warehouse A,19,3,2025-02-22 16:58:00,16
10270,ORD_10271,26462,Lukotas LC Tablet,Warehouse C,14,4,2025-02-22 17:29:00,10
10271,ORD_10272,14480,Lekace Serra 100 mg/500 mg/15 mg Tablet,Warehouse B,43,36,2025-02-22 00:17:00,7
10272,ORD_10273,12150,Wooden Gift Set,Warehouse A,115,97,2025-02-22 02:53:00,18
10273,ORD_10274,27320,Bariderm Ointment,Warehouse A,93,81,2025-02-22 06:48:00,12
10274,ORD_10275,33704,Insight Cosmetics Lash Extension Mascara Eye Liquid 9 ml,Warehouse A,78,59,2025-02-22 02:43:00,19
10275,ORD_10276,24299,"INSTAPLAY INSTABUDS in-Ear Bluetooth 5.0 Wireless Headphones with Extra Bass Stereo Sound, 12Hrs Playtime, Lightweight Nec...",Warehouse A,35,26,2025-02-22 07:49:00,9
10276,ORD_10277,30656,Unidine Lotion,Warehouse C,19,9,2025-02-22 01:22:00,10
10277,ORD_10278,24820,Dragonwar Emera ELE-G11 Gaming Wired Mouse (Black),Warehouse A,31,16,2025-02-22 14:26:00,15
10278,ORD_10279,9885,Ayush Kwath,Warehouse B,37,26,2025-02-22 05:07:00,11
10279,ORD_10280,19355,Onid O Tablet,Warehouse A,43,30,2025-02-22 18:23:00,13
10280,ORD_10281,21679,Lime Bath Soap,Warehouse C,107,94,2025-02-22 05:42:00,13
10281,ORD_10282,1486,TECH-X 12 Inch USB to DC Power Cable Charger Cord Barrel Jack USB 2.0 toDC Jack 5.5 x 2.5mm or 5.5 x 2.1mm Power Plug for ...,Warehouse A,79,68,2025-02-22 04:24:00,11
10282,ORD_10283,26938,Webpred 4mg Tablet,Warehouse C,118,99,2025-02-22 07:11:00,19
10283,ORD_10284,14674,Cinoflox 200mg Tablet,Warehouse A,92,73,2025-02-22 08:54:00,19
10284,ORD_10285,2537,Casio MJ-12Sb Desktop Calculator,Warehouse B,79,69,2025-02-22 04:05:00,10
10285,ORD_10286,27363,Ajmal 4 Wisal Deo & Ascend EDP Pack of 5 20 ml,Warehouse A,35,20,2025-02-22 00:04:00,15
10286,ORD_10287,26634,HP Bluetooth Mouse 250/4.2 Bluetooth connectivity/Adjustable DPI Upto 3600/15-month Long Battery Life and Safe encryption ...,Warehouse A,52,37,2025-02-22 08:35:00,15
10287,ORD_10288,12633,Extraordinary Clay Conditioner,Warehouse A,44,27,2025-02-22 13:32:00,17
10288,ORD_10289,21557,Lakme Lip Love Chapstick Mango 4.5 Gm,Warehouse B,46,37,2025-02-22 06:06:00,9
10289,ORD_10290,26628,Revlon Colorstay Looks Book Palette - Player 3.4 Gm,Warehouse C,63,58,2025-02-22 22:49:00,5
10290,ORD_10291,20212,Xonacef XP 500mg/250mg Injection,Warehouse B,21,10,2025-02-22 16:22:00,11
10291,ORD_10292,27831,"Fashion Colour Hair Colour Spray, Blue 150 ml",Warehouse A,100,93,2025-02-22 14:39:00,7
10292,ORD_10293,17974,Needle CMYK Refill Kit with Suction Tool Combo Pack of High Yield Inkjet Cartridge Ink Refill Compatible for HP and Canon ...,Warehouse B,24,11,2025-02-22 04:10:00,13
10293,ORD_10294,13129,Artis Mini 2.0 USB Multimedia Speakers (Blue),Warehouse C,44,37,2025-02-22 12:38:00,7
10294,ORD_10295,13849,"Sports Men EDT + Deodorant, No 9 White",Warehouse C,35,25,2025-02-22 21:12:00,10
10295,ORD_10296,594,Lenovo GX20L29764 65W Laptop Adapter/Charger with Power Cord for Select Models of Lenovo (Round pin),Warehouse C,31,23,2025-02-22 17:06:00,8
10296,ORD_10297,23817,Azzicin 100mg Oral Suspension,Warehouse A,71,64,2025-02-22 20:40:00,7
10297,ORD_10298,4352,"FLiX (Beetel USB to Type C PVC Data Sync & 2A Fast Charging Cable, Made in India, 480Mbps Data Sync, Tough Cable, 1 Meter ...",Warehouse A,28,23,2025-02-22 11:40:00,5
10298,ORD_10299,17925,Dapcard 5mg Tablet,Warehouse B,88,73,2025-02-22 22:40:00,15
10299,ORD_10300,25291,Quench Botanics Mama Cica Pore Clearing Exfoliating Face Wash 100 ml,Warehouse B,71,53,2025-02-22 07:30:00,18
10300,ORD_10301,676,"Dove Nourishing Secretes Invigorating Ritual Body Wash, 500ml",Warehouse C,28,10,2025-02-22 01:06:00,18
10301,ORD_10302,13061,"Honeywell Surge Protector/Spike Guard/Extension Board, Master Switch, 4 Universal Sockets, 15000Amp, 2 Mtr Cord, Device Se...",Warehouse A,101,90,2025-02-22 11:50:00,11
10302,ORD_10303,15163,Lanop Kid 15mg Tablet Strawberry,Warehouse B,47,41,2025-02-22 05:34:00,6
10303,ORD_10304,35723,Rabecom 20mg Tablet,Warehouse A,86,74,2025-02-22 08:45:00,12
10304,ORD_10305,17475,"Philips Audio TAE1107BK Wired in-Ear Earphones with Built in Mic, Ergonomic Comfort-Fit | 10mm Drivers, 1.2m Durable Cabl...",Warehouse A,85,71,2025-02-22 09:56:00,14
10305,ORD_10306,11020,Beutan 100mg/325mg/15mg Tablet,Warehouse C,107,89,2025-02-22 04:40:00,18
10306,ORD_10307,32326,"Redmi 11 Prime (Flashy Black, 6GB RAM, 128GB Storage) | Prime Design | High Performance Helio G99 | 50 MP AI Triple Cam | ...",Warehouse B,85,68,2025-02-22 16:02:00,17
10307,ORD_10308,34086,"URBN 20000 mAh lithium_polymer Power Bank with 12 Watt Fast Charging, Camo",Warehouse C,38,27,2025-02-22 02:36:00,11
10308,ORD_10309,7816,Amoc 500mg Capsule,Warehouse A,79,63,2025-02-22 10:06:00,16
10309,ORD_10310,10553,Collagen Face Cleansing Foam,Warehouse B,53,46,2025-02-22 22:46:00,7
10310,ORD_10311,36539,Dentain 50 mg/500 mg Tablet,Warehouse A,79,67,2025-02-22 18:04:00,12
10311,ORD_10312,31233,"Synqe Nylon Braided USB Data Sync & Fast Charging Small Cable Compatible For iPhone, iPad Air, iPad Mini, iPad Pro (0.25M,...",Warehouse C,62,46,2025-02-22 16:27:00,16
10312,ORD_10313,17079,I Am Eyeconic Matte Neon Pure Pigments ELECTRO -YELLOW 2 gm,Warehouse A,58,45,2025-02-22 12:14:00,13
10313,ORD_10314,32166,"Logitech MX Master 2S Wireless Mouse, Multi-Device, Bluetooth or 2.4GHz Wireless with USB Unifying Receiver, 4000 DPI Any ...",Warehouse A,88,71,2025-02-22 21:19:00,17
10314,ORD_10315,13765,Amazon Brand - Solimo Basic Case for Nothing 1 (Thermoplastic Polyurethane_Transparent),Warehouse A,97,81,2025-02-22 19:32:00,16
10315,ORD_10316,11281,Vivo T1 44w Midnight Galaxy (4+128GB),Warehouse A,48,34,2025-02-22 19:42:00,14
10316,ORD_10317,36020,Adofys Mobile Phone Chest Strap Mount GoPro Chest Harness Holder for VLOG/POV Compatible with All Cell Phones and GoPro He...,Warehouse C,12,6,2025-02-22 18:42:00,6
10317,ORD_10318,13811,Lube - Strawberry Sensation,Warehouse A,25,8,2025-02-22 18:04:00,17
10318,ORD_10319,11282,Amazon Brand - Solimo Back Cover for Samsung Galaxy A32 (Plastic | Transparent),Warehouse C,42,34,2025-02-22 15:55:00,8
10319,ORD_10320,34093,Deodorant Body Spray - Red for Man,Warehouse C,78,66,2025-02-22 19:36:00,12
10320,ORD_10321,30382,Voricet M Syrup,Warehouse C,42,35,2025-02-22 01:30:00,7
10321,ORD_10322,16637,Rosperex Plus Syrup,Warehouse A,66,51,2025-02-22 03:42:00,15
10322,ORD_10323,11455,Anti Hair Loss Cream,Warehouse B,11,1,2025-02-22 19:12:00,10
10323,ORD_10324,29314,Glimmer Nail Polish Dragon 5 ml,Warehouse C,71,54,2025-02-22 14:27:00,17
10324,ORD_10325,17049,Amikasil 500mg Injection,Warehouse B,31,26,2025-02-22 18:52:00,5
10325,ORD_10326,4291,"Dr Foot Diabetic Neuropathy Foot Cream L-Arginine & Dimethicone Improves Blood Circulation, 100 g",Warehouse B,97,84,2025-02-22 11:48:00,13
10326,ORD_10327,23998,Clinbet 600mg Injection,Warehouse A,59,46,2025-02-22 07:13:00,13
10327,ORD_10328,2722,Axitrix T 1000mg/125mg Injection,Warehouse C,88,74,2025-02-22 22:30:00,14
10328,ORD_10329,33233,Prodox 100mg Tablet,Warehouse B,19,8,2025-02-22 03:21:00,11
10329,ORD_10330,28939,CX CV 200mg/125mg Tablet,Warehouse C,77,62,2025-02-22 20:34:00,15
10330,ORD_10331,17012,Ss Day 10mg Tablet,Warehouse A,105,96,2025-02-22 06:50:00,9
10331,ORD_10332,23981,Gabwic-NT Tablet,Warehouse C,62,53,2025-02-22 07:27:00,9
10332,ORD_10333,6170,Elcab 300mg Tablet,Warehouse B,19,7,2025-02-22 03:16:00,12
10333,ORD_10334,15030,"DIGITEK® (DRL-18H C) Professional 46 CM (18"" inch) Big LED Ring Light with Stand, 2 color modes Dimmable Lighting, for Pho...",Warehouse A,51,40,2025-02-22 19:47:00,11
10334,ORD_10335,17677,Offmark 200mg Tablet,Warehouse A,72,58,2025-02-22 20:00:00,14
10335,ORD_10336,283,Lipcheek The Nude Edition Long Lasting Sensational Liquid Matte Lipstick Non Transfer Set Of 4 Nude Shades Combo Pack,Warehouse B,77,70,2025-02-22 16:31:00,7
10336,ORD_10337,688,Foxiabh OZ Suspension,Warehouse C,24,16,2025-02-22 14:37:00,8
10337,ORD_10338,15102,Levotake 500mg Infusion,Warehouse C,37,27,2025-02-22 23:07:00,10
10338,ORD_10339,30349,Rifasat 200mg Tablet,Warehouse B,110,97,2025-02-22 01:40:00,13
10339,ORD_10340,6357,"Body Spray - Play, For Women",Warehouse A,94,87,2025-02-22 20:38:00,7
10340,ORD_10341,10602,Tenepride M  1000 Tablet SR,Warehouse B,20,11,2025-02-22 22:00:00,9
10341,ORD_10342,11288,Cosome MSR Tablet,Warehouse A,34,27,2025-02-22 14:05:00,7
10342,ORD_10343,8077,Jotter 100mg Tablet,Warehouse A,20,9,2025-02-22 02:09:00,11
10343,ORD_10344,23821,Dothip 25mg Tablet,Warehouse A,48,34,2025-02-22 17:45:00,14
10344,ORD_10345,32389,Qupod 100mg Tablet DT,Warehouse B,48,29,2025-02-22 15:46:00,19
10345,ORD_10346,4564,S.F.R. COLOR matte mini blusher I pocket blusher I matte mini cheek pearls blusher (Hrart Shape),Warehouse B,66,54,2025-02-22 13:24:00,12
10346,ORD_10347,661,Larox 1mg Tablet,Warehouse B,90,85,2025-02-22 00:16:00,5
10347,ORD_10348,4351,Amazon Brand - Solimo Back Cover for Samsung Galaxy M31s (Silicone | Clear),Warehouse C,60,53,2025-02-22 18:19:00,7
10348,ORD_10349,13931,Coleus Root Powder - Supports Healthy Metabolism & Weight Management,Warehouse B,83,73,2025-02-22 13:34:00,10
10349,ORD_10350,23814,Serranac-K 50mg/10mg Tablet,Warehouse A,44,37,2025-02-22 16:41:00,7
10350,ORD_10351,11394,Coxwin ZH Kid 100 mg/300 mg Tablet,Warehouse C,32,15,2025-02-22 11:06:00,17
10351,ORD_10352,29310,TheGiftKart Ultra-Hybrid Crystal Clear Back Case Cover for iPhone XR | Shockproof Design | Camera Protection Bump | Hard C...,Warehouse A,84,69,2025-02-22 04:56:00,15
10352,ORD_10353,25348,Amcus LS Syrup,Warehouse A,45,37,2025-02-22 13:50:00,8
10353,ORD_10354,10884,"boAt Xtend Smartwatch Wonder Woman Edition with Alexa Built-in, 1.69” HD Display, Multiple Watch Faces, Stress Monitor, He...",Warehouse B,21,14,2025-02-22 14:47:00,7
10354,ORD_10355,7908,"Cool, Charm and Swag Avatar Deodorant & Body Spray Perfume For Men",Warehouse B,17,2,2025-02-22 08:20:00,15
10355,ORD_10356,3872,Gativis 0.3% Eye Drop,Warehouse C,94,78,2025-02-22 04:09:00,16
10356,ORD_10357,6441,Toothpaste - Fire Freeze Gel Dual Sensation Warm and Cool,Warehouse A,50,41,2025-02-22 07:44:00,9
10357,ORD_10358,7771,Dayfixi 200mg Tablet DT,Warehouse C,49,44,2025-02-22 02:44:00,5
10358,ORD_10359,15175,"Print Star Canon 3010 Compatible Toner Cartridge for Canon MF3010 , MF 3010 Monochrome Multi-Function Laser Printer (Pack ...",Warehouse B,25,7,2025-02-22 10:43:00,18
10359,ORD_10360,10909,Vega Pocket Comb (HMC - 120) 21 gm,Warehouse A,37,18,2025-02-22 05:50:00,19
10360,ORD_10361,12248,Radipram 20 Tablet,Warehouse C,74,58,2025-02-22 10:40:00,16
10361,ORD_10362,7774,NOTE ULTRA RICH COLOR EYE PENCIL 07 1.1 gm,Warehouse B,36,18,2025-02-22 19:25:00,18
10362,ORD_10363,16916,Ractofex Tablet,Warehouse C,59,53,2025-02-22 18:02:00,6
10363,ORD_10364,29557,Faszide M 80mg/500mg Tablet,Warehouse B,48,39,2025-02-22 07:20:00,9
10364,ORD_10365,28942,"Tygot Bluetooth Extendable Selfie Sticks with Wireless Remote and Tripod Stand, 3-in-1 Multifunctional Selfie Stick with T...",Warehouse B,112,96,2025-02-22 04:16:00,16
10365,ORD_10366,25750,Lupipara 150mg Injection,Warehouse C,57,39,2025-02-22 14:15:00,18
10366,ORD_10367,23048,The Face Shop Smart Peeling White Jewel 120 Ml,Warehouse C,52,46,2025-02-22 23:41:00,6
10367,ORD_10368,4473,Keratin Infused Hair Serum For Dry & Damaged Hair,Warehouse C,57,51,2025-02-22 19:13:00,6
10368,ORD_10369,7367,Nabico3-DS Tablet,Warehouse B,39,24,2025-02-22 12:10:00,15
10369,ORD_10370,33354,Faces Canada hi Shine Nail Enamel Pearl White-03 9 Ml,Warehouse A,85,76,2025-02-22 18:12:00,9
10370,ORD_10371,31777,Locuff BT Syrup,Warehouse B,50,43,2025-02-22 16:59:00,7
10371,ORD_10372,28647,"Sery Colorflirt Nail Paint Rustic Charm, Pink 10 ml",Warehouse B,19,10,2025-02-22 06:19:00,9
10372,ORD_10373,1688,Asxime 50mg/5ml Syrup,Warehouse B,50,31,2025-02-22 23:57:00,19
10373,ORD_10374,16631,"Gift Set - SG + EDT + Deo, Yellow 8",Warehouse B,37,25,2025-02-22 08:20:00,12
10374,ORD_10375,25751,"ZEBRONICS Nitro PRO Outemu RED Switch Gaming Mechanical Keyboard with Software Customization for Macros, RGB LED, 1000Hz P...",Warehouse B,60,55,2025-02-22 21:21:00,5
10375,ORD_10376,4333,N95 + PM2.5 Anti Pollution Face Mask With Activated Carbon - Small,Warehouse C,37,25,2025-02-22 10:01:00,12
10376,ORD_10377,2716,MI 108 cm (43 inches) 5X Series 4K Ultra HD LED Smart Android TV L43M6-ES (Grey),Warehouse C,20,2,2025-02-22 12:58:00,18
10377,ORD_10378,4700,"MILAP Urbane Velvet matte lipstick for Women, Long Lasting Lipstick, matte lipstick, Hydrating & Moisturizing Lipsticks, L...",Warehouse C,55,45,2025-02-22 20:31:00,10
10378,ORD_10379,11256,"Wecool Unbreakable 3 in 1 Charging Cable with 3A Speed, Fast Charging Multi Purpose Cable 1.25 Mtr Long, Type C cable, Mic...",Warehouse A,100,83,2025-02-22 19:12:00,17
10379,ORD_10380,16223,"Logitech C310 Digital HD Webcam with Widescreen HD Video Calling, HD Light Correction, Noise-Reducing Mic, for Skype, Face...",Warehouse B,44,38,2025-02-22 13:32:00,6
10380,ORD_10381,9206,Nourishing Peach Body Lotion,Warehouse C,83,69,2025-02-22 23:52:00,14
10381,ORD_10382,16630,boAt Bassheads 105 Wired in Ear Earphones with Mic (White),Warehouse C,51,33,2025-02-22 21:53:00,18
10382,ORD_10383,37063,Nails On Board Handmade Press On Gel Nails- Holographic Liliac X Small 50 gm,Warehouse A,39,33,2025-02-22 20:13:00,6
10383,ORD_10384,13857,Gblin M 750mcg/150mg Capsule,Warehouse A,84,73,2025-02-22 12:05:00,11
10384,ORD_10385,10842,"IFB 8 Kg 5 Star Front Load Washing Machine 2X Power Steam (SENATOR WSS 8014, Silver, In-built Heater, 4 years Comprehensiv...",Warehouse B,28,22,2025-02-22 18:27:00,6
10385,ORD_10386,17777,Jyomox-CV 625 Tablet,Warehouse B,113,96,2025-02-22 04:43:00,17
10386,ORD_10387,18156,Terpalm 250 Tablet,Warehouse C,46,27,2025-02-22 21:33:00,19
10387,ORD_10388,31770,"Huda Girl Beauty Professional Colossal Kajal Deep And Thick White Kohl Kajal Long Stay Waterproof Smudge Proof, Pure Whit...",Warehouse B,65,60,2025-02-22 00:38:00,5
10388,ORD_10389,8034,Maryaj Dynamic EDP Spicy Woody Perfume And Ajmal Blu Homme Deodorant Aquatic Woody Fragrance 300 ml,Warehouse B,90,79,2025-02-22 01:31:00,11
10389,ORD_10390,7566,Faces Canada Weightless Matte Finish Foundation Ivory 01 35 Ml,Warehouse A,86,77,2025-02-22 09:03:00,9
10390,ORD_10391,3376,Extra Nourishing Moisturiser - Rose & Almond,Warehouse B,67,54,2025-02-22 16:12:00,13
10391,ORD_10392,18168,Skin Brightening Serum Morning Nectar 40 Ml,Warehouse B,80,67,2025-02-22 01:41:00,13
10392,ORD_10393,23148,Whey Protein - Cafe Mocha,Warehouse A,78,64,2025-02-22 23:48:00,14
10393,ORD_10394,16786,Redragon Kumara K552 Rainbow LED Backlit TKL Ten Key-Less Mechanical Wired Gaming Keyboard Without Numlock Keys (Black),Warehouse B,40,27,2025-02-22 06:46:00,13
10394,ORD_10395,34207,Terbikem Cream,Warehouse A,102,85,2025-02-22 05:13:00,17
10395,ORD_10396,4692,Aceva SP 100mg/500mg/15mg Tablet,Warehouse A,31,14,2025-02-22 15:05:00,17
10396,ORD_10397,33867,"OLICOM New Launch Smart Watches ID116 Bluetooth Smartwatch Wireless Fitness Band for Boys, Girls, Men, Women & Kids | Spor...",Warehouse B,82,72,2025-02-22 15:59:00,10
10397,ORD_10398,1758,Seract P 500mg/10mg Tablet,Warehouse A,47,36,2025-02-22 21:38:00,11
10398,ORD_10399,30241,"Amazon Basics USB 3.0 Cable - A Male to Micro B - 6 Feet (1.8 Meters), Black",Warehouse A,24,6,2025-02-22 12:56:00,18
10399,ORD_10400,33267,Essential Souls Anti Pigmentation Gel - Saffaire 50 gm,Warehouse A,102,89,2025-02-22 10:42:00,13
10400,ORD_10401,17001,Swiss Beauty Foundation Brush - Brown,Warehouse C,46,27,2025-02-22 03:06:00,19
10401,ORD_10402,17961,Qulef 250mg Tablet,Warehouse A,73,64,2025-02-22 20:52:00,9
10402,ORD_10403,1747,Faber-Castell Water Color Pencils with Paint Brush - Pack of 24 (Assorted),Warehouse A,95,84,2025-02-22 00:32:00,11
10403,ORD_10404,18170,"Amazon Basics 6-Feet VGA to VGA Cable for Monitor, Personal Computer (Black)",Warehouse C,50,39,2025-02-22 23:44:00,11
10404,ORD_10405,835,"ESR Thermoplastic Polyurethane Classic Kickstand Case with HaloLock Compatible for iPhone 14 Pro Max, MagSafe-Compatible C...",Warehouse A,90,81,2025-02-22 01:11:00,9
10405,ORD_10406,23724,"Mivi Roam 2 Wireless Bluetooth Speaker 5W, Portable Speaker with Studio Quality Sound, Powerful Bass, 24 Hours Playtime, W...",Warehouse C,82,70,2025-02-22 23:46:00,12
10406,ORD_10407,6518,Exfoliating Face Scrub - Aloe Vera & Grapes,Warehouse C,104,96,2025-02-22 18:20:00,8
10407,ORD_10408,13227,HELLO ZONE Exclusive Rubber Matte Finish Soft Back Cover for Google Pixel 3a - Black,Warehouse C,103,84,2025-02-22 17:30:00,19
10408,ORD_10409,17642,Olay Total Effects Cleanser With Salicylic Acid & Exfoliating Silica Beads Throughly Cleanse and Exfoliate Skin for Glowin...,Warehouse A,101,96,2025-02-22 06:46:00,5
10409,ORD_10410,4380,Staedtler 137 C 48 Luna Water Colour Pencil - Pack of 48 (Multicolour),Warehouse C,49,35,2025-02-22 09:37:00,14
10410,ORD_10411,17154,Portable In-Ear TWS Bluetooth L-21 Earbuds Bluetooth Headset with Chaging Case (with Mic),Warehouse C,116,97,2025-02-22 16:47:00,19
10411,ORD_10412,17779,Rey Naturals Cold Pressed Castor Oil & Sweet Almond Oil - for hair & skin - 200ml + 200ml,Warehouse B,31,23,2025-02-22 17:45:00,8
10412,ORD_10413,7675,Betorlan SR Forte 1000mg Tablet,Warehouse C,42,31,2025-02-22 18:16:00,11
10413,ORD_10414,28801,"TRESemme Hyaluronic Moisture Boost Shampoo with Hyaluronic Acid,Sulphate Free & Paraben Free, 370ml",Warehouse A,73,61,2025-02-22 00:12:00,12
10414,ORD_10415,23320,"Redmi Buds 3 Lite, True Wireless in Ear Earbuds with Mic, Bluetooth 5.2,IP54 Splash Resistant, Ultra-Light,Fast Charging &...",Warehouse A,63,53,2025-02-22 08:25:00,10
10415,ORD_10416,17646,Bio Almond & Cashew - Fresh Replenishing Serum For Color Treated & Permed Hair,Warehouse A,75,66,2025-02-22 00:45:00,9
10416,ORD_10417,33199,Fexinol-M Tablet,Warehouse B,67,50,2025-02-22 10:56:00,17
10417,ORD_10418,2139,The Moms Co. Green Tea Face Wash 100 ml,Warehouse A,25,6,2025-02-22 22:06:00,19
10418,ORD_10419,17950,Faber-Castell Exam Pad(Assorted),Warehouse B,40,21,2025-02-22 15:44:00,19
10419,ORD_10420,13602,Fixital CV Dry Syrup,Warehouse C,55,47,2025-02-22 20:46:00,8
10420,ORD_10421,15252,"SanDisk Ultra Luxe USB 3.1 Flash Drive 32GB, Upto 150MB/s, All Metal, Metallic Silver",Warehouse C,103,94,2025-02-22 00:21:00,9
10421,ORD_10422,13845,Nirgo AT Syrup,Warehouse C,25,12,2025-02-22 01:31:00,13
10422,ORD_10423,28746,"Nokia T20 Tab with 10.36 Inch(26cm) 2K Screen, Low Blue Light, Wi-Fi, 8200mAh Battery, Android 11 with 2 Years of OS Upgra...",Warehouse B,46,32,2025-02-22 21:04:00,14
10423,ORD_10424,29493,Myglamm Wandurlust Sand Matt Nail Paint Tiramisu 11 Ml,Warehouse A,60,52,2025-02-22 19:29:00,8
10424,ORD_10425,29122,Meto XL 50 Tablet,Warehouse A,75,59,2025-02-22 17:56:00,16
10425,ORD_10426,1708,"SHOPEE Microfiber Phone Screen Camera Lens Glass Cleaner Cleaning Cloth, 10 Piece (5x5 inch)",Warehouse A,28,15,2025-02-22 11:20:00,13
10426,ORD_10427,25560,"Spa Ceylon Luxury Ayurveda White Tuberose Facial Mask, 3 Inch X 3.2 Inch X 2.5 Inch, White, 100 G",Warehouse A,82,66,2025-02-22 05:47:00,16
10427,ORD_10428,10702,ZigZag Medium Bristle Toothbrush,Warehouse A,104,95,2025-02-22 23:56:00,9
10428,ORD_10429,7644,"Menstrual Cup - Hygienic, After Delivery / Above Age 25 Years, Size L (Large)",Warehouse B,19,10,2025-02-22 21:47:00,9
10429,ORD_10430,34047,Azegud 200  Oral Suspension,Warehouse B,70,53,2025-02-22 02:56:00,17
10430,ORD_10431,33877,Woman - Trendy Eau De Toilette Deodorant,Warehouse A,92,82,2025-02-22 11:51:00,10
10431,ORD_10432,7870,Kaytrix-C 5mg/2mg Tablet,Warehouse A,16,8,2025-02-22 21:36:00,8
10432,ORD_10433,13743,Naturale Aloe Vera Detoxifying Soap Bar,Warehouse C,23,5,2025-02-22 04:10:00,18
10433,ORD_10434,13739,Henpar-D Tablet,Warehouse B,95,90,2025-02-22 00:55:00,5
10434,ORD_10435,4518,Bella Vita Organic Orange Essential Oil 15 ml,Warehouse C,43,30,2025-02-22 16:17:00,13
10435,ORD_10436,7688,Charcoal Face Scrub With Black Sand - Exfoliates Skins & Removes Black Heads,Warehouse C,90,82,2025-02-22 17:25:00,8
10436,ORD_10437,29109,Donice 5mg Tablet,Warehouse A,103,85,2025-02-22 02:05:00,18
10437,ORD_10438,17334,Yogurt Powder (Spray Dired) - 100 gms,Warehouse A,18,8,2025-02-22 17:05:00,10
10438,ORD_10439,25369,Apple Cider Vinegar & Organic Argan Oil Hair Shampoo,Warehouse C,11,6,2025-02-22 23:27:00,5
10439,ORD_10440,11472,Cetapam 0.5mg/10mg Tablet,Warehouse B,98,93,2025-02-22 21:30:00,5
10440,ORD_10441,7611,L'Occitane Intensive Repair Solid Conditioner,Warehouse C,78,69,2025-02-22 16:21:00,9
10441,ORD_10442,2782,Satben 6mg/400mg Chewable Tablet,Warehouse B,57,52,2025-02-22 16:31:00,5
10442,ORD_10443,31513,Nutriment Ubtan Mask All Skin Type 300 gm,Warehouse C,24,18,2025-02-22 15:30:00,6
10443,ORD_10444,30317,"Fashion Colour Cc Cream, Shade 03 35 gm",Warehouse A,95,80,2025-02-22 11:26:00,15
10444,ORD_10445,17892,Oronac 25mg Injection,Warehouse C,59,49,2025-02-22 18:22:00,10
10445,ORD_10446,17893,FAE Beauty Ice Cream Soda Lip Balm I Intensely Moisturizing I Spf 20+ | Hydrating and Nourishing Lip Balm I Enriched with ...,Warehouse B,64,52,2025-02-22 00:51:00,12
10446,ORD_10447,18066,"Western Digital WD 2TB My Passport Portable Hard Disk Drive, Compatible with Windows and Mac, External HDD-Black",Warehouse B,95,89,2025-02-22 02:19:00,6
10447,ORD_10448,17399,Needle CMYKK Refill Kit with Suction Tool Combo Pack of High Yield Inkjet Cartridge Ink Refill Compatible for HP and Canon...,Warehouse B,51,41,2025-02-22 23:14:00,10
10448,ORD_10449,35687,Zeophylin 100mg Capsule,Warehouse A,50,33,2025-02-22 05:35:00,17
10449,ORD_10450,32345,Aquagel Sunscreen SPF-50 PA+++ (Broad Spectrum Protection UVA/UVB) 100ml,Warehouse A,55,47,2025-02-22 08:40:00,8
10450,ORD_10451,10703,"Brustro Artists Stitched Bound Sketch Book, A5 Size, 160 Pages, 110 GSM (Acid Free)",Warehouse C,109,95,2025-02-22 15:36:00,14
10451,ORD_10452,23234,"Sanfe Spotlite Sensitive Body Scrub For Dark Underarms, Inner Thighs and Sensitive Areas | 10X Powerful, Enriched with She...",Warehouse A,35,17,2025-02-22 21:29:00,18
10452,ORD_10453,23650,Simmtronics 8GB DDR3L Laptop RAM 1600 MHz (PC 12800) with 3 Year Warranty,Warehouse B,71,54,2025-02-22 12:40:00,17
10453,ORD_10454,3848,Etoglobe 90mg Tablet,Warehouse C,78,59,2025-02-22 04:24:00,19
10454,ORD_10455,638,"Spigen Rugged Armor Pro Back Cover Case for iPad Pro 12.9 inch (2022 / 2021) - Black, thermoplastic polyurethane laptopsss",Warehouse A,46,37,2025-02-22 05:46:00,9
10455,ORD_10456,1848,"LIRAMARK Type C to 3.5 mm Jack Audio Connector, Noise Cancelling Headphones Jack Converter Audio Adapter for OnePlus (Not ...",Warehouse B,112,97,2025-02-22 14:21:00,15
10456,ORD_10457,23903,"New OnePlus USB A 3.0 to Type C OTG Adapter, USB C Male to Female USB OTG Adapter, Thunderbolt to USB Adapter Compatible w...",Warehouse C,25,19,2025-02-22 13:34:00,6
10457,ORD_10458,1800,"Cubic A7 Size Wiro Pocket Notebook, Pack of 10 (Black)",Warehouse B,54,40,2025-02-22 01:12:00,14
10458,ORD_10459,4444,"Yamaha PSS-F30, 37-Keys Portable Mini Keyboard",Warehouse C,81,75,2025-02-22 04:14:00,6
10459,ORD_10460,4515,JBL Tune 130NC True Wireless in Ear Earbuds |ANC Earbuds (Upto 40dB) APP - Adjust EQ for Extra Bass | Massive 40Hrs Playti...,Warehouse C,50,31,2025-02-22 22:32:00,19
10460,ORD_10461,31182,Eproron 500mg Injection,Warehouse C,52,38,2025-02-22 16:02:00,14
10461,ORD_10462,3316,"boAt floAtpad 350 Qi Certified Wireless Charger with 6mm Transmission Range, Smart IC Protection Against Damage & 1 Type C...",Warehouse C,54,41,2025-02-22 02:25:00,13
10462,ORD_10463,32254,HP 805XL Tri-Color Original Ink Cartridge,Warehouse C,96,78,2025-02-22 15:31:00,18
10463,ORD_10464,6593,Expotus BR Syrup,Warehouse B,98,92,2025-02-22 18:19:00,6
10464,ORD_10465,29108,Ajmal Nightingale & Distraction & Magnetize & Persuade Deo & Neea EDP Pack of 3 20 ml,Warehouse A,91,81,2025-02-22 03:20:00,10
10465,ORD_10466,18030,Lilirab D 30mg/20mg Capsule SR,Warehouse A,60,45,2025-02-22 07:56:00,15
10466,ORD_10467,3759,Pain Releaver - Red,Warehouse B,22,16,2025-02-22 08:18:00,6
10467,ORD_10468,842,SUGAR Cosmetics Citrus Got Real Refreshing Mist 60 gm,Warehouse A,95,77,2025-02-22 15:06:00,18
10468,ORD_10469,10708,"Viva Diseno Ruby Pink Tint | For Eye, Cheeks and Lips | Natural Tint",Warehouse B,81,65,2025-02-22 10:01:00,16
10469,ORD_10470,7370,"Brwn Deep Active Serum, 30ml, tackles hyperpigmentation, enhances skin health + texture| made with vitamins, prebiotics an...",Warehouse B,91,72,2025-02-22 06:30:00,19
10470,ORD_10471,17350,Dronex C 200mg/125mg Tablet,Warehouse B,91,82,2025-02-22 20:21:00,9
10471,ORD_10472,6377,Bendiflox OZ 200mg/500mg Tablet,Warehouse A,42,34,2025-02-22 13:06:00,8
10472,ORD_10473,7963,Superdrug Blueberry Jam Mask 75 ml,Warehouse C,50,35,2025-02-22 13:22:00,15
10473,ORD_10474,1878,Kasamrita Herbal Syrup -  For Cough & Cold,Warehouse A,22,6,2025-02-22 19:29:00,16
10474,ORD_10475,12342,Toyodom 1mg Syrup,Warehouse A,96,88,2025-02-22 00:50:00,8
10475,ORD_10476,22963,"BONTRESS Pro Hair Serum, 60 ml",Warehouse C,44,29,2025-02-22 21:41:00,15
10476,ORD_10477,7736,"eller santé® Wireless Charger 3in1 23W Magnetic Mag-Safe Charger for iPhone 14/ 14 Plus/ 14 Pro/ 14 Pro Max, iPhone 13/13 ...",Warehouse C,38,19,2025-02-22 13:25:00,19
10477,ORD_10478,25235,Fujifilm Instax Mini Picture Format Film - Value Pack 40 Shots Films (White),Warehouse B,63,45,2025-02-22 17:52:00,18
10478,ORD_10479,32319,Olmy-CH 20mg/12.5mg Tablet,Warehouse C,23,8,2025-02-22 11:25:00,15
10479,ORD_10480,1711,"Oraimo 20W Type C Fast Charger PD 3.0 USB C Wall Adapter,Compatible for iPhone Charger14,13/13 Mini/13 Pro Max/12/12 Pro M...",Warehouse B,23,17,2025-02-22 16:36:00,6
10480,ORD_10481,23252,"SYSKA 10A Wi-Fi Smart Plug for Low Power Appliance like Mobile & Laptop Chargers, TV, Kettle (Works with Alexa & Google As...",Warehouse A,80,70,2025-02-22 21:38:00,10
10481,ORD_10482,3826,"Pilot V5 Liquid Ink Roller Ball Pen - Blue (Pack of 2), (9000014714)",Warehouse B,18,5,2025-02-22 15:47:00,13
10482,ORD_10483,13649,Klopam 2mg Tablet,Warehouse A,34,16,2025-02-22 16:17:00,18
10483,ORD_10484,10807,"Lenovo IdeaPad Slim 3 Intel Core i3-1115G4 11th Gen 15.6"" (39.62cm) FHD Laptop (8GB/256GB SSD/Win 11/Office 2021/2 Year Wa...",Warehouse A,58,50,2025-02-22 13:53:00,8
10484,ORD_10485,11234,Anti-Dandruff Styling Gel - Strong Hold,Warehouse A,19,11,2025-02-22 17:38:00,8
10485,ORD_10486,17944,Liss Unlimited Evening Primrose Oil,Warehouse A,51,33,2025-02-22 03:29:00,18
10486,ORD_10487,35629,Medical Face Shield - Break Resistant,Warehouse C,8,1,2025-02-22 16:06:00,7
10487,ORD_10488,35719,Pikkme Brown Leather Magnetic Vintage Flip Wallet Case Cover for Vivo Y12 / Y15 / Y17 / U10 (Brown),Warehouse C,16,8,2025-02-22 07:01:00,8
10488,ORD_10489,28619,Lakme True Wear Nail Color Nudes V014 9 Ml,Warehouse C,77,72,2025-02-22 10:51:00,5
10489,ORD_10490,30383,Spigen Ultra Hybrid Back Cover Case Compatible with iPhone 14 Plus (TPU + Poly Carbonate | Crystal Clear),Warehouse B,68,52,2025-02-22 02:37:00,16
10490,ORD_10491,2731,Dorcold Fast Tablet,Warehouse A,50,44,2025-02-22 04:06:00,6
10491,ORD_10492,36056,Fexonid 180mg Tablet,Warehouse C,16,4,2025-02-22 20:33:00,12
10492,ORD_10493,13855,Herbal Under Eye Cream,Warehouse B,103,98,2025-02-22 10:00:00,5
10493,ORD_10494,33406,"Pure Lavender Glycerin Soap With Coconut Oil - Cold Processed, 100% Natural",Warehouse B,67,55,2025-02-22 09:07:00,12
10494,ORD_10495,13565,Line SR Tablet,Warehouse C,18,1,2025-02-22 11:33:00,17
10495,ORD_10496,25429,Tricef-AZ Tablet,Warehouse A,36,29,2025-02-22 13:53:00,7
10496,ORD_10497,28610,Dupanta 40 Injection,Warehouse C,74,60,2025-02-22 08:12:00,14
10497,ORD_10498,4569,Euroxim 50mg Tablet DT,Warehouse B,57,43,2025-02-22 16:24:00,14
10498,ORD_10499,29291,Atvas 20mg Tablet,Warehouse C,80,73,2025-02-22 05:40:00,7
10499,ORD_10500,16620,Ecan 250mg Tablet,Warehouse C,23,16,2025-02-22 00:47:00,7
10500,ORD_10501,32125,Matra Activated Charcoal Scrub With Argan Oil & Aloe Vera 100 gm,Warehouse B,105,86,2025-02-22 13:18:00,19
10501,ORD_10502,15413,Genlip 10mg Tablet,Warehouse B,21,8,2025-02-22 01:53:00,13
10502,ORD_10503,11031,Zithronour 200 Oral Suspension,Warehouse B,105,98,2025-02-22 09:04:00,7
10503,ORD_10504,31211,Nicka K NINE COLOR Eyeshadow PALETTE - BIRTHDAY CAKE 11.7 gm,Warehouse A,99,89,2025-02-22 01:06:00,10
10504,ORD_10505,22893,Artil 100mg Injection,Warehouse A,79,60,2025-02-22 08:27:00,19
10505,ORD_10506,4499,Quezo 300mg Tablet SR,Warehouse A,24,13,2025-02-22 12:27:00,11
10506,ORD_10507,7920,Yves Rocher Energizing Bath And Shower Gel Mango Coriander 400 ml,Warehouse C,57,45,2025-02-22 11:13:00,12
10507,ORD_10508,18221,"Narciso Rodriguez Eau De Toilette Rouge for Women, 90ml",Warehouse A,70,56,2025-02-22 17:33:00,14
10508,ORD_10509,13687,AEIDESS Tempered Glass/Screen Guard Compatible for Oneplus 11 / OnePlus 9 Pro with Edge to Edge Full Screen Coverage (Tran...,Warehouse C,51,40,2025-02-22 12:57:00,11
10509,ORD_10510,17904,Moxicap 500mg Capsule,Warehouse A,44,38,2025-02-22 22:16:00,6
10510,ORD_10511,33946,Dapanorm 5mg Tablet,Warehouse A,92,77,2025-02-22 00:50:00,15
10511,ORD_10512,23310,AHUJA Karaoke Microphone Aud54,Warehouse B,99,94,2025-02-22 08:21:00,5
10512,ORD_10513,13225,Beauty People Peach Bellini Eyeshadow Palette Peach Bellini Eyeshadow Palette 12 gm,Warehouse A,98,83,2025-02-22 02:42:00,15
10513,ORD_10514,10952,Solotrate 20mg Tablet,Warehouse C,103,98,2025-02-22 23:21:00,5
10514,ORD_10515,58,Zaminol 650mg Tablet,Warehouse C,32,15,2025-02-22 09:56:00,17
10515,ORD_10516,7457,Tft Kit,Warehouse C,81,74,2025-02-22 12:29:00,7
10516,ORD_10517,10809,Bio Nut Walnut Purifying & Polishing Scrub,Warehouse C,79,67,2025-02-22 00:58:00,12
10517,ORD_10518,32086,Kleral Shampoo Ai Semi Di Lino 300 ml,Warehouse B,101,83,2025-02-22 05:43:00,18
10518,ORD_10519,11078,Medseff 200mg Tablet,Warehouse C,78,68,2025-02-22 00:42:00,10
10519,ORD_10520,23350,AND Eternal Radiance Eau De Parfum 50ML & Chic Connect Body Mist 200ML Pack of 2 for Women Crafted by Ajmal,Warehouse C,74,55,2025-02-22 04:01:00,19
10520,ORD_10521,17583,Trixim 50mg Dry Syrup,Warehouse A,55,38,2025-02-22 06:56:00,17
10521,ORD_10522,33254,"Biotique Walnut Exfoliating & Polishing Face Scrub For Normal to Dry Skin, 50g",Warehouse B,48,32,2025-02-22 16:46:00,16
10522,ORD_10523,35928,Lolita Lempicka Lolitaland Women Eau De Parfum 80ml,Warehouse A,69,56,2025-02-22 08:54:00,13
10523,ORD_10524,36043,Premium Applicator Tampons - Regular Flow,Warehouse A,61,42,2025-02-22 00:16:00,19
10524,ORD_10525,13084,Winble Back Cover For OnePlus 9R ( Silicone|Black ),Warehouse B,70,64,2025-02-22 08:49:00,6
10525,ORD_10526,6222,Tellzy 20 Tablet,Warehouse B,36,30,2025-02-22 02:21:00,6
10526,ORD_10527,16758,D'Addario EJ15 Acoustic Guitar Strings,Warehouse B,72,66,2025-02-22 11:13:00,6
10527,ORD_10528,31333,Ajmal Blu & Aurum & Sacred Love & Silver Shade Deo & Prose EDP Pack of 4 20 ml,Warehouse C,57,46,2025-02-22 01:32:00,11
10528,ORD_10529,7623,"R for Rabbit Lullabies Automatic Swing Baby Cradle with Remote Control & Mosquito Net, Soothing Musical Swing Cradles, Ele...",Warehouse A,59,46,2025-02-22 12:11:00,13
10529,ORD_10530,34162,Milestone Nothing Phone 1 Camera Protector/Camera Lens Tempered Glass Compatible with Nothing Phone 1 Back Metal Ring (Sil...,Warehouse C,63,58,2025-02-22 05:25:00,5
10530,ORD_10531,852,Divinerv-GB Tablet,Warehouse A,66,58,2025-02-22 21:22:00,8
10531,ORD_10532,22796,FOMIYES Lashes Rings Ink Caps Cups Holder Ring Cups Pigment Rings Makeup Glue Holder For Eyelash Extension Nail Glue Makeu...,Warehouse C,57,41,2025-02-22 13:58:00,16
10532,ORD_10533,25891,Memorica Syrup - Relieves Stress & Enhances Memory,Warehouse C,33,27,2025-02-22 21:40:00,6
10533,ORD_10534,36599,Vomirem Tablet,Warehouse C,83,66,2025-02-22 18:04:00,17
10534,ORD_10535,13839,"Noise ColorFit Pulse Buzz 1.69"" Smart Watch with Call Function, Bluetooth Calling, 150 Watch Faces, 60 Sports Modes, Spo2...",Warehouse A,64,46,2025-02-22 15:01:00,18
10535,ORD_10536,17840,"PITARA Multi-Purpose Laptop Table| Study Table| Bed Table| Writing Desk| Laptop Workbench with tab, Mobile, Foldable and P...",Warehouse B,85,67,2025-02-22 00:35:00,18
10536,ORD_10537,36106,Gliva 40mg Tablet,Warehouse A,46,39,2025-02-22 11:42:00,7
10537,ORD_10538,13727,Myglamm Lit Nail Enamel - No Chill 7 Ml,Warehouse A,22,6,2025-02-22 02:11:00,16
10538,ORD_10539,12355,Aqukof-LS Syrup,Warehouse A,67,59,2025-02-22 21:41:00,8
10539,ORD_10540,15268,Pikkme Vintage Leather Finish Inside TPU Wallet Stand Magnetic Closing Flip Cover for Mi Redmi 10A / Redmi 9 / Redmi 9C / ...,Warehouse B,114,96,2025-02-22 17:48:00,18
10540,ORD_10541,33895,Cifran C TH Tablet,Warehouse A,16,11,2025-02-22 05:02:00,5
10541,ORD_10542,7616,Go Icy Perfume Spray,Warehouse C,15,2,2025-02-22 12:20:00,13
10542,ORD_10543,2333,Debipro H 150mg/12.5mg Tablet,Warehouse B,41,32,2025-02-22 16:08:00,9
10543,ORD_10544,26493,"Redmi 10 (Shadow Black, 4GB RAM, 64GB Storage)",Warehouse B,27,10,2025-02-22 08:11:00,17
10544,ORD_10545,21744,"Maybelline New York Fit Me Blush, Pink 25 4.5 gm",Warehouse C,24,11,2025-02-22 08:06:00,13
10545,ORD_10546,30524,"Blue Heaven 2X intense Kajal, Green Queen 0.35 gm",Warehouse B,47,38,2025-02-22 15:55:00,9
10546,ORD_10547,34276,Dipain 50mg Tablet,Warehouse A,104,87,2025-02-22 17:35:00,17
10547,ORD_10548,26064,Aroxim 100mg Tablet DT,Warehouse B,82,67,2025-02-22 00:40:00,15
10548,ORD_10549,14980,FUR JADEN Anti Theft 15.6 Inch Laptop Backpack with USB Charging Port and Anti Theft Pocket For Men Women Boys Girls,Warehouse A,104,93,2025-02-22 10:19:00,11
10549,ORD_10550,9184,"Shot Body Spray - Maxx, Flick",Warehouse C,73,56,2025-02-22 04:41:00,17
10550,ORD_10551,18452,Nova Gold Super Firm Hold Long Lasting Hair Spray 200 ml,Warehouse B,63,54,2025-02-22 01:13:00,9
10551,ORD_10552,30566,Clot-XL 500 Tablet,Warehouse A,80,73,2025-02-22 14:55:00,7
10552,ORD_10553,24726,Donetine-M 5 Tablet,Warehouse C,56,44,2025-02-22 12:23:00,12
10553,ORD_10554,22412,realme Narzo 50 Pro 5G (Hyper Black 8GB RAM+128GB Storage) Dimensity 920 5G Processor |90Hz Super AMOLED Display,Warehouse A,72,59,2025-02-22 22:48:00,13
10554,ORD_10555,20510,"AmazonBasics RJ45 Cat 7 High-Speed Gigabit Ethernet Patch Internet Cable for Printer, Server - 10Gbps, 600MHz - White, 10-...",Warehouse B,72,63,2025-02-22 21:54:00,9
10555,ORD_10556,9277,Lodiv 2mg Tablet MD,Warehouse A,29,12,2025-02-22 23:39:00,17
10556,ORD_10557,10406,TA Technology Ahead LG AC Remote Control Universal Compatible for LG Window and Split Air Conditioner,Warehouse B,75,57,2025-02-22 19:52:00,18
10557,ORD_10558,4190,AmazonBasics 8-Sheet Strip Cut Paper With CD and Credit Card Shredder With 12 Liter Waste Basket Capacity,Warehouse A,90,85,2025-02-22 20:36:00,5
10558,ORD_10559,3397,"realme C35 (Glowing Black, 4GB RAM, 64GB Storage)",Warehouse B,99,83,2025-02-22 18:59:00,16
10559,ORD_10560,1681,Depovig 500mg Injection,Warehouse B,51,42,2025-02-22 20:59:00,9
10560,ORD_10561,36414,"AGARO 3.5mm Audio Cable Stereo Aux 90 Degree Right Angle Aux Cable 24K Gold Plated Male to Male Hi-Fi Sound for Car, Home ...",Warehouse A,43,37,2025-02-22 19:13:00,6
10561,ORD_10562,22439,Pantovel 40 Tablet,Warehouse C,42,37,2025-02-22 16:56:00,5
10562,ORD_10563,14959,Pregarol 500mcg/75mg Tablet SR,Warehouse A,113,95,2025-02-22 14:46:00,18
10563,ORD_10564,6886,OJ 1 Golden Stone Bindi Fancy Designer Tikali Kumkum Sticker Bindiya Tikka Giftable Forehead Skin Friendly Glue Traditiona...,Warehouse A,67,56,2025-02-22 22:25:00,11
10564,ORD_10565,16518,Matra Hair Fall Treatment Oil - Onion 100 ml,Warehouse A,29,11,2025-02-22 16:45:00,18
10565,ORD_10566,24776,Rholic Round Empty Luxurious Portable Air Cushion Puff Box BB Cream Container Case Pink,Warehouse A,97,91,2025-02-22 03:53:00,6
10566,ORD_10567,22444,Mach 3 Shaving Razor Holder + 2 Shaving Blade/Cartridge,Warehouse C,75,60,2025-02-22 19:08:00,15
10567,ORD_10568,18469,India Grooming Club Royale Hydrating & Acne Control Face Wash 100 ml,Warehouse B,36,23,2025-02-22 12:53:00,13
10568,ORD_10569,34907,"The True Therapy Micellar Water Infused with Oil to Remove Makeup Remover 200 ml, Safe for Eyes, Non- Irritationg and Skin...",Warehouse B,109,95,2025-02-22 17:12:00,14
10569,ORD_10570,32425,"pTron Tangent Lite Bluetooth 5.0 Wireless in Ear Earphones with mic, Hi-Fi Stereo Sound, 8Hrs Playtime, Lightweight Snug-f...",Warehouse C,35,29,2025-02-22 01:54:00,6
10570,ORD_10571,13041,Noristal 5 Tablet,Warehouse B,64,56,2025-02-22 06:13:00,8
10571,ORD_10572,30043,Creme - Under Eye,Warehouse A,70,58,2025-02-22 23:01:00,12
10572,ORD_10573,34274,"JBL Quantum 100, Wired Over Ear Gaming Headphones with mic for PC, Mobile, Laptop, PS4, Xbox, Nintendo Switch, VR (Black)",Warehouse B,112,95,2025-02-22 09:28:00,17
10573,ORD_10574,18400,UPort 1.8 Meter 3 Pin Laptop Power Cable Cord Universal AC Replacement Power Cord for Laptop (Black),Warehouse C,41,28,2025-02-22 07:33:00,13
10574,ORD_10575,24042,Rexime 100 DT Tablet,Warehouse A,91,85,2025-02-22 18:34:00,6
10575,ORD_10576,31906,"iQOO Z6 Lite 5G by vivo (Stellar Green, 6GB RAM, 128GB Storage) | World's First Snapdragon 4 Gen 1 | 120Hz Refresh Rate | ...",Warehouse A,34,15,2025-02-22 22:13:00,19
10576,ORD_10577,8155,Cavat 25mg Tablet,Warehouse A,35,22,2025-02-22 19:27:00,13
10577,ORD_10578,3416,s.Oliver Selection Shower Gel 200 ml,Warehouse B,95,88,2025-02-22 01:41:00,7
10578,ORD_10579,34801,Ajmal Aurum Sacrifice II Silvershade Deodorant Spray (Pack of 3) 200 ml,Warehouse A,67,48,2025-02-22 10:45:00,19
10579,ORD_10580,5989,"SupCares Tempered Glass Screen Protector for Samsung Galaxy Watch 5 and Galaxy Watch 4 (44mm) (1.4"" inch), Pack of 2 with ...",Warehouse C,33,25,2025-02-22 10:41:00,8
10580,ORD_10581,10109,Stbotanica Rose & Jasmine Handmade Luxury Soap 125 gm,Warehouse B,89,76,2025-02-22 08:33:00,13
10581,ORD_10582,35404,Flormar Baked Blush-On 043 Golden Peach 9 gm,Warehouse A,86,79,2025-02-22 12:06:00,7
10582,ORD_10583,36234,Boujee Beauty Dual Ended Brow Brush B111 135 gm,Warehouse A,19,8,2025-02-22 08:10:00,11
10583,ORD_10584,22029,"Redmi 11 Prime (Flashy Black, 4GB RAM, 64GB Storage) | Prime Design | High Performance Helio G99 | 50 MP AI Triple Cam | 5...",Warehouse C,29,15,2025-02-22 11:01:00,14
10584,ORD_10585,22030,Belle-D-Oud Eau De Parfum,Warehouse A,110,95,2025-02-22 06:58:00,15
10585,ORD_10586,10112,"Portronics Hydra 10 Mechanical Wireless Gaming Keyboard with Bluetooth 5.0 + 2.4 GHz, RGB Lights 16.8 Million Colors, Type...",Warehouse C,73,65,2025-02-22 05:27:00,8
10586,ORD_10587,31923,MANOLL Capsules - A Nutritive Tonic For All Age Group,Warehouse C,105,94,2025-02-22 07:59:00,11
10587,ORD_10588,15807,Dragest 500mg Injection,Warehouse B,16,11,2025-02-22 17:07:00,5
10588,ORD_10589,18942,"iClever Wireless Keyboard and Mouse Combo - 2.4G Portable Wireless Keyboard Mouse with Rechargeable Battery, Ergonomic Des...",Warehouse B,37,21,2025-02-22 14:31:00,16
10589,ORD_10590,28327,Nincip Plus 100mg/325mg Tablet,Warehouse C,38,25,2025-02-22 23:04:00,13
10590,ORD_10591,9121,Etlas 5mg Tablet,Warehouse B,54,42,2025-02-22 08:42:00,12
10591,ORD_10592,16549,"DIZO GoPods Neo (by realme Techlife), True Wireless in Earbuds with Active Noise Cancellation(ANC), Bluetooth Headset (DEE...",Warehouse B,68,62,2025-02-22 02:34:00,6
10592,ORD_10593,36434,"Amazon Brand - Solimo Back Case Cover for Apple iPhone 13, Apple iPhone 13 Back Case Cover, Matte Soft Flexible Silicone, ...",Warehouse A,117,98,2025-02-22 03:39:00,19
10593,ORD_10594,18437,HUMBLE® Spiral Charger Cable Protector Data Cable Saver Charging Cord Protective Cable Cover Set of 2 (8 Pieces),Warehouse A,110,97,2025-02-22 07:35:00,13
10594,ORD_10595,6122,"Xiaomi Pad 5| Qualcomm Snapdragon 860| 120Hz Refresh Rate| 6GB, 128GB| 2.5K+ Display (10.95-inch/27.81cm)|1 Billion Colour...",Warehouse A,50,34,2025-02-22 23:21:00,16
10595,ORD_10596,18434,Tobax 60mg Injection,Warehouse A,32,16,2025-02-22 03:26:00,16
10596,ORD_10597,2656,Avlor P 8mg/325mg Tablet,Warehouse C,31,15,2025-02-22 20:12:00,16
10597,ORD_10598,10463,Thanktel CH Tablet,Warehouse B,19,4,2025-02-22 09:23:00,15
10598,ORD_10599,33449,Fendex 200mg Tablet,Warehouse B,65,55,2025-02-22 09:51:00,10
10599,ORD_10600,28484,"Fonemax [Apple MFi Certified] Lightning to 3.5mm Headphones Dongle Jack Adapter for iPhone,2 in 1 Charger and Aux Audio Sp...",Warehouse A,87,74,2025-02-22 17:30:00,13
10600,ORD_10601,25144,"JK Excel Bond - A4, 100 Sheets, 90 GSM (Pack of 3)",Warehouse A,108,91,2025-02-22 00:18:00,17
10601,ORD_10602,32839,"GoldMedal (EA Poonawala) 360° Power Strip High Grade Adapter (With 6-Outlet International Sockets, Master Switch, Indicator)",Warehouse B,22,13,2025-02-22 02:55:00,9
10602,ORD_10603,22488,Derinide 200mcg Respicap,Warehouse A,78,69,2025-02-22 20:52:00,9
10603,ORD_10604,13045,"(Renewed) Dell Latitude E7270 6th Gen Intel Core i7 Thin & Light FHD Laptop (16 GB DDR4 RAM/512 GB SSD/12.5"" (31.8 cm) FH...",Warehouse B,53,48,2025-02-22 22:30:00,5
10604,ORD_10605,32405,"HP Black/Tri Color Combo Printhead DeskJet GT5800 Series, Ink Tank 110/310/410 Series, Smart Tank 300/400 Series",Warehouse C,93,85,2025-02-22 09:17:00,8
10605,ORD_10606,14447,Vega Grooming Comb (HMBC - 204) 43 gm,Warehouse C,104,89,2025-02-22 13:22:00,15
10606,ORD_10607,16446,Europred 5mg Tablet,Warehouse C,69,54,2025-02-22 10:36:00,15
10607,ORD_10608,30851,Biomox 500mg Capsule,Warehouse A,34,20,2025-02-22 20:12:00,14
10608,ORD_10609,24024,Morfik SP 100mg/325mg/15mg Tablet,Warehouse C,103,86,2025-02-22 05:55:00,17
10609,ORD_10610,2248,CZARTECH Native Back Cover for iPhone 14 Plus Clear case (TPU + Tough Polycarbonate Back I 5ft Drop Protection Tested I Tr...,Warehouse B,91,79,2025-02-22 10:15:00,12
10610,ORD_10611,6136,Makeup Revolution Super Serum Foundation F8.5 25 ml,Warehouse B,72,57,2025-02-22 14:43:00,15
10611,ORD_10612,8127,Alemox CV 500mg/125mg Tablet,Warehouse B,45,27,2025-02-22 22:10:00,18
10612,ORD_10613,34893,Alidoxime CV 200mg/125mg Tablet,Warehouse C,109,90,2025-02-22 05:48:00,19
10613,ORD_10614,29591,Sattva Multipurpose Printed Laptop Table | Study Table | Bed Table | Foldable and Portable | Wooden Table | Writing Desk |...,Warehouse C,104,99,2025-02-22 19:08:00,5
10614,ORD_10615,13558,Sivanna Colors Makeup Studio Nude Blush - HF3018 07 5 gm,Warehouse A,52,47,2025-02-22 21:52:00,5
10615,ORD_10616,35544,Furoway 250mg Tablet,Warehouse B,28,15,2025-02-22 17:01:00,13
10616,ORD_10617,27,Cefirax Kid 100mg Tablet DT,Warehouse B,22,13,2025-02-22 03:04:00,9
10617,ORD_10618,16505,Hapan 40mg Tablet,Warehouse B,32,20,2025-02-22 22:42:00,12
10618,ORD_10619,9131,Rexonac P Tablet,Warehouse B,26,19,2025-02-22 15:11:00,7
10619,ORD_10620,2637,"Milagro Beauty Velvet Makeup Sponge Soft Microfiber Bristles Cosmetic Puff Blender for Liquid, Cream, Dry Make Up Comes wi...",Warehouse B,58,49,2025-02-22 15:28:00,9
10620,ORD_10621,29655,AEIDESS Tempered Glass Screen Protector Compatible For iPhone 12 and for iPhone 12 Pro with Edge to Edge Coverage and Easy...,Warehouse B,77,63,2025-02-22 17:32:00,14
10621,ORD_10622,12519,"Microware Audio Video Capture Cards，HDMI to USB2.0 Full HD 1080p Record,via DSLR Camcorder Action Cam for High Definition ...",Warehouse C,17,4,2025-02-22 13:16:00,13
10622,ORD_10623,13559,Ajmal Musk Rose CP And Aurum CP & Ascend EDP Pack of 3 20 ml,Warehouse C,82,67,2025-02-22 15:40:00,15
10623,ORD_10624,35506,Fragrance Body Spray For Men (1000 sprays) - Adventure,Warehouse C,70,61,2025-02-22 17:24:00,9
10624,ORD_10625,34343,Yves Rocher Serum Vegetal Perfecting Toning Lotion For All Skin Types 200 ml,Warehouse C,19,5,2025-02-22 11:00:00,14
10625,ORD_10626,6055,"Consistent 8GB DDR3 Desktop RAM,1600MHz",Warehouse C,87,69,2025-02-22 17:10:00,18
10626,ORD_10627,33465,Hair Removal Cream For Sensitive Skin,Warehouse B,50,37,2025-02-22 21:52:00,13
10627,ORD_10628,10300,"GOVO GOBOLD 610 Bluetooth Wireless On Ear Headphone with Mic, 15H Play Time, 40MM Driver, Bluetooth 5.2, Passive Noise Can...",Warehouse A,86,79,2025-02-22 18:11:00,7
10628,ORD_10629,13014,Ompira 20 Capsule,Warehouse A,22,17,2025-02-22 03:14:00,5
10629,ORD_10630,13020,Plantas Pigmentation Defence Organic Face Cream 30 gm,Warehouse A,20,2,2025-02-22 17:50:00,18
10630,ORD_10631,9132,Coffrid AT Syrup,Warehouse C,58,42,2025-02-22 18:32:00,16
10631,ORD_10632,28355,"Acer Aopen 20CH1Q 19.5-Inch (49.53 Cm) HD Backlit LED LCD 1366 X 768 Pixels Monitor I 200 Nits Brightness I 5MS Response, ...",Warehouse C,98,89,2025-02-22 10:59:00,9
10632,ORD_10633,14910,Camlin Kokuyo Trinity Fountain Pen with 3-in-1 Mechanism (Color may vary),Warehouse C,85,76,2025-02-22 15:56:00,9
10633,ORD_10634,24116,Clear Glycerine Soap - Natural Toning (Tea Tree Oil & Honey),Warehouse A,110,97,2025-02-22 16:41:00,13
10634,ORD_10635,11642,Absolut Repair Lipidium Instant Reconstructing Masque,Warehouse A,79,60,2025-02-22 23:48:00,19
10635,ORD_10636,16462,Anudol 500mg/50mg Tablet,Warehouse B,100,82,2025-02-22 03:38:00,18
10636,ORD_10637,2414,"Plum Naturstudio All-Day-Wear Kohl Kajal, Matte Finish Black Brilliance With Free Sharpener, Smudge-Proof, Waterproof, 2-I...",Warehouse C,44,29,2025-02-22 09:47:00,15
10637,ORD_10638,34259,2-In-1 Anti-Dandruff Shampoo + Conditioner -  Cool Menthol,Warehouse B,43,35,2025-02-22 16:42:00,8
10638,ORD_10639,14985,Pikkme Redmi Note 9 Pro/Note 9 Pro Max/Poco M2 Pro/Redmi Note 10 Lite Flip Cover Leather Finish | Inside TPU with Card Poc...,Warehouse B,66,54,2025-02-22 03:52:00,12
10639,ORD_10640,26047,Kamz Beauty 4pcs/Set Professional Eye Brushes Set Foundation Mascara Blending Pencil Brushes Makeup Tools Cosmetic Black B...,Warehouse C,75,58,2025-02-22 06:57:00,17
10640,ORD_10641,5546,"ZEBRONICS DC Black ADAM Edition Sound Bomb 7 TWS Earbuds with 40H* Backup, Rapid Charge, 50ms Gaming Mode, ENC mic, Voice ...",Warehouse A,48,31,2025-02-22 15:20:00,17
10641,ORD_10642,4202,MI 80 cm (32 inches) 5A Series HD Ready Smart Android LED TV L32M7-5AIN (Black),Warehouse B,26,15,2025-02-22 07:57:00,11
10642,ORD_10643,24762,Osia Osia Jasmine Mogra 125 gm,Warehouse B,102,89,2025-02-22 21:23:00,13
10643,ORD_10644,18328,House Of Makeup Good On You Hydra Matte Lipstick - Pinkie Swear 3.5 gm,Warehouse C,110,97,2025-02-22 17:25:00,13
10644,ORD_10645,25166,Euroxim 100mg Tablet DT,Warehouse B,98,88,2025-02-22 03:13:00,10
10645,ORD_10646,10531,"TP-Link TL-WR820N 300 Mbps Single_Band Speed Wireless WiFi Router, Easy Setup, IPv6 Compatible, Supports Parent Control, G...",Warehouse B,44,28,2025-02-22 02:57:00,16
10646,ORD_10647,28578,Ralcet 5mg/5ml Syrup,Warehouse B,55,49,2025-02-22 19:25:00,6
10647,ORD_10648,3736,Yves Rocher Concentrated Shower Gel - Lavender Blackberry 100 ml,Warehouse A,38,23,2025-02-22 12:48:00,15
10648,ORD_10649,22592,Lotus Herbal Professional Phytorx Whitening & Brightening Cream (Set Of 2),Warehouse B,89,78,2025-02-22 21:18:00,11
10649,ORD_10650,20643,ADS White Radiance Face Powder Compact,Warehouse C,101,84,2025-02-22 13:44:00,17
10650,ORD_10651,18297,Melrox 500mg Tablet,Warehouse A,51,39,2025-02-22 18:36:00,12
10651,ORD_10652,5541,Soap - Coconut & Olive Oil,Warehouse B,35,26,2025-02-22 16:53:00,9
10652,ORD_10653,18294,Cifimark 100mg Tablet,Warehouse A,107,94,2025-02-22 00:32:00,13
10653,ORD_10654,2951,Emilos Tablet,Warehouse C,48,33,2025-02-22 05:49:00,15
10654,ORD_10655,28581,Fantastic Absolute,Warehouse C,73,65,2025-02-22 11:12:00,8
10655,ORD_10656,22598,Nucez MC Kid 2.5mg/4mg Tablet,Warehouse B,45,32,2025-02-22 20:50:00,13
10656,ORD_10657,1292,Finehart Tablet,Warehouse B,54,38,2025-02-22 17:58:00,16
10657,ORD_10658,10543,Chemitex-DX Syrup,Warehouse A,49,32,2025-02-22 11:04:00,17
10658,ORD_10659,32406,"TP-Link Deco E4 Whole Home Wi-Fi Mesh System, Seamless and Speedy(AC1200) 1200Mbps Wireless, Works with Amazon Echo/Alexa,...",Warehouse C,88,74,2025-02-22 13:17:00,14
10659,ORD_10660,28531,Synthopen 500mg/125mg Tablet,Warehouse B,100,82,2025-02-22 21:30:00,18
10660,ORD_10661,26036,Kid's 2+ Years Extra Soft Toothbrush,Warehouse B,21,13,2025-02-22 17:48:00,8
10661,ORD_10662,22544,Artedaz-L Tablet,Warehouse C,51,39,2025-02-22 22:20:00,12
10662,ORD_10663,24743,Amozo Sensor Protector Easy Fit Tempered Glass Screen Protector Guard for iPhone 14 Pro Max (with easy applicator) - Pack ...,Warehouse A,93,85,2025-02-22 06:13:00,8
10663,ORD_10664,28506,"boAt Rockerz 103 Pro Bluetooth in Ear Neckband with Beast Mode(40ms Low Latency), ENx Tech, ASAP Charge(Fast Charge), Upto...",Warehouse C,83,76,2025-02-22 05:49:00,7
10664,ORD_10665,4782,Loreal Paris Total Repair 5 Shampoo 1 Litre,Warehouse C,65,59,2025-02-22 11:39:00,6
10665,ORD_10666,1668,Tea Tree Shampoo - For Dandruff,Warehouse B,83,66,2025-02-22 22:33:00,17
10666,ORD_10667,15697,Uvxim-LB Tablet,Warehouse C,13,2,2025-02-22 21:39:00,11
10667,ORD_10668,34897,Simxen Massage Brush Bathing Brush Practical Back Cleaning Scrubber Silicone Bath Brush Multi-Function Body Long Handle Do...,Warehouse A,83,78,2025-02-22 13:48:00,5
10668,ORD_10669,30053,Mapperz Facial Cleaning Wash Puff Sponge Stick Face Cleansing Pad Sponge For Face Cleaning (pack of 12) (Multicolor),Warehouse A,46,37,2025-02-22 22:43:00,9
10669,ORD_10670,32527,Purifying Neem Facial Wipes,Warehouse A,105,89,2025-02-22 08:28:00,16
10670,ORD_10671,34410,Dell USB Wired Keyboard and Mouse Set (Black) KB216+MS116,Warehouse C,96,81,2025-02-22 13:51:00,15
10671,ORD_10672,24229,Edemase D 50mg/10mg Tablet,Warehouse A,110,98,2025-02-22 03:34:00,12
10672,ORD_10673,18798,BB Home Loofah Pink BH002 PNK 1pc + Dettol Honey Shea Butter Gel Nourish 250ml,Warehouse C,84,75,2025-02-22 20:14:00,9
10673,ORD_10674,13383,A Tron 2mg Injection,Warehouse B,51,35,2025-02-22 07:03:00,16
10674,ORD_10675,30578,Asocin OZ 200mg/500mg Tablet,Warehouse B,72,66,2025-02-22 17:08:00,6
10675,ORD_10676,2074,"Echo Dot (4th Gen, 2020 release)| Smart speaker with Alexa (Black)",Warehouse A,41,31,2025-02-22 01:25:00,10
10676,ORD_10677,520,Dole DM 10mg/40mg Tablet,Warehouse B,49,30,2025-02-22 07:16:00,19
10677,ORD_10678,3680,"2.5mm Male to 3.5mm Female / 3.5mm Female to 2.5mm Male Stereo Audio Adapter Headset Converter Connector for Smartphones, ...",Warehouse B,53,44,2025-02-22 20:12:00,9
10678,ORD_10679,35463,Vivapod 200mg Tablet DT,Warehouse B,69,52,2025-02-22 04:03:00,17
10679,ORD_10680,22178,Acelom-SP Tablet,Warehouse A,35,30,2025-02-22 16:36:00,5
10680,ORD_10681,24157,"Smart Watch Melbon M5 Smart Fitness Band & Activity Tracker, Heart Rate Sensor, Step Tracking All Android Device & iOS Dev...",Warehouse A,24,10,2025-02-22 17:30:00,14
10681,ORD_10682,22190,Thyrorich 150mcg Tablet,Warehouse B,52,41,2025-02-22 11:52:00,11
10682,ORD_10683,32800,"ILTPL - (1 PCS) Lady Fashion Small Size Stone Silver Colour Stone Bindi,Silver Stone Bindi for girls,women,ladies,Diamond ...",Warehouse B,100,92,2025-02-22 18:37:00,8
10683,ORD_10684,22185,Acerav P 100mg/325mg Tablet,Warehouse A,102,86,2025-02-22 16:53:00,16
10684,ORD_10685,18738,Telihep RS 40mg/10mg Tablet,Warehouse B,14,6,2025-02-22 12:52:00,8
10685,ORD_10686,13281,Clob gm Cream,Warehouse C,102,95,2025-02-22 09:23:00,7
10686,ORD_10687,22200,iClever GK08 Wireless USB Keyboard and Mouse Set - Type-C Rechargeable Wireless Keyboard Ergonomic Full Size Design with N...,Warehouse A,27,20,2025-02-22 21:49:00,7
10687,ORD_10688,20824,Trapsure P 325mg/37.5mg Tablet,Warehouse A,70,55,2025-02-22 00:03:00,15
10688,ORD_10689,4929,makeup fix powder compact 2 in 1 shine and matte compact in water proof long lasting paroduct need in daly use traveling,Warehouse A,61,50,2025-02-22 21:42:00,11
10689,ORD_10690,8347,"Classmate 2100128 Soft Cover 5 Subject Spiral Binding Notebook, Single Line, 250 Pages (Assorted cover design)",Warehouse B,100,81,2025-02-22 17:37:00,19
10690,ORD_10691,10188,Doubledicestore Tempered Glass Screen Protector Compatible for Redmi Note 12 pro 5G / Note 12 Pro Plus/Note 12 5G with Edg...,Warehouse C,87,79,2025-02-22 10:15:00,8
10691,ORD_10692,8351,Glynamic M 1 Forte Tablet SR,Warehouse B,42,33,2025-02-22 18:29:00,9
10692,ORD_10693,9308,Hepton Syrup,Warehouse A,53,47,2025-02-22 05:57:00,6
10693,ORD_10694,22201,Mouth Freshener,Warehouse C,58,49,2025-02-22 14:50:00,9
10694,ORD_10695,24695,"CP PLUS 2.4MP Full HD IR Dome Night Vision Camera, 3.6mm- 1080p CP-VAC-D24L2-V3",Warehouse B,53,48,2025-02-22 06:19:00,5
10695,ORD_10696,33096,Pure Skin Neem Facial Kit,Warehouse B,74,56,2025-02-22 01:04:00,18
10696,ORD_10697,13004,The Beauty Co. Body Wash Gel - Chocolate & Coffee 250 ml,Warehouse B,41,35,2025-02-22 16:30:00,6
10697,ORD_10698,30601,WildCard India 30Pcs Eyebrow Tattoo Needle With Cap Disposable Sterilized Tattoo Needle for Tattoo Pen Machine Microbladin...,Warehouse A,74,61,2025-02-22 18:07:00,13
10698,ORD_10699,6901,"Dry Shampoo - Instant Hair Refresh, Floral & Flirty Blush",Warehouse B,62,49,2025-02-22 04:02:00,13
10699,ORD_10700,10202,Geranium Essential Oil,Warehouse A,52,46,2025-02-22 21:48:00,6
10700,ORD_10701,14043,Procap 40mg Tablet,Warehouse C,43,25,2025-02-22 21:23:00,18
10701,ORD_10702,5610,Ajmal Silver Shade & Evoke silver Edition Homme & Carbon & Avid Deo & Ascend EDP Pack of 5 20 ml,Warehouse A,29,14,2025-02-22 10:25:00,15
10702,ORD_10703,35455,Vega Dressing Wooden Comb (HMWC - 22) 40 gm,Warehouse C,65,53,2025-02-22 08:07:00,12
10703,ORD_10704,8337,"Mi Type C 3Amp 100cm Fast Charge Cable Black|USB to Type C|Supports Upto 22.5W Fast Charging|Suitable for All Smartphones,...",Warehouse A,87,68,2025-02-22 15:15:00,19
10704,ORD_10705,3501,Aceknob-SP Tablet,Warehouse A,18,3,2025-02-22 13:51:00,15
10705,ORD_10706,999,The Skin Story New Keratin Repair & Strengthen Conditioner 250 gm,Warehouse B,97,84,2025-02-22 20:51:00,13
10706,ORD_10707,10158,Typam 0.25mg Tablet,Warehouse C,29,18,2025-02-22 13:44:00,11
10707,ORD_10708,12549,I AM EYECONIC 3D GLITTER ISSA POTION 4 gm,Warehouse A,35,29,2025-02-22 08:47:00,6
10708,ORD_10709,14863,Herbal  Sandalwood Massage Oil,Warehouse A,89,81,2025-02-22 13:04:00,8
10709,ORD_10710,18828,Karpasasthyadi Thailam,Warehouse B,99,87,2025-02-22 22:37:00,12
10710,ORD_10711,35440,Amika 500mg Injection,Warehouse B,77,67,2025-02-22 07:33:00,10
10711,ORD_10712,22129,"Ambrane Stringz 38 Wired Earphones with Mic, Powerful HD Sound with High Bass, Tangle Free Cable, Comfort in-Ear Fit, 3.5m...",Warehouse C,49,38,2025-02-22 23:48:00,11
10712,ORD_10713,5602,CELLUTION Back Camera Lens Protector Tempered Glass For Oneplus 11R (5G) Case Friendly with Edge to Edge Coverage and Easy...,Warehouse C,76,71,2025-02-22 22:26:00,5
10713,ORD_10714,16425,"upReale Professional 10"" inch LED Ring Light with 7 Ft Tripod Stand Combo | 3 color modes Dimmable | Lighting For Tiktok Y...",Warehouse A,20,7,2025-02-22 09:19:00,13
10714,ORD_10715,10141,TONYMOLY Mini Peach Lip Balm,Warehouse A,51,42,2025-02-22 01:13:00,9
10715,ORD_10716,36949,Kokino Injection,Warehouse C,50,37,2025-02-22 17:05:00,13
10716,ORD_10717,34379,"realme 9 5G SE (Starry Glow, 6GB RAM, 128GB Storage)",Warehouse C,19,1,2025-02-22 09:20:00,18
10717,ORD_10718,4891,Acilex P Suspension,Warehouse C,18,6,2025-02-22 20:46:00,12
10718,ORD_10719,4947,Sefdic SP 50mg/500mg/10mg Tablet,Warehouse C,30,20,2025-02-22 21:46:00,10
10719,ORD_10720,5604,Power - Fresh Breath Fluoride Toothpaste 100 g + Sensitive Toothpaste 2x80 g,Warehouse B,18,13,2025-02-22 04:33:00,5
10720,ORD_10721,28288,"O3+ Plunge Nail Paint Polish Lacquer, Silver Lining, 10 ml",Warehouse B,59,50,2025-02-22 03:02:00,9
10721,ORD_10722,4952,Zisan 500mg Injection,Warehouse C,57,52,2025-02-22 06:57:00,5
10722,ORD_10723,10150,Cantonide 40mg Injection,Warehouse A,66,51,2025-02-22 06:38:00,15
10723,ORD_10724,5601,Colorbar 24Hrs Wear Matte Finish Weightless Powder Foundation (9.5 g),Warehouse A,87,70,2025-02-22 17:50:00,17
10724,ORD_10725,18865,Raxcold-C Syrup,Warehouse A,59,43,2025-02-22 17:53:00,16
10725,ORD_10726,5600,"HORLICKS Health, Energy & Sports Nutrition Drink",Warehouse B,78,59,2025-02-22 07:12:00,19
10726,ORD_10727,36224,NEW Superdrug Raspberry Face Mask 10 ml,Warehouse A,88,71,2025-02-22 06:33:00,17
10727,ORD_10728,31860,"POCO M4 Pro 5G (Cool Blue, 4GB RAM 64GB Storage) Dual Sim 5G 50MP Dual Camera Setup 6.6 Inch FHD+ 90 Hz Display 5000 mAh H...",Warehouse C,82,70,2025-02-22 08:08:00,12
10728,ORD_10729,5969,Hair Removal Waxing Kit - Normal Skin,Warehouse A,106,90,2025-02-22 01:35:00,16
10729,ORD_10730,21942,Ayurvedic Neem Powder,Warehouse C,94,75,2025-02-22 07:50:00,19
10730,ORD_10731,34977,"APPETINA Hair Trimmer For Men Dragan Style Trimmer, Professional Hair Clipper, Adjustable Blade Clipper, Hair Trimmer and ...",Warehouse C,54,44,2025-02-22 07:50:00,10
10731,ORD_10732,10047,Stbotanica Pure Vetiver Essential Oil 15 ml,Warehouse A,22,14,2025-02-22 17:47:00,8
10732,ORD_10733,3233,"AmazonBasics HAMA299068 RJ45 Cat-5e Ethernet Patch/LAN Cable for Router (14 Feet/4.26 Meters, White)",Warehouse C,20,3,2025-02-22 06:46:00,17
10733,ORD_10734,21919,"PTron Solero TB301 3A Type-C Data and Fast Charging Cable, Made in India, 480Mbps Data Sync, Strong and Durable 1.5-Meter ...",Warehouse C,37,21,2025-02-22 11:54:00,16
10734,ORD_10735,28102,Power Glow Licorice Face Wash,Warehouse B,82,77,2025-02-22 17:01:00,5
10735,ORD_10736,18986,Sattva Portable Foldable Study Table with White Board | Laptop Table | Writing Desk with Cup Holder | for Kids & Adults,Warehouse C,59,50,2025-02-22 16:04:00,9
10736,ORD_10737,11686,Ustraa Cologne for Men - Tattoo 100 ml,Warehouse B,41,29,2025-02-22 17:02:00,12
10737,ORD_10738,22042,Ajmal Selfie Concentrated Perfume Oil Woody Aromatic And Maryaj Wild Stripes EDP Aromatic Oriental Perfume 110 ml,Warehouse C,65,53,2025-02-22 22:10:00,12
10738,ORD_10739,12562,MAPPERZ Stainless Steel False Eyelashes Extension Applicator Tool Fish Tail Clip Auxiliary Clip Tweezers Nipper Tool (Black),Warehouse C,35,29,2025-02-22 10:43:00,6
10739,ORD_10740,33082,"ACESHLEY Soft Silicon with Colour Metal Buckle Band, Strap Compatible with Noise ColorFit Pro 3 Smartwatch (Black)",Warehouse A,106,99,2025-02-22 08:01:00,7
10740,ORD_10741,3062,Faces Canada Perfect Blush Cocktail Peach 04 5g,Warehouse A,90,85,2025-02-22 16:27:00,5
10741,ORD_10742,31076,Eyeconic Kajal,Warehouse B,103,97,2025-02-22 13:34:00,6
10742,ORD_10743,8406,Vilaguard-M 500 Tablet SR,Warehouse B,56,47,2025-02-22 08:58:00,9
10743,ORD_10744,32789,Blast Inn Warp 65W Charging Cable 'Type-C to Type-C' Compatible with Oneplus 10T 5G New/Nord 2T 5G/10R 5G/10 Pro 5G/Nord C...,Warehouse A,25,12,2025-02-22 22:52:00,13
10744,ORD_10745,18923,"Doodle Adventures of The Mind Hard Bound Non Dated Diary (5.5 X 8.5 Inches, 80 GSM, 192 Ruled Perforated Pages) Birthday G...",Warehouse C,83,69,2025-02-22 16:58:00,14
10745,ORD_10746,18909,Vosep 500 Tablet,Warehouse C,70,64,2025-02-22 21:44:00,6
10746,ORD_10747,5982,boAt Bassheads 100 in Ear Wired Earphones with Mic(Furious Red),Warehouse C,51,44,2025-02-22 00:58:00,7
10747,ORD_10748,13385,"Dynotrek Grade 15.6 Inch Laptop Sleeve Case Cover with Charger Pouch for Inspiron 15 VivoBook/Chromebook/ROG/Zenbook, MacB...",Warehouse C,57,46,2025-02-22 21:35:00,11
10748,ORD_10749,16359,"PiBOX India , USB C to HDMI VGA USB Adapter, Aluminium Type C USB hub 3.1 to HDMI 4K/VGA /USB 3.0/USB C Converter Cable Ch...",Warehouse A,46,32,2025-02-22 10:07:00,14
10749,ORD_10750,18904,"Kadence Guitar Stand Folding, Tripod, Metal Universal for Acoustic guitar, Electric Guitars, Ukulele, Violin, Banjo and Ma...",Warehouse A,16,8,2025-02-22 19:50:00,8
10750,ORD_10751,20374,Bonjour Paris Photo Match Crayon Concealer - Ivory 3.2 gm,Warehouse B,95,86,2025-02-22 18:23:00,9
10751,ORD_10752,32033,Urban Gabru Hair Growth Serum Oil - Power of Castor Oil & Pro Vitamin B5 60 ml,Warehouse A,86,74,2025-02-22 16:16:00,12
10752,ORD_10753,10130,Glimmer Premium Nail Enamel Neon Pink 10 ml,Warehouse C,108,96,2025-02-22 16:27:00,12
10753,ORD_10754,1009,"Kesari Shakti Kalp Chyawanprash - Immunity Booster With Gold, Silver & Saffron",Warehouse C,73,64,2025-02-22 02:26:00,9
10754,ORD_10755,34963,Hola TF 700 Corded Speaker Phone with Caller ID (CLI) and Two Way Speakerphone Function Supported by Date/Time Display (Bl...,Warehouse B,94,83,2025-02-22 10:07:00,11
10755,ORD_10756,20816,"Duracell USB Type C, 3A Braided Sync & Fast Charging Cable, 3.9 Ft (1.2M), QC 2.0/3.0 Ultra Fast Charging, Compatible with...",Warehouse C,90,72,2025-02-22 15:41:00,18
10756,ORD_10757,24212,Flormar Color Up Lip Crayon 05 Bright Orange 3.2 gm,Warehouse A,65,53,2025-02-22 08:06:00,12
10757,ORD_10758,36391,Flutigo Plus 40mg/10mg Tablet,Warehouse B,109,98,2025-02-22 01:51:00,11
10758,ORD_10759,27299,Kodak Photo Paper High Gloss 200 GSM A4 Size 100 sheets,Warehouse C,114,99,2025-02-22 19:22:00,15
10759,ORD_10760,19035,HAPYSA World Map Extra Large Extended Anti Slip Rubber Gaming Mouse Pad & Keyboard Desk Mat for PC Computer Laptop,Warehouse A,46,33,2025-02-22 18:39:00,13
10760,ORD_10761,35360,Pure & Light Tan Removal Choco Cherry Scrub,Warehouse B,21,11,2025-02-22 03:33:00,10
10761,ORD_10762,31924,Biotique Bio Bhringraj Therapeutic Oil for Falling Hair 120 ml,Warehouse C,78,66,2025-02-22 03:59:00,12
10762,ORD_10763,34795,"TP-Link WiFi 6 AX1500 Mbps Archer AX10,Smart WiFi,Triple-Core CPU, Gigabit, Dual-Band OFDMA, MU-MIMO, Compatible with Alex...",Warehouse C,74,58,2025-02-22 17:44:00,16
10763,ORD_10764,2594,Repair & Protect Sensitive Toothpaste,Warehouse C,18,5,2025-02-22 01:34:00,13
10764,ORD_10765,16315,Maha Bhringraj Hair Oil,Warehouse C,96,81,2025-02-22 05:41:00,15
10765,ORD_10766,34974,House Of Makeup Good On You Hydra Matte Lipstick - Zen Zinnia 3.5 gm,Warehouse B,69,53,2025-02-22 19:38:00,16
10766,ORD_10767,13489,Wottagirl Moisturizing Lotion,Warehouse A,58,52,2025-02-22 16:03:00,6
10767,ORD_10768,4139,Pt-Zole 40mg Tablet,Warehouse C,68,62,2025-02-22 11:05:00,6
10768,ORD_10769,3421,Medimade Pink Rose Moisturising Cream (Pack of 2) 1's,Warehouse C,30,22,2025-02-22 03:24:00,8
10769,ORD_10770,5973,Valdini 200mg/87mg Tablet CR,Warehouse B,68,51,2025-02-22 01:32:00,17
10770,ORD_10771,24663,TRESemme Climate Control Shampoo 580 ml,Warehouse C,106,95,2025-02-22 00:49:00,11
10771,ORD_10772,20336,Glimmer Nail Polish Mojito 5 ml,Warehouse C,81,76,2025-02-22 12:24:00,5
10772,ORD_10773,16327,"HP x306w 128GB USB 3.2 Pen Drive, Silver",Warehouse C,24,6,2025-02-22 09:53:00,18
10773,ORD_10774,35390,Gavimont Syrup,Warehouse B,93,88,2025-02-22 10:40:00,5
10774,ORD_10775,28147,Fashionury Silicone OnePlus Nord CE 2 5G Case Transparent Flexible Soft Back Case Cover for OnePlus Nord CE 2 5G,Warehouse A,82,77,2025-02-22 11:21:00,5
10775,ORD_10776,21985,Carolox AD 250 mg/250 mg Capsule,Warehouse C,93,76,2025-02-22 05:36:00,17
10776,ORD_10777,35373,Fashion Colour Face and Body Hi-Lite Bronzer (Shade 08),Warehouse A,46,32,2025-02-22 10:18:00,14
10777,ORD_10778,30629,Ranslevo 5 Tablet,Warehouse C,55,40,2025-02-22 15:16:00,15
10778,ORD_10779,8466,"Clapbox Cajon CB02 Flow -Black, Oak Wood (H:50 W:30 L:30) - 3 Internal Snares",Warehouse B,94,79,2025-02-22 01:32:00,15
10779,ORD_10780,26400,ZARPA (LABEL) Floral 19 Cms Cosmetic Pouch (Standard_bb - 6324_multi color),Warehouse A,74,57,2025-02-22 12:39:00,17
10780,ORD_10781,2315,"Amazon Brand - Solimo Polycarbonate, Thermoplastic Polyurethane Back Cover for OnePlus 9R (Soft & Flexible Back Cover) Tra...",Warehouse C,117,99,2025-02-22 00:44:00,18
10781,ORD_10782,21899,"(Renewed) boAt Rockerz 255 Pro+ in-Ear Earphones with 40 Hours Battery, ASAP Charge, IPX7, Bluetooth Version 5.0, 10mm Dri...",Warehouse C,62,52,2025-02-22 22:14:00,10
10782,ORD_10783,13387,Active Care Lip Balm - SPF For 24h Moisture,Warehouse C,63,55,2025-02-22 18:26:00,8
10783,ORD_10784,33051,MOBITUSSION Shockproof Flexible Matte Square Pattern Silicon TPU Camera Protection Back Cover Compatible for iPhone 11 (Pu...,Warehouse C,86,80,2025-02-22 18:31:00,6
10784,ORD_10785,5018,19MM Smart Watch Strap Compatible for BOAT STORM 1.3 with Silver Buckle Lock (BLACK),Warehouse C,25,9,2025-02-22 04:14:00,16
10785,ORD_10786,8483,Tough Lee Tempered Glass Screen Guard Protector for Samsung Galaxy Watch 4 44MM / Samsung Galaxy Watch 5 44MM / Realme Wat...,Warehouse C,99,82,2025-02-22 11:13:00,17
10786,ORD_10787,14800,Altraphen 1000mg Infusion,Warehouse C,54,45,2025-02-22 05:36:00,9
10787,ORD_10788,11636,Nourish & Replenish Conditioner,Warehouse C,19,11,2025-02-22 00:05:00,8
10788,ORD_10789,14821,Amislor 50mg Tablet,Warehouse B,98,82,2025-02-22 16:54:00,16
10789,ORD_10790,5493,Fulfresh 5mg Syrup,Warehouse C,111,98,2025-02-22 12:53:00,13
10790,ORD_10791,8907,Cuten 250 Tablet,Warehouse B,42,33,2025-02-22 04:26:00,9
10791,ORD_10792,31890,DPISZONE Adjustable Safe Soft Bathing Baby Shower Cap Wash Hair For Children Baby Eye Ear Protector Adjustable Leaves Shap...,Warehouse C,57,39,2025-02-22 11:33:00,18
10792,ORD_10793,15639,Fycef D 200mg/500mg Tablet,Warehouse B,20,15,2025-02-22 23:15:00,5
10793,ORD_10794,14288,Winble Back Cover for iPhone 14 Pro Case | Metal Camera Guard Acrylic Clear Protective Back | Back Cover Case for iPhone 1...,Warehouse B,71,61,2025-02-22 14:35:00,10
10794,ORD_10795,2485,Paradic-SP Tablet,Warehouse A,104,92,2025-02-22 22:56:00,12
10795,ORD_10796,19980,SupCares Edge to Edge Tempered Glass for Samsung Galaxy S22 and Galaxy S23 (6.1 Inch) with Easy Self Installation Kit | Black,Warehouse B,11,4,2025-02-22 04:40:00,7
10796,ORD_10797,21133,Maybelline New York Biphase Make-Up Remover 40 ml,Warehouse B,79,70,2025-02-22 04:49:00,9
10797,ORD_10798,2921,"Epyz Derma Roller With 540 Titanium Alloy Needles (1.00mm, Golden)",Warehouse A,16,11,2025-02-22 03:37:00,5
10798,ORD_10799,35094,Sedell Lipstick Dark Wine (Matte),Warehouse A,74,57,2025-02-22 04:26:00,17
10799,ORD_10800,30937,"Nokia 2660 Flip 4G Volte keypad Phone with Dual SIM, Dual Screen, inbuilt MP3 Player & Wireless FM Radio | Black",Warehouse B,97,91,2025-02-22 17:20:00,6
10800,ORD_10801,1973,"SESDERMA C-Vit Radiance Glowing Liquid Fluid, 50ml",Warehouse C,81,74,2025-02-22 10:25:00,7
10801,ORD_10802,32919,Hair Claw Clips:2 Pcs Gold Hair Clips for Thick Hair Metal Hair Claw Clips Long Hair Clips Big Jaw Clips for Hair Butterfl...,Warehouse A,22,16,2025-02-22 09:58:00,6
10802,ORD_10803,27503,Poji D 30mg/40mg Capsule SR,Warehouse A,23,4,2025-02-22 14:28:00,19
10803,ORD_10804,367,Cipbid 250mg Tablet,Warehouse A,50,35,2025-02-22 01:25:00,15
10804,ORD_10805,12104,D2Q Wired Original Galaxy In Ear Earphones for All Samsung Smartphones with Mic | Pure Bass Sound | One Button Multi-Funct...,Warehouse C,83,70,2025-02-22 03:04:00,13
10805,ORD_10806,21459,"Quantum Wireless Mouse with Upto 12 Months Battery Life(Cell Included), Silent Keys, 800/1200/1600 DPI, USB Nano Receiver,...",Warehouse A,37,19,2025-02-22 13:22:00,18
10806,ORD_10807,431,Acikinz-SP Tablet,Warehouse C,98,89,2025-02-22 21:52:00,9
10807,ORD_10808,24893,Dersidic B Cream,Warehouse B,32,24,2025-02-22 23:05:00,8
10808,ORD_10809,19949,Sulpidon 100 Tablet,Warehouse A,75,61,2025-02-22 00:31:00,14
10809,ORD_10810,36344,"Nivea Deodorant, Fresh Flower for Women, 150ml",Warehouse A,12,1,2025-02-22 18:42:00,11
10810,ORD_10811,24549,Rosetab 10mg Tablet,Warehouse B,46,39,2025-02-22 23:53:00,7
10811,ORD_10812,31952,M-Xone Injection,Warehouse C,28,18,2025-02-22 04:47:00,10
10812,ORD_10813,20007,TARKAN Foldable Wooden Laptop Desk for Bed (Walnut Black),Warehouse A,53,35,2025-02-22 07:53:00,18
10813,ORD_10814,27479,HP 802 Small Ink Cartridge - Tri-color,Warehouse A,58,46,2025-02-22 06:44:00,12
10814,ORD_10815,2000,Vega Eye Applicator (MBP - 11) 16 gm,Warehouse C,98,87,2025-02-22 23:37:00,11
10815,ORD_10816,10,Karpooradi Thailam,Warehouse B,16,4,2025-02-22 21:49:00,12
10816,ORD_10817,36861,Ajmal Aurum Blu Wisal Deodorant Spray (Pack of 3) 200 ml,Warehouse A,27,21,2025-02-22 05:17:00,6
10817,ORD_10818,20097,Afiner Simple Plain Round Multicolour Forehead Sticker 240 pcs bindis kumkum Spiral Bindi Booklet For Women & Girls (Mediu...,Warehouse C,83,66,2025-02-22 15:43:00,17
10818,ORD_10819,9484,"VINAURA Professional Eyeliner Brush, Gel/Liquid Eyeliner Applicator with Pointed Tip | Makeup | Eye make up 1pc(Eyeliner B...",Warehouse B,21,13,2025-02-22 14:29:00,8
10819,ORD_10820,24541,"TRue FRoG Uplifting Under Eye Gel for Dark Circles, Puffy Eyes, Wrinkles & Removal of Fine Lines for Women & Men, 20 gm",Warehouse A,42,24,2025-02-22 03:35:00,18
10820,ORD_10821,29722,Laxinol H,Warehouse C,73,54,2025-02-22 07:19:00,19
10821,ORD_10822,3492,Citinerve 250mg Injection,Warehouse C,21,5,2025-02-22 22:49:00,16
10822,ORD_10823,26769,Meaxon Injection,Warehouse C,77,65,2025-02-22 19:40:00,12
10823,ORD_10824,9735,Yantralay School Of gadgets Reversible 2 Side Neoprene Waterproof DSLR Camera Liner Case Cover Pouch Compatible with All D...,Warehouse B,16,10,2025-02-22 21:03:00,6
10824,ORD_10825,19602,Bathing Soap - Lavender & Milk Cream,Warehouse C,104,86,2025-02-22 16:12:00,18
10825,ORD_10826,30137,Moxiclox 250mg/250mg Capsule,Warehouse C,64,56,2025-02-22 23:15:00,8
10826,ORD_10827,35205,"HP 15s, 11th Gen Intel Core i3 8GB RAM/1TB HDD+256 GB SSD 15.6-inches/39.6 cm FHD Laptop/Windows 11/Intel UHD Graphics/Dua...",Warehouse A,87,77,2025-02-22 07:57:00,10
10827,ORD_10828,4015,Amozo Designed for iPhone 14 Pro Cover | Ultra Hybrid Drop and Camera Protection Back Cover Case for iPhone 14 PRO (TPU + ...,Warehouse A,103,94,2025-02-22 00:49:00,9
10828,ORD_10829,5223,"Store2508 Illuminated Chrome Finish Round Makeup Mirror With Bright Led Light With 16 Leds And Battery Powered (Nq119, 11C...",Warehouse A,42,34,2025-02-22 11:43:00,8
10829,ORD_10830,16103,Pikkme Samsung Galaxy S21 FE 5G Back Cover | Crystal Clear Transparent Back | Ultra Hyrbid | Full Camera Protection | Rais...,Warehouse A,29,20,2025-02-22 17:43:00,9
10830,ORD_10831,21391,Ajmal Avid And Magnetize Deodorants Pack of 2 200 ml,Warehouse B,113,99,2025-02-22 20:39:00,14
10831,ORD_10832,1451,Lofidol-SP Tablet,Warehouse A,30,16,2025-02-22 15:32:00,14
10832,ORD_10833,21393,Prorab-D Capsule SR,Warehouse B,95,76,2025-02-22 06:36:00,19
10833,ORD_10834,36755,I AM EYECONIC FINE GLITTER FINAL BOARDING 4 gm,Warehouse A,29,23,2025-02-22 18:42:00,6
10834,ORD_10835,5769,Elivish 25mg Tablet,Warehouse B,85,70,2025-02-22 12:59:00,15
10835,ORD_10836,19656,SKYVIK SIGNI X Mobile Camera 20x Macro Lens Kit,Warehouse B,19,4,2025-02-22 08:57:00,15
10836,ORD_10837,30993,AmazingHind Leatherette Files for documents.File folders for documents.Certificate File Holder to Store Your documents (B...,Warehouse A,83,72,2025-02-22 21:31:00,11
10837,ORD_10838,5413,Grof OZ 200mg/500mg Tablet,Warehouse B,21,12,2025-02-22 14:00:00,9
10838,ORD_10839,36315,Essential Souls Toner - Morning Glow 100 ml,Warehouse A,60,52,2025-02-22 00:08:00,8
10839,ORD_10840,20988,Maczed 250mg Tablet,Warehouse C,98,92,2025-02-22 08:12:00,6
10840,ORD_10841,19652,Orpat OT 400T/400GT Calculator (White/Grey),Warehouse C,32,22,2025-02-22 00:41:00,10
10841,ORD_10842,19650,Kinsound USB Type C to 3.5 mm Audio Jack Connector with 32bit Hi-Res Hi-Res DAC Headphone Converter Adapter for Samsung Ga...,Warehouse C,72,63,2025-02-22 03:29:00,9
10842,ORD_10843,1445,Cipam Plus Tablet,Warehouse C,105,90,2025-02-22 09:16:00,15
10843,ORD_10844,21410,Flutycandy 200mg Capsule,Warehouse C,87,82,2025-02-22 12:57:00,5
10844,ORD_10845,19643,"Gizga Essentials Earphone Carrying Case, Multi-Purpose Pocket Storage Travel Organizer for Earphones, Headset, Pen Drives,...",Warehouse B,15,3,2025-02-22 04:01:00,12
10845,ORD_10846,5773,Kecin 500mg Injection,Warehouse C,53,40,2025-02-22 07:12:00,13
10846,ORD_10847,30132,"Apple Watch Series 8 [GPS 45 mm] Smart Watch w/Midnight Aluminium Case with Midnight Sport Band. Fitness Tracker, Blood Ox...",Warehouse A,45,33,2025-02-22 15:59:00,12
10847,ORD_10848,31982,Leekof DX Syrup,Warehouse B,33,26,2025-02-22 07:12:00,7
10848,ORD_10849,26706,Burnol Antiseptic Solution - Multipurpose Disinfectant Liquid,Warehouse B,75,56,2025-02-22 00:19:00,19
10849,ORD_10850,30720,URBN 4 in 1 Quad Cable | 100W PD | Apple MFi Certified Type C to Lightning|USB to LTG|Type C to C|Flat Cable|Made for Mobi...,Warehouse B,61,55,2025-02-22 09:23:00,6
10850,ORD_10851,36311,MCB Forte Injection,Warehouse A,79,61,2025-02-22 18:07:00,18
10851,ORD_10852,24560,Maxol-MR Tablet,Warehouse B,26,15,2025-02-22 22:15:00,11
10852,ORD_10853,8948,Serase 10mg Tablet,Warehouse C,85,77,2025-02-22 08:22:00,8
10853,ORD_10854,32733,Sivanna Shimmer Face Highlighter,Warehouse C,82,73,2025-02-22 00:40:00,9
10854,ORD_10855,19861,"Offbeat® - DASH 2.4GHz Wireless + Bluetooth 5.1 Mouse, Multi-Device Dual Mode Slim Rechargeable Silent Click Buttons Wirel...",Warehouse B,72,63,2025-02-22 18:35:00,9
10855,ORD_10856,6793,Ajmal Wisal Dhahab & Wisal Deo & Aretha EDP Pack of 3 20 ml,Warehouse A,67,53,2025-02-22 17:57:00,14
10856,ORD_10857,27558,Vega Set Of 3 Comb (HCS - 04) 78 gm,Warehouse C,116,99,2025-02-22 21:19:00,17
10857,ORD_10858,9479,Alifiya Polyester Tablet Sleeve/Laptop Sleeve Bag/Case Cover Upto 11.6 inch for iPad/Samsung Galaxy/Lenovo (Grey_L20),Warehouse C,75,57,2025-02-22 09:05:00,18
10858,ORD_10859,27526,Glitter Eye Liner (Pack of 3) Silver Blue Rosegold,Warehouse C,86,81,2025-02-22 11:01:00,5
10859,ORD_10860,19923,Mehndi - Brown,Warehouse B,108,95,2025-02-22 08:20:00,13
10860,ORD_10861,30947,Drota-MF Tablet,Warehouse A,74,66,2025-02-22 00:27:00,8
10861,ORD_10862,24901,"Cosmic Byte Asteroid Laptop Cooling Pad, Adjustable Height, 5 Fan Design, LED Light, USB Ports, Support Upto 17"" laptops (...",Warehouse A,40,32,2025-02-22 16:34:00,8
10862,ORD_10863,6786,Emanzen N 100mg/15mg Tablet,Warehouse B,56,51,2025-02-22 03:48:00,5
10863,ORD_10864,5400,SH. HUDA Professional Makeup Liquid Matte Minis Lipstick Red Edition Pack of 4 (Multicolor),Warehouse B,64,58,2025-02-22 03:53:00,6
10864,ORD_10865,11884,"Western Digital WD Blue SA510 SATA 500GB, Up to 560MB/s, 2.5 Inch/7 mm, 5Y Warranty, Internal Solid State Drive (SSD) (WDS...",Warehouse C,85,77,2025-02-22 09:13:00,8
10865,ORD_10866,32708,"Vivo Y16 (Stellar Black, 3GB RAM, 64GB Storage) with No Cost EMI/Additional Exchange Offers",Warehouse A,48,29,2025-02-22 06:44:00,19
10866,ORD_10867,2911,"Aroma® NB119 Titanium Bluetooth Wireless Headset In Ear Neckband with Long Lasting Playtime 48 Hrs, Smart Voice Assistant,...",Warehouse C,21,10,2025-02-22 08:12:00,11
10867,ORD_10868,14593,Wipro 3 way multiplug with built in Surge Protector,Warehouse A,48,37,2025-02-22 17:13:00,11
10868,ORD_10869,20123,Makeup Revolution Colour Play Soulful Eyeshadow Palette 5.2 gm,Warehouse A,54,47,2025-02-22 10:01:00,7
10869,ORD_10870,26792,"Sery Aurora Eye Shadow Palette - 9 In 1 Matt, Cosmo Delight EPS - 01 9.9 gm",Warehouse B,22,3,2025-02-22 11:12:00,19
10870,ORD_10871,11873,Doxyzom A 400mg/30mg Tablet,Warehouse A,107,94,2025-02-22 03:39:00,13
10871,ORD_10872,32928,Osteodol 325 mg/37.5 mg Tablet,Warehouse C,101,94,2025-02-22 14:05:00,7
10872,ORD_10873,5324,"Meyaar Silicone Replacement Bands Compatible with Fitbit Versa/Versa 2 / Versa Lite, & for Boat Xtend smartwatch Adjustabl...",Warehouse C,58,46,2025-02-22 03:13:00,12
10873,ORD_10874,9743,3D Temporary Tattoo Arrows Design Size 10.5x6CM - 1PC.,Warehouse C,94,76,2025-02-22 20:17:00,18
10874,ORD_10875,2471,LipiWorld® RM-1180M -1(N2QAYB000823 N2QAYB000486 N2QAYB000820 N2QAYB000487 N2QAYB000752 N2QAYB000572) Remote Compatible wi...,Warehouse B,61,48,2025-02-22 11:39:00,13
10875,ORD_10876,33672,Lakme Color Crush Nailart S1 6 Ml,Warehouse C,48,31,2025-02-22 08:10:00,17
10876,ORD_10877,19262,Cool Almond Drops Hair Oil,Warehouse B,25,11,2025-02-22 21:26:00,14
10877,ORD_10878,177,Moxyviz 625 Tablet,Warehouse B,78,66,2025-02-22 04:09:00,12
10878,ORD_10879,32476,Bendiflox 200mg Tablet,Warehouse B,67,55,2025-02-22 07:13:00,12
10879,ORD_10880,34497,AMACOOL 5000mAh Rechargeable Neck Fan 21 Working Hours Max 4 Speeds (Black),Warehouse A,46,35,2025-02-22 02:43:00,11
10880,ORD_10881,34676,HP 158A Black Original Laserjet Toner Reload Kit,Warehouse A,34,29,2025-02-22 06:29:00,5
10881,ORD_10882,2514,AmazonBasics Compact Portable Digital Tyre Inflator with Carrying Case,Warehouse B,78,65,2025-02-22 03:15:00,13
10882,ORD_10883,5693,Exil LS Syrup Cherry,Warehouse B,48,41,2025-02-22 22:39:00,7
10883,ORD_10884,2513,Bella Vita Organic Multani Mitti Ubtan Plus Face Glow Pack 60 gm,Warehouse B,14,4,2025-02-22 00:15:00,10
10884,ORD_10885,26852,"Apple 2022 10.9-inch iPad (Wi-Fi, 64GB) - Blue (10th Generation)",Warehouse C,34,23,2025-02-22 18:28:00,11
10885,ORD_10886,9507,Goldmedal Curve Plus 202042 Plastic Spice 3-Pin 240V Universal Travel Adaptor (White),Warehouse A,93,82,2025-02-22 04:00:00,11
10886,ORD_10887,6962,"Western Digital 1TB Elements Portable SSD, 400MB/s R, Upto 2 Meter Drop Protection, PC & MAC Compatible, 3 Y Warranty (WDB...",Warehouse A,103,91,2025-02-22 04:09:00,12
10887,ORD_10888,14560,"ESR Boost Phone Kickstand, Vertical and Horizontal Stand, Adjustable Angle, Compatible with iPhone 14/14 Plus/14 Pro/14 Pr...",Warehouse C,65,60,2025-02-22 00:27:00,5
10888,ORD_10889,29926,Sepodine Ointment,Warehouse A,68,52,2025-02-22 12:52:00,16
10889,ORD_10890,30930,Necob Plus Injection,Warehouse C,60,51,2025-02-22 09:02:00,9
10890,ORD_10891,32915,"3M Scotch Magic Tape Roll with Refillable Dispenser | 1.9cm x 32.9 meter | Invisible, writable and hand tearable | For sch...",Warehouse C,28,9,2025-02-22 23:44:00,19
10891,ORD_10892,29933,Doubledicestore Tempered Glass Screen Protector Compatible for Redmi Note 9 Pro/Note 9 Pro Max/Note 10 Pro/Note 10 Pro Max...,Warehouse A,105,93,2025-02-22 03:53:00,12
10892,ORD_10893,2492,OpenTech® Tempered Glass Screen Protector Compatible with OnePlus Nord CE 2 5G (2022) with Edge to Edge Coverage and Easy ...,Warehouse C,46,27,2025-02-22 11:51:00,19
10893,ORD_10894,2002,Danavish Rosuvastatin+Aspirin 10mg/75mg Capsule,Warehouse B,10,3,2025-02-22 01:49:00,7
10894,ORD_10895,24865,Lapster Anti-Slip Silicone Ear Buds 4Pieces Silicone Earphone Ear Hooks Plugs for in-Ear Neckband 9MM-13MM Black,Warehouse A,88,69,2025-02-22 15:15:00,19
10895,ORD_10896,30115,Shbpin 10mg Tablet,Warehouse B,50,40,2025-02-22 10:45:00,10
10896,ORD_10897,20130,"Charcoal Face Pack Anti-Pollution & Blackhead - Wash Off Face Mask, Black",Warehouse A,30,25,2025-02-22 02:47:00,5
10897,ORD_10898,14251,Colorbar Lux Nail Lacquer Cbn1246 12 Ml,Warehouse B,94,79,2025-02-22 02:50:00,15
10898,ORD_10899,6773,Refreshing Perfumed Body Spray - Silver,Warehouse A,117,99,2025-02-22 20:08:00,18
10899,ORD_10900,19840,"ULANZI VL49 RGB Video, LED Camera Light 360° Full Color Portable Photography Lighting with 3 Cold Shoe, 2000mAh Rechargeab...",Warehouse C,113,98,2025-02-22 04:51:00,15
10900,ORD_10901,26780,Ethilox CV 1000mg/200mg Injection,Warehouse B,35,18,2025-02-22 16:15:00,17
10901,ORD_10902,31439,Toothbrush - Kids (Soft),Warehouse A,103,98,2025-02-22 12:40:00,5
10902,ORD_10903,3594,Herbal Mint & Cucumber Face Spray,Warehouse C,22,6,2025-02-22 19:18:00,16
10903,ORD_10904,3115,Texas Instruments BA II Plus Financial Calculator | Prompt 10-Digit Display | with Cash Flow Analysis & Advanced List Base...,Warehouse A,71,64,2025-02-22 08:43:00,7
10904,ORD_10905,36330,Deodorant Body Spray - Sweet (Woody Bouquet),Warehouse B,25,9,2025-02-22 16:34:00,16
10905,ORD_10906,19829,"Boya BY-M1 Pro Omnidirectional Lavalier Condenser Microphone with Gain control, Headphone-out, Noise cancellation for iPho...",Warehouse A,20,15,2025-02-22 22:38:00,5
10906,ORD_10907,24920,Wayona USB Type C 6FT 2Meter Charger Cable Fast Charging USB C Cable Compatible for Samsung Galaxy S10e S20 S9 S8 Plus S1...,Warehouse A,29,18,2025-02-22 00:47:00,11
10907,ORD_10908,1372,Arther 150mg Injection,Warehouse B,61,42,2025-02-22 06:43:00,19
10908,ORD_10909,8843,"Juarez Lindenwood Acoustic Guitar, 38 Inches Curved Body Cutaway, 38CUR With Bag, Strings, Pick And Strap (Black)",Warehouse B,69,52,2025-02-22 03:54:00,17
10909,ORD_10910,24924,Cobalyte 1500mcg Injection,Warehouse C,101,91,2025-02-22 12:26:00,10
10910,ORD_10911,21267,"Blaupunkt Newly Launched SBA15 14W Bluetooth Soundbar I 2000 mAh Battery I TurboVolt Charging I AUX, Bluetooth, USB & TWS ...",Warehouse A,97,83,2025-02-22 09:45:00,14
10911,ORD_10912,21018,Fashion Colour Coconut Foaming Face Wash 150 ml,Warehouse C,93,82,2025-02-22 07:55:00,11
10912,ORD_10913,24426,Zenil 50mg Tablet,Warehouse A,33,22,2025-02-22 14:33:00,11
10913,ORD_10914,12703,Losed 2mg Tablet,Warehouse C,41,24,2025-02-22 09:42:00,17
10914,ORD_10915,12496,"TP-Link NFC-Enabled Bluetooth 4.1 Music Receiver, Wireless Audio Adapter Streaming Music from Echo Smart Phone Tablet PC t...",Warehouse B,106,88,2025-02-22 08:36:00,18
10915,ORD_10916,30186,"NIVEA DEEP IMPACT & DEEP IMPACT #457 Deodorant Roll-on - For Men & Women (50 ml, Pack of 2)",Warehouse B,73,65,2025-02-22 20:07:00,8
10916,ORD_10917,28415,Omron Karada Scan Body Composition Monitor HBF-375,Warehouse B,89,80,2025-02-22 19:24:00,9
10917,ORD_10918,31912,L'Amante Intensity Eau De Parfum - Perfume For Women,Warehouse C,24,10,2025-02-22 19:47:00,14
10918,ORD_10919,12182,Rosunik F 160mg/10mg Tablet,Warehouse B,54,38,2025-02-22 21:42:00,16
10919,ORD_10920,28419,Reoflox 400mg Tablet,Warehouse A,65,52,2025-02-22 11:44:00,13
10920,ORD_10921,29635,MADES Hair Care Wonder Volume Conditioner Luxurious Lifting 75 ml,Warehouse A,38,33,2025-02-22 13:26:00,5
10921,ORD_10922,5505,Beauty People Pure Matte Lipstick - Pink - Flushed - 415 3.8 gm,Warehouse A,64,53,2025-02-22 00:32:00,11
10922,ORD_10923,36832,Pantoflam CT 3mg/40mg Capsule SR,Warehouse A,16,5,2025-02-22 05:38:00,11
10923,ORD_10924,9278,Betacard H 50 mg/12.5 mg Tablet,Warehouse B,22,17,2025-02-22 19:15:00,5
10924,ORD_10925,12791,"ZEBRONICS Zeb-Evolve 5.0 Bluetooth Wireless in Ear Earphones with Mic with Voice Assistant, Rapid Charge, Dual Pairing, Ca...",Warehouse A,40,34,2025-02-22 22:57:00,6
10925,ORD_10926,250,CLAVIER Super Bass in-Ear Earphones with Mic for All Smartphones with Rich Bass & Noise Cancellation (Black),Warehouse B,60,54,2025-02-22 21:52:00,6
10926,ORD_10927,32056,Clatis 250mg Tablet,Warehouse C,54,37,2025-02-22 12:41:00,17
10927,ORD_10928,28402,"HP Deskjet 1212 Printer for Home for Dependable Printing, Simple Setup for Everyday Usage, Ideal for Home.",Warehouse C,49,36,2025-02-22 07:29:00,13
10928,ORD_10929,36666,Pome 200mg Tablet,Warehouse C,81,65,2025-02-22 16:05:00,16
10929,ORD_10930,34325,Parker Vector Gift Set Spark Black Special Edition Roller Ball Pen Round Key Chain (Ink - Blue),Warehouse C,102,88,2025-02-22 17:18:00,14
10930,ORD_10931,13021,Energizer CR2032 3V Lithium Battery - Pack of 4 Pieces,Warehouse A,26,13,2025-02-22 19:58:00,13
10931,ORD_10932,33771,Amicide 200mg Injection,Warehouse B,28,19,2025-02-22 21:00:00,9
10932,ORD_10933,22328,Oil-Free Radiance Gel Cream,Warehouse A,103,94,2025-02-22 02:44:00,9
10933,ORD_10934,34924,Neurofine Plus Injection,Warehouse A,74,62,2025-02-22 06:42:00,12
10934,ORD_10935,10337,Falciden Kit,Warehouse A,82,76,2025-02-22 16:48:00,6
10935,ORD_10936,20474,Asvik CV 250mg/125mg Tablet,Warehouse B,42,33,2025-02-22 19:54:00,9
10936,ORD_10937,28385,Jovithro 250mg Tablet,Warehouse A,74,55,2025-02-22 07:40:00,19
10937,ORD_10938,18575,Etorpin-P Tablet,Warehouse C,94,79,2025-02-22 14:13:00,15
10938,ORD_10939,26171,Flex Extra Body Conditioner,Warehouse B,97,88,2025-02-22 00:14:00,9
10939,ORD_10940,22341,"Bambalio BL82MS 240 Functions and 2 Line Display Scientific Calulator, 3 Years Warranty.",Warehouse C,75,65,2025-02-22 21:32:00,10
10940,ORD_10941,13989,Rheumartho Gold Plus Capsule - For Chronic Joint Pain,Warehouse B,76,58,2025-02-22 23:52:00,18
10941,ORD_10942,13023,"TheGiftKart Shockproof 360 Degree Protection Bumper Back Cover for Motorola Moto G60 / G40 Fusion (PC, TPU | Black, Crysta...",Warehouse B,75,70,2025-02-22 23:36:00,5
10942,ORD_10943,8227,Euroguard 250mg/250mg Tablet,Warehouse C,39,30,2025-02-22 06:44:00,9
10943,ORD_10944,28414,"Lapster efficient 3-in-1 Cleaning Kit for PC, laptops, LCD TV, Monitor,Camera, Smartphone, Lens, Tablet.(100ML)",Warehouse C,62,54,2025-02-22 02:13:00,8
10944,ORD_10945,16487,JGD PRODUCTS for Google Pixel 6A Premium Transparent Hybrid Soft Slim Dust Proof Back Case Cover with Camera Protection,Warehouse A,71,64,2025-02-22 19:22:00,7
10945,ORD_10946,4842,R.K's Aroma Facial Kit - Propolis 19 gm,Warehouse A,51,40,2025-02-22 02:44:00,11
10946,ORD_10947,1274,"Careflection || Coding/Programming Sticker Decals - Pack of 16 (Vinyl Stickers,Multipurpose use for Walls,Suitcase,Laptop,...",Warehouse A,27,16,2025-02-22 21:16:00,11
10947,ORD_10948,1315,Micro Lithium Cell CR2032 3V Coin Battery,Warehouse B,72,60,2025-02-22 17:44:00,12
10948,ORD_10949,28339,WeCool Moonwalk Mini Earbuds with Magnetic Charging Case IPX5 Wireless Earphones with Digital Battery Indicator for Crisp ...,Warehouse C,95,87,2025-02-22 22:31:00,8
10949,ORD_10950,31879,Global Edition Australian Adventures Deodorant For Men,Warehouse A,69,50,2025-02-22 22:47:00,19
10950,ORD_10951,28312,Stbotanica Pure Neroli Pure Essential Oil 15 ml,Warehouse A,26,21,2025-02-22 22:26:00,5
10951,ORD_10952,26218,OneAssist 1 Year Extended Warranty Plan for Headphones 500 to 1000 - Email Delivery Within 2 Hours,Warehouse B,78,64,2025-02-22 22:10:00,14
10952,ORD_10953,18681,Cefdron 50mg Tablet,Warehouse B,33,26,2025-02-22 22:05:00,7
10953,ORD_10954,1612,Amazon Brand - Solimo Thermoplastic Polyurethane Soft and Flexible Back Phone Case for Poco X2 / Xiaomi Redmi K30 (Transpa...,Warehouse B,71,54,2025-02-22 05:10:00,17
10954,ORD_10955,33110,Faces Canada Mascara & Eye Brow Brush 1'S,Warehouse A,37,27,2025-02-22 15:31:00,10
10955,ORD_10956,11655,Amd O Oral Suspension,Warehouse A,57,42,2025-02-22 19:16:00,15
10956,ORD_10957,28325,"Amazon Basics High-Speed Braided HDMI Cable - 6 Feet - Supports Ethernet, 3D, 4K and Audio Return - Single Pack (Black)",Warehouse B,114,95,2025-02-22 21:42:00,19
10957,ORD_10958,30026,Adiflox 200mg Tablet,Warehouse B,24,5,2025-02-22 06:44:00,19
10958,ORD_10959,27314,Meriflox 500mg Tablet,Warehouse C,29,13,2025-02-22 15:37:00,16
10959,ORD_10960,26210,Bonjour Paris Satin Matte Nail Polish (Dark Purple) 9 ml,Warehouse A,43,24,2025-02-22 07:52:00,19
10960,ORD_10961,3407,Climbing Chalk 1KG Sold By Beauty Tool,Warehouse C,38,32,2025-02-22 21:47:00,6
10961,ORD_10962,36950,Moxidif 250mg/125mg Tablet,Warehouse B,49,33,2025-02-22 02:46:00,16
10962,ORD_10963,1615,CROGIE DX1 Smart Tracker Key Finder Locator Anti Lost Wireless Anti Lost Alarm Sensor Device Finder Mini PET for Kids Loca...,Warehouse B,74,61,2025-02-22 18:23:00,13
10963,ORD_10964,30872,Clopan D 10mg/40mg Tablet,Warehouse A,54,36,2025-02-22 11:09:00,18
10964,ORD_10965,7207,Torglip R 100mg/50mg Tablet,Warehouse C,72,63,2025-02-22 15:31:00,9
10965,ORD_10966,8275,Ambulax Tablet,Warehouse C,73,65,2025-02-22 14:06:00,8
10966,ORD_10967,20451,"Palap Piano Stickers Labels for 37, 49, 54, 61, 88 Keys Keyboard, Piano Removal Stickers",Warehouse C,101,90,2025-02-22 18:29:00,11
10967,ORD_10968,30560,India's No-1 Fluoride Free Toothpaste,Warehouse A,32,13,2025-02-22 08:08:00,19
10968,ORD_10969,3961,Kraft Seeds Assorted Hand Pruner Cutter - 1 Pc (Steel Blades) | Heavy Duty Gardening Cutter Tool | Plant Cutter for Home G...,Warehouse B,47,31,2025-02-22 02:16:00,16
10969,ORD_10970,22313,Biopod CV 200mg/125mg Tablet,Warehouse C,19,3,2025-02-22 03:29:00,16
10970,ORD_10971,22317,TheGiftKart Tough Armor Bumper Back Cover Case for Oppo F21 Pro 5G / F21s Pro 5G | Ring Holder & Kickstand in-Built | 360 ...,Warehouse C,14,3,2025-02-22 22:36:00,11
10971,ORD_10972,20682,Bonjour Paris Premium Mettalic Shine Lipstick for Women - Pink 4.2 gm,Warehouse B,59,53,2025-02-22 00:36:00,6
10972,ORD_10973,30533,Vivo T1 44w Starry Sky (6+128GB),Warehouse B,83,74,2025-02-22 07:31:00,9
10973,ORD_10974,6076,Polo Tablet,Warehouse C,39,32,2025-02-22 03:17:00,7
10974,ORD_10975,37134,Acinil-O Oral Suspension,Warehouse C,47,40,2025-02-22 22:00:00,7
10975,ORD_10976,35531,Manodep Forte 5mg/25mg Tablet,Warehouse A,49,39,2025-02-22 16:06:00,10
10976,ORD_10977,18565,"Amazon Brand - Solimo in Ear Wired Earphones with Mic, 9mm Driver, Gold Plated Jack, Angular Ear Hooks (Black)",Warehouse B,24,18,2025-02-22 20:45:00,6
10977,ORD_10978,14915,Gensulide 100mg Tablet,Warehouse B,22,3,2025-02-22 14:54:00,19
10978,ORD_10979,14225,"FEDUS Cat6 Ethernet Cable, 15 Meter High Speed 550MHZ / 10 Gigabit Speed UTP LAN Cable, Network Cable Internet Cable RJ45 ...",Warehouse B,56,42,2025-02-22 12:27:00,14
10979,ORD_10980,15909,Jovees Detoxifying Peel Off Face Mask - Activated Charcoal 100 gm,Warehouse B,88,71,2025-02-22 11:20:00,17
10980,ORD_10981,19772,"Deborah Milano Velvet Kajal and Eyeliner, Butter, 1.5g",Warehouse C,32,24,2025-02-22 04:03:00,8
10981,ORD_10982,5277,Kodak 80 cm (32 Inches) HD Ready LED TV Kodak 32HDX900S (Black),Warehouse B,99,80,2025-02-22 16:12:00,19
10982,ORD_10983,15611,Risnia Forte 4mg/2mg Tablet,Warehouse A,101,93,2025-02-22 23:18:00,8
10983,ORD_10984,29860,Urdhva Retail 50 Pcs Eyeshadow Shields Professional Lint Free Under Eye Eyeshadow Gel Pad Patches For False Eyelash Extens...,Warehouse A,82,70,2025-02-22 22:58:00,12
10984,ORD_10985,3604,Olapod Dry Syrup,Warehouse A,69,62,2025-02-22 04:12:00,7
10985,ORD_10986,15914,"Oneplus 10R Type c to 3.5mm Audio Jack, 1-Plus Audio Jack Adapter, car Audio Connector USB Type c, Headphone Converter Cab...",Warehouse C,85,77,2025-02-22 04:15:00,8
10986,ORD_10987,15910,Kaynit 250mg Injection,Warehouse C,107,89,2025-02-22 12:33:00,18
10987,ORD_10988,2518,"Kama Ayurveda Turmeric and Myrrh Skin Brightening Soap, 125g & Kama Ayurveda Himalayan Deodar Soap for Men with Organic Co...",Warehouse C,74,62,2025-02-22 15:49:00,12
10988,ORD_10989,12665,Azid 200mg/5ml Syrup,Warehouse B,41,29,2025-02-22 22:46:00,12
10989,ORD_10990,8973,Omibert-D Capsule,Warehouse B,72,53,2025-02-22 02:42:00,19
10990,ORD_10991,6854,SunHeart Hubs Ice Roller Face Massager - Therapeutic Cooling to Naturally Tone & Tighten | Brighten Complexion and Reduce ...,Warehouse B,46,39,2025-02-22 17:29:00,7
10991,ORD_10992,9670,"Fashion Colour Jersy Girl Fantastic Palette Eyeshadow, Shade 02 24 gm",Warehouse B,33,15,2025-02-22 23:51:00,18
10992,ORD_10993,19735,Beardo Acne Control Face Gel - Turmeric & Aloe Vera Extract 50 gm,Warehouse C,92,79,2025-02-22 14:27:00,13
10993,ORD_10994,19718,Clopam 2mg Tablet,Warehouse A,77,64,2025-02-22 21:17:00,13
10994,ORD_10995,12098,"ESR Clear Case Compatible For iPhone 14 Plus Case, Shockproof Thin Silicone Cover, Yellowing-Resistant Slim Transparent TP...",Warehouse A,61,46,2025-02-22 02:21:00,15
10995,ORD_10996,5235,Flormar Silk Matte Liquid Lipstick 006 Cherry Blossom 4.5 gm,Warehouse A,47,33,2025-02-22 07:23:00,14
10996,ORD_10997,16087,Niveoli Inhaler,Warehouse B,20,9,2025-02-22 08:39:00,11
10997,ORD_10998,20164,Fexbest MT 10mg/120mg Tablet,Warehouse A,22,4,2025-02-22 01:47:00,18
10998,ORD_10999,21427,"ProDot Kobra 3688 Laser Toner Powder Compatible for HP 35A, 36A, 88A, 278A, 285A Toner Cartridges (Pack of 5)",Warehouse A,30,15,2025-02-22 23:33:00,15
10999,ORD_11000,36894,Fexolam 10mg/120mg Tablet,Warehouse C,53,34,2025-02-22 03:05:00,19
11000,ORD_11001,19634,"Wild Stone Legend Deodorants for Men, Long Lasting Masculine Body Spray, Pack of 2 (225ml each)",Warehouse B,84,65,2025-02-22 01:44:00,19
11001,ORD_11002,9718,Mystery Body Deodorant,Warehouse C,83,66,2025-02-22 21:59:00,17
11002,ORD_11003,2526,Zipline Unisex Messenger Bags,Warehouse A,44,31,2025-02-22 22:56:00,13
11003,ORD_11004,4069,Axpogest 200 Soft Gelatin Capsule,Warehouse A,59,47,2025-02-22 03:27:00,12
11004,ORD_11005,20985,"Dyazo USB Type C Male 3.0 to Female OTG Adapter Compatible for MacBook Air /Pro 2020 2019 2018, Samsung Galaxy S20 / Plus ...",Warehouse A,39,33,2025-02-22 02:05:00,6
11005,ORD_11006,3446,Conaril Syrup,Warehouse A,88,74,2025-02-22 21:06:00,14
11006,ORD_11007,9728,Gemblue Biocare Argan Oil Scrub 500 ml,Warehouse A,100,82,2025-02-22 13:16:00,18
11007,ORD_11008,8736,Zapcase Back Case Cover for iPhone XR | Compatible for iPhone XR Back Case Cover | Matte Soft Flexible Silicon | Liquid Si...,Warehouse B,78,59,2025-02-22 00:30:00,19
11008,ORD_11009,14651,Casio MJ-12VCb-GN 300 Steps Check & Correct Colourful Desktop Calculator (Green),Warehouse C,39,21,2025-02-22 10:53:00,18
11009,ORD_11010,8836,Pikkme Mi Redmi Note 11 / Note 11s Flip Cover | PU Leather Finish | 360 Protection | Wallet & Stand | Strong Magnetic Flip...,Warehouse B,41,27,2025-02-22 22:00:00,14
11010,ORD_11011,19756,Tymocil-CV LB Tablet,Warehouse B,42,32,2025-02-22 16:28:00,10
11011,ORD_11012,21334,Asformin GV 1mg/500mg/0.2mg Tablet,Warehouse B,40,27,2025-02-22 05:24:00,13
11012,ORD_11013,19679,TheGiftKart Crystal Clear Back Cover Case for Motorola Moto G52 / G82 5G | 360 Degree Protection | Shock Proof Design | Tr...,Warehouse A,22,17,2025-02-22 08:56:00,5
11013,ORD_11014,7236,Bharglob 16.5% Injection,Warehouse C,8,2,2025-02-22 07:57:00,6
11014,ORD_11015,2577,"CRYSTALOPRO Cartoon 3D Design Protective Case for 18W 20W iPhone 14 13 12 11 Pro Max Fast Charging Cable Adapter Charger, ...",Warehouse B,28,18,2025-02-22 11:33:00,10
11015,ORD_11016,24270,I AM EYECONIC 3D GLITTER MONEY MOVES 4 gm,Warehouse A,74,60,2025-02-22 11:32:00,14
11016,ORD_11017,1126,Zitel® Charger Compatible with Samsung Galaxy Watch 4 / Watch 4 Classic - Replacement USB Charging Cable 100cm - Black,Warehouse C,105,95,2025-02-22 22:59:00,10
11017,ORD_11018,32659,Nevocit 10mg Tablet,Warehouse B,34,20,2025-02-22 17:19:00,14
11018,ORD_11019,14639,Gkool 20mg Tablet,Warehouse A,88,72,2025-02-22 12:30:00,16
11019,ORD_11020,8791,Zonefor TZ 500mg/62.5mg Injection,Warehouse B,37,20,2025-02-22 10:14:00,17
11020,ORD_11021,32947,EESOME M10 TWS Bluetooth 5.1 Earphone Charging Box Wireless Earbuds Stereo Sports Waterproof with Microphone Bluetooth Hea...,Warehouse A,104,95,2025-02-22 17:42:00,9
11021,ORD_11022,26731,Hexa Advanced Germ Protection Bathing Soap,Warehouse A,84,65,2025-02-22 22:24:00,19
11022,ORD_11023,8786,"ESR Poly Carbonate Metal Kickstand Versatile Patented Tabletop Stand, Slim Flexible Back Cover for Samsung Galaxy S22 Ultr...",Warehouse B,75,70,2025-02-22 22:52:00,5
11023,ORD_11024,205,CEDO Clear Case for iPhone 13 Pro | Soft Flexible Full Protection Shock Proof TPU Back Cover for iPhone 13 Pro (Transparent),Warehouse A,34,22,2025-02-22 22:56:00,12
11024,ORD_11025,19689,"Fashion Colour Vivid Matte Lipstick, 14 Full Cherry 3.8 gm",Warehouse C,102,87,2025-02-22 18:53:00,15
11025,ORD_11026,27415,Rabevel-DSR Capsule,Warehouse C,99,87,2025-02-22 03:51:00,12
11026,ORD_11027,30992,Vrota M 80mg/250mg Tablet,Warehouse C,90,83,2025-02-22 01:55:00,7
11027,ORD_11028,14519,Azirop 250 Tablet,Warehouse A,18,11,2025-02-22 17:52:00,7
11028,ORD_11029,34634,Typlin 75mg Tablet,Warehouse B,37,29,2025-02-22 07:32:00,8
11029,ORD_11030,1199,Q Rab 20mg Tablet,Warehouse B,108,94,2025-02-22 15:27:00,14
11030,ORD_11031,16084,Onsitego 1 year Extended Warranty for Small Appliances up to Rs 2500 (Email Delivery - No Physical Kit),Warehouse C,59,51,2025-02-22 08:06:00,8
11031,ORD_11032,35183,"Freshsitry Liquid Lip And Cheek Tint | Coffee, Aloe Vera & Vitamin E | Lip Tint For Women 10 ML",Warehouse C,109,95,2025-02-22 14:32:00,14
11032,ORD_11033,27709,Robustrion [Anti-Scratch] & [Smudge Proof] [S Pen Compatible] Premium Tempered Glass Screen Protector for Samsung Tab S6 L...,Warehouse C,36,29,2025-02-22 00:40:00,7
11033,ORD_11034,8772,Pantomil 40mg Tablet,Warehouse B,59,46,2025-02-22 01:31:00,13
11034,ORD_11035,20154,Ustraa Men's Activated Charcoal Face Scrub 100 gm,Warehouse A,54,45,2025-02-22 07:23:00,9
11035,ORD_11036,19672,"Portronics Power Plate 6 with 4 USB Port + 5 Power Sockets Extension Board, 2500W Power Converter, Cord Length 3Mtr (Black)",Warehouse C,96,90,2025-02-22 04:14:00,6
11036,ORD_11037,12899,Facial Scrub - Lime Gently Scrubs Purifies & Stimulates,Warehouse B,42,32,2025-02-22 14:38:00,10
11037,ORD_11038,34136,FORACET 500MG/15MG TABLET,Warehouse A,99,82,2025-02-21 12:55:00,17
11038,ORD_11039,22010,"TP-Link TL-WA850RE Single_Band 300Mbps RJ45 Wireless Range Extender, Broadband/Wi-Fi Extender, Wi-Fi Booster/Hotspot with ...",Warehouse B,105,95,2025-02-21 08:57:00,10
11039,ORD_11040,1910,Enflamo Soft Silicone Slim Back Cover Case for iPhone 6 & 6S (Black),Warehouse A,57,39,2025-02-21 11:27:00,18
11040,ORD_11041,2606,Cudryl-L Syrup,Warehouse B,54,44,2025-02-21 15:58:00,10
11041,ORD_11042,7901,"M.G.R.J® Tempered Glass Screen Protector Compatible with Apple iPad Air 5, (5th Gen) / iPad Pro 11 (2022) / iPad Pro 11 (2...",Warehouse C,40,31,2025-02-21 02:35:00,9
11042,ORD_11043,2607,"Lenphor True Browmance Eyebrow Definer, Eyebrow Pencil Enhancer comes with Precision Tip, Smudge Proof, Long lasting & Wat...",Warehouse C,79,68,2025-02-21 12:38:00,11
11043,ORD_11044,18160,"realme narzo 50i (Carbon Black, 2GB RAM+32GB Storage) Octa Core Processor | 6.5"" inch Large Display",Warehouse B,27,12,2025-02-21 20:58:00,15
11044,ORD_11045,25190,Sparnole Tablet,Warehouse B,61,44,2025-02-21 12:32:00,17
11045,ORD_11046,22442,Biosulin 30/70 100IU/ml Cartridge,Warehouse A,57,44,2025-02-21 08:59:00,13
11046,ORD_11047,10413,Triptaz 10mg Tablet,Warehouse C,44,37,2025-02-21 06:16:00,7
11047,ORD_11048,10291,Dazolam-P 0.25mg/20mg Tablet,Warehouse B,52,41,2025-02-21 16:35:00,11
11048,ORD_11049,32524,Parijoy 25mg Tablet CR,Warehouse C,68,60,2025-02-21 23:07:00,8
11049,ORD_11050,8293,"HP Laserjet 108w Single Function Monochrome Laser Wi-Fi Printer For Home/Office, Compact Design, Printing",Warehouse C,17,6,2025-02-21 21:14:00,11
11050,ORD_11051,35714,Mapperz Stainless Steel Cosmetic 5 Dip Makeup Mixing Plate with Spatula Tool for Women (Silver),Warehouse B,32,17,2025-02-21 19:37:00,15
11051,ORD_11052,26076,Novamont FX 10mg/120mg Tablet,Warehouse B,53,38,2025-02-21 08:36:00,15
11052,ORD_11053,1706,"KINGONE Wireless Charging Pencil (2nd Generation) for iPad with Magnetic and Tilt Sensitive, Compatible with Apple iPad Pr...",Warehouse B,29,17,2025-02-21 02:51:00,12
11053,ORD_11054,34189,Orthokind 200mg Tablet,Warehouse A,19,6,2025-02-21 15:59:00,13
11054,ORD_11055,31111,Nicka K RADIANT LIQUID SHADOW- GOLD LAVA 5 gm,Warehouse A,29,12,2025-02-21 21:34:00,17
11055,ORD_11056,24149,Rid-AR Kid 2.5mg/4mg Tablet,Warehouse A,38,20,2025-02-21 12:45:00,18
11056,ORD_11057,22222,Alfucoz 200mg Tablet,Warehouse B,45,26,2025-02-21 09:34:00,19
11057,ORD_11058,24145,TheGiftKart Shockproof Crystal Clear Back Cover Case for Oppo Reno 8T 5G | 360 Degree Protection | Protective Design | Tra...,Warehouse B,98,82,2025-02-21 20:15:00,16
11058,ORD_11059,843,Dinac Gel,Warehouse C,113,97,2025-02-21 09:22:00,16
11059,ORD_11060,3685,TheGiftKart Crystal Clear Back Cover Case for Samsung Galaxy M04 / F04 / A04e | 360 Degree Protection | Shock Proof Design...,Warehouse A,53,37,2025-02-21 01:45:00,16
11060,ORD_11061,13528,Apdime 125mg Injection,Warehouse A,64,58,2025-02-21 11:03:00,6
11061,ORD_11062,3260,Effy 100mg Tablet,Warehouse B,96,88,2025-02-21 08:59:00,8
11062,ORD_11063,16461,Insight Cosmetics Pastel Color Nail Polish - 30 9 ml,Warehouse A,63,48,2025-02-21 18:37:00,15
11063,ORD_11064,3417,"Loofah/Sponge Scrubber/Body Bath  - Hangable, Black, BH-035 BLK",Warehouse C,84,76,2025-02-21 16:50:00,8
11064,ORD_11065,11488,Aceofen TH 100mg/4mg Tablet,Warehouse C,45,37,2025-02-21 03:09:00,8
11065,ORD_11066,28689,"Fashion Colour Fixup Hair Wax, Grey 150 gm",Warehouse B,104,85,2025-02-21 21:23:00,19
11066,ORD_11067,24069,Myglamm Wandurlust Matt Chrome Nail Paint Havelock 11 Ml,Warehouse A,26,19,2025-02-21 08:32:00,7
11067,ORD_11068,10415,Montypen LC 5mg/10mg Tablet,Warehouse B,87,73,2025-02-21 06:52:00,14
11068,ORD_11069,18439,Fizicet 37.5mg/325mg Tablet,Warehouse A,54,47,2025-02-21 05:17:00,7
11069,ORD_11070,1608,Spigen Ultra Hybrid Cover Case Compatible with Airpods Pro 2 (2022) - Crystal Clear,Warehouse B,25,19,2025-02-21 21:24:00,6
11070,ORD_11071,7881,"Reynolds RACER GEL 20 CT JAR, BLUE Gel Pen I Lightweight Gel Pen With Comfortable Grip for Extra Smooth Writing I School a...",Warehouse C,57,41,2025-02-21 19:45:00,16
11071,ORD_11072,15110,"Cleanfly Eyebrow Hair Remover,upper lip hair remover for women hair removal trimmer for women with LED Light for Women - R...",Warehouse B,57,43,2025-02-21 12:44:00,14
11072,ORD_11073,19018,Raface H 5mg/12.5mg Tablet,Warehouse B,28,14,2025-02-21 22:16:00,14
11073,ORD_11074,30626,Fashion Colour Vitamin C Face Wash 130 gm,Warehouse B,68,56,2025-02-21 15:43:00,12
11074,ORD_11075,19015,Amazon Brand - Solimo Back Cover Case for REDMI Note 4 | Compatible for REDMI Note 4 Back Cover Case | 360 Degree Protecti...,Warehouse A,34,17,2025-02-21 07:57:00,17
11075,ORD_11076,29607,Predijem 8 Tablet,Warehouse B,78,65,2025-02-21 05:58:00,13
11076,ORD_11077,28804,Qutin 25mg Tablet,Warehouse A,112,93,2025-02-21 00:51:00,19
11077,ORD_11078,1572,Grisopex 250mg Tablet,Warehouse A,58,40,2025-02-21 03:20:00,18
11078,ORD_11079,30197,Amister 250mg Injection,Warehouse B,86,71,2025-02-21 10:02:00,15
11079,ORD_11080,25043,Geranium Pure Aroma Essential Oil,Warehouse A,82,63,2025-02-21 20:06:00,19
11080,ORD_11081,35653,Eziotec 12A Compatible Toner Cartridge for Hp LaserJet Series 1010/1012/1015/1018/1020/1022/3015/3020/3030/3050/3052/3055/...,Warehouse A,89,72,2025-02-21 14:36:00,17
11081,ORD_11082,34135,Queen Selection 8.5 inch LCD E-Writer Electronic Writing Pad/Tablet Drawing Board (Paperless Memo Digital Tablet) Black,Warehouse C,29,14,2025-02-21 11:43:00,15
11082,ORD_11083,24216,"Fire-Boltt Phoenix Pro 1.39"" Bluetooth Calling Smartwatch, AI Voice Assistant, Metal Body with 120+ Sports Modes, SpO2, He...",Warehouse B,14,9,2025-02-21 20:13:00,5
11083,ORD_11084,22919,Bio Believe-In-Organic - Skin Care Oil,Warehouse C,92,78,2025-02-21 21:23:00,14
11084,ORD_11085,26319,"Nilkamal Inspiron Portable Laptop Table (Walnut, Polyvinyl Chloride, Pack Of 1)",Warehouse A,41,24,2025-02-21 22:10:00,17
11085,ORD_11086,31343,Nugest 100mg Tablet,Warehouse A,106,94,2025-02-21 07:52:00,12
11086,ORD_11087,14826,"Arjuna - Cardiac Care, 500 mg",Warehouse C,48,36,2025-02-21 12:31:00,12
11087,ORD_11088,29502,Rholic Travel Empty Luxurious Storage Box BB Cream Container Makeup Case 72 x 33mm,Warehouse A,72,63,2025-02-21 21:53:00,9
11088,ORD_11089,29547,Bella Voste Luxe Matt Chrome Shade 225 10 Ml,Warehouse B,81,75,2025-02-21 17:30:00,6
11089,ORD_11090,34400,INEFABLE® Mi Band 3 & 4 Straps Silicon Wristband Band Straps for Original M3 & M4 Bands with One Year Warranty - Device No...,Warehouse C,102,95,2025-02-21 23:18:00,7
11090,ORD_11091,1652,Biosoft Menthol Pre Wax Gel 500 ml,Warehouse A,56,37,2025-02-21 15:00:00,19
11091,ORD_11092,22015,Ajmal 2 Magnetize Deo & Neea EDP Pack of 3 20 ml,Warehouse A,100,93,2025-02-21 04:06:00,7
11092,ORD_11093,32522,Beauty People Pure Matte Lipstick - Pretty - Orange - 603 3.8 gm,Warehouse B,77,69,2025-02-21 08:48:00,8
11093,ORD_11094,10759,Acer Nitro 5 Gaming Laptop Intel Core i5-11400H 11th Gen Processor (16GB/512GB SSD/NVIDIA GeForce GTX 1650 4GB GDDR6 Graph...,Warehouse C,104,86,2025-02-21 21:41:00,18
11094,ORD_11095,35406,"3M Scotch BOPP Packaging Clear Tape (Transparent) | 48mm x 50 Meter | Pack of 2 | for Packaging, Decorating and DIY",Warehouse A,54,43,2025-02-21 18:29:00,11
11095,ORD_11096,16511,Rapidotzz Band Straps - 3 Pcs (Unisex) | Removable Straps ONLY for Honor Band 4 Honor Band 5| MultiColour | Free Size | On...,Warehouse B,50,45,2025-02-21 12:01:00,5
11096,ORD_11097,12209,Teal & Terra Foot And Heel Repair Treatment With Coconut & Olive Oil 50 gm,Warehouse B,99,93,2025-02-21 20:09:00,6
11097,ORD_11098,4973,Original 20W Fast Charger with Cable Compatible for Apple iPhone 11 iPhone 11 Pro iPhone 11 Pro Max and i Pad Adapter Plus...,Warehouse B,26,18,2025-02-21 04:56:00,8
11098,ORD_11099,18022,Lenphor Nail Tint Mango Tango 04 12 Ml,Warehouse C,79,61,2025-02-21 08:34:00,18
11099,ORD_11100,8350,"Juârez Acoustic Guitar, 38 Inch Cutaway, 038C with Bag, Strings, Pick and Strap, Black",Warehouse A,33,19,2025-02-21 06:04:00,14
11100,ORD_11101,36209,"Rich Creme Hair Colour - Shade 4.16 Burgundy, Single Use",Warehouse B,16,6,2025-02-21 09:17:00,10
11101,ORD_11102,577,Miss Claire Glimmersticks for Eyes E-01 Black 1.4gm,Warehouse B,61,56,2025-02-21 18:10:00,5
11102,ORD_11103,34183,Doxyfine LB 100mg Capsule,Warehouse B,104,88,2025-02-21 14:38:00,16
11103,ORD_11104,3871,"ARDAKI 5 in 1 Keyboard & Earphone Cleaner Brush Laptop Cleaning Kit Cleaning Pen for Airpods Cleaner Soft Brush, Airpods C...",Warehouse A,83,72,2025-02-21 00:50:00,11
11104,ORD_11105,6216,Lipbalm,Warehouse B,60,47,2025-02-21 06:57:00,13
11105,ORD_11106,33766,Mucon 150mg Tablet,Warehouse C,49,30,2025-02-21 21:36:00,19
11106,ORD_11107,6668,"ESR HaloLock Universal MagSafe Ring 360, MagSafe Conversion Kit, MagSafe Sticker, Compatible with iPhone 14/14 Plus/14 Pr...",Warehouse A,36,29,2025-02-21 17:02:00,7
11107,ORD_11108,16678,Beardo Body Wash - Activated Charcoal 200 ml,Warehouse B,59,49,2025-02-21 00:59:00,10
11108,ORD_11109,4228,Passion Indulge CLEANSER-ALOE TREE 100 ml,Warehouse A,59,48,2025-02-21 20:47:00,11
11109,ORD_11110,11638,"Tizum Hard Shell EVA Headphone Carrying Case for Universal Oversized Over-Ear Headset, Shockproof, Water Repellent, Anti-P...",Warehouse C,35,25,2025-02-21 19:40:00,10
11110,ORD_11111,35518,Immunity Kit - Improves Immunity,Warehouse B,24,9,2025-02-21 12:35:00,15
11111,ORD_11112,32085,"Nycil Powder Germ Expert Protect Cool Herbal 150gms + 50gms, Pack of 2",Warehouse A,57,44,2025-02-21 01:56:00,13
11112,ORD_11113,28360,Cefpar 1gm Injection,Warehouse A,59,49,2025-02-21 23:16:00,10
11113,ORD_11114,18070,"HP Deskjet Ink Advantage Ultra 4826 Print, Copy, Scan, Self Reset Dual Band WiFi, 2 Sets of Inbox Cartridges, Smart App Se...",Warehouse B,29,23,2025-02-21 23:47:00,6
11114,ORD_11115,31100,Sertakon Cream,Warehouse B,88,74,2025-02-21 00:07:00,14
11115,ORD_11116,32349,Thron 250mg Tablet,Warehouse A,47,28,2025-02-21 00:32:00,19
11116,ORD_11117,26213,"S.A.V.I 3D Temporary Tattoo Golden and Silver Metallic Sticker Wings Peacock Feathers Design Size 21x15cm - 1pc. (202), Go...",Warehouse A,20,2,2025-02-21 16:58:00,18
11117,ORD_11118,26231,Herbal Peach Soap,Warehouse C,92,86,2025-02-21 15:56:00,6
11118,ORD_11119,16435,Helmox 500mg/125mg Tablet,Warehouse B,52,42,2025-02-21 13:57:00,10
11119,ORD_11120,8251,Aerotak 5mg Tablet,Warehouse A,72,60,2025-02-21 01:46:00,12
11120,ORD_11121,10681,Zeclor 500mg Tablet,Warehouse B,50,36,2025-02-21 20:21:00,14
11121,ORD_11122,13015,Micpro 50mg Injection,Warehouse C,105,94,2025-02-21 03:24:00,11
11122,ORD_11123,7214,DavaIndia Gabapentin+Nortriptyline 400mg/10mg Tablet,Warehouse B,41,22,2025-02-21 19:16:00,19
11123,ORD_11124,16707,Shampoo - Macadamia Oil Extract,Warehouse C,45,32,2025-02-21 11:13:00,13
11124,ORD_11125,26170,WOW IMAGINE Shock Proof Clear Back Cover Case Mobile Cover for Samsung Galaxy M33 5G (Hard | Hybrid PC + TPU | Full Armour...,Warehouse A,52,38,2025-02-21 16:23:00,14
11125,ORD_11126,26239,Roarx Google Pixel 7 Charger Original [Compatible] with Google Pixel 7 / Google Pixel 7 Pro Adapter [20 Watt - Type C] Tab...,Warehouse B,89,74,2025-02-21 02:11:00,15
11126,ORD_11127,18748,"HP v207w 32GB USB 2.0 Pen Drive,Black",Warehouse B,71,57,2025-02-21 08:47:00,14
11127,ORD_11128,22143,Cyposure Syrup,Warehouse C,69,50,2025-02-21 23:48:00,19
11128,ORD_11129,26148,Rabzol-DSR 30mg/20mg Capsule,Warehouse A,51,41,2025-02-21 21:29:00,10
11129,ORD_11130,33819,"SUPERBAK Epic 30 Ltrs Anti-Theft Laptop Backpack (Black-Orange), One Size (LBPEPIC000109)",Warehouse C,50,44,2025-02-21 14:50:00,6
11130,ORD_11131,11515,"QOCXRRIN C_567 New Version-Car Phone Holder Mount, Rearview Mirror Phone Holder for Car, 360°Rotatable and Retractable Car...",Warehouse C,21,11,2025-02-21 07:56:00,10
11131,ORD_11132,33214,"RHYTECH 360 ° Rotation Long Bluetooth Mobile Phone Selfie Stick Tripod Stand with LED Fill Light, Bluetooth Wireless Remot...",Warehouse B,81,65,2025-02-21 16:36:00,16
11132,ORD_11133,13276,Tecef 500mg Injection,Warehouse A,45,38,2025-02-21 22:32:00,7
11133,ORD_11134,15446,Relate H 50 mg/12.5 mg Tablet,Warehouse B,54,45,2025-02-21 02:59:00,9
11134,ORD_11135,22319,Ketromac 10mg Tablet DT,Warehouse B,102,87,2025-02-21 06:25:00,15
11135,ORD_11136,28708,"ESR Classic Kickstand Case with HaloLock Compatible with iPhone 14 Pro Max Case, MagSafe-Compatible Case with Stand, Milit...",Warehouse A,66,54,2025-02-21 17:37:00,12
11136,ORD_11137,18744,Daily Life Forever52 Powder / Blush Brush Nx012 1's,Warehouse A,10,1,2025-02-21 20:21:00,9
11137,ORD_11138,22197,Triocin 650mg Tablet,Warehouse B,78,64,2025-02-21 20:07:00,14
11138,ORD_11139,31554,Revlon Top Speed Hair Color Small Pack Woman - Natural Black 70 (20Gm + 20Gm + 15Ml) 55 Gm,Warehouse C,21,3,2025-02-21 00:02:00,18
11139,ORD_11140,7953,"COSTAR Mateband Bluetooth Wireless Neckband Earphones - Adjust EQ for Bombastic Bass, 24 Hours Playtime, Magnetic Instant ...",Warehouse A,15,3,2025-02-21 17:16:00,12
11140,ORD_11141,22824,Passion Indulge E OILS-PEPPERMINT 10 ml,Warehouse A,78,68,2025-02-21 18:39:00,10
11141,ORD_11142,16478,"TOUARETAILS Travel Digital Accessories Storage Bag, Gadget Organizer Case Portable Zippered Pouch For All Small Gadgets Ta...",Warehouse C,42,23,2025-02-21 17:34:00,19
11142,ORD_11143,32092,Sounce Type C to Headphone Jack Adapter with 3.5mm Aux Audio and Type C Charger Converter USB-C and Earphone Compatible wi...,Warehouse C,49,36,2025-02-21 08:38:00,13
11143,ORD_11144,11659,Remiglim M 2mg/500mg Tablet,Warehouse C,90,75,2025-02-21 04:39:00,15
11144,ORD_11145,25916,Boosty® 75 Watts Handheld Megaphone with Recorder USB and Memory Card Input for Announcing; Talk; Record; Play; Siren; Mus...,Warehouse A,44,27,2025-02-21 01:40:00,17
11145,ORD_11146,10240,Antof OR Dry Syrup,Warehouse C,70,53,2025-02-21 13:55:00,17
11146,ORD_11147,14919,"Swiss Beauty Makeup Brushes Set, Makeup Accessory,Gold, 100G",Warehouse B,23,6,2025-02-21 12:33:00,17
11147,ORD_11148,4861,4 Way Spike and Surge Guard,Warehouse C,28,20,2025-02-21 01:53:00,8
11148,ORD_11149,24153,Nikant-MPS Oral Suspension Mint Sugar Free,Warehouse C,102,95,2025-02-21 13:14:00,7
11149,ORD_11150,8309,Teal & Terra Moroccan Argan Oil (Cold Pressed) 30 ml,Warehouse B,26,17,2025-02-21 15:35:00,9
11150,ORD_11151,25878,Rabicos 20 Tablet,Warehouse B,109,95,2025-02-21 08:40:00,14
11151,ORD_11152,2631,Ajmal Wisal & Shadow Homme & Sacrificeiihim & Carbon Deo & Neea EDP Pack of 5 20 ml,Warehouse C,98,81,2025-02-21 05:38:00,17
11152,ORD_11153,16391,Wycel 200mg Capsule,Warehouse C,48,41,2025-02-21 06:51:00,7
11153,ORD_11154,10692,"Vivo Y100 5G (Pacific Blue, 8GB RAM, 128GB Storage) with No Cost EMI/Additional Exchange Offers",Warehouse A,30,18,2025-02-21 19:03:00,12
11154,ORD_11155,30185,"Navya Export Silicone Half Heel Protector Socks Moisturizing Socks for Foot-Care,Heel Cushion Inserts Liners Shoe Bite Tap...",Warehouse C,111,94,2025-02-21 11:05:00,17
11155,ORD_11156,36208,Renac P 50mg/500mg Tablet,Warehouse B,54,39,2025-02-21 20:01:00,15
11156,ORD_11157,3689,"ZEBRONICS Gaming AC32FHD LED Curved 165Hz 80cm (32"") 1920x1080 Pixels FHD Resolution Monitor with Display Port + HDMI Dual...",Warehouse B,54,45,2025-02-21 03:14:00,9
11157,ORD_11158,18628,RAGHAV ENTERPRISES Type c cable for Xiaomi Redmi Note 8 Pro USB Cable Original Like usb | Charging & Sync Data Cable | Rap...,Warehouse A,50,37,2025-02-21 20:30:00,13
11158,ORD_11159,24135,"Brother DCP-T426W - Wi-Fi Color Ink Tank Multifunction (Print, Scan & Copy) All in One Printer for Home",Warehouse C,94,83,2025-02-21 10:44:00,11
11159,ORD_11160,35507,Amazon Brand - Solimo Mobile Soft & Flexible Shockproof Back Cover with Cushioned Edges Transparent for Apple iPhone 5s,Warehouse C,48,29,2025-02-21 01:56:00,19
11160,ORD_11161,28719,Exiler 120mg Tablet,Warehouse C,107,92,2025-02-21 10:48:00,15
11161,ORD_11162,15073,"Larah by BOROSIL Opalware Dinner Set - 19 Pieces, White, Blue Eve Silk",Warehouse B,113,95,2025-02-21 06:52:00,18
11162,ORD_11163,35381,Bodylicious Deodorant Spray - Mate (For Men),Warehouse A,18,1,2025-02-21 11:22:00,17
11163,ORD_11164,24876,Cypol T Syrup,Warehouse C,75,57,2025-02-21 15:56:00,18
11164,ORD_11165,12452,Torsikind 20mg Tablet,Warehouse C,17,2,2025-02-21 23:24:00,15
11165,ORD_11166,6191,Vega Dressing Comb (HMBC - 124) 49 gm,Warehouse C,69,55,2025-02-21 17:43:00,14
11166,ORD_11167,27435,Daily Intimate Foam Wash,Warehouse A,19,10,2025-02-21 22:11:00,9
11167,ORD_11168,24531,Spigen Thin Fit Back Cover Case Compatible with iPhone 14 Pro (TPU + Poly Carbonate | Black),Warehouse B,39,27,2025-02-21 06:56:00,12
11168,ORD_11169,12275,"ZEBRONICS Zeb-V19Hd 18.5 Inch (46.99 Cm) Led Monitor with Supporting Hdmi, Vga Input, Hd 1366 X 768 Pixels, 16.7M Colors, ...",Warehouse B,114,98,2025-02-21 20:02:00,16
11169,ORD_11170,786,"HP 15s, AMD Ryzen 3 3250U, 15.6 inch(39.6cm) HD Laptop(8GB RAM/256 GB SSD/AMD Radeon Graphics/Win 11/MSO/Dual Speakers) 15...",Warehouse B,55,50,2025-02-21 20:12:00,5
11170,ORD_11171,3763,Global Desi CosmiC EDP & RythS Mist Pack of 2 250 ml,Warehouse C,101,94,2025-02-21 00:38:00,7
11171,ORD_11172,12556,"Classmate Pulse Spiral Notebook - 203 mm x 267 mm, Soft Cover, 160 Pages, Unruled",Warehouse B,65,57,2025-02-21 07:49:00,8
11172,ORD_11173,28441,Divalin OD   750mg Tablet,Warehouse A,45,37,2025-02-21 03:28:00,8
11173,ORD_11174,33204,Macjoint Tablet,Warehouse A,34,18,2025-02-21 04:29:00,16
11174,ORD_11175,3238,"THR3E STROKES Super Large Mineral Powder Brush, Nail Brushes Kabuki Makeup Brushes Soft Fluffy Foundation Brush Blush Brus...",Warehouse C,10,5,2025-02-21 18:32:00,5
11175,ORD_11176,35421,Falcinate 60mg Injection,Warehouse C,96,78,2025-02-21 05:07:00,18
11176,ORD_11177,6588,Faces Canada Eye Pencil Teal 12 M 1.2 Gm,Warehouse A,113,95,2025-02-21 10:01:00,18
11177,ORD_11178,4189,Escigress CZ 0.25 Tablet,Warehouse B,92,79,2025-02-21 14:15:00,13
11178,ORD_11179,28680,TNW-THE NATURAL WASH Underarm Roll-On Deodorant For Women| Reduces Odor & Controls Excessive Sweat and Lighten Dark Undera...,Warehouse C,75,64,2025-02-21 17:32:00,11
11179,ORD_11180,7636,"Lava Hero 600i (Sapphire Blue) with Sleek and Stylish Design, 10 Regional Languages Input Support, Auto Call Recording, Wi...",Warehouse B,90,72,2025-02-21 05:04:00,18
11180,ORD_11181,13576,"Greeniche Garcinia Cambogia, Green Coffee Extract for Weight Loss - 30 Capsules",Warehouse B,108,98,2025-02-21 02:13:00,10
11181,ORD_11182,30612,"Redmi 10 (Caribbean Green, 6GB RAM, 128GB Storage)",Warehouse A,67,56,2025-02-21 10:31:00,11
11182,ORD_11183,4829,Charmacy Milano Stunning Longstay Liquid Lip (Flamenco Red) 5.6 ml,Warehouse A,66,47,2025-02-21 16:45:00,19
11183,ORD_11184,23890,"Oaky Keyboard Protector Compatible with MacBook Pro M1 13 inch 2020 Model - A2338, A2289, A2251, Ultra Thin Keyboard Cover...",Warehouse A,73,63,2025-02-21 21:39:00,10
11184,ORD_11185,22415,"Micromax X809 (Blue, Anti Theft, 1000mAh)",Warehouse A,60,43,2025-02-21 05:03:00,17
11185,ORD_11186,28182,Wakcet 5mg Tablet,Warehouse C,93,79,2025-02-21 20:40:00,14
11186,ORD_11187,16723,Plum Bodylovin' Oopsie Daisy Body Butter 200 Gm,Warehouse A,26,11,2025-02-21 20:00:00,15
11187,ORD_11188,29513,"BabyMoon Synthetic (Set of 2) Crochet Mermaid New Born Baby Photography Shoot Props Costume (6-18 Months, Pink)",Warehouse A,51,37,2025-02-21 23:00:00,14
11188,ORD_11189,22039,"Fashion Colour Kiss Lip No Transfer Lipstick, 02 Orange 2.6 gm",Warehouse A,89,73,2025-02-21 23:47:00,16
11189,ORD_11190,35728,Coconut Oil - 100 % Pure,Warehouse A,35,27,2025-02-21 11:28:00,8
11190,ORD_11191,28793,Baba Enterprises Eye Shadow Eyebrow Eyeliner Eyelash Lip Brush Cosmetic Tool Make Up Eye Brush Set - (Multicolor),Warehouse B,100,87,2025-02-21 00:19:00,13
11191,ORD_11192,2847,Zithrel 500 Tablet,Warehouse C,39,31,2025-02-21 22:32:00,8
11192,ORD_11193,30926,"Maybelline New York Blush, True to Colour Result, Fit Me Mono Blush, 20 Hopeful, 4.5 g",Warehouse A,92,79,2025-02-21 14:41:00,13
11193,ORD_11194,14529,TheGiftKart Flip Back Cover Case for Motorola Moto G52 / G82 5G | Dual-Color Leather Finish | Inbuilt Stand & Pockets | Wa...,Warehouse B,56,49,2025-02-21 14:33:00,7
11194,ORD_11195,25133,Energy Essential Oil,Warehouse B,27,14,2025-02-21 15:40:00,13
11195,ORD_11196,31810,Atorday 5mg Tablet,Warehouse B,55,50,2025-02-21 15:21:00,5
11196,ORD_11197,4171,"ULRIC DE VARENS Night Set for him, 300ml",Warehouse A,47,38,2025-02-21 13:05:00,9
11197,ORD_11198,25364,"ZEBRONICS 68.5cms 27inch Widescreen Monitor, IPS, Ultra Slim, FHD 1920x1080 Pixels, HDMI, VGA, 250nits, Built in Speaker, ...",Warehouse C,84,77,2025-02-21 08:43:00,7
11198,ORD_11199,32736,Ravoxacin OZ 200mg/200mg Tablet,Warehouse B,116,98,2025-02-21 12:15:00,18
11199,ORD_11200,5692,Kufvina-LS Syrup Sugar Free,Warehouse B,38,24,2025-02-21 18:08:00,14
11200,ORD_11201,20094,Cascade Moisturising Day Care Lotion,Warehouse B,45,26,2025-02-21 15:31:00,19
11201,ORD_11202,5376,Ajmal Carbon & Silvershade Deo & Neea EDP Pack of 3 20 ml,Warehouse B,71,52,2025-02-21 18:54:00,19
11202,ORD_11203,2154,Nails On Board Handmade Press On Gel Nails- Holographic Liliac Medium 50 gm,Warehouse C,13,3,2025-02-21 13:57:00,10
11203,ORD_11204,35069,Spigen Liquid Air Back Cover Case for Samsung Galaxy S22 (TPU | Matte Black),Warehouse A,29,16,2025-02-21 02:49:00,13
11204,ORD_11205,32729,Emsulate 500mg Tablet,Warehouse A,29,13,2025-02-21 19:01:00,16
11205,ORD_11206,31623,Cipronate T 500mg/600mg Tablet,Warehouse C,22,9,2025-02-21 02:32:00,13
11206,ORD_11207,1175,"Lava Gem (Gold+Black), Speaker with Amplifier, PMMA 2.5D Glass, Military Grade Certified,1.3 MP Camera, Keypad Mobile",Warehouse A,106,98,2025-02-21 12:25:00,8
11207,ORD_11208,20022,Essential Souls Face Wash - Matcha 100 ml,Warehouse B,22,13,2025-02-21 08:08:00,9
11208,ORD_11209,20021,"Mom & World Mineral Based Baby Sunscreen Lotion, Spf 50 Pa+++, Uva/Uvb Protection, Water Resistance, 120 ml",Warehouse C,28,10,2025-02-21 23:44:00,18
11209,ORD_11210,13174,"Energizer E96BP AAAA Alkaline Battery (2 Pieces), Silver",Warehouse C,94,79,2025-02-21 08:58:00,15
11210,ORD_11211,24591,Ajmal Silver Shade & Evoke silver Edition Homme & Carbon & Avid Deo & Yearn EDP Pack of 5 20 ml,Warehouse B,45,35,2025-02-21 22:35:00,10
11211,ORD_11212,6805,"Nokia 225 4G Dual SIM Feature Phone with Long Battery Life, Camera, Multiplayer Games, and Premium Finish – Black Colour",Warehouse C,65,56,2025-02-21 20:31:00,9
11212,ORD_11213,21026,Playboy King Man New Eau de Toilette 100ml,Warehouse B,36,18,2025-02-21 19:50:00,18
11213,ORD_11214,20148,"KABEER ART Dip Feather Pen Set Calligraphy Pen Set Writing Quill Ink Dip Pen with 5PCs Nib,RED",Warehouse B,113,96,2025-02-21 16:59:00,17
11214,ORD_11215,3817,Tripkinz Tablet,Warehouse B,68,49,2025-02-21 04:16:00,19
11215,ORD_11216,5404,Fission Eau De Toilette Deodorant - For Woman,Warehouse A,58,39,2025-02-21 03:38:00,19
11216,ORD_11217,36797,Ajmal Sacred Love & Raindrops & Wisal Deo & Aretha EDP Pack of 3 20 ml,Warehouse A,81,75,2025-02-21 18:35:00,6
11217,ORD_11218,9477,The Body Shop Japanese Matcha Tea Pollution Clearing Mask - Pack Of 1,Warehouse C,105,90,2025-02-21 17:45:00,15
11218,ORD_11219,3277,"1 Minute Pedicure, Foot Scrub Tea Tree Oil, Lemon Oil & Vitamin B3 100% Natural",Warehouse B,105,98,2025-02-21 10:09:00,7
11219,ORD_11220,31946,R.K's Aroma Facial Kit - Diamond 19 gm,Warehouse B,29,22,2025-02-21 08:10:00,7
11220,ORD_11221,6504,Letzmove 150mg Tablet,Warehouse C,28,11,2025-02-21 01:43:00,17
11221,ORD_11222,6501,Repagab M 1500mcg/75mg Tablet,Warehouse C,72,58,2025-02-21 19:28:00,14
11222,ORD_11223,2476,Thyco-MR Tablet,Warehouse B,52,36,2025-02-21 23:55:00,16
11223,ORD_11224,24572,Revlon ColorSilk Hair Color with Keratin - 1N Black 91.8 ML,Warehouse A,53,44,2025-02-21 06:30:00,9
11224,ORD_11225,34304,"Samsung 253L 3 Star Inverter Frost Free Double Door Refrigerator (RT28T3743S8/HL, Silver, Elegant Inox, Convertible, 2022 ...",Warehouse C,65,53,2025-02-21 14:01:00,12
11225,ORD_11226,8190,Vega Round Brush (R1 - RBB) 60 gm,Warehouse A,27,17,2025-02-21 15:05:00,10
11226,ORD_11227,22049,Bicox 450mg/300mg Tablet,Warehouse B,12,1,2025-02-21 23:32:00,11
11227,ORD_11228,14815,Defidrot A 80mg/100mg Tablet,Warehouse B,48,30,2025-02-21 09:41:00,18
11228,ORD_11229,36199,7 O Clock Razor and Blades - Super Platinum,Warehouse C,43,24,2025-02-21 08:29:00,19
11229,ORD_11230,16380,"FORFOR® Forever Matte Me Long Lasting | Waterproof | Liquid Matte Lip Color Combo of 4 (upto 12 hours Stay) (Bury Brown , ...",Warehouse A,34,18,2025-02-21 02:17:00,16
11230,ORD_11231,30228,Omezee 20 Capsule,Warehouse C,83,75,2025-02-21 10:00:00,8
11231,ORD_11232,7927,Ajmal Sacred Love EDP Floral Musky Perfume And Blu Homme Deodorant Aquatic Woody Fragrance 250 ml,Warehouse C,39,21,2025-02-21 06:01:00,18
11232,ORD_11233,26141,Ivori 6mg Tablet,Warehouse B,67,61,2025-02-21 07:21:00,6
11233,ORD_11234,12547,Bio Milk Protein Whitening & Rejuvenating Face 175 Gm,Warehouse C,28,12,2025-02-21 08:54:00,16
11234,ORD_11235,11679,"Banjara's Black Henna Hair Colour, Brazilian Black (54gms, Pack of 2)",Warehouse A,24,8,2025-02-21 13:24:00,16
11235,ORD_11236,18528,Essence De Shalimar Body Mist,Warehouse C,89,74,2025-02-21 13:15:00,15
11236,ORD_11237,25051,"Tizum USB Type C to Lightning Cable with 20W Fast Charging & 480 Mbps Data Transmission Speed for iPhones, iPads & other i...",Warehouse C,50,39,2025-02-21 19:29:00,11
11237,ORD_11238,954,Levofloxy 500mg Tablet,Warehouse A,109,90,2025-02-21 10:39:00,19
11238,ORD_11239,17916,EvoFox Shadow Optical USB Wired Gaming Mouse with Upto 3600 DPI Gaming Sensor | 6 Buttons Design | Press Life Upto 7 Milli...,Warehouse C,57,43,2025-02-21 04:48:00,14
11239,ORD_11240,13851,HI-PLASST PINS N PLUGS Hard PVC 5 to 15 Ampere Converter Socket for Big Size 16 Ampere Plug Top with Universal Sockets for...,Warehouse A,76,57,2025-02-21 19:44:00,19
11240,ORD_11241,16531,Aloe Veda Neem Oil 200 ml,Warehouse A,59,50,2025-02-21 00:57:00,9
11241,ORD_11242,16530,Stbotanica Moroccan Argan Oil Anti Wrinkle Regenerating Night Cream 50 gm,Warehouse C,36,19,2025-02-21 12:33:00,17
11242,ORD_11243,7302,Nykaa Cosmetics Eyes On Me! 4 in 1 Quad Eyeshadow Palette - Sunset Stroll,Warehouse B,52,44,2025-02-21 15:22:00,8
11243,ORD_11244,11693,Apple AirPods (3rd Generation),Warehouse A,83,72,2025-02-21 17:17:00,11
11244,ORD_11245,15424,Lakme Absolute Matte Ultimate Lip Color With Argan Oil Red Extreme 3.4 Gm,Warehouse C,49,33,2025-02-21 15:54:00,16
11245,ORD_11246,35394,"DOMS Champions Kit, Multicolour (7760)",Warehouse C,90,78,2025-02-21 09:11:00,12
11246,ORD_11247,8429,Karela Powder,Warehouse C,17,2,2025-02-21 18:52:00,15
11247,ORD_11248,35395,Freego Granules,Warehouse C,47,31,2025-02-21 01:58:00,16
11248,ORD_11249,1726,Bonjour Paris Photo Match Crayon Concealer - Cool Tan 3.2 gm,Warehouse C,97,90,2025-02-21 20:44:00,7
11249,ORD_11250,33068,Onsitego 2 Year Extended Warranty for Small Household Appliances from Rs. 9001-10000 (Email Delivery - No Physical Kit),Warehouse A,109,99,2025-02-21 20:28:00,10
11250,ORD_11251,22932,draval 6 Piece Wall Mounted Storage Box Remote Storage Organizer Case for Air Conditioner TV Mobile Phone Plug Holder Stan...,Warehouse C,15,9,2025-02-21 12:09:00,6
11251,ORD_11252,32427,Master Body Spray - Pine,Warehouse C,48,34,2025-02-21 02:37:00,14
11252,ORD_11253,11696,L'Oreal Paris Dream Lengths Shampoo 192.5 ml,Warehouse A,43,25,2025-02-21 07:01:00,18
11253,ORD_11254,1936,Terrific S 250mg/125mg Injection,Warehouse B,79,71,2025-02-21 23:11:00,8
11254,ORD_11255,13962,Kapsulair 5mg Tablet,Warehouse A,87,72,2025-02-21 14:23:00,15
11255,ORD_11256,29707,"GOQii Smart Vital Fitness SpO2 1.3"" HD Full Touch, Smart Notification Waterproof Smart Watch for Android Phones Blood Oxyg...",Warehouse C,31,26,2025-02-21 16:11:00,5
11256,ORD_11257,5975,Rapidotzz Mi Band Straps - 3 Pcs (Unisex) | Removable Straps ONLY for MI Band 3 and 4 | MultiColour | Free Size | Only Str...,Warehouse B,85,75,2025-02-21 05:07:00,10
11257,ORD_11258,6085,"Noise ColorFit Ultra 2 with 1.78"" (4.52cm) AMOLED Display, Best-in-Class Resolution, Premium Stainless Steel Body, 60+ Spo...",Warehouse A,116,99,2025-02-21 20:58:00,17
11258,ORD_11259,14849,Ical 560mg Tablet,Warehouse B,114,98,2025-02-21 15:13:00,16
11259,ORD_11260,13598,Robustrion Hybrid Shell Case Cover with Pencil Holder (Right Side) for iPad 10th Generation Cover 10.9 inch - Royal Blue,Warehouse C,83,77,2025-02-21 03:28:00,6
11260,ORD_11261,28683,Zaxone 500mg Injection,Warehouse A,60,50,2025-02-21 08:22:00,10
11261,ORD_11262,31080,Zivex 25mg Tablet,Warehouse B,107,90,2025-02-21 07:50:00,17
11262,ORD_11263,33143,"COAL Clean Beauty , De-Tan Serum with Hylauronic Acid 30 ml",Warehouse C,89,82,2025-02-21 14:47:00,7
11263,ORD_11264,12166,Innisfree Jeju Volcanic Pore Cleansing Foam,Warehouse A,88,81,2025-02-21 15:20:00,7
11264,ORD_11265,17927,"Sounce Watch Case Compatible for Fire-Boltt Ninja 3 Tempered Glass Screen Protector,HD Clear Touch Sensitive Ultra Thin TP...",Warehouse B,42,34,2025-02-21 10:28:00,8
11265,ORD_11266,17947,"Fashion Colour 24hr Longwear Liquid Foundation With Skin Care, Sunset 30 ml",Warehouse A,17,12,2025-02-21 14:00:00,5
11266,ORD_11267,8388,OpenTech® Screen Protector Compatible for Samsung Galaxy F41 / M21 / M31 / M30s / M30 / A30 / A50 / A50s (Matte Transparen...,Warehouse B,116,97,2025-02-21 09:33:00,19
11267,ORD_11268,30438,BOMBAY SHAVING COMPANY Musk & Oudh Deodorant Combo Pack | Premium Long Lasting Body Spray - For Men,Warehouse C,47,28,2025-02-21 20:32:00,19
11268,ORD_11269,22882,Quench Botanics Chialeader Shine Control Gel Face wash 100 ml,Warehouse A,91,75,2025-02-21 15:41:00,16
11269,ORD_11270,16383,Rvs 20mg Tablet,Warehouse B,44,28,2025-02-21 01:30:00,16
11270,ORD_11271,13290,Ivermoh-S 6 Tablet,Warehouse B,70,65,2025-02-21 03:52:00,5
11271,ORD_11272,22112,Rosuday 10 Tablet,Warehouse A,93,80,2025-02-21 16:55:00,13
11272,ORD_11273,18840,Amazon Basics High Power 65W Mobile/Laptop Charger Dual Port Output with Type-C Charging Cable (Black),Warehouse A,29,24,2025-02-21 16:51:00,5
11273,ORD_11274,13862,Bold Care Topical Non-Transferable Spray for Men (Pack of 1),Warehouse C,20,11,2025-02-21 12:01:00,9
11274,ORD_11275,30213,Esomy-DSR Capsule,Warehouse B,36,22,2025-02-21 00:38:00,14
11275,ORD_11276,13094,ADISA 35L Large Laptop Backpack Office Bag College Travel Back Pack with rain Cover (Black),Warehouse C,21,10,2025-02-21 20:55:00,11
11276,ORD_11277,3752,T.O.G. Air Cushion Puff Box Easy to Carry Cosmetic Container DIY for BB cc Cream Red,Warehouse B,60,53,2025-02-21 02:02:00,7
11277,ORD_11278,10165,Turboheal 5% Ointment,Warehouse B,96,84,2025-02-21 03:10:00,12
11278,ORD_11279,11668,HB PLUS M3 Colorful Wireless Bluetooth Speakers Mini Electroplating Round Steel Speaker (Random Color) (Black),Warehouse A,77,65,2025-02-21 07:45:00,12
11279,ORD_11280,10172,Terbiz 1% Ointment,Warehouse A,31,17,2025-02-21 06:50:00,14
11280,ORD_11281,3249,"Sery Colorflirt Nail Paint Seafoam, Green 10 ml",Warehouse B,68,62,2025-02-21 12:06:00,6
11281,ORD_11282,18847,Easy 5 Minute Hair Colour - Natural Brown,Warehouse A,57,41,2025-02-21 03:32:00,16
11282,ORD_11283,10725,Amozo Back Case Cover for iPhone 13 Pro (Polycarbonate|Blue),Warehouse B,108,90,2025-02-21 22:48:00,18
11283,ORD_11284,33462,"EGOTUDE Frameless Hard Back Cover Case for iPhone 13 (Camera Protection, Black, Polycarbonate)",Warehouse B,69,53,2025-02-21 07:53:00,16
11284,ORD_11285,33831,Levi M 5 mg/10 mg Tablet,Warehouse A,64,47,2025-02-21 05:27:00,17
11285,ORD_11286,6088,KilTer By Life Like M10 TWS Bluetooth 5.1 Earphone Charging boxwireless Earbuds Stereo Sports Waterproof with Microphone T...,Warehouse A,34,19,2025-02-21 10:53:00,15
11286,ORD_11287,6077,Vitalize Mutivitamin Effervescent Tablets Extract For Men & Women - Orange Flavour,Warehouse C,90,76,2025-02-21 19:09:00,14
11287,ORD_11288,10187,Rabtop-DSR Capsule,Warehouse B,19,11,2025-02-21 01:01:00,8
11288,ORD_11289,2101,"Syvo S -1000 PRO 67 Inch (170CM) Tripod for DSLR, Camera | Operating Height: 5.57 Feet| Maximum Load Capacity up to 5kg | ...",Warehouse B,89,77,2025-02-21 13:51:00,12
11289,ORD_11290,12375,Beard Growth Oil - Bergamot & Lavender,Warehouse B,113,95,2025-02-21 16:21:00,18
11290,ORD_11291,36644,Zofen Plus 100 mg/500 mg Tablet,Warehouse C,26,10,2025-02-21 08:03:00,16
11291,ORD_11292,218,Plum Bodylovin' Vanilla Vibes Body Oil 200 Ml,Warehouse C,38,19,2025-02-21 13:49:00,19
11292,ORD_11293,3430,"RiaTech 3mm Thickness Extra Large Size (900x400mm) Speed Type Extended Gaming Mouse Pad with Stitched Embroidery Edge, No...",Warehouse A,59,45,2025-02-21 03:53:00,14
11293,ORD_11294,16573,"DIGITEK® (ENEL14) Secondary Rechargeable Battery Packs for Digital Camera & Digital Camcorders, Compatibility - D3100 DSL...",Warehouse B,43,37,2025-02-21 20:57:00,6
11294,ORD_11295,1063,Clavnic Dry Syrup,Warehouse B,73,65,2025-02-21 23:18:00,8
11295,ORD_11296,2825,Livodic-SP Tablet,Warehouse B,60,55,2025-02-21 00:07:00,5
11296,ORD_11297,30505,"Logitech Mx Keys Advanced Illuminated Wireless Keyboard, Bluetooth, Tactile Responsive Typing, Backlit Keys, USB-C, Pc/Ma...",Warehouse C,103,87,2025-02-21 20:07:00,16
11297,ORD_11298,18,Dorman Spas 10mg/250mg Tablet,Warehouse C,15,8,2025-02-21 00:59:00,7
11298,ORD_11299,24337,"Camel Artist Purified Linseed Oil for Oil Color, 100ml (Yellow)",Warehouse B,18,13,2025-02-21 14:13:00,5
11299,ORD_11300,10579,ORICO 2.5 inch USB C Hard Drive Enclosure USB 3.1 Gen 2 to SATA III External Hard Drive Case for SSD HDD 9.5 7mm Tool-Free...,Warehouse B,102,87,2025-02-21 19:30:00,15
11300,ORD_11301,23980,Casio SX-300-W Portable Calculator,Warehouse C,60,52,2025-02-21 17:34:00,8
11301,ORD_11302,3661,Cilnipine 5 Tablet,Warehouse C,94,87,2025-02-21 21:16:00,7
11302,ORD_11303,33053,Belora Paris World Matte Vit C Popsicles - 016 Hungarian Rose 4.2 gm,Warehouse B,51,36,2025-02-21 16:10:00,15
11303,ORD_11304,17732,Atorbia C 10mg/75mg Tablet,Warehouse B,19,7,2025-02-21 11:29:00,12
11304,ORD_11305,28542,"Deep Relax Aromatherapy Diffuser Oil - Cedarwood, Ylang-Ylang & Vetiver",Warehouse C,115,98,2025-02-21 15:39:00,17
11305,ORD_11306,28819,Faces Canada Velvet Matte Lipstick Pink Alert 09 3.5 Gm,Warehouse B,59,44,2025-02-21 01:59:00,15
11306,ORD_11307,31715,Rabenax-DSR Capsule,Warehouse C,32,27,2025-02-21 06:54:00,5
11307,ORD_11308,14128,"Hold Up Tabletop Tablet Holder Stand, iPad Stand Floor Height Adjustable Tablet Tripod Stand for iPad Mini 1, 2, 3, iPad A...",Warehouse C,67,48,2025-02-21 08:44:00,19
11308,ORD_11309,36636,Uwan 4mg Tablet,Warehouse C,64,57,2025-02-21 07:26:00,7
11309,ORD_11310,7121,Finishing Touch Flawless Original Facial Hair Removal Rechargeable White,Warehouse B,47,40,2025-02-21 19:15:00,7
11310,ORD_11311,1553,mCaffeine Naked Detox Exfoliating Green Tea Face Scrub 100 gm,Warehouse C,62,54,2025-02-21 03:43:00,8
11311,ORD_11312,11762,Hair Logic Illuminating Conditioner 1's,Warehouse B,60,55,2025-02-21 17:29:00,5
11312,ORD_11313,30680,"Duracell Rechargeable AA 1300mAh Batteries, 2Pcs",Warehouse A,50,45,2025-02-21 09:53:00,5
11313,ORD_11314,6579,"HUMBLE® Bike Phone Holder, 360 Rotation Silicone Bicycle Phone Holder/Mount, Universal Motorcycle Handlebar Mount Compatib...",Warehouse C,69,64,2025-02-21 13:53:00,5
11314,ORD_11315,2191,Evog-M 500mg/0.3mg Tablet,Warehouse B,69,57,2025-02-21 00:38:00,12
11315,ORD_11316,905,"Duracell Rechargeable AA 2500mAh Batteries, 4 Pcs",Warehouse B,112,97,2025-02-21 07:28:00,15
11316,ORD_11317,28093,Espford D 30mg/40mg Capsule,Warehouse A,27,20,2025-02-21 13:50:00,7
11317,ORD_11318,5906,Nymzap P 100mg/500mg Tablet,Warehouse A,49,42,2025-02-21 23:52:00,7
11318,ORD_11319,7834,"realme Buds Wireless in Ear Bluetooth Earphones with mic, 11.2mm Bass Boost Driver, Magnetic Fast Pair, Fast Charging and ...",Warehouse C,96,89,2025-02-21 08:26:00,7
11319,ORD_11320,21772,"boAt Airdopes 191G True Wireless In Ear Earbuds with ENx Tech Equipped Quad Mics, Beast Mode(Low Latency- 65ms) for Gamin...",Warehouse A,87,80,2025-02-21 07:43:00,7
11320,ORD_11321,18256,Jovees Premium Matte Tint Sun Shield SPF 40 PA++ Protective Lotion 50 ml,Warehouse A,65,55,2025-02-21 13:54:00,10
11321,ORD_11322,26490,"Sounce Fast Phone Charging Cable & Data Sync USB Cable Compatible for iPhone 13, 12,11, X, 8, 7, 6, 5, iPad Air, Pro, Mini...",Warehouse B,81,65,2025-02-21 18:57:00,16
11322,ORD_11323,5052,Allure Contour Brush (flat Blending Brush C-24 ) 1's,Warehouse B,59,52,2025-02-21 13:30:00,7
11323,ORD_11324,14745,Cefbet 750mg Injection,Warehouse A,75,57,2025-02-21 14:17:00,18
11324,ORD_11325,25286,"ELV Surge Protector and Spike Guard, 10 AMP, 6 Socket Extension Board Cord, 6 Feet Wire, Overload Protection Master Switch...",Warehouse C,19,5,2025-02-21 07:22:00,14
11325,ORD_11326,23832,Sony MDR-ZX110A Wired On Ear Headphone without Mic (White),Warehouse C,78,70,2025-02-21 08:46:00,8
11326,ORD_11327,34489,LOHAYA Remote Compatible for Panasonic Split AC Remote Control with Backlight (AC-29C),Warehouse A,98,79,2025-02-21 08:19:00,19
11327,ORD_11328,19,Dicorex Injection,Warehouse C,47,35,2025-02-21 22:30:00,12
11328,ORD_11329,8074,"Freshistry Rose Extract & Aloe Vera Liquid Tint For Women | Moisturizing, Hydrating & Soothing | For Cheeks, Eyelids & Lips",Warehouse B,66,51,2025-02-21 03:16:00,15
11329,ORD_11330,6145,Adispore Oral Suspension,Warehouse C,98,91,2025-02-21 13:25:00,7
11330,ORD_11331,36495,Fexocet Suspension,Warehouse A,106,98,2025-02-21 11:26:00,8
11331,ORD_11332,9937,Mixiderm Cream,Warehouse C,34,28,2025-02-21 09:22:00,6
11332,ORD_11333,26501,"TP-Link Nano USB WiFi Dongle 150Mbps High Gain Wireless Network Wi-Fi Adapter for PC Desktop and Laptops, Supports Windows...",Warehouse B,73,57,2025-02-21 17:06:00,16
11333,ORD_11334,25165,TheGiftKart Back Cover for Samsung Galaxy M51 (Poly Carbonate Polymer | Black),Warehouse C,79,63,2025-02-21 02:34:00,16
11334,ORD_11335,21782,Bio Dandelion Serum 40 Ml,Warehouse C,74,60,2025-02-21 04:02:00,14
11335,ORD_11336,21799,"SanDisk Ultra Dual Drive Go USB 3.0 Type C Flash Drive, Peach, 64GB, 5Y",Warehouse C,93,77,2025-02-21 20:15:00,16
11336,ORD_11337,35306,"BONACE Strap for Samsung Galaxy Watch 4/5 40/44mm/Classic 42/46mm,20mm Metal Replacement Strap for Samsung Watch 4/5 Pro S...",Warehouse A,92,80,2025-02-21 14:21:00,12
11337,ORD_11338,6144,"Rene Furterer Triphasic Strengthening Shampoo for Hair Loss, 50 ml",Warehouse A,94,86,2025-02-21 23:12:00,8
11338,ORD_11339,26463,"Mivi Duopods A25 Bluetooth Truly Wireless In Ear Earbuds With Mic Upto 40 Hours Playtime With Ipx4 Water Resistance, Smoot...",Warehouse C,47,30,2025-02-21 07:17:00,17
11339,ORD_11340,5054,Acekon P 100 mg/500 mg Tablet,Warehouse A,29,21,2025-02-21 12:16:00,8
11340,ORD_11341,19209,Insight Cosmetics Long Wear Color Rich Lip Gloss - Bitten 4 ml,Warehouse B,9,2,2025-02-21 22:01:00,7
11341,ORD_11342,21741,Corditel H 40mg/12.5mg Tablet,Warehouse B,56,41,2025-02-21 15:15:00,15
11342,ORD_11343,12141,SOM Eyelash Curler With Special Curved Design To Suit All Eye Shapes For Lashes,Warehouse C,74,68,2025-02-21 04:13:00,6
11343,ORD_11344,6138,Canon EOS 1500D 24.1 Digital SLR Camera (Black) with EF S18-55 is II Lens,Warehouse A,85,80,2025-02-21 01:36:00,5
11344,ORD_11345,24309,Nulong 5 Tablet,Warehouse B,105,92,2025-02-21 12:25:00,13
11345,ORD_11346,24310,"Noise ColorFit Pulse Smartwatch with 1.4"" Full Touch HD Display, SpO2, Heart Rate, Sleep Monitors & 10-Day Battery - Teal ...",Warehouse A,85,70,2025-02-21 16:54:00,15
11346,ORD_11347,33505,Azip 250mg Tablet,Warehouse B,48,35,2025-02-21 23:40:00,13
11347,ORD_11348,3642,"SH. HUDA Forever Matte Me Liquid Beauty Lipstick Set Of 6 (Multicolor, 36 ml)",Warehouse C,99,81,2025-02-21 17:09:00,18
11348,ORD_11349,482,Exlla 200mg Tablet,Warehouse A,39,22,2025-02-21 11:57:00,17
11349,ORD_11350,3787,Lakme True Wear Nail Color Shade Tm103 9 Ml,Warehouse A,26,15,2025-02-21 03:03:00,11
11350,ORD_11351,31366,Clay Fresh Shower Gel - Hibiscus & Grapefruit,Warehouse A,82,77,2025-02-21 17:52:00,5
11351,ORD_11352,16625,Apple EarPods with 3.5mm Headphone Plug,Warehouse C,105,86,2025-02-21 11:18:00,19
11352,ORD_11353,36600,Strawberry Lip Balm,Warehouse C,48,35,2025-02-21 16:21:00,13
11353,ORD_11354,22573,"Offbeat RIPJAW 2.4Ghz Rechargeable Wireless Gaming Mouse, Silent Click Buttons Mouse - 7D Buttons, DPI : 1600,2400,3200, M...",Warehouse C,107,94,2025-02-21 03:51:00,13
11354,ORD_11355,33047,"Samsung Galaxy Tab A8 10.5 inches Display with Calling, RAM 4 GB, ROM 64 GB Expandable, Wi-Fi+LTE Tablets, Gray, (SM-X205N...",Warehouse C,96,86,2025-02-21 07:10:00,10
11355,ORD_11356,29723,Gemblue Biocare Neem Face and Body Scrub 500 ml,Warehouse A,115,97,2025-02-21 03:36:00,18
11356,ORD_11357,6735,Zisan XL 200mg Oral Suspension,Warehouse B,62,45,2025-02-21 07:30:00,17
11357,ORD_11358,1071,"Portronics Decibel 21 10W Wireless Bluetooth Soundbar with LED Lights, TWS Function, Built-in Mic, Built-in FM Radio, USB ...",Warehouse A,103,87,2025-02-21 16:27:00,16
11358,ORD_11359,31755,"Carvaan Saregama Musicbar Karaoke CBWK121, 120W 2.1 Channel Soundbar, Karaoke Function to Sing Any Song, 2 mics, 1000 pre-...",Warehouse C,59,47,2025-02-21 04:28:00,12
11359,ORD_11360,25778,"Amkette Power Pro 3 Port 33 Watts USB Car Charger with Quick Charge 3.0 & Free Braided Type C Cable, 1 Year Warranty (Black).",Warehouse A,66,56,2025-02-21 03:07:00,10
11360,ORD_11361,6173,House of Beauty Derma Roller 0.50mm 1's,Warehouse C,92,81,2025-02-21 07:31:00,11
11361,ORD_11362,28844,Broncorid Syrup,Warehouse A,50,45,2025-02-21 13:06:00,5
11362,ORD_11363,34451,Essential Oil Facial Kit - Party Ready,Warehouse B,64,48,2025-02-21 14:49:00,16
11363,ORD_11364,4605,Acistensa-P Oral Suspension,Warehouse C,108,91,2025-02-21 11:25:00,17
11364,ORD_11365,1072,TheGiftKart Translucent Hybrid Back Case Cover for OnePlus Nord 2T 5G | Smoked Matte Back | 360 Degree Protection | Protec...,Warehouse C,44,33,2025-02-21 15:25:00,11
11365,ORD_11366,1044,"Seagate Ultra Touch 2 TB External Hard Drive Portable HDD USB-C USB 3.0, 1yr Mylio Create, 4 Months Adobe CC Photography P...",Warehouse B,81,62,2025-02-21 06:40:00,19
11366,ORD_11367,34443,"Adult Diaper Pants Classic, Large",Warehouse A,76,67,2025-02-21 09:02:00,9
11367,ORD_11368,30488,"Wella Professionals Wella Professionals Invigo Color Brilliance Regime For Fine/Normal Hair - Shampoo 250ml, Conditioner 2...",Warehouse A,95,85,2025-02-21 05:36:00,10
11368,ORD_11369,10036,Shallaki - Tablets (Wellness),Warehouse A,94,85,2025-02-21 01:43:00,9
11369,ORD_11370,279,Fresh Woody,Warehouse B,50,42,2025-02-21 21:33:00,8
11370,ORD_11371,6174,Clodapin-A 150 Tablet,Warehouse C,108,97,2025-02-21 14:53:00,11
11371,ORD_11372,28583,Arclav DS Dry Syrup,Warehouse A,53,44,2025-02-21 11:43:00,9
11372,ORD_11373,33445,Root Hair Shampoo,Warehouse A,67,53,2025-02-21 17:40:00,14
11373,ORD_11374,1860,Kinsound Red USB Type C to 3.5mm Audio Jack Earphones Splitter Connector Headphone Converter Adapter with 384khz-32bit Hi-...,Warehouse B,28,20,2025-02-21 23:01:00,8
11374,ORD_11375,29487,"Ambrane 20000 mAh Lithium Polymer Stylo-20k Power Bank with 20 Watt Fast Charging, 2 USB,Type C Port,Green",Warehouse B,79,61,2025-02-21 04:44:00,18
11375,ORD_11376,16795,Neurozeet Gaba 300mg/500mcg Tablet,Warehouse B,38,30,2025-02-21 01:30:00,8
11376,ORD_11377,14798,Jovees Aloe Vera Gel 200 gm,Warehouse A,32,14,2025-02-21 06:44:00,18
11377,ORD_11378,27445,Lastuss LA Syrup,Warehouse B,71,65,2025-02-21 04:32:00,6
11378,ORD_11379,36169,Flormar Waterproof Lipliner 243 Hot Cocoa 1.14 gm,Warehouse C,109,99,2025-02-21 03:51:00,10
11379,ORD_11380,17727,"Chambor Silver Shadow, Sable Rr3 32 gm",Warehouse B,91,81,2025-02-21 12:36:00,10
11380,ORD_11381,10604,Grapeseed Oil,Warehouse A,29,14,2025-02-21 13:06:00,15
11381,ORD_11382,25969,Serra AP 100 mg/500 mg/15 mg Tablet,Warehouse C,63,49,2025-02-21 18:02:00,14
11382,ORD_11383,33494,Joynap 1mg Tablet,Warehouse A,34,27,2025-02-21 09:19:00,7
11383,ORD_11384,3038,Sensitive Toothpaste - Whitening,Warehouse C,16,10,2025-02-21 10:03:00,6
11384,ORD_11385,22975,Listerine Fresh Burst Mouthwash 250ml,Warehouse C,57,47,2025-02-21 19:57:00,10
11385,ORD_11386,11760,Clopan Lotion,Warehouse A,29,20,2025-02-21 06:06:00,9
11386,ORD_11387,6125,"Google Pixel 6 Charger Original Compatible with Cellular Phones Google Pixel 7, Google Pixel 7 Pro, Google Pixel 6A, Googl...",Warehouse A,42,23,2025-02-21 20:26:00,19
11387,ORD_11388,16551,BASECASE Thermoplastic Polyurethane Shock Proof Clear Hybrid Hard Back Cover Mobile Cover for 1+ OnePlus Nord 2T 5G (Jet B...,Warehouse C,60,50,2025-02-21 08:53:00,10
11388,ORD_11389,32545,Itconiv 200mg Capsule,Warehouse B,99,91,2025-02-21 17:52:00,8
11389,ORD_11390,16750,Ribanz IT 20mg/150mg Capsule SR,Warehouse C,97,88,2025-02-21 19:38:00,9
11390,ORD_11391,17879,HP 678 2-Pack Black/Tri-Color Original Ink Advantage Cartridges,Warehouse B,15,4,2025-02-21 19:48:00,11
11391,ORD_11392,24000,Elucil Oral Suspension,Warehouse C,45,35,2025-02-21 17:47:00,10
11392,ORD_11393,16797,"ProElite Slim Trifold Flip case Cover for Redmi Pad 10.6"" Tablet, Hippy",Warehouse A,32,15,2025-02-21 12:49:00,17
11393,ORD_11394,15114,Ajmal 2 Silver Shade And 2 Distraction Deodorants Pack of 4 200 ml,Warehouse B,19,5,2025-02-21 22:00:00,14
11394,ORD_11395,1026,Brenzol Plus 6mg/400mg Tablet,Warehouse A,25,17,2025-02-21 17:13:00,8
11395,ORD_11396,34233,Lakme 9To5 Primer + Matte Perfect Cover Foundation C140 Cool Rose 25 Ml,Warehouse B,96,84,2025-02-21 14:28:00,12
11396,ORD_11397,5002,"moxly Universal Car Rear View Phone Holder Mount, 360°Rotatable Retractable Rearview Mirror Phone Holder for Car, GPS Hold...",Warehouse C,23,9,2025-02-21 11:03:00,14
11397,ORD_11398,35376,SupCares Edge to Edge Anti Glare Matte Tempered Glass for iPhone 12 and iPhone 12 Pro (6.1 Inch) with Easy Self Installati...,Warehouse B,15,10,2025-02-21 21:44:00,5
11398,ORD_11399,5964,Juvinate P 750mcg/75mg Capsule,Warehouse A,50,32,2025-02-21 21:51:00,18
11399,ORD_11400,25724,Biotique Bio Sandalwood 50+ SPF UVA/UVB Sunscreen Ultra Soothing Face Lotion 190 ml,Warehouse C,84,69,2025-02-21 06:15:00,15
11400,ORD_11401,28491,Gemblue Biocare Gold Face and Body Scrub 500 ml,Warehouse B,35,21,2025-02-21 07:47:00,14
11401,ORD_11402,10071,Romesec 10mg Tablet,Warehouse A,112,93,2025-02-21 01:07:00,19
11402,ORD_11403,4695,Azilide 200mg/5ml Suspension,Warehouse A,100,90,2025-02-21 20:03:00,10
11403,ORD_11404,6646,Naturals Bhringraj Hair Oil,Warehouse A,51,32,2025-02-21 05:30:00,19
11404,ORD_11405,26072,Pritorva CV 20 Capsule,Warehouse A,30,23,2025-02-21 12:49:00,7
11405,ORD_11406,15421,Sivanna Colors Bronze & Highlighter Make Up Studio - HF358 03 12 gm,Warehouse A,93,86,2025-02-21 12:54:00,7
11406,ORD_11407,28913,Chyawanprash - 2X Immunity,Warehouse A,40,33,2025-02-21 05:38:00,7
11407,ORD_11408,1660,"VAGMI 6 IN 1 Plastic Military Pen with Compass, Torch, Tools, Phone Stand And Stylus for Smartphones , Multicolour.",Warehouse A,59,44,2025-02-21 18:48:00,15
11408,ORD_11409,31793,TheGiftKart Smoked Translucent Protective Hard Back Case Cover for Samsung Galaxy M32 4G / M32 Prime (TPU & PC | Black Bum...,Warehouse C,40,31,2025-02-21 03:57:00,9
11409,ORD_11410,23835,"Redmi Note 11 (Horizon Blue, 6GB RAM, 128GB Storage)|90Hz FHD+ AMOLED Display | Qualcomm® Snapdragon™ 680-6nm | 33W Charge...",Warehouse C,104,91,2025-02-21 19:36:00,13
11410,ORD_11411,35782,Bio Herbcolor 1N Natural Black 50 Gm +110 Ml 160 Ml,Warehouse A,96,79,2025-02-21 12:55:00,17
11411,ORD_11412,22853,Tinoxin 100mg/100mg Suspension,Warehouse A,45,37,2025-02-21 21:34:00,8
11412,ORD_11413,24095,"L'Oreal Paris Liquid Foundation, Oil Absorbing Formula, Transferproof, Heatproof and Long-lasting, Infallible 32H Fresh We...",Warehouse C,52,41,2025-02-21 22:13:00,11
11413,ORD_11414,35680,Cosmic Byte CB-GK-27 Vanth Mechanical Keyboard Upgraded with Swappable Outemu Blue Switches and Rainbow LED (Black/Grey),Warehouse C,77,69,2025-02-21 19:34:00,8
11414,ORD_11415,35468,Lemon & Tea Tree Oil Soap,Warehouse A,40,35,2025-02-21 05:14:00,5
11415,ORD_11416,17999,Pores pink rice mask 10 pieces,Warehouse C,45,32,2025-02-21 08:37:00,13
11416,ORD_11417,79,Ajmal Selfie Concentrated Perfume Oil Woody Aromatic And Maryaj Dynamic EDP Spicy Woody Perfume 110 ml,Warehouse C,84,69,2025-02-21 14:31:00,15
11417,ORD_11418,346,Oil Clear Lemon Foaming Face Wash,Warehouse A,30,19,2025-02-21 09:21:00,11
11418,ORD_11419,28753,"ZOUK Handmade PeTA Approved Vegan Leather 15.6 Inch Laptop Office Bag with Double Handles, Multicolor Geometric Print Shou...",Warehouse A,88,83,2025-02-21 13:26:00,5
11419,ORD_11420,22748,"ETI Duct Tape, 48x50m (Grey)",Warehouse C,84,79,2025-02-21 08:40:00,5
11420,ORD_11421,34194,Fashion Colour Hair Spray Fixup Keratin Super Firm Hold 75 ml,Warehouse C,52,35,2025-02-21 03:17:00,17
11421,ORD_11422,31170,The Man Company Pre Shave Oil - Argan & Jojoba 50 ml,Warehouse B,64,47,2025-02-21 22:47:00,17
11422,ORD_11423,13986,Organic Sesame Oil - Pure Coldpressed Oil,Warehouse A,25,7,2025-02-21 08:37:00,18
11423,ORD_11424,31729,Accuprints 2023 Size 7 by 9.5 inch planner calendar Black and white,Warehouse C,31,15,2025-02-21 15:27:00,16
11424,ORD_11425,14931,"GIZGA essentials Rubber Extended Gaming Mouse Pad for Laptops, Laptop Desk Mat, Computer Mouse Pad with Smooth Mouse Contr...",Warehouse B,93,88,2025-02-21 06:01:00,5
11425,ORD_11426,30536,Losarwock H 50mg/12.5mg Tablet,Warehouse B,22,11,2025-02-21 22:33:00,11
11426,ORD_11427,13872,Syntram Injection,Warehouse B,50,45,2025-02-21 06:49:00,5
11427,ORD_11428,16483,"Nourishing Liquid Hand Wash - For Soft Moisturised Skin, Washes Away Germs",Warehouse A,52,37,2025-02-21 02:28:00,15
11428,ORD_11429,2617,Canon PIXMA G3060 All-in-One High Speed Wi-Fi Ink Tank Colour Printer (Black),Warehouse A,112,93,2025-02-21 19:03:00,19
11429,ORD_11430,25921,Asterab IT 20mg/150mg Capsule,Warehouse A,66,50,2025-02-21 04:48:00,16
11430,ORD_11431,31330,Winble Back Cover for Redmi K20 Pro/K20 (Silicone | Black),Warehouse B,47,40,2025-02-21 15:40:00,7
11431,ORD_11432,2278,Rosu F 145mg/10mg Tablet,Warehouse A,83,70,2025-02-21 01:39:00,13
11432,ORD_11433,22352,"Syoss - Color Salon Protect Anti Fade, 02 Conditioner",Warehouse A,74,61,2025-02-21 17:48:00,13
11433,ORD_11434,22166,moxly Universal Silicone Sucker Long Neck Car Mobile Phone Holder Mount Stand Ultimate Reusable Suction Cup with 360 Degre...,Warehouse C,109,90,2025-02-21 03:56:00,19
11434,ORD_11435,35462,MorningVale Jackly Magnetic Screw Driver 31 in 1 Tool Kit (Yellow),Warehouse A,27,15,2025-02-21 10:02:00,12
11435,ORD_11436,10609,Focobal 500mcg Injection,Warehouse A,113,95,2025-02-21 20:09:00,18
11436,ORD_11437,24226,Passion Indulge CARRIER OIL-ALMOND 60 ml,Warehouse A,94,82,2025-02-21 00:41:00,12
11437,ORD_11438,23018,"QianLink USB C To Lightning Apple Certified (Mfi) Sync & Charge Cable For Iphone, Ipad And Ipod. Fast Charging Lightning C...",Warehouse B,102,86,2025-02-21 21:02:00,16
11438,ORD_11439,4133,Medimade Hair Growth Shampoo With Red Onion And Black Seed 300 ml,Warehouse C,28,23,2025-02-21 00:26:00,5
11439,ORD_11440,6150,"Samsung T7 Touch 1TB Up to 1,050MB/s USB 3.2 Gen 2 (10Gbps, Type-C) External Solid State Drive (Portable SSD) Black (MU-PC...",Warehouse B,48,43,2025-02-21 23:52:00,5
11440,ORD_11441,31731,Ondistop 4mg Tablet,Warehouse A,21,14,2025-02-21 08:24:00,7
11441,ORD_11442,37135,Special Bathing Brush No 24,Warehouse A,34,26,2025-02-21 17:09:00,8
11442,ORD_11443,23038,"Florican Portable Invisible Laptop Riser Stand | Mini Aluminum Cooling Pad, Lightweight Laptop Desk Stand for MacBook, Len...",Warehouse A,86,81,2025-02-21 10:20:00,5
11443,ORD_11444,31550,Alporate 300 Tablet CR,Warehouse B,25,13,2025-02-21 00:41:00,12
11444,ORD_11445,22362,Vertidale D 15mg/20mg Tablet,Warehouse B,49,43,2025-02-21 20:34:00,6
11445,ORD_11446,28693,Restonorm LS 2mg/2mg Tablet,Warehouse B,37,18,2025-02-21 14:53:00,19
11446,ORD_11447,14027,"Amazon Basics Bluetooth 5.0 Truly Wireless in Ear Earbuds, Up to 38 Hours Playtime, IPX-5 Rated, Type-C Charging Case, Tou...",Warehouse B,54,48,2025-02-21 10:10:00,6
11447,ORD_11448,4844,Tolopar 150mg Tablet,Warehouse A,87,77,2025-02-21 06:13:00,10
11448,ORD_11449,28254,"Casio FX-82MS 2nd Gen Non-Programmable Scientific Calculator, 240 Functions and 2-line Display, Black",Warehouse A,52,36,2025-02-21 07:26:00,16
11449,ORD_11450,31161,"ZEBRONICS Juke BAR 3810 PRO Dolby Audio Soundbar with 100W RMS Output, Premium Glossy Finish, Powerful Quad Drives, HDMI A...",Warehouse B,21,3,2025-02-21 07:27:00,18
11450,ORD_11451,22140,Camlin Colour Pencils Full Size - 24 Shades,Warehouse C,44,37,2025-02-21 12:03:00,7
11451,ORD_11452,8355,Flormar Silk Matte Liquid Lipstick 021 Smoky Lilac 4.5 gm,Warehouse A,85,74,2025-02-21 20:08:00,11
11452,ORD_11453,12225,boAt 102 Bluetooth Wireless in Ear Earphones with Mic (Red),Warehouse A,85,75,2025-02-21 07:06:00,10
11453,ORD_11454,22381,Ontus-L Syrup,Warehouse B,58,45,2025-02-21 10:17:00,13
11454,ORD_11455,997,AUTO SNAP 9 Inch HD 1280 Android Double Din Stereo Player 12 Android Version Gorilla Glass IPS Display Car Stereo Touch Sc...,Warehouse B,32,16,2025-02-21 06:34:00,16
11455,ORD_11456,18536,Zedocef 100 Oral Suspension,Warehouse B,98,87,2025-02-21 00:38:00,11
11456,ORD_11457,28251,"Tukzer Gizga 2-in-1 Professional Screen Cleaning Kit (500ML) for Camera, Lens, Binocular, Laptop, TV, Monitor, Smartphone,...",Warehouse A,29,19,2025-02-21 08:22:00,10
11457,ORD_11458,22137,"MYVN Fast Charging Adapter (5W) with Data Sync (480mbps) USB Cable Compatible with All iPhone 5, 5s, SE, 6/6s, 6/6Plus, 7/...",Warehouse B,74,65,2025-02-21 03:35:00,9
11458,ORD_11459,6233,Kohl Kiss Intense Hydrating Kajal Eyeliner 1.2 gm,Warehouse C,18,1,2025-02-21 19:47:00,17
11459,ORD_11460,7238,Sarfixim LB 200mg Tablet DT,Warehouse B,39,29,2025-02-21 19:56:00,10
11460,ORD_11461,15092,Acevog P 100mg/325mg Tablet,Warehouse B,69,51,2025-02-21 03:38:00,18
11461,ORD_11462,265,DronaIndia Tambourine Hand Percussion Musical Instrument,Warehouse C,14,3,2025-02-21 02:31:00,11
11462,ORD_11463,7239,Mars Long Lasting Smudge Proof Eyeliner 1 g (Black INK),Warehouse C,84,79,2025-02-21 15:04:00,5
11463,ORD_11464,15512,Nicka K TRUE MATTE LIP COLOR MILANO RED 3.5 gm,Warehouse B,71,53,2025-02-21 22:08:00,18
11464,ORD_11465,7179,Skin Care Lotion - Cooling Aloe Vera with Naturals,Warehouse B,55,41,2025-02-21 20:25:00,14
11465,ORD_11466,29542,All Natural Sanitary Pads - XL,Warehouse A,25,8,2025-02-21 19:26:00,17
11466,ORD_11467,26156,Alpodox CV Dry Syrup,Warehouse B,69,63,2025-02-21 22:57:00,6
11467,ORD_11468,16410,Epopod 50mg Dry Syrup,Warehouse C,26,14,2025-02-21 07:39:00,12
11468,ORD_11469,12509,FISICO SPF 50+ & PA+++ Transparent Sunscreen Gel,Warehouse C,77,58,2025-02-21 11:54:00,19
11469,ORD_11470,3674,Quinox 250mg Tablet,Warehouse B,90,79,2025-02-21 23:35:00,11
11470,ORD_11471,22170,Azichio Tablet,Warehouse A,113,99,2025-02-21 01:31:00,14
11471,ORD_11472,28901,"Skypearll Bluetooth Car Adapter, Mini USB Bluetooth 5.0 Transmitter Receiver Wireless 3.5mm Aux Jack Adapter Hands-Free Ca...",Warehouse A,6,1,2025-02-21 02:37:00,5
11472,ORD_11473,13829,Drotafor-M Tablet,Warehouse B,55,43,2025-02-21 08:55:00,12
11473,ORD_11474,31040,Acespar 200mg Tablet,Warehouse B,82,63,2025-02-21 08:32:00,19
11474,ORD_11475,10576,Ajmal Majmua And Jannatul Firdaus & Ascend EDP Pack of 3 20 ml,Warehouse A,96,89,2025-02-21 09:50:00,7
11475,ORD_11476,8143,"ProElite Smart Flip Case Cover for Apple iPad 10.2"" 9th Gen (2021) / 8th Gen / 7th Gen with Stylus Pen, Grey",Warehouse B,63,52,2025-02-21 13:43:00,11
11476,ORD_11477,21866,Refreshing Strawberry Body Lotion,Warehouse A,79,71,2025-02-21 17:15:00,8
11477,ORD_11478,33444,"Swiss Beauty Creamy Matte Smooth Velvet Lipstick | Highly Pigmented and Long Lasting Lipstick |Shade - 29, 3.2 G",Warehouse A,106,94,2025-02-21 15:06:00,12
11478,ORD_11479,26436,Spigen Modern Fit Strap for Samsung Galaxy Watch5 Pro | Galaxy Watch5 (44mm/40mm) | 4 (44mm/40mm) | 4 Classic (46mm/42mm)...,Warehouse A,22,5,2025-02-21 12:28:00,17
11479,ORD_11480,3781,Biofluence Therapeutic Conditioner,Warehouse C,32,22,2025-02-21 20:10:00,10
11480,ORD_11481,12600,Ajmal 3 Wisal Dahab Deo & Aretha EDP Pack of 4 20 ml,Warehouse A,51,32,2025-02-21 22:32:00,19
11481,ORD_11482,31587,Calmpose 5mg Tablet,Warehouse A,18,3,2025-02-21 06:13:00,15
11482,ORD_11483,19139,"Antibacterial Hand Sanitizer - 72% Alcohol Based Sanitizer, Non-Sticky, Gentle On Hands",Warehouse A,24,10,2025-02-21 08:44:00,14
11483,ORD_11484,10578,Diclopee M 50mg/100mg/500mg Tablet,Warehouse C,31,17,2025-02-21 17:14:00,14
11484,ORD_11485,16569,"Newly Smart Watch Charger Magnetic, Charging Cable for Boat Xtend, Noise ColorFit Pulse, Colorfit Ultra/Ultra 2, Color Fit...",Warehouse A,55,50,2025-02-21 11:32:00,5
11485,ORD_11486,7819,Honey Moisture Mask - For Dry & Damaged Hair,Warehouse A,47,39,2025-02-21 17:06:00,8
11486,ORD_11487,24026,Cipic-OD 500mg Tablet,Warehouse B,79,74,2025-02-21 21:27:00,5
11487,ORD_11488,3065,Massage Oil - Wheat Germ Oil,Warehouse B,52,38,2025-02-21 13:21:00,14
11488,ORD_11489,4251,TheGiftKart Ultra-Hybrid Crystal Clear Back Cover Case for OnePlus 7 | 360 Degree Protection | Shockproof Design | Hard Ba...,Warehouse A,25,20,2025-02-21 23:00:00,5
11489,ORD_11490,2968,Multani Mitti With Natural Rose Water Lotion,Warehouse C,50,31,2025-02-21 04:57:00,19
11490,ORD_11491,32286,"Himalaya Herbals Oil Control/Oil Clear Lemon Face Wash, 50ml",Warehouse A,53,34,2025-02-21 06:30:00,19
11491,ORD_11492,16597,Oratech New_Edition i7 Pro Max All in One Series 7 Smart Watch with Fitness Tracker Heart Monitor Men Women Smartwatch ( B...,Warehouse B,90,79,2025-02-21 15:36:00,11
11492,ORD_11493,28851,"TP-Link USB WiFi Adapter for PC(TL-WN725N), N150 Wireless Network Adapter for Desktop - Nano Size WiFi Dongle Compatible w...",Warehouse A,101,85,2025-02-21 06:58:00,16
11493,ORD_11494,14766,D2Q Vivo Compatible Fast Charging USB Data Cable for Vivo Smartphones Supports High Speed Charging Upto 3.1A (White) (6 Mo...,Warehouse C,108,97,2025-02-21 09:33:00,11
11494,ORD_11495,15554,Anchor White Toothpaste 150 gm,Warehouse A,102,95,2025-02-21 19:11:00,7
11495,ORD_11496,28536,Lafz Intense Care Hand Serum 40 ml,Warehouse C,35,30,2025-02-21 07:09:00,5
11496,ORD_11497,21770,Beard Wax For Beard Styling - Almond & Thyme,Warehouse A,114,95,2025-02-21 21:15:00,19
11497,ORD_11498,256,Comb - G Curve Ladies Derby Deluxe No 60,Warehouse A,37,23,2025-02-21 18:07:00,14
11498,ORD_11499,19239,Spigen Liquid Crystal Back Cover Case for iPhone 13 (TPU | Crystal Clear),Warehouse C,97,89,2025-02-21 08:19:00,8
11499,ORD_11500,4753,Grisovin-FP 500mg Tablet,Warehouse A,22,10,2025-02-21 21:46:00,12
11500,ORD_11501,34247,"Fashion Colour Cover Up Liquid Concealer, Shade 01 11 gm",Warehouse B,93,79,2025-02-21 16:18:00,14
11501,ORD_11502,3786,Faces Canada Splash Nail Enamel Biscotti 124 8 Ml,Warehouse A,77,67,2025-02-21 08:00:00,10
11502,ORD_11503,24998,Fungfine 250mg Tablet,Warehouse A,79,62,2025-02-21 20:10:00,17
11503,ORD_11504,5079,Revelo AZ 500mg/500mg Tablet,Warehouse B,76,63,2025-02-21 20:01:00,13
11504,ORD_11505,13941,URBN 27000 mAh 65W Ultra Fast Charging Compact Power Bank | Type C Power Delivery (Input& Output) | Quick Charge | Two-Way...,Warehouse A,91,77,2025-02-21 22:53:00,14
11505,ORD_11506,13462,Onstil 4mg Tablet,Warehouse B,57,49,2025-02-21 09:06:00,8
11506,ORD_11507,33708,Cfc 500mg Tablet,Warehouse B,27,16,2025-02-21 05:21:00,11
11507,ORD_11508,2242,"Face Mask 3-Layer Surgical - Disposable, Anti-Dust & Anti-Pollution, With Earloop",Warehouse C,42,35,2025-02-21 19:37:00,7
11508,ORD_11509,30491,SanDisk Cruzer Blade SDCZ50-016G-135 16 GB USB 2.0 Pen Drive (Red),Warehouse C,51,38,2025-02-21 06:07:00,13
11509,ORD_11510,10501,Divinectar Anti-Ageing Face Serum - Green Tea 30 ml,Warehouse B,47,30,2025-02-21 10:52:00,17
11510,ORD_11511,35333,Raboz D 30mg/20mg Capsule SR,Warehouse B,61,52,2025-02-21 05:18:00,9
11511,ORD_11512,19167,AmazonBasics MFI certified 2M USB C to lightning aluminum with nylon braided charging cable (Grey),Warehouse B,105,90,2025-02-21 03:23:00,15
11512,ORD_11513,7848,Kurtzy Paint Brushes Set - (15Pcs) Professional Wooden Brush Kit with Zipper Carry Case & Nylon Bristles/Knife/Sponge/Long...,Warehouse B,96,83,2025-02-21 03:47:00,13
11513,ORD_11514,32115,Herbal Fruit Face Pack,Warehouse A,76,65,2025-02-21 15:02:00,11
11514,ORD_11515,33259,Callmate 20000 mAh Lithium Polymer Digital Display Power Bank with in-Built 4 in 1 Cable USB Input Port DX15 with 18 Watt ...,Warehouse A,67,52,2025-02-21 20:05:00,15
11515,ORD_11516,4601,Cefmax 200mg Tablet DT,Warehouse A,48,36,2025-02-21 10:04:00,12
11516,ORD_11517,36257,Merostar 125mg Injection,Warehouse B,25,14,2025-02-21 17:30:00,11
11517,ORD_11518,28622,Styling Cream Original Non Greasy,Warehouse B,20,2,2025-02-21 08:46:00,18
11518,ORD_11519,28525,"Lenovo M10 Fhd Plus 2Nd Gen 10.3 Inches (4Gb, 128 Gb, Wi-Fi + Lte, Volte Calling) Tab With Active Pen, Kids Mode With Pare...",Warehouse A,103,98,2025-02-21 01:59:00,5
11519,ORD_11520,15026,Ferilinso [6-in-1 for Apple iPhone 14 & 13 Screen Protector Guard Accessories 3 Pack 9H Tempered Glass 3 Pack HD Camera Le...,Warehouse A,17,1,2025-02-21 06:16:00,16
11520,ORD_11521,21738,"AILKIN Lightning to USB Cable Apple Certified (Mfi) Sync & Charge Cable for iPhone, Ipad and iPod. Fast Charging Lightning...",Warehouse C,32,27,2025-02-21 11:24:00,5
11521,ORD_11522,31871,Pierre Cardin Paris - Mineral Powder 716-Honey,Warehouse A,62,50,2025-02-21 21:52:00,12
11522,ORD_11523,18247,Amro CV 500mg/125mg Tablet,Warehouse C,21,13,2025-02-21 18:57:00,8
11523,ORD_11524,12589,Gabavir-NT Tablet,Warehouse A,77,70,2025-02-21 03:30:00,7
11524,ORD_11525,15460,Natural Henna Powder,Warehouse C,80,72,2025-02-21 23:21:00,8
11525,ORD_11526,33848,Neurofix-Plus Injection,Warehouse C,88,69,2025-02-21 20:18:00,19
11526,ORD_11527,1743,Apigrow Syrup,Warehouse B,60,46,2025-02-21 11:39:00,14
11527,ORD_11528,14089,TheGiftKart Transparent Crystal Clear Shockproof TPU Back Cover Case for OnePlus Nord (2020) (Transparent),Warehouse B,70,60,2025-02-21 22:15:00,10
11528,ORD_11529,26459,RJ Wi-Fi Wireless Display Dongle | DLNA Wireless HDMI Screen Mirroring Wi-Fi Adaptor (Cromecast),Warehouse C,92,83,2025-02-21 05:15:00,9
11529,ORD_11530,4255,KAPAVER ® Polycarbonate Back Cover Case for Nothing Phone 1 5G (Transparent and Black),Warehouse B,63,57,2025-02-21 09:44:00,6
11530,ORD_11531,13818,Arata Natural Purifying Face Wash Rejuvenating Daily Cleanse 150 ml,Warehouse A,68,61,2025-02-21 15:58:00,7
11531,ORD_11532,36252,"OREI India to USA Converter Plug, Japan, Canada Adapter - Type B USA Travel Adapter - 2 in 1 - Perfect for Laptop, Camera ...",Warehouse C,64,55,2025-02-21 13:41:00,9
11532,ORD_11533,34456,Tycin 100mg Injection,Warehouse A,84,68,2025-02-21 01:51:00,16
11533,ORD_11534,30238,Mlor 100mg/8mg Tablet,Warehouse B,31,17,2025-02-21 23:18:00,14
11534,ORD_11535,2250,AERINA 240V Electrical Head Lice Comb Lice Solution Chemical Free Kills Head Lice Capture Lice Removal Treatment Lice Comb...,Warehouse B,87,68,2025-02-21 19:06:00,19
11535,ORD_11536,1519,Urvimycin 500 Tablet,Warehouse B,89,71,2025-02-21 04:51:00,18
11536,ORD_11537,33008,Deugest 200mg Injection,Warehouse A,94,82,2025-02-21 19:45:00,12
11537,ORD_11538,21722,Krocef-SB 1.5 Injection,Warehouse C,15,5,2025-02-21 16:49:00,10
11538,ORD_11539,14543,Meflux Gel Sugar Free,Warehouse B,77,59,2025-02-21 17:29:00,18
11539,ORD_11540,18390,Sivanna Colors Makeup Studio Nude Blush - HF3018 08 5 gm,Warehouse C,77,70,2025-02-21 03:59:00,7
11540,ORD_11541,21059,"Passiflora Herb Powder - Supports Low Stress, Strain & Low Blood Pressure",Warehouse C,24,18,2025-02-21 18:30:00,6
11541,ORD_11542,30706,Ucocil CV Injection,Warehouse C,25,8,2025-02-21 04:11:00,17
11542,ORD_11543,15194,Rexez UV Tempered Glass Screen Guard Protector for Xiaomi 13 Pro 5G (Transparent) Advanced Border Less Edge to Edge Full S...,Warehouse A,77,63,2025-02-21 20:10:00,14
11543,ORD_11544,21417,Betazide 80mg Tablet,Warehouse B,83,65,2025-02-21 12:31:00,18
11544,ORD_11545,36518,Kronim Cold Tablet,Warehouse C,34,28,2025-02-21 22:32:00,6
11545,ORD_11546,15196,Theoresp Plus 600mg Tablet,Warehouse A,90,82,2025-02-21 16:40:00,8
11546,ORD_11547,25332,Neutram P 37.5mg/325mg Tablet,Warehouse A,67,48,2025-02-21 00:38:00,19
11547,ORD_11548,14197,Mypol 650mg Tablet,Warehouse A,63,48,2025-02-21 03:55:00,15
11548,ORD_11549,23217,Fashion Colour Prep Priming Spray 100 gm,Warehouse C,55,40,2025-02-21 18:10:00,15
11549,ORD_11550,7735,"boAt Rockerz 330ANC Bluetooth in Ear Neckband with Mic, Crystal Bionic Sound Powered by Dirac Opteo, Active Noise Cancella...",Warehouse C,53,41,2025-02-21 22:51:00,12
11550,ORD_11551,4077,Mom Dad With Baby Waterproof Temporary Body Tattoo For Boys Girls Men Women,Warehouse C,35,16,2025-02-21 15:33:00,19
11551,ORD_11552,27757,Office-OZ Tablet,Warehouse A,34,24,2025-02-21 01:19:00,10
11552,ORD_11553,23198,AmazonBasics Permanent Markers - Assorted - Pack of 12,Warehouse C,15,2,2025-02-21 01:29:00,13
11553,ORD_11554,1478,The Moms Co. Damaged Control Shampoo 200 ml,Warehouse C,33,27,2025-02-21 22:22:00,6
11554,ORD_11555,19539,Natural Vita Rich Under Eye Cream,Warehouse C,65,49,2025-02-21 04:29:00,16
11555,ORD_11556,31997,Okami ZenPack LITE Laptop Messenger Bag with USB Fast Charger (Kyoto Black),Warehouse A,14,1,2025-02-21 21:14:00,13
11556,ORD_11557,16153,"Honeywell Moxie V500 10W Portable USB Wired Soundbar, Speaker for PC, Desktop and Laptop with Volume Control and 3.5 mm AU...",Warehouse B,107,97,2025-02-21 13:10:00,10
11557,ORD_11558,2745,Ofluce OZ Oral Suspension,Warehouse A,42,37,2025-02-21 10:43:00,5
11558,ORD_11559,29449,Timeless Beauty Secrets Lip Balm -Egyptian Goat Milk Softening and Moisturizing Tinted Lustrous Lip Butter (8 g),Warehouse A,57,44,2025-02-21 10:40:00,13
11559,ORD_11560,460,Beauty People Sheer Color Lipstick - 422 3.8 gm,Warehouse C,57,52,2025-02-21 03:10:00,5
11560,ORD_11561,1475,Methalco Forte Injection,Warehouse A,69,56,2025-02-21 17:14:00,13
11561,ORD_11562,13322,Baro LV 75mg/20mg Tablet,Warehouse A,16,1,2025-02-21 06:12:00,15
11562,ORD_11563,3916,Insight Cosmetics Pastel Color Nail Polish - 32 9 ml,Warehouse B,56,41,2025-02-21 14:30:00,15
11563,ORD_11564,14174,Bonjour Paris Premium Go Creative Dual Satin Matte Lipsticks (Bubble Gum/Fuchsia) 4.2 gm,Warehouse C,58,45,2025-02-21 15:43:00,13
11564,ORD_11565,7038,Daily Life Forever 52 Angled Face Brush Nx002 1's,Warehouse C,111,95,2025-02-21 13:28:00,16
11565,ORD_11566,30702,"Globus Naturals Banana Stem Juice for both Men and Women For Weight Loss & Healthy Heart, Liver & Kidney 500 ml",Warehouse B,100,88,2025-02-21 21:27:00,12
11566,ORD_11567,36297,"Lotus Makeup Herbals Loose Powder With Auto-Puff, SPF 15, Iceberg, 10g",Warehouse C,54,38,2025-02-21 07:39:00,16
11567,ORD_11568,24398,Superdrug Anti Dandruff Citrus Shampoo 500 ml,Warehouse C,36,24,2025-02-21 15:18:00,12
11568,ORD_11569,30377,Nuprox-CV 200mg/125mg Tablet,Warehouse C,110,97,2025-02-21 00:17:00,13
11569,ORD_11570,10924,PULOKA Multi Functional Holster Pouch for Mobile (Leather | Brown),Warehouse A,42,24,2025-02-21 06:53:00,18
11570,ORD_11571,21512,"boAt Stone 620 Bluetooth Speaker with 12W RMS Stereo Sound, 10HRS Playtime, TWS Feature, IPX4, Multi-Compatibility Modes(G...",Warehouse C,18,13,2025-02-21 01:55:00,5
11571,ORD_11572,5229,Westinghouse 106 cm (43 inches) Full HD Smart Certified Android LED TV WH43SP99 (Black),Warehouse A,15,2,2025-02-21 09:54:00,13
11572,ORD_11573,17552,Novafect 1000mg/500mg Injection,Warehouse C,21,2,2025-02-21 07:58:00,19
11573,ORD_11574,1086,Lovivex 1% Cream,Warehouse B,44,35,2025-02-21 08:32:00,9
11574,ORD_11575,5222,Oil Control Bath Soap With Tea Tree extracts & Oatmeal - For Sensitive Skin,Warehouse B,88,71,2025-02-21 21:23:00,17
11575,ORD_11576,13807,Ofcro 50mg Oral Suspension,Warehouse B,47,29,2025-02-21 09:45:00,18
11576,ORD_11577,23111,"KABEER ART 8 In 1, 0.7mm Color Ball Point Pen With Transparent Body",Warehouse B,38,23,2025-02-21 10:11:00,15
11577,ORD_11578,16160,"Verilux® Flash Drive 64GB 4 in 1 Pendrive with Light-ning, Micro USB, USB A, Type-C Interface Mini Hangable Pen Drive for ...",Warehouse B,72,64,2025-02-21 20:07:00,8
11578,ORD_11579,34073,"realme narzo 50 (Speed Black, 6GB RAM+128GB Storage) Helio G96 Processor | 50MP AI Triple Camera | 120Hz Ultra Smooth Display",Warehouse C,24,8,2025-02-21 01:40:00,16
11579,ORD_11580,32971,Creme Soft Shower Gel With Almond Oil For Soft Skin,Warehouse A,88,74,2025-02-21 22:08:00,14
11580,ORD_11581,9724,"Sery Color Flirt Nail Paint Glitter, Party Rose Gold, Copper Glitter 10 ml",Warehouse C,19,10,2025-02-21 10:20:00,9
11581,ORD_11582,1457,Parozep 12.5 Tablet CR,Warehouse A,113,94,2025-02-21 02:08:00,19
11582,ORD_11583,16851,Kemycin 600mg Injection,Warehouse A,60,52,2025-02-21 15:29:00,8
11583,ORD_11584,7739,Ajmal Impress Concentrated Perfume Oil Citrus And Shadow Homme Deodorant Citrus Woody Fragrance 210 ml,Warehouse A,68,56,2025-02-21 12:04:00,12
11584,ORD_11585,12354,Carveday 3.125mg Tablet,Warehouse A,59,40,2025-02-21 23:37:00,19
11585,ORD_11586,7026,Professional Herbal All Purpose Massage Cream With Aloe Vera,Warehouse A,79,61,2025-02-21 15:05:00,18
11586,ORD_11587,21442,"LOVERIGHT Professional Makeup Combo Kit 18 Color Rose Gold Eyeshadow Palette, Matte Foundation, Red Edition Lipstick, Face...",Warehouse A,104,98,2025-02-21 00:19:00,6
11587,ORD_11588,2527,Deflatis 6mg Tablet,Warehouse B,93,85,2025-02-21 21:44:00,8
11588,ORD_11589,26685,"Fastrack Men Square Sunglasses , White, FREE-Pack of 1",Warehouse C,89,84,2025-02-21 09:48:00,5
11589,ORD_11590,34594,Tygot Gorilla Tripod/Mini 33 CM (13 Inch) Tripod for Mobile Phone with Phone Mount & Remote | Flexible Gorilla Stand for D...,Warehouse B,73,57,2025-02-21 19:41:00,16
11590,ORD_11591,17551,Glycohale Respules 1ml Each,Warehouse B,65,46,2025-02-21 03:47:00,19
11591,ORD_11592,33294,Ondistar 4mg Tablet MD,Warehouse A,49,43,2025-02-21 00:15:00,6
11592,ORD_11593,23204,Osteoflam 500mg/50mg/500mg Tablet MR,Warehouse A,96,77,2025-02-21 19:24:00,19
11593,ORD_11594,2902,Rofica 1% Gel,Warehouse A,39,25,2025-02-21 12:27:00,14
11594,ORD_11595,17582,Rosuvotin 40mg Tablet,Warehouse B,102,90,2025-02-21 13:26:00,12
11595,ORD_11596,33291,Adrox 50mg Tablet,Warehouse B,79,67,2025-02-21 17:55:00,12
11596,ORD_11597,24436,Careflox MS Oral Suspension,Warehouse B,38,20,2025-02-21 01:37:00,18
11597,ORD_11598,10960,mCaffeine Coffee Lip Sleeping Mask 12 gm,Warehouse B,47,37,2025-02-21 13:43:00,10
11598,ORD_11599,1446,YELLOWFIN Claw-Grip Aluminium Alloy Bicycle | Cycle | Motorcycle | Bike Mobile Phone Holder Mount Stand Cradle for Handleb...,Warehouse B,115,97,2025-02-21 06:54:00,18
11599,ORD_11600,19655,ENVOUS Noise_ColorFit Pulse Grand SmartWatch Charger 2 Pin USB Fast Charger Magnetic Charging Cable Adapter (Smart Watch C...,Warehouse C,9,1,2025-02-21 12:39:00,8
11600,ORD_11601,33517,Miss Rose 6 Color Blusher Glow Palette 7004 - 015N 02 20 gm,Warehouse B,32,26,2025-02-21 09:25:00,6
11601,ORD_11602,33388,Ayurveda Deep Pore Cleansing & Brightening Haldi & Tulsi Face Wash,Warehouse A,14,9,2025-02-21 01:45:00,5
11602,ORD_11603,14645,Ajmal Bombay Dreams EDP Floral Fruity Perfume And Raindrops Femme Deodorant Floral Chypre Fragrance 300 ml,Warehouse C,81,64,2025-02-21 05:43:00,17
11603,ORD_11604,23777,Amazon Brand - Solimo Basic Case for Apple iPhone 12 Mini (Silicone_Transparent),Warehouse C,78,62,2025-02-21 07:09:00,16
11604,ORD_11605,21462,Welset Injection,Warehouse C,80,65,2025-02-21 08:45:00,15
11605,ORD_11606,29255,"TRUE HUMAN Panda Pencil Pouch Pencil case for Girls ,Kids and Students",Warehouse C,101,87,2025-02-21 04:30:00,14
11606,ORD_11607,7504,Metosan XR 25 Tablet,Warehouse A,31,15,2025-02-21 08:50:00,16
11607,ORD_11608,23515,AmazonBasics AAA Performance Alkaline Non-Rechargeable Batteries (8-Pack) - Appearance May Vary,Warehouse B,103,91,2025-02-21 19:55:00,12
11608,ORD_11609,11236,Presticort-T Injection,Warehouse C,87,76,2025-02-21 11:16:00,11
11609,ORD_11610,17150,Gip 20 Capsule,Warehouse C,23,8,2025-02-21 15:54:00,15
11610,ORD_11611,30883,realme Pad WiFi Tablet | 3GB RAM 32GB ROM (Expandable) | 26.4cm (10.4 inch) WUXGA+ Display | 7100 mAh Battery | Dolby Atmo...,Warehouse B,68,63,2025-02-21 17:57:00,5
11611,ORD_11612,30816,SheOak Round Empty Luxurious Portable Air Cushion Puff Box BB Cream Container Case White,Warehouse C,111,96,2025-02-21 14:20:00,15
11612,ORD_11613,11248,Ajmal Musk Rose CP And Aurum CP & Prose EDP Pack of 3 20 ml,Warehouse A,81,66,2025-02-21 09:05:00,15
11613,ORD_11614,15787,Dolocide MR Tablet,Warehouse B,37,18,2025-02-21 14:55:00,19
11614,ORD_11615,36814,"Swiss Beauty Matte Metallic Lipgloss Gloss ME, Lip Makeup, White, 10 ml (10 ml, Shade-02)",Warehouse C,36,25,2025-02-21 17:59:00,11
11615,ORD_11616,30074,"Nokia 3310 Dual SIM Keypad Phone with MP3 Player, Wireless FM Radio and Rear Camera | Red",Warehouse A,96,84,2025-02-21 11:20:00,12
11616,ORD_11617,6897,Qvcef-CV Tablet,Warehouse B,52,44,2025-02-21 03:52:00,8
11617,ORD_11618,9322,Hanuzid 250mg Injection,Warehouse B,77,72,2025-02-21 11:10:00,5
11618,ORD_11619,7564,Consistent 64GB Pen Drive USB 2.0 Metal Body with Keychain Carabiner,Warehouse A,89,80,2025-02-21 15:47:00,9
11619,ORD_11620,13698,OpenTech® Tempered Glass Screen Protector Compatible for Google Pixel 6A with Edge to Edge Coverage and Easy Installation kit,Warehouse A,56,37,2025-02-21 07:45:00,19
11620,ORD_11621,12237,Hansimol M DS Oral Suspension,Warehouse B,69,54,2025-02-21 06:47:00,15
11621,ORD_11622,30291,Eveready Rechargeable battery - 1000 Series AAA - Pack of 2,Warehouse C,52,37,2025-02-21 07:56:00,15
11622,ORD_11623,34955,Casio KL-820 Label Printer (Black),Warehouse B,42,32,2025-02-21 07:23:00,10
11623,ORD_11624,14460,"boAt Stone Symphony Portable Bluetooth Speaker with 20W RMS Stereo Sound, Party LEDs, TWS Feature, Carry Strap, Multi-Comp...",Warehouse B,31,23,2025-02-21 03:51:00,8
11624,ORD_11625,3002,Simcef 1000mg Injection,Warehouse B,79,66,2025-02-21 00:40:00,13
11625,ORD_11626,11247,Win Orange Syrup,Warehouse B,86,75,2025-02-21 00:29:00,11
11626,ORD_11627,5606,"SKADIOO 2 Pieces Universal Travel Adapter, Adapter, Travel Adapter, Universal Adapter, Adapter Charger, International Adap...",Warehouse B,83,64,2025-02-21 17:48:00,19
11627,ORD_11628,34814,"L'Occitane Nourishing Almond Scrubbing Soap, 250gm",Warehouse C,76,59,2025-02-21 00:50:00,17
11628,ORD_11629,1246,"Fashion Colour Two Way Pancake, Shade 03 10 gm",Warehouse C,71,66,2025-02-21 09:17:00,5
11629,ORD_11630,20795,"Digital Shoppy Romantic Bear Wow Tattoo Lipstick With Lip Mask/Plumper, Glossy Finish - Cherry Red and Rose Pink",Warehouse C,14,2,2025-02-21 03:11:00,12
11630,ORD_11631,12289,"OnePlus 10 Pro 5G (Emerald Forest, 12GB RAM, 256GB Storage)",Warehouse A,88,74,2025-02-21 01:36:00,14
11631,ORD_11632,11233,Fluford Tablet,Warehouse A,83,77,2025-02-21 13:29:00,6
11632,ORD_11633,29206,Zeptol 100 Tablet,Warehouse B,74,68,2025-02-21 12:57:00,6
11633,ORD_11634,11231,"Solo EX- 802 Expanding File (Elastic, with Swing) - 12 Section A4 - Black",Warehouse B,114,98,2025-02-21 21:40:00,16
11634,ORD_11635,26982,Jbtor 20mg Tablet,Warehouse A,59,48,2025-02-21 22:03:00,11
11635,ORD_11636,20344,Hypa 40mg Tablet,Warehouse A,32,21,2025-02-21 12:06:00,11
11636,ORD_11637,6908,"Irusu Play VR Plus VR Headset with Adjustable Headphones,40MM HD Lens and Touch Button for Mobiles (Without Remote)",Warehouse A,27,19,2025-02-21 22:26:00,8
11637,ORD_11638,3307,"Portronics Toad 26 Wired Optical Mouse with 1500 DPI, Optical Orientation, Click Wheel, 1.35M Cable Length(Black)",Warehouse A,103,94,2025-02-21 11:51:00,9
11638,ORD_11639,23519,MOKOBARA The Transit Backpack Laptop Bag for Men and Women,Warehouse C,70,58,2025-02-21 07:34:00,12
11639,ORD_11640,34588,"SanDisk Ultra Shift USB Flash Drive USB 3.0, 100MB/s R, 64GB",Warehouse A,48,43,2025-02-21 22:38:00,5
11640,ORD_11641,19600,Culmi 10mg Tablet,Warehouse A,45,40,2025-02-21 06:57:00,5
11641,ORD_11642,14186,Lyrovir 200mg Tablet,Warehouse C,12,3,2025-02-21 17:14:00,9
11642,ORD_11643,26672,Gold Soap,Warehouse C,48,29,2025-02-21 19:56:00,19
11643,ORD_11644,9746,Prazonic 5mg Tablet XL,Warehouse A,82,77,2025-02-21 17:06:00,5
11644,ORD_11645,23188,Laxifresh 5mg Syrup,Warehouse B,81,66,2025-02-21 05:26:00,15
11645,ORD_11646,15580,Browik-P Syrup,Warehouse C,106,91,2025-02-21 23:13:00,15
11646,ORD_11647,23185,Pendip S 50mg/10mg Tablet,Warehouse B,49,42,2025-02-21 07:02:00,7
11647,ORD_11648,27779,Parker Moments Classic Gold Trim Ball Pen (Silver),Warehouse A,59,54,2025-02-21 12:00:00,5
11648,ORD_11649,32635,Maryaj M White For Her EDP Floral Fruity Perfume And Ajmal Raindrops Femme Deodorant Floral Chypre Fragrance 290 ml,Warehouse B,91,74,2025-02-21 14:19:00,17
11649,ORD_11650,27785,Batiste Dry Hair Shampoo - Coconut & Exotic Tropical 50 ml,Warehouse A,87,78,2025-02-21 14:49:00,9
11650,ORD_11651,12913,Ontac Plus 250 mg/50 mg/325 mg Tablet,Warehouse B,48,30,2025-02-21 09:55:00,18
11651,ORD_11652,31992,Swiss Beauty Youth Freeze Toner 84ml,Warehouse C,62,54,2025-02-21 06:20:00,8
11652,ORD_11653,27631,Jeclofen-P 100mg/325mg Tablet,Warehouse A,101,94,2025-02-21 13:29:00,7
11653,ORD_11654,6161,Osia Osia Lemon Lime 125 gm,Warehouse A,41,28,2025-02-21 14:21:00,13
11654,ORD_11655,2120,Mercusys MW300RE Wireless Repeater WiFi Booster | MIMO Technology | Three External Antennas | 300Mbps Speed Wi-Fi Range Ex...,Warehouse B,103,91,2025-02-21 18:00:00,12
11655,ORD_11656,20337,"Arata Advanced Curl Care Hair Detangler Detangles, Refreshes & Strengthens Curls CG Approved 100 ml",Warehouse C,86,73,2025-02-21 15:35:00,13
11656,ORD_11657,9333,eller santé® 15W Wireless Charger MONTCLAD SERIES Fast charging pad| PD & Qi-Certified with Type C Cable Fireproof ABS for...,Warehouse C,70,59,2025-02-21 06:14:00,11
11657,ORD_11658,33583,Toshiba 108 cm (43 inches) V Series Full HD Smart Android LED TV 43V35KP (Silver),Warehouse C,82,76,2025-02-21 18:08:00,6
11658,ORD_11659,31820,GLUN 11 mm Transparent HOT MELT 14 Glue Sticks for DIY and Craft Work,Warehouse C,101,93,2025-02-21 22:50:00,8
11659,ORD_11660,30080,Roxid Kid 50mg Tablet,Warehouse C,47,34,2025-02-21 03:19:00,13
11660,ORD_11661,13661,Aloe Veda Gentle Cleansing Milk - Liquorice & Ginger 100 ml,Warehouse A,100,90,2025-02-21 05:34:00,10
11661,ORD_11662,7573,"Tough Lee Tempered Glass Screen Guard for Poco C50 / Mi Redmi 11 Prime / A1 / 10A / 9A Sport / 9 Activ / 9A / 9 / 9i, Oppo...",Warehouse C,15,3,2025-02-21 20:08:00,12
11662,ORD_11663,20363,AHUJA AUD-98XLR Unidirectional Dynamic Microphone -Corded Mic,Warehouse A,106,89,2025-02-21 08:15:00,17
11663,ORD_11664,30011,"Portronics Power Plate 11 1500W Power Converter with 4 Power Sockets, 3M Cord Length, Short Circuit Protection, Imported I...",Warehouse B,63,50,2025-02-21 06:10:00,13
11664,ORD_11665,2019,Denjil-Plus Tablet,Warehouse C,63,46,2025-02-21 22:18:00,17
11665,ORD_11666,33585,"JBL C100SI Wired In Ear Headphones with Mic, JBL Pure Bass Sound, One Button Multi-function Remote, Angled Buds for Comfor...",Warehouse A,42,36,2025-02-21 00:29:00,6
11666,ORD_11667,9079,Lumgos 1% Cream,Warehouse B,79,73,2025-02-21 07:44:00,6
11667,ORD_11668,36843,Flormar Style Matic Eyeliner S01 Chocolate Cream 0.35 gm,Warehouse B,23,10,2025-02-21 11:24:00,13
11668,ORD_11669,16194,"NISHTECH HDMI to RCA,HDMI to AV, 1080P HDMI to 3RCA HDMI2AV AV Composite Video Audio Converter Adapter Media Streaming Device",Warehouse B,8,1,2025-02-21 18:42:00,7
11669,ORD_11670,471,"Fashion Colour Super Smooth Translucent Powder, Shade 03 15 gm",Warehouse B,50,45,2025-02-21 07:40:00,5
11670,ORD_11671,24821,"PTron Bassbuds Plus True Wireless Bluetooth 5.0 in Ear Earbuds, Deep Bass, IPX4 Water/Sweat Resistant, Passive Noise Cance...",Warehouse A,58,43,2025-02-21 08:56:00,15
11671,ORD_11672,17516,M10 TWS Bluetooth V5.1 in-Ear Wireless Earbuds with Upto 4 Hours Playback Stereo Sports Waterproof Bluetooth Earphones wit...,Warehouse C,24,19,2025-02-21 11:07:00,5
11672,ORD_11673,764,Olmivib 40 Tablet,Warehouse B,27,15,2025-02-21 07:08:00,12
11673,ORD_11674,15607,"Cosmic Byte Oberon 7.1 RGB Gaming Headset with Dual Input- USB and 3.5mm Jack, Detachable Microphone, 90° Rotatable Earcup...",Warehouse B,72,66,2025-02-21 08:55:00,6
11674,ORD_11675,5248,"Dyazo Solid Height and Angle Adjustable Tabletop Laptop Riser/Laptop Stand for Desk Compatible for Mac Book, Laptops, Note...",Warehouse B,31,15,2025-02-21 23:00:00,16
11675,ORD_11676,30361,Supatret 0.1 Aqueous Gel,Warehouse B,57,52,2025-02-21 19:35:00,5
11676,ORD_11677,24941,Itracott 200mg Capsule,Warehouse C,67,49,2025-02-21 13:01:00,18
11677,ORD_11678,21323,Turbo Bright Anti-Pollution Double Action Face Wash,Warehouse B,67,48,2025-02-21 06:07:00,19
11678,ORD_11679,30979,Mother Sparsh 99% Water Based Wipes 72's,Warehouse A,63,50,2025-02-21 18:10:00,13
11679,ORD_11680,36321,Fameth 40 Injection,Warehouse C,56,51,2025-02-21 15:48:00,5
11680,ORD_11681,30245,Niminol-P Tablet,Warehouse C,78,70,2025-02-21 14:58:00,8
11681,ORD_11682,21378,House of Aroma Organic Pillow Mist 50 gm,Warehouse B,21,6,2025-02-21 10:33:00,15
11682,ORD_11683,25614,"Fashion Colour Kiss Lip No Transfer Lipstick, 84 Dull Violet 2.6 gm",Warehouse C,90,75,2025-02-21 13:23:00,15
11683,ORD_11684,16056,Conditioner - Lusciously Thick & Long Nourishing,Warehouse C,51,46,2025-02-21 03:38:00,5
11684,ORD_11685,9656,Celicard 200mg Tablet,Warehouse A,36,18,2025-02-21 23:19:00,18
11685,ORD_11686,11007,Pilot V7 Liquid Ink Roller Ball Pen (2 Blue + 1 Black),Warehouse C,86,76,2025-02-21 14:13:00,10
11686,ORD_11687,27700,Ibugen 400mg Tablet,Warehouse B,66,47,2025-02-21 12:50:00,19
11687,ORD_11688,3454,Viscomet 2% Eye Drop,Warehouse C,66,59,2025-02-21 11:29:00,7
11688,ORD_11689,26761,"M White - Eau De Parfum, For Her",Warehouse B,34,17,2025-02-21 05:31:00,17
11689,ORD_11690,12655,Minscalp 2% Gel,Warehouse B,99,86,2025-02-21 16:16:00,13
11690,ORD_11691,2368,Luxor UNIFLO Ball Pen Black (20's Box),Warehouse C,48,39,2025-02-21 05:18:00,9
11691,ORD_11692,12893,Renvorab 20mg Injection,Warehouse B,25,17,2025-02-21 18:13:00,8
11692,ORD_11693,8828,Glitaray 2 Tablet,Warehouse A,34,28,2025-02-21 23:00:00,6
11693,ORD_11694,7008,St.Botanica Moroccan Argan Hair Shampoo 300 ml,Warehouse B,98,91,2025-02-21 11:58:00,7
11694,ORD_11695,23255,Moxzar CV 500mg/125mg Tablet,Warehouse A,40,28,2025-02-21 01:15:00,12
11695,ORD_11696,17485,U Too Tablet,Warehouse C,38,21,2025-02-21 11:46:00,17
11696,ORD_11697,32244,Anafen A Tablet,Warehouse C,55,49,2025-02-21 02:05:00,6
11697,ORD_11698,6532,Azole 20mg Capsule,Warehouse B,35,24,2025-02-21 05:02:00,11
11698,ORD_11699,29010,HP Laserjet P1108 Single Function Monochrome Laser Printer,Warehouse B,54,40,2025-02-21 17:25:00,14
11699,ORD_11700,27867,Uroquin Syrup,Warehouse B,46,36,2025-02-21 05:56:00,10
11700,ORD_11701,9811,Amozo Ultra Hybrid Clear Transparent Drop Protection Back Cover Case for Samsung Galaxy S23 5G (Polycarbonate | Transparent),Warehouse A,47,29,2025-02-21 08:52:00,18
11701,ORD_11702,9813,ZOUK Women Office Bag Ikat Grered,Warehouse B,105,95,2025-02-21 16:08:00,10
11702,ORD_11703,8789,Xfit 1000mg Injection,Warehouse C,101,85,2025-02-21 07:13:00,16
11703,ORD_11704,4066,"Dell Vostro 3420 Laptop,12th Gen Intel Core i5-1235U, 8GB & 512GB SSD, 14.0"" (35.56Cms) FHD WVA AG 250 nits, Windows 11 + ...",Warehouse B,45,26,2025-02-21 09:25:00,19
11704,ORD_11705,32603,Blackt Electrotech (BT16D) : Wireless Remote Control Switch System for 4 Lights and 1 Fan with Speed Speed Display,Warehouse A,97,87,2025-02-21 06:07:00,10
11705,ORD_11706,24944,Ofzen-OZ Syrup,Warehouse A,38,28,2025-02-21 14:16:00,10
11706,ORD_11707,6802,Moxiphage 250mg/125mg Tablet,Warehouse B,18,5,2025-02-21 10:08:00,13
11707,ORD_11708,19668,"Petals - Mandya Pad, Classic",Warehouse A,85,67,2025-02-21 23:34:00,18
11708,ORD_11709,2519,"boAt Newly Launched Wave Call Plus with 1.83"" HD Display, ENx™ Tech(Clear Calls),Advanced Bluetooth Calling,Hindi & Englis...",Warehouse A,27,19,2025-02-21 02:45:00,8
11709,ORD_11710,13148,YAMAHA PSR-I500 PORTABLE KEYBOARD WITH ADAPTOR,Warehouse B,54,45,2025-02-21 10:57:00,9
11710,ORD_11711,1423,Gentelman Royale Deodorant,Warehouse A,12,4,2025-02-21 00:58:00,8
11711,ORD_11712,27691,Face Mask For Kids - Disney Princess,Warehouse A,19,14,2025-02-21 00:46:00,5
11712,ORD_11713,7442,"Skadioo WiFi Adapter for pc | Car Accessories, WiFi Dongle for pc | USB WiFi Adapter for pc | Wi-Fi Receiver 2.4GHz, 802.1...",Warehouse B,104,87,2025-02-21 12:30:00,17
11713,ORD_11714,32949,Maryaj Pebble Style EDP Spicy Woody Perfume And Ajmal Avid Homme Deodorant Aquatic Woody Fragrance 300 ml,Warehouse C,83,68,2025-02-21 08:33:00,15
11714,ORD_11715,23245,Femcinol-ADP Gel,Warehouse C,44,32,2025-02-21 17:39:00,12
11715,ORD_11716,19786,Cold Processed Apple Mangosteen Handmade Soap for Natural Glow,Warehouse A,99,82,2025-02-21 20:52:00,17
11716,ORD_11717,12657,COBESE 60 MG CAPSULE,Warehouse A,16,8,2025-02-21 17:47:00,8
11717,ORD_11718,25624,Natural Damage Repair Conditioner,Warehouse C,64,49,2025-02-21 20:51:00,15
11718,ORD_11719,1778,Skin Defense Mud Face Pack,Warehouse A,98,87,2025-02-21 10:17:00,11
11719,ORD_11720,21341,JGD PRODUCTS for iPhone 13 Pro Premium Transparent Hybrid Soft Slim Dust Proof Back Case Cover with Camera Protection,Warehouse A,64,51,2025-02-21 09:23:00,13
11720,ORD_11721,9705,"Mi 5V Charger|10W Wall Charger with USB Cable|Compatible for Mobile, Headphones, TWS, Game Console, Power Banks|Fast Charg...",Warehouse A,90,76,2025-02-21 01:06:00,14
11721,ORD_11722,27661,Ricox 120mg Tablet,Warehouse C,23,4,2025-02-21 10:20:00,19
11722,ORD_11723,6523,Vizitra 100mg Capsule,Warehouse A,106,88,2025-02-21 17:29:00,18
11723,ORD_11724,27693,Anti-Ageing Massage Cream,Warehouse A,106,90,2025-02-21 16:23:00,16
11724,ORD_11725,23737,L.A Girl HD PRO Conceal Warm Honey 8 gm,Warehouse C,56,48,2025-02-21 03:45:00,8
11725,ORD_11726,23236,Buxstat 40mg Tablet,Warehouse B,62,46,2025-02-21 00:43:00,16
11726,ORD_11727,13335,Esoprime 40mg Injection,Warehouse C,13,2,2025-02-21 06:39:00,11
11727,ORD_11728,31230,Epizam 0.5mg Tablet,Warehouse A,107,96,2025-02-21 04:07:00,11
11728,ORD_11729,8810,Desifol-Plus Tablet,Warehouse B,50,33,2025-02-21 12:24:00,17
11729,ORD_11730,1433,"Lakme Insta Eye Liner, Black Semi_Matte Finish, Water Resistant, Long-Lasting, 9 Ml",Warehouse A,22,13,2025-02-21 11:08:00,9
11730,ORD_11731,23283,OnePlus SUPERVOOC 80W Power Adapter for Cellular Phones - White,Warehouse B,30,17,2025-02-21 07:10:00,13
11731,ORD_11732,36886,Rejuvenating UBTAN Essential Oil - Lavender 10 ml,Warehouse A,46,31,2025-02-21 15:33:00,15
11732,ORD_11733,35865,Bio Pineapple Oil Control Foaming Face Wash,Warehouse A,44,26,2025-02-21 22:00:00,18
11733,ORD_11734,11002,"Xtore® Universal Mobile Phone Holder & Tablet Tabletop Holder with 360° Rotation (Black, Pack of 1)",Warehouse C,82,77,2025-02-21 16:17:00,5
11734,ORD_11735,14229,Ocugate DX Eye Drop,Warehouse A,18,13,2025-02-21 11:42:00,5
11735,ORD_11736,25616,DIGITEK® (LP-E6 Platinum) 2100mAh Rechargeable Lithium-ion Battery for Canon DSLR Camera | Compatibility - EOS SD Mark II...,Warehouse B,80,71,2025-02-21 12:57:00,9
11736,ORD_11737,3269,INEFABLE Oneplus Band Strap and Oppo Band Strap Soft Silicone Adjustable Band Strap - Device Not Included - Navy Blue - Pa...,Warehouse C,61,45,2025-02-21 22:24:00,16
11737,ORD_11738,7775,"ESR Classic Kickstand Case with HaloLock Compatible with iPhone 14 Pro Max, MagSafe-Compatible Case with Stand, Military-G...",Warehouse B,11,5,2025-02-21 21:22:00,6
11738,ORD_11739,35244,MMAK Anti-Slip Car Dashboard Mat with Phone Holder & Car Perfume - Universal Non Slip Sticky Rubber Pad with 2 Aroma Stick...,Warehouse C,82,66,2025-02-21 07:34:00,16
11739,ORD_11740,13457,Beauty People Velvet Matte Nail Polish Matte - Me - Azure - 1004 9.9 ml,Warehouse C,10,1,2025-02-21 20:41:00,9
11740,ORD_11741,17701,"Yodel 3D6 5.0 Bluetooth Wireless In Ear Earphones With Mic Magnetic With Stereo Sound And Hands Free, Black",Warehouse C,61,56,2025-02-21 19:09:00,5
11741,ORD_11742,33861,Floxi Pred Plus Eye Drop,Warehouse C,104,85,2025-02-21 20:54:00,19
11742,ORD_11743,2340,Fpgli M 4 Forte Tablet PR,Warehouse A,26,7,2025-02-21 10:23:00,19
11743,ORD_11744,34087,"AmazonBasics 24W Phone Charger for Cellular Phones | Fast Charging, Dual Output | Type C and A Adapter (White)",Warehouse C,92,86,2025-02-21 22:04:00,6
11744,ORD_11745,16801,Vintop D 30mg/40mg Capsule SR,Warehouse C,91,75,2025-02-21 17:40:00,16
11745,ORD_11746,5858,Ajmal 2 Wisal Dhahab Deo & Ascend EDP Pack of 3 20 ml,Warehouse A,103,86,2025-02-21 09:02:00,17
11746,ORD_11747,21658,Volcanic Stone (MP-14),Warehouse B,48,36,2025-02-21 11:21:00,12
11747,ORD_11748,17700,mCaffeine Cappuccino Coffee Face Scrub - Kills 99.9% Acne Causing Germs with Vitamin E & Cinnamon 75 gm,Warehouse C,85,66,2025-02-21 12:13:00,19
11748,ORD_11749,117,Qubo Car Dash Camera Pro (with GPS) Dash Cam from Hero Group | Made in India Dashcam | Full HD 1080p | Wide Angle View | ...,Warehouse C,94,85,2025-02-21 11:52:00,9
11749,ORD_11750,10886,XECH Extension Board with USB Ports 2500W Power Spike Guard 3 Universal Sockets & 3 USB Output Ports 10 Amp Rated Charging...,Warehouse B,40,27,2025-02-21 23:18:00,13
11750,ORD_11751,19365,Black Mirror Men Messenger Bags,Warehouse A,99,84,2025-02-21 15:36:00,15
11751,ORD_11752,19362,Ibcil 10mg Tablet,Warehouse B,76,64,2025-02-21 19:40:00,12
11752,ORD_11753,25718,Dv Zole 40mg Injection,Warehouse C,106,97,2025-02-21 07:37:00,9
11753,ORD_11754,32997,Deodorant Body Spray - To Be Woman,Warehouse C,69,50,2025-02-21 22:01:00,19
11754,ORD_11755,24984,"Meneza Menstrual Cup - Medium Size, For Women Under 30 Years Of Age Or Who Have Not Given Birth",Warehouse A,50,43,2025-02-21 03:17:00,7
11755,ORD_11756,23793,Azipire 500mg Tablet,Warehouse A,96,88,2025-02-21 19:36:00,8
11756,ORD_11757,7059,Oflodiz 200mg Tablet,Warehouse A,50,41,2025-02-21 11:36:00,9
11757,ORD_11758,27919,"SEIBEN Universal Stylus Pen Compatible with iOS &Android Enabled Devices, High Precision & Sensitivity,Rechargeable Stylus...",Warehouse B,48,38,2025-02-21 16:51:00,10
11758,ORD_11759,33506,Ikea Steel Tabletop 15 x 8 x 27 cm Headset/Tablet Stand (Black),Warehouse C,111,99,2025-02-21 14:32:00,12
11759,ORD_11760,7793,"Deltoid Turbo Face Masks In Grey Mesh With Pink, Blue & Green Bindings - Assorted, 3C2007-XL",Warehouse B,36,18,2025-02-21 04:48:00,18
11760,ORD_11761,2343,The Moms Co. Vita Rich Under Eye Cream 15 gm,Warehouse C,97,84,2025-02-21 02:43:00,13
11761,ORD_11762,8642,Addclav Forte Suspension,Warehouse C,59,45,2025-02-21 23:06:00,14
11762,ORD_11763,27893,Livomed Syrup,Warehouse B,13,6,2025-02-21 05:06:00,7
11763,ORD_11764,3619,Flupact 150mg Tablet,Warehouse C,46,39,2025-02-21 11:00:00,7
11764,ORD_11765,32126,Ofric 200mg Tablet,Warehouse B,27,18,2025-02-21 02:50:00,9
11765,ORD_11766,2556,Telmidip 40mg Tablet,Warehouse C,81,68,2025-02-21 10:42:00,13
11766,ORD_11767,14701,Nance 100mg Injection,Warehouse C,26,7,2025-02-21 08:53:00,19
11767,ORD_11768,9865,Bergamot Delight Handwash Refill,Warehouse A,76,65,2025-02-21 05:43:00,11
11768,ORD_11769,6347,Serrocon N 100 mg/10 mg Tablet,Warehouse A,88,78,2025-02-21 06:23:00,10
11769,ORD_11770,28938,Xibit O 200mg Tablet DT,Warehouse B,32,13,2025-02-21 04:06:00,19
11770,ORD_11771,23788,Pikkme iPhone 7/8 Back Cover | Flexible Pu Leather | Full Camera Protection | Raised Edges | Super Soft-Touch | Bumper Cas...,Warehouse C,59,43,2025-02-21 00:56:00,16
11771,ORD_11772,24379,Ugflam MR 250mg/50mg/325mg Tablet,Warehouse A,18,8,2025-02-21 01:53:00,10
11772,ORD_11773,5826,Color Fever Eye Bomb Metallic Eye Pencil cum Eye Shadow Water Proof - Just Gold 1.8 gm,Warehouse A,82,73,2025-02-21 00:15:00,9
11773,ORD_11774,29787,Soap - Saffron,Warehouse A,104,91,2025-02-21 02:57:00,13
11774,ORD_11775,36515,Siozole 20mg Capsule,Warehouse C,71,66,2025-02-21 20:49:00,5
11775,ORD_11776,12362,Pronate 10 Tablet,Warehouse A,100,91,2025-02-21 18:03:00,9
11776,ORD_11777,5138,"Storite 1 Meter USB Type-C to Micro-B USB 3.0 Cable, 10Gbps Fast Charging & Syncing Cord Compatible with Windows/Mac & Ext...",Warehouse B,48,38,2025-02-21 00:13:00,10
11777,ORD_11778,19437,Fluscot 150mg Tablet,Warehouse B,97,78,2025-02-21 13:48:00,19
11778,ORD_11779,21609,HUMBLE® Universal Silicone Sucker Long Neck Car Mobile Phone Holder Mount Stand Ultimate Reusable Suction Cup with 360 Deg...,Warehouse A,86,69,2025-02-21 13:27:00,17
11779,ORD_11780,7785,CE 200mg Capsule,Warehouse B,87,79,2025-02-21 10:56:00,8
11780,ORD_11781,34559,Ajanta Extension Cord Heavy Duty Wire Spike & Surge Guard 4 Way Extension Boards Charging Station with Multiple Plug for H...,Warehouse A,19,1,2025-02-21 03:27:00,18
11781,ORD_11782,24387,"100% Organic Rejuvenating Face, Skin & Hair Nourisher, Revitalizer & Repair",Warehouse C,53,42,2025-02-21 11:32:00,11
11782,ORD_11783,34540,"Nokia 105 Plus Dual SIM, Keypad Mobile Phone with Wireless FM Radio, Memory Card Slot and MP3 Player | Charcoal",Warehouse C,45,31,2025-02-21 09:37:00,14
11783,ORD_11784,19492,Ajamamsa Rasayanam,Warehouse B,36,21,2025-02-21 12:42:00,15
11784,ORD_11785,3086,Lemon Shave Gel With Essential Oils,Warehouse A,85,76,2025-02-21 23:54:00,9
11785,ORD_11786,21539,L.A. Colors Eyeliner Pencil - Brown 1 gm,Warehouse B,38,32,2025-02-21 11:07:00,6
11786,ORD_11787,36074,"Redmi Pad | MediaTek Helio G99 | 26.95cm (10.61 inch) 2K Resolution & 90Hz Refresh Rate Display | 6GB RAM & 128GB Storage,...",Warehouse B,93,83,2025-02-21 01:35:00,10
11787,ORD_11788,468,M.G.R.J® Tempered Glass Screen Protector for Lenovo Tab M10 FHD Plus 10.6 inch 3rd Gen Tablet (TB-125FU/128FU/128XU) (10.6...,Warehouse A,75,65,2025-02-21 23:00:00,10
11788,ORD_11789,4542,Daily Life Forever52 Glitz Waterproof Eyeliner Eyeshadow Glt002 0.6 gm,Warehouse A,82,71,2025-02-21 00:52:00,11
11789,ORD_11790,19495,Dealfreez Case Compatible for Fire TV Stick 4K All Alexa Voice Remote Shockproof Silicone Anti-Lost Cover with Loop (C-Black),Warehouse C,67,50,2025-02-21 06:20:00,17
11790,ORD_11791,23785,SanDisk Extreme Pro SD UHS I 128GB Card for 4K Video for DSLR and Mirrorless Cameras 200MB/s Read & 90MB/s Write,Warehouse C,69,56,2025-02-21 03:20:00,13
11791,ORD_11792,23786,"Fire-Boltt 360 SpO2 Full Touch Large Round Display with in-Built Games, 8 Days Battery Life, IP67 Water Resistant with Blo...",Warehouse C,39,29,2025-02-21 05:31:00,10
11792,ORD_11793,12936,Corphen A Syrup,Warehouse C,71,62,2025-02-21 23:48:00,9
11793,ORD_11794,14677,"theBalm Meet Matte Hughes Long Lasting Liquid Lipstick, Doting, 7.4ml",Warehouse A,65,55,2025-02-21 02:20:00,10
11794,ORD_11795,5816,EMBOX 10A Extension Board with USB-Multi Plug Socket with 3 Universal Sockets + 3 USB ports (5V/2.4A)-Extension Box with S...,Warehouse C,102,84,2025-02-21 00:09:00,18
11795,ORD_11796,26630,"Portronics SoundDrum Wireless POR-547 Bluetooth 4.2 Stereo Speaker with FM, USB Music (Blue)",Warehouse C,35,28,2025-02-21 13:15:00,7
11796,ORD_11797,21556,"Lerobo Sport Band Compatible with Apple Watch Band 38mm 40mm 41mm 45mm 44mm 42mm for Women Men,Soft Silicone Sport Breatha...",Warehouse C,22,9,2025-02-21 00:29:00,13
11797,ORD_11798,8688,"Portronics Resound 5W Bluetooth 5.3 Wireless Speaker with FM Radio, TWS Function, Multicolor LED Lights, 6-8 Hrs Playtime(...",Warehouse A,42,23,2025-02-21 05:54:00,19
11798,ORD_11799,16828,Bgmont-LC Tablet,Warehouse A,96,82,2025-02-21 18:45:00,14
11799,ORD_11800,15369,"Streax Ultralight, Highlights Blonder Powder 350 gm + Argan Secrets Developer Volume 20 (6%) 250ml - Blonde",Warehouse C,91,81,2025-02-21 22:08:00,10
11800,ORD_11801,20287,Amkette iGrip Telescopic One Touch Car Mount for Dashboard and Windshield | Universal Compatibility | Telescopic Adjustabl...,Warehouse C,12,4,2025-02-21 06:27:00,8
11801,ORD_11802,15612,"pTron Solero i241 2.4A Lighting to USB Fast Charging Data & Sync USB Cable Compatible for iPhone/iPad, Made in India Durab...",Warehouse C,40,35,2025-02-21 03:14:00,5
11802,ORD_11803,19977,Levofos 750mg Tablet,Warehouse A,68,58,2025-02-21 16:49:00,10
11803,ORD_11804,6965,"ESR Classic Kickstand Case with HaloLock Compatible for iPhone 14 Pro, Thermoplastic Polyurethane MagSafe-Compatible Case ...",Warehouse C,88,73,2025-02-21 06:19:00,15
11804,ORD_11805,23330,Brudex Tablet,Warehouse A,103,84,2025-02-21 02:18:00,19
11805,ORD_11806,12685,ELV Mini Aluminum Adjustable Mobile Phone Foldable Holder Stand Dock Mount for All Smartphones (Mini Black),Warehouse C,82,72,2025-02-21 10:01:00,10
11806,ORD_11807,5448,Cepotin 200mg Tablet,Warehouse A,75,70,2025-02-21 20:17:00,5
11807,ORD_11808,25596,Sudicin 400 B Tablet,Warehouse A,106,90,2025-02-21 23:35:00,16
11808,ORD_11809,17458,Pretoria MNT 75mg/10mg/1500mcg Tablet,Warehouse A,22,10,2025-02-21 07:20:00,12
11809,ORD_11810,24919,"boAt Newly Launched Rockerz 255 Max in Ear Earphones with 60H Playtime, EQ Modes, Power Magnetic Earbuds, Beast™ Mode,ENx™...",Warehouse B,51,33,2025-02-21 14:11:00,18
11810,ORD_11811,1406,"O3+ Moisture & Glow Face Sheet Mask for Brightening & Moisturizing Action (1 Pc, 30g)",Warehouse B,81,69,2025-02-21 18:50:00,12
11811,ORD_11812,21251,Ninja 50mg Tablet,Warehouse C,47,34,2025-02-21 16:40:00,13
11812,ORD_11813,12673,Winble Silicone Anti Slip Soft Flexible Ultra Matte Silicon Protective with Camera Protection Back Cover for OnePlus 6 / O...,Warehouse A,43,24,2025-02-21 09:42:00,19
11813,ORD_11814,23297,Esover L 75mg/40mg Capsule SR,Warehouse C,70,63,2025-02-21 07:18:00,7
11814,ORD_11815,17396,Herbal Hair Serum,Warehouse A,83,65,2025-02-21 00:33:00,18
11815,ORD_11816,1139,Lunitex Cream,Warehouse A,11,4,2025-02-21 04:10:00,7
11816,ORD_11817,21264,Lakme Absolute White Intense Spf 20 Concealer Stick Beige 03 3.6 Gm,Warehouse A,72,56,2025-02-21 23:44:00,16
11817,ORD_11818,9633,Crysendo Ear Muffs Headphone Cushion (60mm / 6cm) 6Pcs 5mm Thick Replacement Earpads for Headphone Sponge Cover | High-Den...,Warehouse A,75,60,2025-02-21 22:42:00,15
11818,ORD_11819,21268,Portronics POR-015 Toad 11 Wireless USB Bluetooth Mouse with 2.4GHz Technology (Blue),Warehouse C,35,18,2025-02-21 12:23:00,17
11819,ORD_11820,11022,Zypodox Dry Syrup,Warehouse A,31,12,2025-02-21 06:26:00,19
11820,ORD_11821,24926,Ezet 250mg Tablet,Warehouse B,54,43,2025-02-21 22:20:00,11
11821,ORD_11822,5293,Adom P 10mg/500mg Tablet,Warehouse C,10,2,2025-02-21 21:26:00,8
11822,ORD_11823,17480,The Body Shop Lemon Purifying Hair & Body Wash,Warehouse C,61,48,2025-02-21 16:10:00,13
11823,ORD_11824,21276,Monosprin 60 Capsule SR,Warehouse C,19,2,2025-02-21 21:32:00,17
11824,ORD_11825,5742,Key Bact Ointment,Warehouse A,95,89,2025-02-21 01:28:00,6
11825,ORD_11826,29068,Cipron 4mg Tablet,Warehouse B,37,21,2025-02-21 05:57:00,16
11826,ORD_11827,3809,The Cosmetic Republic Detox Wrap - Damaged Hair,Warehouse C,72,61,2025-02-21 17:17:00,11
11827,ORD_11828,11871,Clinic Plus Strength & Shine With Egg Protein Shampoo For Hair Strengthening & Shine 1 L,Warehouse A,19,8,2025-02-21 07:40:00,11
11828,ORD_11829,27537,"Garnier Hair Color (70ml+60g) Shade 3, Darkest Brown+Loreal Paris Shampoo 75ml",Warehouse A,26,21,2025-02-21 16:50:00,5
11829,ORD_11830,30934,Geranium Essential Oil For Scalp,Warehouse B,28,18,2025-02-21 04:59:00,10
11830,ORD_11831,26834,Shampoo Colour Shade - 3 Brown Black,Warehouse B,29,13,2025-02-21 03:09:00,16
11831,ORD_11832,23341,Mont L Syrup,Warehouse A,56,44,2025-02-21 12:51:00,12
11832,ORD_11833,24891,Unicitral Syrup,Warehouse B,16,1,2025-02-21 20:06:00,15
11833,ORD_11834,6970,"Samsung Soundbar {HW-B67E/XL} 5.1 Channel, Wireless Subwoofer, 1x Wireless Rear Speaker, 1x Center Speaker and Energy Sta...",Warehouse A,54,38,2025-02-21 03:40:00,16
11834,ORD_11835,25577,StayHappi Isosorbide Mononitrate 20mg Tablet,Warehouse C,51,43,2025-02-21 12:15:00,8
11835,ORD_11836,1986,COVER CAPITAL Tablet Tempered Glass Guard for Realme Pad X 5G 11 inch -Pack Of 1,Warehouse B,60,46,2025-02-21 18:54:00,14
11836,ORD_11837,29088,Metofid AM 5 mg/50 mg Tablet,Warehouse C,87,81,2025-02-21 09:10:00,6
11837,ORD_11838,6792,Bella Voste Matt Nail Paint Shade 301 10 Ml,Warehouse C,86,75,2025-02-21 21:26:00,11
11838,ORD_11839,21178,Scent - Intensio For Men,Warehouse C,42,31,2025-02-21 03:36:00,11
11839,ORD_11840,31960,Yaxoslide P 100mg/325mg Tablet,Warehouse B,94,80,2025-02-21 20:01:00,14
11840,ORD_11841,32924,Nutriment Sheabutter Cream All Skin Type 250 gm,Warehouse B,20,9,2025-02-21 07:59:00,11
11841,ORD_11842,19918,Sinxiga 10mg Tablet,Warehouse B,80,75,2025-02-21 03:52:00,5
11842,ORD_11843,34691,boAt Bassheads 242 in Ear Wired Earphones with Mic(Orange),Warehouse A,108,92,2025-02-21 03:13:00,16
11843,ORD_11844,27529,Mo Zine Syrup,Warehouse A,60,49,2025-02-21 19:23:00,11
11844,ORD_11845,15994,LAZI 100ml Blue Scented Laptop Screen Cleaner Cleaning Liquid Spray kit for Laptop PC Computer Tablet Smart Phone Screen D...,Warehouse B,83,64,2025-02-21 05:32:00,19
11845,ORD_11846,24516,Lifocet-M Tablet,Warehouse C,62,56,2025-02-21 05:38:00,6
11846,ORD_11847,27530,"Sanitary Napkins, Extra Long 275 mm, Ultra Thin",Warehouse B,56,42,2025-02-21 12:29:00,14
11847,ORD_11848,21143,Soulflower Essential Oil Eucalyptus 15 ml,Warehouse B,25,18,2025-02-21 11:02:00,7
11848,ORD_11849,14290,Preganor 75mg Tablet SR,Warehouse C,94,84,2025-02-21 20:55:00,10
11849,ORD_11850,3212,"Swiss Beauty Beauty Matte Lip Palette-02, Matte Finish - Multicolor",Warehouse A,80,68,2025-02-21 04:10:00,12
11850,ORD_11851,7461,Nitzole 40mg Tablet,Warehouse A,70,63,2025-02-21 06:29:00,7
11851,ORD_11852,15955,Retonac 0.1% Eye Drop,Warehouse C,101,84,2025-02-21 15:15:00,17
11852,ORD_11853,26843,Hair Oil - Bhringraj,Warehouse C,109,97,2025-02-21 20:01:00,12
11853,ORD_11854,33627,The Skin Story Illuminating Day Cream 50 gm,Warehouse C,62,52,2025-02-21 11:36:00,10
11854,ORD_11855,20012,"Portia JadiBooti GAJ PIPAL, GAJPEEPAL, GAJ PEEPAL, SCINDAPSUS OFFICINALIS Seed (100gm per packet) Gaj Pipal, 100 Grams Pack Natural Granules",Warehouse C,29,13,2025-02-21 10:18:00,16
11855,ORD_11856,7656,Rejuvenating UBTAN Essential Oil -Ylang Ylang 10 ml,Warehouse B,62,44,2025-02-21 17:02:00,18
11856,ORD_11857,11917,Glynamic MV 2 Tablet,Warehouse A,69,55,2025-02-21 01:19:00,14
11857,ORD_11858,32724,Leefdott RC Syrup,Warehouse B,19,8,2025-02-21 08:06:00,11
11858,ORD_11859,14563,Ajmal Nightingale & Distraction & Magnetize & Persuade Deo & Prose EDP Pack of 3 20 ml,Warehouse A,95,86,2025-02-21 01:33:00,9
11859,ORD_11860,8927,Intenze Tattoo Ink Light Brown (1/2oz),Warehouse C,49,39,2025-02-21 16:50:00,10
11860,ORD_11861,16908,Telvas-CT 80 Tablet,Warehouse C,25,11,2025-02-21 08:00:00,14
11861,ORD_11862,21200,Benim P Oral Suspension,Warehouse A,30,24,2025-02-21 16:07:00,6
11862,ORD_11863,1397,Ajmal Aurum Concentrated Perfume Oil Fruity Floral Attar And Aura Concentrated Perfume Oil Floral Fruity Attar 20 ml,Warehouse B,99,81,2025-02-21 06:45:00,18
11863,ORD_11864,5337,Gramika 100mg Injection,Warehouse C,47,36,2025-02-21 13:40:00,11
11864,ORD_11865,12306,"Karbonn K9 (Black RED), 1800mAh Big Battery, Dual Sim, 2.4 Inch, Wireless FM with Recording, 2MP Camera, Basic Phone, 108 ...",Warehouse B,88,69,2025-02-21 20:46:00,19
11865,ORD_11866,5412,Gnv Injection,Warehouse A,99,82,2025-02-21 06:58:00,17
11866,ORD_11867,17309,Deflotop 6mg Tablet,Warehouse A,18,1,2025-02-21 14:14:00,17
11867,ORD_11868,3497,Like Fresh Cut Grass With Morning Dew Room Fragrance Spray,Warehouse A,79,60,2025-02-21 09:25:00,19
11868,ORD_11869,29970,Amazon Brand - Solimo Back Cover Case for OnePlus 6 | Compatible for OnePlus 6 Back Cover Case | 360 Degree Protection | S...,Warehouse A,72,67,2025-02-21 20:06:00,5
11869,ORD_11870,2406,Coldhit Tablet,Warehouse B,29,14,2025-02-21 19:40:00,15
11870,ORD_11871,9024,"Wecool Mr.Bass Snug Fit Metallic C Type Earphones with Mic and Volume Controller, High Bass Headphoens for Mobile, Wired E...",Warehouse B,54,42,2025-02-21 14:25:00,12
11871,ORD_11872,34768,"Fashion Colour Jersy Girl 2 In 1 Concealer Stick, Shade 01 2.2 gm",Warehouse B,88,80,2025-02-21 21:48:00,8
11872,ORD_11873,27349,Nimotil 200mg Tablet,Warehouse C,97,84,2025-02-21 23:19:00,13
11873,ORD_11874,26956,Glismin PM 1mg/500mg/15mg Tablet SR,Warehouse B,110,98,2025-02-21 00:41:00,12
11874,ORD_11875,20922,"Posh CAsing-Black External 6.35 cm (2.5"") Hard Disk Drive for Laptop - Multi Colour",Warehouse B,115,97,2025-02-21 17:52:00,18
11875,ORD_11876,17255,Pinda Thailam,Warehouse B,41,28,2025-02-21 15:05:00,13
11876,ORD_11877,13717,TheGiftKart Crystal Clear Mi Redmi Note 10s / 10 / Note 11 SE Back Cover Case 360 Degree Protection Shock Proof Design Tra...,Warehouse B,104,95,2025-02-21 05:23:00,9
11877,ORD_11878,23442,Nandika Beauty Astringent Lotion - Aloevera with Mint 500 ml,Warehouse C,104,99,2025-02-21 21:30:00,5
11878,ORD_11879,35117,F Gear Luxur Brown 25 liter Laptop Backpack (2404),Warehouse B,64,51,2025-02-21 20:43:00,13
11879,ORD_11880,11167,"Artis AR-60W-MG2 60 Watts MG2 Laptop Adapter/Charger Compatible with MB Pro 13” Retina Display (16.5V, 3.65A) Connector: M...",Warehouse A,13,8,2025-02-21 00:43:00,5
11880,ORD_11881,14496,"Sakura Gelly Roll Pen, White, Assorted Sizes, Fine/Medium/Bold -3 Pen Set",Warehouse C,92,87,2025-02-21 04:51:00,5
11881,ORD_11882,15870,Cymet ER 25 Tablet,Warehouse A,103,92,2025-02-21 11:40:00,11
11882,ORD_11883,5646,Onsitego 1 Year Extended Warranty for Small Household Appliances from Rs. 1501-2000 (Email Delivery - No Physical Kit),Warehouse A,18,1,2025-02-21 19:38:00,17
11883,ORD_11884,1209,BOXO Straight 2 clip Hair Piece Invisible Hairpin For Thinning Hair Adding Hair Volume Extension - Black,Warehouse A,53,44,2025-02-21 14:17:00,9
11884,ORD_11885,719,Camlin Champ Flast Brush Set - Pack of 7 (Multicolor),Warehouse A,50,42,2025-02-21 02:16:00,8
11885,ORD_11886,3310,Cidloc D 30mg/40mg Capsule SR,Warehouse B,97,83,2025-02-21 09:20:00,14
11886,ORD_11887,33547,Fashion Colour Vitamin C Face Mask 130 gm,Warehouse A,115,97,2025-02-21 09:14:00,18
11887,ORD_11888,4019,HP 158X Black Original Laserjet Toner Reload Kit,Warehouse A,26,8,2025-02-21 20:38:00,18
11888,ORD_11889,15266,"(Renewed) Hp 800 G3 Tiny Desktop (Core i5 6th gen 2.5ghz, 16 GB RAM, 480gb SSD, Win 11 Pro, MS Office, WIFI , USB 3.0, Eth...",Warehouse C,94,88,2025-02-21 11:30:00,6
11889,ORD_11890,21001,"MX 3 Pin Universal Conversion Plug Converts Power 5 AMP to 15 AMP Plug, Flame Retardant Body Material with Child Safety Sh...",Warehouse B,98,87,2025-02-21 23:17:00,11
11890,ORD_11891,13165,Met Stamlo Active 5 mg/50 mg Capsule,Warehouse C,20,3,2025-02-21 23:07:00,17
11891,ORD_11892,12294,"Wild Stone Night Rider Long Lasting Eau de Parfum for Men, 30ml",Warehouse A,30,18,2025-02-21 12:16:00,12
11892,ORD_11893,5395,"HP Ink Tank 316 All-in-one Colour Printer with Upto 7500 Black and 8000 Colour Pages Included in The Box - Print, Scan & C...",Warehouse A,76,67,2025-02-21 22:18:00,9
11893,ORD_11894,20170,Ethipred 4 Tablet,Warehouse A,95,83,2025-02-21 16:28:00,12
11894,ORD_11895,7614,Cucumber Toner Spray,Warehouse B,43,28,2025-02-21 03:03:00,15
11895,ORD_11896,29955,Bencefi O 200mg/200mg Tablet,Warehouse C,34,21,2025-02-21 20:30:00,13
11896,ORD_11897,8987,Cello Bling Pastel Ball Pen | Blue Ball Pen | Jar of 25 Units | Best Ball Pens for Smooth Writing | Ball Point Pen Set | P...,Warehouse A,21,13,2025-02-21 03:30:00,8
11897,ORD_11898,6977,boAt Bassheads 102 in Ear Wired Earphones with Mic(Jazzy Blue),Warehouse C,95,78,2025-02-21 19:11:00,17
11898,ORD_11899,30343,Zenotin 200 mg/600 mg Tablet,Warehouse A,29,10,2025-02-21 05:08:00,19
11899,ORD_11900,24912,Myotop-P Tablet,Warehouse C,98,83,2025-02-21 20:49:00,15
11900,ORD_11901,25588,Vosnac XL 50mg/325mg Tablet,Warehouse C,106,99,2025-02-21 13:30:00,7
11901,ORD_11902,6983,Arkorad 250mg/250mg Capsule,Warehouse A,45,27,2025-02-21 00:20:00,18
11902,ORD_11903,35122,Nixzine Tablet,Warehouse B,65,48,2025-02-21 17:50:00,17
11903,ORD_11904,16019,House Of Makeup Nail Lacquer - Oh My Magenta! 12 ml,Warehouse C,51,37,2025-02-21 00:27:00,14
11904,ORD_11905,26783,Infeczon S 1000mg/500mg Injection,Warehouse A,67,60,2025-02-21 12:03:00,7
11905,ORD_11906,4477,Qclor 125mg Suspension,Warehouse C,113,96,2025-02-21 00:40:00,17
11906,ORD_11907,21230,Fixzom CV 500mg/125mg Tablet,Warehouse B,90,75,2025-02-21 22:23:00,15
11907,ORD_11908,749,Beauty People Velvet Matte Nail Polish Matte - Me - Fuschia - 367 9.9 ml,Warehouse B,9,3,2025-02-21 14:49:00,6
11908,ORD_11909,15954,Solorox 150mg Tablet,Warehouse A,67,51,2025-02-21 13:21:00,16
11909,ORD_11910,3202,"NEXDIGITRON CPL Filter Compatible with 70mai A500S, A500, Lite & Pro DashCam",Warehouse C,20,7,2025-02-21 00:07:00,13
11910,ORD_11911,32221,"TECHONTO 22MM Watch Band Strap with Rust Free Button Compatible with ColorFit Pro 4/Pro 4 Max/Ultra/Ultra 2, Amazfit GTR (...",Warehouse A,100,90,2025-02-21 21:01:00,10
11911,ORD_11912,11922,Astigo Remote Control Compatible with Airtel Xstream Set Top Box (Without Voice Function),Warehouse B,43,27,2025-02-21 22:20:00,16
11912,ORD_11913,23440,Anatin 300mg Tablet,Warehouse A,105,89,2025-02-21 22:26:00,16
11913,ORD_11914,29380,Deodorant Body Spray - Fresh,Warehouse B,39,22,2025-02-21 04:10:00,17
11914,ORD_11915,9431,Nature's Essence Lightening Gel Face Wash - Orange & Lime 100 ml,Warehouse C,77,63,2025-02-21 13:26:00,14
11915,ORD_11916,3553,Mefentod Plus Oral Suspension,Warehouse B,102,86,2025-02-21 05:04:00,16
11916,ORD_11917,25373,Nylo-SO Oral Suspension Sugar Free,Warehouse A,82,63,2025-02-21 06:35:00,19
11917,ORD_11918,5422,"TANTRA BLUEME Car Bluetooth Device with Mic 5.0 - Aux to Bluetooth Converter, Bluetooth Receiver for Home Theatre, Bluetoo...",Warehouse B,106,94,2025-02-21 21:01:00,12
11918,ORD_11919,2784,M.G.R.J® Tempered Glass Screen Protector Compatible for Samsung Galaxy Tab S8 Plus/Tab S7 Plus/Tab S7 FE (SM-X800 /SM-X806...,Warehouse C,99,80,2025-02-21 04:43:00,19
11919,ORD_11920,8992,T Prost Eye Drop,Warehouse B,60,45,2025-02-21 12:41:00,15
11920,ORD_11921,35021,Bath & Body Works You're the One Daily Nourishing Body Lotion,Warehouse B,27,18,2025-02-21 05:33:00,9
11921,ORD_11922,2009,Sounce 36W Fast Car Charger with Dual USB Output Qualcomm (Qc) 3.1 + Qualcomm (Qc) 3.1 Compatible with All Cars for iPhon...,Warehouse A,33,22,2025-02-21 11:34:00,11
11922,ORD_11923,15652,Wet n Wild Lip Gloss Call Me Boss (Glossy),Warehouse A,54,48,2025-02-21 09:25:00,6
11923,ORD_11924,1366,Gadliv M 500mg/50mg Tablet,Warehouse B,71,52,2025-02-21 12:33:00,19
11924,ORD_11925,29897,Difital 50mg/650mg Tablet,Warehouse C,81,65,2025-02-21 17:26:00,16
11925,ORD_11926,32927,"Oppo F21s Pro 5G (Dawnlight Gold, 8GB RAM, 128 Storage) with No Cost EMI/Additional Exchange Offers",Warehouse A,97,81,2025-02-21 15:20:00,16
11926,ORD_11927,17715,Hypose 5mg Tablet,Warehouse A,22,4,2025-02-21 13:44:00,18
11927,ORD_11928,9262,TheGiftKart Sleek Back Cover Case for iQOO Neo 7 5G | Slim Fit Protective Design | Ultra Matte Finish | Camera Protection ...,Warehouse C,91,76,2025-02-21 13:42:00,15
11928,ORD_11929,2953,Tenrite M Forte 1000mg/20mg Tablet SR,Warehouse A,26,8,2025-02-21 13:18:00,18
11929,ORD_11930,34826,Kaypen 125mg Tablet,Warehouse A,104,85,2025-02-21 07:09:00,19
11930,ORD_11931,3099,"Nik case iPhone 13 Back Cover| iPhone 13 case| Back Cover for iPhone 13 (6.1"") (Soft|Silicone|Black)",Warehouse A,86,76,2025-02-21 14:17:00,10
11931,ORD_11932,14454,coocaa 80 cm (32 inches) Frameless Series HD Ready Smart IPS LED TV 32S3U Pro (Black),Warehouse C,70,53,2025-02-21 22:37:00,17
11932,ORD_11933,20764,"Amazon Basics High Speed HDMI Cable (Gold-Plated, A Male to A Male) - Supports 4K @60Hz and Audio Return (10 Feet)",Warehouse B,24,15,2025-02-21 05:23:00,9
11933,ORD_11934,17020,Zifcas LB 200mg Tablet,Warehouse A,53,42,2025-02-21 14:07:00,11
11934,ORD_11935,6879,OFIXO Card,Warehouse A,35,25,2025-02-21 20:20:00,10
11935,ORD_11936,30035,Sunscreen SPF 60,Warehouse C,29,15,2025-02-21 16:24:00,14
11936,ORD_11937,1306,"Vivo Y16 (Drizzling Gold, 3GB RAM, 32GB Storage) with No Cost EMI/Additional Exchange Offers",Warehouse C,67,57,2025-02-21 23:55:00,10
11937,ORD_11938,20533,Nitopan 40mg Tablet,Warehouse C,38,19,2025-02-21 01:07:00,19
11938,ORD_11939,13365,Essential Souls Anti Acne Gel - Soft Touch 50 gm,Warehouse B,81,76,2025-02-21 02:46:00,5
11939,ORD_11940,11273,Makeup Revolution Colour Play Manifest Eyeshadow Palette 5.2 gm,Warehouse B,41,24,2025-02-21 18:24:00,17
11940,ORD_11941,30836,"Makeup Revolution London I Heart Makeup Palette (Eyeshadow), Chocolate Rose Gold V4, Matte & Shimmery Finish, 22g",Warehouse C,37,20,2025-02-21 02:06:00,17
11941,ORD_11942,20667,Jovees Face Massage Gel for Oily Skin - Vera & Apple 100 gm,Warehouse C,106,87,2025-02-21 06:37:00,19
11942,ORD_11943,27316,"Camel Student Poster Color - 10ml each, 12 Shades",Warehouse A,29,19,2025-02-21 01:19:00,10
11943,ORD_11944,27183,Pierre Cardin Paris - Magnetic Dream Lipstick 268-Blood Red,Warehouse B,83,65,2025-02-21 21:13:00,18
11944,ORD_11945,9271,Ottazi 250 Tablet,Warehouse A,17,6,2025-02-21 04:44:00,11
11945,ORD_11946,13364,HOMEMATES 2 Pcs Large Pearl Hair Claw White Hair Claw Thick Long Hair Jaw Clips Clutches Barrettes Hair Accessories for Wo...,Warehouse A,88,73,2025-02-21 19:30:00,15
11946,ORD_11947,167,Es Omedom 30mg/40mg Capsule SR,Warehouse C,84,69,2025-02-21 19:41:00,15
11947,ORD_11948,25426,Emigo Oral Solution,Warehouse C,33,18,2025-02-21 10:37:00,15
11948,ORD_11949,1824,Avocado Fruit Face & Body Bleach,Warehouse C,55,50,2025-02-21 11:31:00,5
11949,ORD_11950,20509,Love Earth Organic Eyelash Growth Serum Enriched With Pure Organic & Natural Essential Oils For Eyelashes & Eyebrows,Warehouse C,91,74,2025-02-21 00:01:00,17
11950,ORD_11951,27097,"Aroma® NB120C Dhamaka Pro Bluetooth Wireless In Ear Neckband with Playtime 40 Hours, Smart Voice Assistant, Dual Pairing, ...",Warehouse B,27,19,2025-02-21 19:41:00,8
11951,ORD_11952,13680,Alacforte 120Million spores Tablet,Warehouse A,26,16,2025-02-21 07:57:00,10
11952,ORD_11953,34869,Phenytoin Sodium 100mg Injection,Warehouse C,68,57,2025-02-21 00:04:00,11
11953,ORD_11954,12039,Hbclin 600mg/4ml Injection,Warehouse C,30,20,2025-02-21 21:18:00,10
11954,ORD_11955,27130,Mefcox TX 500mg/250mg Tablet,Warehouse A,8,3,2025-02-21 15:45:00,5
11955,ORD_11956,20610,"Portronics AUTO 12 in-Car Bluetooth Receiver for Handsfree Calling, Music System, Supports All Smartphones (Black)",Warehouse C,28,23,2025-02-21 03:35:00,5
11956,ORD_11957,12292,"realme 9 5G SE (Azure Glow, 6GB RAM, 128GB Storage)",Warehouse C,53,47,2025-02-21 11:11:00,6
11957,ORD_11958,3541,"Sanitary Pads - Dry-Max Ultra-Dry, with Wings",Warehouse C,49,44,2025-02-21 02:18:00,5
11958,ORD_11959,34885,Curirab-DSR Capsule,Warehouse A,111,95,2025-02-21 00:26:00,16
11959,ORD_11960,34782,"Samsung Galaxy M32 (Light Blue, 4GB RAM, 64GB | FHD+ sAMOLED 90Hz Display | 6000mAh Battery | 64MP Quad Camera",Warehouse A,87,73,2025-02-21 15:05:00,14
11960,ORD_11961,29220,Creme Bleach - De-Tan,Warehouse C,57,48,2025-02-21 19:07:00,9
11961,ORD_11962,5453,Winble Ultra Hybrid Crystal Clear Back Cover Case for Samsung Galaxy S23 5G | Shockproof Camera & Drop Protection | Hard C...,Warehouse B,91,75,2025-02-21 21:11:00,16
11962,ORD_11963,34998,"Lava A1 (Candy Blue), Number Talker, Smart AI Battery, 4 Days Battery Backup, Military Grade Certified, Keypad Mobile",Warehouse B,55,41,2025-02-21 13:23:00,14
11963,ORD_11964,27336,"Lapster Laptop Camera Cover Webcam Cover Slider, Ultra Thin Slide Blocker for All Laptop PC Tablet (Pack of 3pcs)",Warehouse A,80,72,2025-02-21 16:16:00,8
11964,ORD_11965,26970,Amozo Back Cover For iPhone 12/ 12 Pro ( Poly Carbonate|Blue ),Warehouse A,73,59,2025-02-21 07:37:00,14
11965,ORD_11966,29209,Mach 3 Shaving Blades 6pcs + Pre Shave Gel Fusion - Hydra Gel Sensitive 195 g,Warehouse B,58,49,2025-02-21 04:04:00,9
11966,ORD_11967,6834,"Himalaya Purifying Scrub - Neem, 100g Tube",Warehouse B,53,37,2025-02-21 04:25:00,16
11967,ORD_11968,26966,Miss Rose 15 Color Glitter Eyeshadow Palette 7001 - 077MT 02 15 gm,Warehouse A,72,57,2025-02-21 07:24:00,15
11968,ORD_11969,319,"Deal Best Deal Professional Beauty 6 Pcs Matte Me Liquid Lipstick Set - Long Lasting. Waterproof, Non Stick Lipsticks for ...",Warehouse C,87,72,2025-02-21 15:26:00,15
11969,ORD_11970,9401,Electvision Remote Control for LED or LCD TV Compatible with Kodak/Thomson Televisions Small (Please Match The Image with ...,Warehouse A,85,68,2025-02-21 13:19:00,17
11970,ORD_11971,24633,Sleep-Well Tablets - Effective In Sleep Disorders,Warehouse C,33,25,2025-02-21 19:19:00,8
11971,ORD_11972,11183,Albolin 50mg Injection,Warehouse B,99,89,2025-02-21 13:54:00,10
11972,ORD_11973,9377,Triredisol H Injection,Warehouse C,96,91,2025-02-21 07:46:00,5
11973,ORD_11974,1227,"Belicia 48 Colors Holographic Chunky Glitter, Nail Glitter Body Sequins for Festive Makeup,Eyes,Hair, Body,Nail,Crafts",Warehouse A,78,69,2025-02-21 05:40:00,9
11974,ORD_11975,6484,Erocol Plus Ear Drop,Warehouse B,20,1,2025-02-21 01:50:00,19
11975,ORD_11976,5462,Qatalitic Detail Pen Knife - Crafts Steel Knife Cutter Tool with 5 Interchangeable Sharp Blades,Warehouse B,110,98,2025-02-21 22:45:00,12
11976,ORD_11977,33345,Estom 40mg Capsule,Warehouse C,41,23,2025-02-21 02:55:00,18
11977,ORD_11978,6840,Ibp Oral Suspension,Warehouse C,50,32,2025-02-21 03:53:00,18
11978,ORD_11979,6430,Mecovia Plus Injection,Warehouse A,36,18,2025-02-21 08:40:00,18
11979,ORD_11980,14472,Medimade Hydrating Serum With Moroccan Argan Oil (Pack of 2) 1's,Warehouse A,37,22,2025-02-21 05:13:00,15
11980,ORD_11981,5623,"Portronics AUTO 10 POR-320, Bluetooth - FM Transmitter in-Car Radio Adapter for Hands-Free Calling, Music Streaming, Micro...",Warehouse C,53,35,2025-02-21 12:19:00,18
11981,ORD_11982,25481,Moclawin Dry Syrup,Warehouse C,32,20,2025-02-21 21:40:00,12
11982,ORD_11983,36388,Gracef 100mg Tablet DT,Warehouse B,99,91,2025-02-21 10:07:00,8
11983,ORD_11984,23488,"Elmask Derma Roller 0.5mm for Face Acne Scars,540 Stainless Steel Microneedle Derma Roller for Beard and Hair Re-Growth, N...",Warehouse A,48,43,2025-02-21 19:28:00,5
11984,ORD_11985,26992,"Kinsound 3.5mm Headphone Auxiliary Splitter, Dual Headphone Y Splitter Adapter Headphone Jack for Phone, PS4, Switch, Tabl...",Warehouse B,26,12,2025-02-21 22:35:00,14
11985,ORD_11986,20864,Cewar 250mg Injection,Warehouse C,99,85,2025-02-21 19:57:00,14
11986,ORD_11987,15713,"Hammer Pulse Ace Pro Bluetooth Calling Smartwatch with SpO2 & 1.81” Aluminium Alloy Body with Blood Oxygen Monitoring, Hea...",Warehouse A,49,32,2025-02-21 23:39:00,17
11987,ORD_11988,29369,Meflac D 80mg/250mg Tablet,Warehouse C,46,32,2025-02-21 07:21:00,14
11988,ORD_11989,6860,"Blue Heaven Hypergel Nailpaint - Very Wine, 306 11 ml",Warehouse A,32,22,2025-02-21 04:28:00,10
11989,ORD_11990,34829,Brufen Junior 100mg/5ml Suspension,Warehouse B,40,26,2025-02-21 05:05:00,14
11990,ORD_11991,397,Zelorn 4mg Tablet,Warehouse A,94,85,2025-02-21 10:30:00,9
11991,ORD_11992,12747,Men Activated Charcoal Detox Peel Off Mask,Warehouse A,40,32,2025-02-21 19:56:00,8
11992,ORD_11993,12285,"UHUD CRAFTS Headphone Tabletop Stand, Wooden Headphone Holder for Gamers & Music Lovers, Computer Table/Desk Organizer Hea...",Warehouse C,28,20,2025-02-21 11:28:00,8
11993,ORD_11994,20724,Aceclomax P Oral Suspension,Warehouse A,53,38,2025-02-21 04:13:00,15
11994,ORD_11995,30830,"Flix (Beetel) Bolt 2.4 12W Dual USB Smart Charger, Made in India, Bis Certified, Fast Charging Power Adaptor with 1 Meter ...",Warehouse A,24,7,2025-02-21 00:27:00,17
11995,ORD_11996,20494,Ckes Eye Drop,Warehouse C,61,43,2025-02-21 00:49:00,18
11996,ORD_11997,34856,Aldol 200mg Oral Suspension,Warehouse B,27,20,2025-02-21 23:01:00,7
11997,ORD_11998,20691,"Tree Hut Shea Moisturizing Body Lotion Moroccan Rose, 255g",Warehouse B,91,81,2025-02-21 00:57:00,10
11998,ORD_11999,32813,Onsitego 1 Year Extended Warranty for Small Household Appliances from Rs. 7001-8000 (Email Delivery - No Physical Kit),Warehouse C,29,12,2025-02-21 05:28:00,17
11999,ORD_12000,17014,Seraxim L 200mg Tablet,Warehouse B,11,6,2025-02-21 08:42:00,5
12000,ORD_12001,30033,Zinret M Syrup,Warehouse B,82,75,2025-02-21 06:24:00,7
12001,ORD_12002,32850,Ajmal Aurum & Wisal & Silver Shade & Evoke silver Edition Homme Deo & Ascend EDP Pack of 5 820 ml,Warehouse B,88,77,2025-02-21 02:06:00,11
12002,ORD_12003,4365,"Shuban 60 cm Stainless Steel Ruler Scale Long 2 Side Measuring Tool for Architects, Engineers, College Students",Warehouse C,37,21,2025-02-21 22:08:00,16
12003,ORD_12004,2138,Zithrovil 250 Tablet,Warehouse B,38,24,2025-02-21 10:13:00,14
12004,ORD_12005,30031,Empire Accessories Bumper || Transparent || Edge to Edge Protection Back case Cover for Google Pixel 6 - Transparent,Warehouse A,16,3,2025-02-21 10:02:00,13
12005,ORD_12006,1273,"Spigen Thermoplastic Polyurethane, Polycarbonate Thin Fit Cover Case for Apple Watch 8/7 (45mm) - Black (Watch not Included)",Warehouse B,18,8,2025-02-21 03:30:00,10
12006,ORD_12007,34922,"Samsung 32-Inch(80.13Cm) LED 1920 x 1080 Pixels, M5 FHD Smart Monitor, Speakers, Remote, 1 Billion Color, Smart TV apps, T...",Warehouse B,83,78,2025-02-21 12:18:00,5
12007,ORD_12008,27087,Cufeto Syrup,Warehouse C,67,50,2025-02-21 07:00:00,17
12008,ORD_12009,1271,Reset-M Tablet,Warehouse A,47,42,2025-02-21 19:36:00,5
12009,ORD_12010,20718,Ceraf Plus 200mg/200mg Tablet,Warehouse C,81,74,2025-02-21 15:02:00,7
12010,ORD_12011,20465,Lip Butter - Rose,Warehouse B,46,34,2025-02-21 20:14:00,12
12011,ORD_12012,12026,Beauty People Pure Matte Lipstick - Pretty - Pink - 419 3.8 gm,Warehouse C,104,87,2025-02-21 17:51:00,17
12012,ORD_12013,20259,Itraclaz 200 Capsule,Warehouse A,77,65,2025-02-21 16:57:00,12
12013,ORD_12014,24834,Levrow 2.5mg Syrup,Warehouse B,53,47,2025-02-21 16:10:00,6
12014,ORD_12015,27626,"Ustraa Face Wash - for Oily skin - 200g - With Basil & Lime - For Ane-Prone Skin, No Sulphate & Paraben, Checks Acne and B...",Warehouse C,33,18,2025-02-21 19:16:00,15
12015,ORD_12016,8874,Carnisure A 500mg Tablet,Warehouse B,53,37,2025-02-21 17:15:00,16
12016,ORD_12017,9550,"Samsung 345L 3 Star Inverter Frost Free Double Door Refrigerator (RT37T4513S8/HL, Elegant Inox, Convertible 5In 1)",Warehouse A,19,8,2025-02-21 02:29:00,11
12017,ORD_12018,5717,GLOBAC SAFE 50 MG INJECTION,Warehouse A,53,40,2025-02-21 20:57:00,13
12018,ORD_12019,34939,TopFinder® New Shades Luxury 24 hours Super Stay Long 5ML Different Liquid Matte Nude Beauty Color Lipsticks Silky long La...,Warehouse C,92,75,2025-02-21 18:29:00,17
12019,ORD_12020,17106,Relipra IT 20mg/150mg Capsule SR,Warehouse C,44,33,2025-02-21 00:46:00,11
12020,ORD_12021,12017,De Tan Face Pack,Warehouse A,21,3,2025-02-21 09:12:00,18
12021,ORD_12022,27198,"NEWDERY Charger for Apple Watch Portable iWatch USB Wireless Charger, Travel Cordless Charger with Light Weight Magnetic Q...",Warehouse B,60,52,2025-02-21 17:15:00,8
12022,ORD_12023,30849,BRACKET INDIA SKY-011 Universal 14-32-inch LED LCD TV Wall Mount Bracket (Black),Warehouse C,58,51,2025-02-21 11:33:00,7
12023,ORD_12024,6894,Goaceb 100mg Capsule,Warehouse B,44,37,2025-02-21 13:59:00,7
12024,ORD_12025,9198,Inefable (16 Pcs) Multicoloured Protection Spiral Cable & Wire Protectors Spring Wire for All Wired Accessories for USB Ch...,Warehouse A,46,40,2025-02-21 14:22:00,6
12025,ORD_12026,34892,Myodum CV Syrup,Warehouse C,10,5,2025-02-21 23:39:00,5
12026,ORD_12027,31468,Pentric-DSR Capsule,Warehouse C,30,18,2025-02-21 17:42:00,12
12027,ORD_12028,15737,Natural Therapeutic Body Wash For Men & Women,Warehouse A,69,58,2025-02-21 02:24:00,11
12028,ORD_12029,4355,TheGiftKart Ultra-Hybrid Crystal Clear Back Case Cover for Google Pixel 7 PRO | Shockproof Design | Camera Protection Bump...,Warehouse A,39,33,2025-02-21 16:00:00,6
12029,ORD_12030,32825,Spantra De Tan Mask for Tan Removal Radiant Glow 500 gm,Warehouse B,76,57,2025-02-21 15:34:00,19
12030,ORD_12031,9194,Improvhome 3.5 mm Jack Stereo Amplifier Connect TV-Out Speaker AV Audio Video TRS 3-Pole Plug Male to 2 RCA Male Cable (1....,Warehouse C,61,53,2025-02-21 12:48:00,8
12031,ORD_12032,12777,Arochem Black Oudh (Pack of 2) Concentrated Perfume 12ml Attar,Warehouse B,64,53,2025-02-21 23:48:00,11
12032,ORD_12033,24769,Trimetaday 1/500 Tablet ER,Warehouse A,29,21,2025-02-21 01:50:00,8
12033,ORD_12034,31647,Lakme 9 To 5 Primer + Matte Powder Foundation Compact Honey Dew 9 Gm,Warehouse A,83,74,2025-02-21 02:14:00,9
12034,ORD_12035,33934,Tabelito® Basic Laptop Bag Laptop Cover Laptop Bags Laptop Sleeve Office Bag Laptop Bag 15.6 inch(39.6cm) Laptop Apple/ Le...,Warehouse C,71,65,2025-02-21 09:45:00,6
12035,ORD_12036,31283,Broncozen G Syrup,Warehouse C,41,28,2025-02-21 16:56:00,13
12036,ORD_12037,30275,Acewalk Plus Tablet,Warehouse A,32,24,2025-02-21 09:26:00,8
12037,ORD_12038,5581,Matte Look SPF 30 Sun Screen Gel Creme,Warehouse B,100,94,2025-02-21 05:56:00,6
12038,ORD_12039,34937,Ceface CV 250 mg/125 mg Tablet,Warehouse C,92,87,2025-02-21 12:55:00,5
12039,ORD_12040,36436,Kesrota MF 80mg/250mg Tablet,Warehouse A,60,55,2025-02-21 03:27:00,5
12040,ORD_12041,14371,Clinrap 300mg Capsule,Warehouse A,19,3,2025-02-21 14:20:00,16
12041,ORD_12042,34834,Ulcelak 20mg Capsule,Warehouse C,88,71,2025-02-21 00:44:00,17
12042,ORD_12043,27236,Aretha Eau De Parfum Fruity Perfume - Party Wear For Women,Warehouse C,103,97,2025-02-21 16:36:00,6
12043,ORD_12044,23631,Wet N Wild Mega Length Mascara - Very Black 6 ml,Warehouse C,50,31,2025-02-21 21:02:00,19
12044,ORD_12045,27049,Labicillin 500mg Injection,Warehouse A,85,71,2025-02-21 04:08:00,14
12045,ORD_12046,9304,"AmazonBasics laptopss Sleeve Case Cover 14.1-inches laptopsss for Men and Women | Slim Profile Neoprene, Soft Puffy Fabric...",Warehouse C,34,28,2025-02-21 18:48:00,6
12046,ORD_12047,34936,NOTE LUMINOUS SILK MONO EYESHADOW 03 4.5 gm,Warehouse A,19,8,2025-02-21 03:57:00,11
12047,ORD_12048,15358,CraftDev Kids Stamp Set Motivation Sticker School Scrapbooking Stamp DIY Teachers Self Inking Praise Reward Stamps(No Ink ...,Warehouse B,28,17,2025-02-21 04:32:00,11
12048,ORD_12049,20455,Btrophil 90mg/48mg/100mg Tablet,Warehouse C,104,95,2025-02-21 09:21:00,9
12049,ORD_12050,17123,Akglim-M 2 Tablet PR,Warehouse B,19,9,2025-02-21 14:01:00,10
12050,ORD_12051,7598,L'Oreal Paris Total Repair 5 Masque 200 Ml,Warehouse A,21,2,2025-02-20 22:45:00,19
12051,ORD_12052,7574,"JIGYAS 15.6 Inch Reversible Laptop Sleeve Cover Case for HP, Lenovo, Dell, Asus, Acer, Sony, Apple MacBook",Warehouse C,69,64,2025-02-20 14:43:00,5
12052,ORD_12053,21078,Miss Rose Glitter Liquid Eyeshadow 7001 - 008M10 3.5 gm,Warehouse C,80,69,2025-02-20 09:41:00,11
12053,ORD_12054,2392,Pro Depot 500mg Injection,Warehouse C,55,46,2025-02-20 13:42:00,9
12054,ORD_12055,23491,Cefsafe 250 Tablet,Warehouse A,90,84,2025-02-20 01:54:00,6
12055,ORD_12056,25490,Rich-D 10mg/20mg Capsule,Warehouse B,110,96,2025-02-20 08:01:00,14
12056,ORD_12057,33979,Gatoline 100mg Tablet,Warehouse B,45,36,2025-02-20 02:23:00,9
12057,ORD_12058,14301,"MI Outdoor Bluetooth Speaker (5W) Up to 20 Hours Battery Life, Dynamic Sound Effect, Bluetooth 5.0, IPX5 Splash Proof, Com...",Warehouse B,20,5,2025-02-20 13:36:00,15
12058,ORD_12059,7579,DS Plus Tablet,Warehouse B,61,45,2025-02-20 22:42:00,16
12059,ORD_12060,23507,"Kottakkal ayurveda® Karpuradi Tailam, Enriched With Goodness of Karpura - Pack of 1 (200ml)",Warehouse B,73,68,2025-02-20 12:40:00,5
12060,ORD_12061,6436,Remove Hard Wax - Aloe Vera 400 ml,Warehouse B,69,62,2025-02-20 11:34:00,7
12061,ORD_12062,25506,"Hierusre Ultra Thin Transparent Tempered Glass Camera Lens Protector for iPhone 13 Pro, iPhone 13 Pro Max, iPhone 13 Mini ...",Warehouse A,50,39,2025-02-20 14:26:00,11
12062,ORD_12063,34719,Misonac Gel,Warehouse B,45,26,2025-02-20 18:16:00,19
12063,ORD_12064,23597,Punarnavasavam,Warehouse A,66,57,2025-02-20 02:07:00,9
12064,ORD_12065,21087,Mefigic-Spas Tablet,Warehouse B,55,45,2025-02-20 17:55:00,10
12065,ORD_12066,33327,"Onelap Micro - Hidden Water Resistant Wired GPS Tracker for Car, Bike, EV, Truck, Bus, etc with 1 Year Sim Card",Warehouse A,92,83,2025-02-20 20:06:00,9
12066,ORD_12067,2149,Rebocare DSR 30mg/20mg Capsule,Warehouse A,88,78,2025-02-20 05:50:00,10
12067,ORD_12068,31264,Whiteglow Active Skin Whitening + Oil Control Facewash,Warehouse C,57,44,2025-02-20 03:35:00,13
12068,ORD_12069,21061,Peppermint Leaves Powder - Useful To Relieve Spasm & Pain In Intestines,Warehouse C,88,73,2025-02-20 13:23:00,15
12069,ORD_12070,21019,4711 Shower Gel 200 ml,Warehouse C,54,41,2025-02-20 13:07:00,13
12070,ORD_12071,8963,Carvaan Saregama Mini 2.0 Bhakti- Music Player with Bluetooth/FM/AM/AUX (Orange),Warehouse A,38,30,2025-02-20 01:06:00,8
12071,ORD_12072,21022,DUNHILL Desire Blue Eau De Toilette For Men 50Ml,Warehouse A,57,50,2025-02-20 16:30:00,7
12072,ORD_12073,21024,Hisense 139 cm (55 inches) Bezelless Series 4K Ultra HD Smart LED Google TV 55A6H (Black),Warehouse C,89,76,2025-02-20 02:49:00,13
12073,ORD_12074,7520,Alphonso Mango Body Wash With Vanilla Beans,Warehouse C,63,44,2025-02-20 08:52:00,19
12074,ORD_12075,25409,Aclovir 200mg Tablet,Warehouse A,13,1,2025-02-20 14:42:00,12
12075,ORD_12076,6468,Passion Indulge BATH BAR-BERRY BURST ( PACK OF 3 ) 1's,Warehouse C,105,89,2025-02-20 21:03:00,16
12076,ORD_12077,8969,Voligin Plus 50mg/325mg Tablet,Warehouse C,47,41,2025-02-20 08:21:00,6
12077,ORD_12078,33923,"Akai Professional MPK mini MK3 25 Key USB MIDI Keyboard Controller with 8 Backlit Drum Pads, 8 Knobs and Music Production ...",Warehouse C,25,20,2025-02-20 01:07:00,5
12078,ORD_12079,23696,Wet N Wild Color Icon 10 Pan Palette - Comfort Zone 10 gm,Warehouse A,67,61,2025-02-20 13:48:00,6
12079,ORD_12080,8971,Mippo Plus Syrup,Warehouse B,33,19,2025-02-20 18:47:00,14
12080,ORD_12081,34765,Casflo OZ 200mg/500mg Tablet,Warehouse B,12,3,2025-02-20 13:03:00,9
12081,ORD_12082,1845,"Fashion Colour Non - Transfer Matt Waterproof Lipstick, 69 Nudes 2.6 gm",Warehouse C,57,49,2025-02-20 12:57:00,8
12082,ORD_12083,23592,Aceclo SR Tablet,Warehouse B,88,71,2025-02-20 14:29:00,17
12083,ORD_12084,48,Acer K273 b 27 Inch IPS Full HD LCD Monitor with LED Back Light I 1MS VRB 75Hz Refresh Rate I AMD Free Sync Technology I Z...,Warehouse C,38,21,2025-02-20 20:31:00,17
12084,ORD_12085,12824,Wisely |Pack 2| For Fire Boltt Invincible Plus SmartWatch Screen Guard Scratch Guard Full Screen Protector Compatible for ...,Warehouse B,45,28,2025-02-20 11:45:00,17
12085,ORD_12086,21000,Anal 100mg/2mg Tablet MR,Warehouse C,92,82,2025-02-20 08:56:00,10
12086,ORD_12087,1834,"ZEBRONICS Jumbo LITE with 70 Hours Backup, Bluetooth v5.2 Wireless In Ear Neckband, Fast Charging, ENC Calling, Gaming Mod...",Warehouse B,75,63,2025-02-20 18:19:00,12
12087,ORD_12088,13216,"OnePlus Warp Charge Type-C To Type-C Cable 100Cm, Compatible With Smartphone, Red,White",Warehouse C,30,25,2025-02-20 05:48:00,5
12088,ORD_12089,21007,"Honeywell Surge Protector/Spike Guard/Extension Board, Master Switch, 4 Universal Sockets, 2USB Ports, 15000Amp, 2Mtr Cor...",Warehouse A,29,11,2025-02-20 01:23:00,18
12089,ORD_12090,7508,"Cosmic Byte CB-GK-18 Firefly Per-Key RGB TKL Mechanical Keyboard with Swappable Outemu Red Switch, Macros, Software (Black)",Warehouse B,100,95,2025-02-20 07:21:00,5
12090,ORD_12091,37064,I-Glide Eye Pencil New Mini Pencil Kajal Iglnm016 0.5 Gm,Warehouse A,48,32,2025-02-20 17:51:00,16
12091,ORD_12092,6527,Spantra Coffee Caffeine Sugar Scrub 125 gm,Warehouse C,78,70,2025-02-20 17:32:00,8
12092,ORD_12093,13230,Macbery-XT Expectorant Sugar Free,Warehouse A,32,13,2025-02-20 22:52:00,19
12093,ORD_12094,13368,Vega Sea Bath Sponge (BA - 3/15) 25 gm,Warehouse C,89,77,2025-02-20 12:14:00,12
12094,ORD_12095,23914,"Nyx Professional Makeup Pore Filler, Orange, 20ml",Warehouse B,10,2,2025-02-20 09:42:00,8
12095,ORD_12096,13593,Flormar Eye Shadow Palette Smoky 9 gm,Warehouse C,39,27,2025-02-20 11:03:00,12
12096,ORD_12097,23778,Almogril 6.25mg Tablet,Warehouse C,14,5,2025-02-20 04:30:00,9
12097,ORD_12098,1875,Camel Camlin Kokuyo Oil Pastel (50 Shades),Warehouse A,95,88,2025-02-20 23:38:00,7
12098,ORD_12099,6587,Glofty-OZ Tablet,Warehouse A,25,11,2025-02-20 14:46:00,14
12099,ORD_12100,6585,LOHAYA LCD/LED Remote Compatible for Sony Bravia Smart LCD LED UHD OLED QLED 4K Ultra HD TV Remote Control with YouTube & ...,Warehouse A,55,50,2025-02-20 19:33:00,5
12100,ORD_12101,31632,Acezip P Oral Suspension,Warehouse B,42,35,2025-02-20 09:49:00,7
12101,ORD_12102,23864,"Jibaro 2 Makup Puff, 7 Bottle Makeup Sponge and1 Foundation Makeup Brush Flat Top Kabuki Hexagon Face Blush Liquid Powder ...",Warehouse A,99,93,2025-02-20 03:22:00,6
12102,ORD_12103,31310,"Lakmé Jewel Sindoor, 5 ml (Maroon)",Warehouse C,45,35,2025-02-20 12:08:00,10
12103,ORD_12104,7377,"SIDRUM 1/4 Thread Gopro Tripod Mount Adapter Compatible with GoPro Hero 10 9 8 7 6 5 4 3+ 3 , SJCAM, DJI OSMO, Insta 360 a...",Warehouse C,107,92,2025-02-20 09:05:00,15
12104,ORD_12105,23857,20pcs Naruto Anime Sticker Pack Fan Art from animo India Perfect for Laptop Computer Car Water Bottle Travel Case Guitar L...,Warehouse A,52,47,2025-02-20 11:53:00,5
12105,ORD_12106,6566,Ajmal 2 Distraction And 1 Carbon Deodorants Pack of 3 200 ml,Warehouse A,78,62,2025-02-20 12:05:00,16
12106,ORD_12107,7391,Physicians Formula Organic Wear 100% Natural Origin Cc Curl + Care Mascara - Ultra Black 7.5 gm,Warehouse C,101,85,2025-02-20 02:19:00,16
12107,ORD_12108,13622,Intavisc PF Injection,Warehouse A,33,25,2025-02-20 02:20:00,8
12108,ORD_12109,26942,"ADTALA Magnifying Glass with Light, Folding Handle, 5 Bright LED Magnifier, 2X Rectangular Handheld Reading Magnifying Gla...",Warehouse A,72,57,2025-02-20 12:27:00,15
12109,ORD_12110,25296,Ofal 200mg Syrup,Warehouse C,105,99,2025-02-20 12:03:00,6
12110,ORD_12111,25415,"ZORBES® Storage Bag for Samsung T7/T7 Touch Portable SSD, Shockproof Travel Organizer Storage Case with Handstrap for Sams...",Warehouse B,97,80,2025-02-20 23:19:00,17
12111,ORD_12112,5684,Caviar Rejuvenate & Protecting Face Mask Sheet,Warehouse C,82,64,2025-02-20 02:27:00,18
12112,ORD_12113,14023,St.Botanica Body Wash - Strawberry & Vitamin-E 250 ml,Warehouse B,41,30,2025-02-20 23:22:00,11
12113,ORD_12114,21511,Shikakai - Amla and Bhringraj,Warehouse C,63,45,2025-02-20 03:00:00,18
12114,ORD_12115,26246,Beauty People Natural HD Matte Lip Crayon Classy - 109 4 gm,Warehouse A,46,33,2025-02-20 05:48:00,13
12115,ORD_12116,32966,Me-On Face Primer,Warehouse B,53,42,2025-02-20 21:00:00,11
12116,ORD_12117,14024,Gemblue Biocare Sandal & Turmeric Face Mask 500 ml,Warehouse C,61,51,2025-02-20 17:46:00,10
12117,ORD_12118,22162,"boAt Newly Launched Rockerz 255 Max in Ear Earphones with 60H Playtime, EQ Modes, Power Magnetic Earbuds, Beast™ Mode, EN...",Warehouse C,97,92,2025-02-20 20:26:00,5
12118,ORD_12119,2279,"Amazon Basics Bluetooth 5.0 Truly Wireless in Ear Earbuds with mic, Up to 38 Hours Playtime, IPX-5 Rated, Type-C Charging ...",Warehouse B,102,84,2025-02-20 18:54:00,18
12119,ORD_12120,13001,Portable Female Urination Device For Women - Disposable,Warehouse A,10,5,2025-02-20 18:12:00,5
12120,ORD_12121,22141,"ELV Small Adjustable Mobile Phone Stand, Phone Stand for Desk, Cradle Dock Mount, Aluminum Desktop Stand Compatible with A...",Warehouse C,62,53,2025-02-20 01:05:00,9
12121,ORD_12122,26636,Be Soulfull Burst of Hydration Moisturizing Cream 50 gm,Warehouse B,74,65,2025-02-20 02:25:00,9
12122,ORD_12123,36946,AmazonBasics High Power 65W Mobile/Laptop Charger Dual Port Output with Type-C Charging Cable (White),Warehouse C,40,28,2025-02-20 00:25:00,12
12123,ORD_12124,31008,"Parker Vector Standard Gold Trim Roller Ball Pen (Body - Black, Ink - Blue)",Warehouse A,18,10,2025-02-20 20:45:00,8
12124,ORD_12125,6016,"ProElite Slim Trifold Flip case Cover for Realme Pad 10.4 inch, Black",Warehouse A,42,24,2025-02-20 09:32:00,18
12125,ORD_12126,36945,Lecof-C Syrup,Warehouse C,35,23,2025-02-20 10:47:00,12
12126,ORD_12127,6013,Pierre Cardin Paris - Magnetic Dream Lipstick 254-Dusty Rose,Warehouse B,92,81,2025-02-20 17:13:00,11
12127,ORD_12128,22090,Insupio 7.5mg Tablet,Warehouse A,46,38,2025-02-20 12:04:00,8
12128,ORD_12129,21545,"Fashion Colour Colour Correction Makeup Base Single Packing, G165 3.5 gm",Warehouse C,19,2,2025-02-20 03:21:00,17
12129,ORD_12130,8449,Vertomin 10 Tablet,Warehouse B,46,37,2025-02-20 03:04:00,9
12130,ORD_12131,34429,Mefnil P Suspension,Warehouse C,113,96,2025-02-20 04:36:00,17
12131,ORD_12132,8617,Lulipil Soap,Warehouse A,20,3,2025-02-20 03:40:00,17
12132,ORD_12133,14140,"Fashion Colour Pro Hd Eyeshadow Palette 18 Shades, Shade 03 14 gm",Warehouse A,37,31,2025-02-20 18:32:00,6
12133,ORD_12134,32993,Eyetex Pallavi G12 Maroon bindis(pack of 10 flaps),Warehouse C,59,42,2025-02-20 16:05:00,17
12134,ORD_12135,33020,Deborah Milano Double Sided Sharpener 1's,Warehouse A,69,62,2025-02-20 04:47:00,7
12135,ORD_12136,8573,"Fashion Colour Jersy Girl Kiss Proof No Transfer Lipstick, 4 Vivid Lilac 2 gm",Warehouse B,17,4,2025-02-20 02:49:00,13
12136,ORD_12137,21668,"Loofah/Sponge Scrubber/Body Bath - Pink, BH-063 PNK",Warehouse C,58,49,2025-02-20 08:34:00,9
12137,ORD_12138,1529,"BENNETT Drax Laptop Sleeve Case Cover for 39.62 cm (15.6-Inch) Laptop MacBook, Protective (Black)",Warehouse B,50,41,2025-02-20 05:22:00,9
12138,ORD_12139,5897,Alzam 0.5mg Tablet,Warehouse C,60,50,2025-02-20 08:58:00,10
12139,ORD_12140,8341,Miss Rose 5 Color Eyeshadow/Highlighter 7001 - 383 N09 10 gm,Warehouse C,89,72,2025-02-20 19:54:00,17
12140,ORD_12141,21562,Volume &  Bounty Conditioner - Coconut Water & Mimosa Flower Aroma,Warehouse A,31,23,2025-02-20 14:28:00,8
12141,ORD_12142,1825,Maryaj Lilas EDP Citrus Floral Perfume And Ajmal Aurum Femme Deodorant Fruity Floral Fragrance 300 ml,Warehouse B,63,47,2025-02-20 15:16:00,16
12142,ORD_12143,22033,Assidol SP Tablet,Warehouse C,40,28,2025-02-20 07:48:00,12
12143,ORD_12144,31277,"Dyazo USB Hub 5 in 1 , 3 USB Port 2.0 & 2 TF & SD Slots Data Transfer Upto 480Mbps Compatible for MacBook, , DELL , Comput...",Warehouse A,55,39,2025-02-20 03:04:00,16
12144,ORD_12145,23580,"Ustraa Base Camp Cologne - 100 ml - Perfume for Men | Cool, Crisp Fragrance of the Mountains | Long-lasting | Zingy, Aquat...",Warehouse A,14,9,2025-02-20 23:48:00,5
12145,ORD_12146,23571,Spigen Liquid Air Back Cover Case Compatible with iPhone 14 Plus (TPU | Matte Black),Warehouse C,92,79,2025-02-20 20:13:00,13
12146,ORD_12147,31267,Coba C Injection,Warehouse B,49,44,2025-02-20 14:19:00,5
12147,ORD_12148,23544,Fixital 200mg Tablet,Warehouse A,40,34,2025-02-20 16:39:00,6
12148,ORD_12149,25447,GRANDSE Virtual Reality Headset 3D Glasses Anti-Radiation,Warehouse A,96,87,2025-02-20 19:16:00,9
12149,ORD_12150,25450,Momriv HT Cream,Warehouse A,30,21,2025-02-20 11:56:00,9
12150,ORD_12151,21270,Cognitab 90mg Tablet,Warehouse B,83,74,2025-02-20 10:33:00,9
12151,ORD_12152,13870,Difee Spas 10mg/250mg Tablet,Warehouse A,74,62,2025-02-20 21:46:00,12
12152,ORD_12153,23938,Votre Under Eye Serum 15 gm,Warehouse A,54,40,2025-02-20 08:59:00,14
12153,ORD_12154,22202,Raptobolin 25 Injection,Warehouse B,79,72,2025-02-20 18:39:00,7
12154,ORD_12155,12995,Nimofed-P Tablet,Warehouse A,86,71,2025-02-20 21:32:00,15
12155,ORD_12156,22041,Antiseptic Liquid 550 ml + Disinfectant Spray- Original 225 ml,Warehouse B,113,99,2025-02-20 21:30:00,14
12156,ORD_12157,22038,Doms Oil Pastel 50 Shades Plastic Pack,Warehouse B,75,68,2025-02-20 02:39:00,7
12157,ORD_12158,34403,Honey Woman Deodorant,Warehouse C,100,91,2025-02-20 06:15:00,9
12158,ORD_12159,36943,The Man Company Eau de Toilette - Spice 100 ml,Warehouse B,98,84,2025-02-20 17:03:00,14
12159,ORD_12160,14160,Afime-O Dry Syrup,Warehouse A,54,37,2025-02-20 04:09:00,17
12160,ORD_12161,34404,Blue Heaven Uhd (Ultra-High-Definition) Waterproof Makeup Stick-05 (Beige Cream),Warehouse A,85,74,2025-02-20 07:06:00,11
12161,ORD_12162,21577,Cefizoc 325 Tablet,Warehouse A,62,50,2025-02-20 16:20:00,12
12162,ORD_12163,26330,Aegte Loose Inches Massage Oil 100 ml,Warehouse C,69,60,2025-02-20 03:44:00,9
12163,ORD_12164,12938,Sebicef S 500mg/500mg Injection,Warehouse B,67,62,2025-02-20 12:34:00,5
12164,ORD_12165,8670,ClubComfort Long Wear Gel Eyeliner Smudge Proof & Waterproof (Black And Brown) With 2 Expert Eyeliner Brushes,Warehouse B,21,7,2025-02-20 16:30:00,14
12165,ORD_12166,21588,Pikkme Back Cover for Mi Redmi Note 7/Note 7 Pro/Note 7S (Thermoplastic Polyurethane|Black),Warehouse B,48,36,2025-02-20 11:08:00,12
12166,ORD_12167,26341,Robustrion Trifold Flip Cover for Apple iPad Cover 10.2 inch / iPad 9th Generation Cover / iPad 8th Generation / iPad 7th ...,Warehouse B,95,86,2025-02-20 19:43:00,9
12167,ORD_12168,26344,Finvin 1mg Tablet,Warehouse A,22,8,2025-02-20 13:46:00,14
12168,ORD_12169,1495,Soset 4mg Injection,Warehouse A,66,55,2025-02-20 13:05:00,11
12169,ORD_12170,26350,Linark 5mg Tablet,Warehouse B,82,77,2025-02-20 10:14:00,5
12170,ORD_12171,21976,Nuvigil NT 75mg/10mg Tablet,Warehouse B,35,28,2025-02-20 19:52:00,7
12171,ORD_12172,32891,Anilide P 100mg/500mg Tablet,Warehouse B,108,93,2025-02-20 03:19:00,15
12172,ORD_12173,34418,Neurobert-PG Capsule,Warehouse B,82,67,2025-02-20 22:30:00,15
12173,ORD_12174,31301,Panzin 40mg Injection,Warehouse B,70,60,2025-02-20 09:21:00,10
12174,ORD_12175,12688,Texet PS-SC1EX Portable Strip Cut Shredder | Cuts 6 Sheets at a time | for both credit and debit cards | Advanced Over Hea...,Warehouse C,85,73,2025-02-20 10:31:00,12
12175,ORD_12176,1369,"Fashion Colour Satin Smooth Lip Definer, 11 Pink Flower 1.41 gm",Warehouse A,8,2,2025-02-20 17:44:00,6
12176,ORD_12177,23125,Orange Pure Aroma Essential Oil,Warehouse B,52,39,2025-02-20 19:44:00,13
12177,ORD_12178,20611,Awnacef SB 1gm/500mg Injection,Warehouse B,24,8,2025-02-20 18:30:00,16
12178,ORD_12179,33990,"Faces Canada Weightless Stay Matte Compact Vitamin E & Shea Butter, Spf-20 Sand 04, 9 g and Faces Canada Weightless Matte ...",Warehouse C,34,19,2025-02-20 18:09:00,15
12179,ORD_12180,64,Glamveda Rice Water Brightening Face Scrub For Women | For Lightens Skin | Reduces Pigmentation & Tanning | Paraben Free |...,Warehouse B,69,60,2025-02-20 20:15:00,9
12180,ORD_12181,5721,ON Capsule,Warehouse A,90,74,2025-02-20 20:26:00,16
12181,ORD_12182,23213,Olmesure-M 50 Tablet ER,Warehouse B,104,97,2025-02-20 08:59:00,7
12182,ORD_12183,7744,Rica White Chocolate Liposoluble Soft Wax Refill Roll-on Cartridge for Full Body Waxing Hair Removal Cream for women (100ml),Warehouse C,22,7,2025-02-20 14:06:00,15
12183,ORD_12184,21163,"Fashion Colour Kiss Lip No Transfer Lipstick, 06 Boysenberry 2.6 gm",Warehouse C,17,5,2025-02-20 16:47:00,12
12184,ORD_12185,34698,Senera D 75mg/15mg Tablet,Warehouse C,54,49,2025-02-20 16:10:00,5
12185,ORD_12186,34061,Adilafil 20 Tablet,Warehouse A,100,83,2025-02-20 05:28:00,17
12186,ORD_12187,34062,Nimef 100mg Tablet,Warehouse B,102,93,2025-02-20 21:06:00,9
12187,ORD_12188,1762,Encin OZ Tablet,Warehouse A,59,45,2025-02-20 12:45:00,14
12188,ORD_12189,23161,Peridem 4mg Tablet,Warehouse C,92,77,2025-02-20 19:13:00,15
12189,ORD_12190,8877,Visbro 100mg Capsule,Warehouse A,79,68,2025-02-20 11:56:00,11
12190,ORD_12191,2172,Glam Girlz Matte Lipstick-Red,Warehouse A,16,6,2025-02-20 02:27:00,10
12191,ORD_12192,36286,Plum E-Luminence Simply Supple Cleansing Balm 90 gm,Warehouse B,41,24,2025-02-20 17:03:00,17
12192,ORD_12193,7798,Roxyn 1.5 Injection,Warehouse C,90,77,2025-02-20 03:55:00,13
12193,ORD_12194,7801,Rucam 400mg Tablet,Warehouse A,96,79,2025-02-20 16:47:00,17
12194,ORD_12195,23108,Pennant Eau De Toilette For Men,Warehouse B,41,29,2025-02-20 07:01:00,12
12195,ORD_12196,2379,Air Condoms,Warehouse C,103,89,2025-02-20 20:38:00,14
12196,ORD_12197,3165,Votre Advance Pore Minimizing Toner - Mini 50 ml,Warehouse B,57,50,2025-02-20 17:13:00,7
12197,ORD_12198,23242,Acidshoonya Tablet,Warehouse C,106,89,2025-02-20 18:31:00,17
12198,ORD_12199,13142,"Elle 8 Color Pops Lipstick, W51 (Matte)",Warehouse A,51,39,2025-02-20 16:25:00,12
12199,ORD_12200,7672,KOTSUN Ultra Fast C Type 25W Dash Charger Compatible for Oneplus7 Pro/7/7T/6/6T/5T/5/3T/3 (Cable+ Adapter) with Fast Charg...,Warehouse A,84,69,2025-02-20 07:52:00,15
12200,ORD_12201,30932,Saltum Kid Tablet DT,Warehouse A,100,93,2025-02-20 00:14:00,7
12201,ORD_12202,23373,House of Aroma Mint Fragrance Oil 100 ml,Warehouse B,38,24,2025-02-20 11:38:00,14
12202,ORD_12203,33996,Panasonic AAA Rechargeable Battery (2 piece),Warehouse C,51,44,2025-02-20 05:26:00,7
12203,ORD_12204,21106,Lakme 9 To 5 Weightless Lip & Cheek Color Brick Bloom 9 Gm,Warehouse B,108,98,2025-02-20 09:37:00,10
12204,ORD_12205,25566,"Fitbit Charge 5 Advanced Health & Fitness Tracker with Built-in GPS, Stress Management, Sleep Tools, 24/7 Heart Rate, SpO2...",Warehouse C,83,74,2025-02-20 13:59:00,9
12205,ORD_12206,12055,Acechos P 100 mg/500 mg Tablet,Warehouse B,93,88,2025-02-20 11:18:00,5
12206,ORD_12207,29888,"mi Bluetooth 4G Phone Smart Watch for Men, Sports Fitness Activity Tracker and Wrist Band for Calorie and Heart Rate Monit...",Warehouse C,85,75,2025-02-20 09:40:00,10
12207,ORD_12208,7463,Fashion Colour Keratin Hair Repair Treatment 500 gm,Warehouse B,99,88,2025-02-20 01:55:00,11
12208,ORD_12209,17953,Zidnac-P Tablet,Warehouse C,111,96,2025-02-20 06:04:00,15
12209,ORD_12210,8560,"Noise Beads Bluetooth Truly Wireless in Ear Earbuds with Mic, 18 Hours of Playtime, Metallic Finish, Hypersync, Full Touch...",Warehouse B,43,27,2025-02-20 16:53:00,16
12210,ORD_12211,17412,"Hold Up 360°Rotatable and Retractable Car Phone Holder, Multifunctional Rearview Mirror Phone Holder [Upgraded] Universal ...",Warehouse A,51,42,2025-02-20 11:44:00,9
12211,ORD_12212,29899,Cleaner Kit for Airpods Pro and 1/2 Multifunction Cleaning Pen with Soft Brush for Bluetooth Earphones Case(White Color),Warehouse B,47,32,2025-02-20 21:06:00,15
12212,ORD_12213,11895,"Ambrane 27000mAh Li-Polymer Powerbank with Type C and USB Ports | Fast Charging for Smartphones, Smart Watches, Neckbands...",Warehouse B,54,43,2025-02-20 07:18:00,11
12213,ORD_12214,36346,Carolina Herrera 212 Vip Black (Red) Eau De Parfum for Men 100ml,Warehouse C,89,83,2025-02-20 10:22:00,6
12214,ORD_12215,27508,Kapifix 100mg Tablet,Warehouse C,88,73,2025-02-20 18:48:00,15
12215,ORD_12216,4038,"Zebronics Zeb- NC1200 USB Powered Laptop Cooling Pad with 125mm Fan, Pass Through USB Connector and Blue LED Lights",Warehouse C,57,38,2025-02-20 17:52:00,19
12216,ORD_12217,29521,Camel Wax Crayons + 1 Glitter Shade Free - 12 Shades,Warehouse C,20,5,2025-02-20 20:39:00,15
12217,ORD_12218,32227,Medimade Apple Cider Vinegar Body Wash 300 ml,Warehouse B,37,20,2025-02-20 13:22:00,17
12218,ORD_12219,17975,Azlay 500 Tablet,Warehouse B,59,47,2025-02-20 23:58:00,12
12219,ORD_12220,11061,Spigen Ultra Hybrid Pro Case with Pencil Holder Compatible with iPad Pro 12.9 inch (2022 / 2021) - Black,Warehouse A,48,37,2025-02-20 00:54:00,11
12220,ORD_12221,16390,"ELV DIRECT Adjustable Portable Laptop Bed Study Table Standing Desk with Foldable Legs for Bed, Sofa, Couch and Floor",Warehouse C,111,98,2025-02-20 09:42:00,13
12221,ORD_12222,31861,Young & Forever Black Non-Precious Metal Hair Band for Unisex,Warehouse A,27,18,2025-02-20 16:12:00,9
12222,ORD_12223,5318,Ultra Ace D 10mg/325mg/37.5mg Tablet,Warehouse B,49,30,2025-02-20 18:46:00,19
12223,ORD_12224,27568,Cefitrust-O Tablet,Warehouse B,92,80,2025-02-20 23:57:00,12
12224,ORD_12225,14588,HUMBLE Universal Monopod Holder Clip for Mobile Camera Holder and Tripod Mount Holder- Black (Pack of 1),Warehouse A,20,9,2025-02-20 19:13:00,11
12225,ORD_12226,29075,Glimmer Nail Polish Pink Flower 5 ml,Warehouse C,77,66,2025-02-20 19:10:00,11
12226,ORD_12227,10145,Nucet 5mg Tablet,Warehouse C,82,74,2025-02-20 12:43:00,8
12227,ORD_12228,10146,D2Q Wired Original Galaxy Earphones for All Samsung Smartphones with Mic | Pure Bass Sound | One Button Multi-Function Rem...,Warehouse B,78,64,2025-02-20 18:34:00,14
12228,ORD_12229,19867,"LK Soft Long Lasting Herbal Kajal,WaterProof With VItamin E Enriched For Healthy Eyes Kajal, 2.5g (Pack Of 2) (Green)",Warehouse B,101,95,2025-02-20 13:45:00,6
12229,ORD_12230,10147,"TP-Link AC750 Dual Band Wireless Cable Router, 4 10/100 LAN + 10/100 WAN Ports, Support Guest Network and Parental Contro...",Warehouse A,36,19,2025-02-20 22:29:00,17
12230,ORD_12231,29404,Insight Cosmetics Non - Transfer Lip Color - 18 RED PREMIERE 4 ml,Warehouse B,23,5,2025-02-20 05:42:00,18
12231,ORD_12232,11496,UNIGEN 20W PD Type-C Fast Charger Adapter [with 1M Type-C to C Cable] for Samsung Galaxy S20/S21/S21+/S21Ultra/S10 5G /Not...,Warehouse A,63,57,2025-02-20 02:25:00,6
12232,ORD_12233,746,Ecbdol Tablet,Warehouse B,68,53,2025-02-20 10:03:00,15
12233,ORD_12234,17437,Muniyal Swasthya Churna,Warehouse A,30,20,2025-02-20 09:29:00,10
12234,ORD_12235,2500,The Body Shop Moringa Hand Cream,Warehouse A,44,26,2025-02-20 01:52:00,18
12235,ORD_12236,35717,Clopilet A 75 Capsule,Warehouse B,48,36,2025-02-20 17:50:00,12
12236,ORD_12237,28231,"ProElite Slim Smart Flip case Cover for Amazon Kindle Paperwhite 11th Generation 6.8 inch 2021, Black (Fits Signature Edit...",Warehouse C,48,33,2025-02-20 22:48:00,15
12237,ORD_12238,29885,"SWAPKART 8 in 1 Soft Brush Multifunction Cleaning Tools Kit for Keyboard, Earphone Laptop Camera & Lens, LED LCD Screen Di...",Warehouse C,108,90,2025-02-20 03:08:00,18
12238,ORD_12239,7659,tizum Mouse Pad/ Computer Mouse Mat with Anti-Slip Rubber Base | Smooth Mouse Control | Spill-Resistant Surface for Lapto...,Warehouse A,88,71,2025-02-20 05:26:00,17
12239,ORD_12240,26840,Serakair N 100mg/10mg Tablet,Warehouse B,74,66,2025-02-20 02:20:00,8
12240,ORD_12241,8922,Tronol 500 mg/37.5 mg Tablet,Warehouse B,32,16,2025-02-20 01:39:00,16
12241,ORD_12242,12865,Soptril S 1000mg/500mg Injection,Warehouse B,116,99,2025-02-20 04:03:00,17
12242,ORD_12243,25737,mobistyle Soft Liquid Silicone Slim Protective Shockproof with Anti-Scratch Microfiber Lining Phone Back Cover Case for iP...,Warehouse C,99,90,2025-02-20 07:01:00,9
12243,ORD_12244,13824,"Farmherbs 100% Herbal Kajal Stick for Adults - Olive wax based, Certified Lead-free, irritation-free, waterproof, relaxing...",Warehouse B,77,61,2025-02-20 22:01:00,16
12244,ORD_12245,23074,NOTE LUMINOUS SILK MONO EYESHADOW 11 4.5 gm,Warehouse A,67,48,2025-02-20 14:57:00,19
12245,ORD_12246,7813,Dromox Eye Drop,Warehouse C,13,3,2025-02-20 21:44:00,10
12246,ORD_12247,7815,Spigen Sand Blast Back Cover Case Compatible with Samsung Galaxy A23 LTE and A23 5G (TPU | Matte Black),Warehouse C,68,56,2025-02-20 08:52:00,12
12247,ORD_12248,23067,Faces Canada Liquid Sindoor Maroon 2.5 Ml,Warehouse B,65,54,2025-02-20 14:16:00,11
12248,ORD_12249,1749,Inte-Cold Tablet,Warehouse B,44,28,2025-02-20 02:02:00,16
12249,ORD_12250,31195,Avicin 100mg Injection,Warehouse B,81,70,2025-02-20 06:44:00,11
12250,ORD_12251,6303,"AmazonBasics USB Type-C to USB Type-C 2.0 Fast Charging Cable for Smartphone, Laptop - 6 Feet (1.8 Meters), White",Warehouse C,59,40,2025-02-20 11:48:00,19
12251,ORD_12252,6297,SIRF TUM 7 FiiME POWDER Pore-less Oil Control Compact Powder- All Day Matte Finish Face -Fit Me Matte-FOUNDATION BRUSH ALL...,Warehouse C,26,21,2025-02-20 13:19:00,5
12252,ORD_12253,31545,ARAMACT 100MG TABLET,Warehouse C,108,89,2025-02-20 18:04:00,19
12253,ORD_12254,6295,"KX3s (Black RED), 1000mAh Battery, Dual Sim, 1.8 Inch, Wireless FM with Recording, Camera, Basic Phone, 108 Days Replaceme...",Warehouse C,49,36,2025-02-20 14:26:00,13
12254,ORD_12255,5738,"Bassoholic Two Way 6.5 Inches Coaxial High Bass Speakers for Car with Imported Rubber Edge Cone, Multicolor",Warehouse A,114,97,2025-02-20 15:38:00,17
12255,ORD_12256,1790,"Vivo Y35 (Dawn Gold, 8GB RAM, 128GB Storage) with No Cost EMI/Additional Exchange Offers",Warehouse A,98,85,2025-02-20 09:57:00,13
12256,ORD_12257,2187,Corti 100mg Injection,Warehouse B,61,44,2025-02-20 19:59:00,17
12257,ORD_12258,21228,Emoxylin 250mg Tablet,Warehouse A,62,47,2025-02-20 20:34:00,15
12258,ORD_12259,25780,Vega Eye Shadow Eye Aplicator (DMB - 01) 12 gm,Warehouse A,72,66,2025-02-20 05:49:00,6
12259,ORD_12260,3358,Neurocil-PG Capsule,Warehouse B,109,95,2025-02-20 03:02:00,14
12260,ORD_12261,14294,"Doodle Initial A Premium Soft Bound Notebook Diary for Girls and Women (B6, 80 GSM, 192 Ruled Pages) Floral Design",Warehouse C,67,50,2025-02-20 01:10:00,17
12261,ORD_12262,2387,Nodip 2mg Tablet,Warehouse A,38,26,2025-02-20 08:26:00,12
12262,ORD_12263,22856,Boxer 400mg Tablet,Warehouse C,61,55,2025-02-20 14:32:00,6
12263,ORD_12264,6385,Glycoset GP 2 Tablet,Warehouse B,43,34,2025-02-20 13:30:00,9
12264,ORD_12265,33882,Natural Hair Strengthening Oil,Warehouse A,103,95,2025-02-20 22:09:00,8
12265,ORD_12266,6521,Samsung Ehs64 Ehs64Avfwecinu Hands-Free Wired In Ear Earphones With Mic With Remote Note (White),Warehouse A,56,42,2025-02-20 01:35:00,14
12266,ORD_12267,33885,I AM EYECONIC FINE GLITTER ROSE GOLD 4 gm,Warehouse A,70,54,2025-02-20 16:55:00,16
12267,ORD_12268,7455,Miss Rose 5 Color Eyeshadow Mini Palette 7001 - 063N 02 6 gm,Warehouse A,98,80,2025-02-20 05:31:00,18
12268,ORD_12269,33891,Azax Liquid,Warehouse B,30,23,2025-02-20 21:47:00,7
12269,ORD_12270,22969,Body Wash - Peach Berry Essence,Warehouse B,50,31,2025-02-20 08:20:00,19
12270,ORD_12271,33248,MISS DOLL Fit ME POWDER Pore-less Oil Control Compact Powder- All Day Finish Face -Fit Me Highlighter Blender (Multi-item-01),Warehouse C,64,47,2025-02-20 20:16:00,17
12271,ORD_12272,36996,Syska SSK-EBS-0402 ABS 4 Way Power Strip,Warehouse A,94,81,2025-02-20 00:56:00,13
12272,ORD_12273,6241,Heptazoom T Syrup,Warehouse A,81,68,2025-02-20 15:18:00,13
12273,ORD_12274,8911,Gemblue Biocare Romance Body lotion 500 ml,Warehouse B,27,17,2025-02-20 08:56:00,10
12274,ORD_12275,6364,HP Pavilion 14 12th Gen Intel Core i5 16GB RAM/512GB SSD 14 inch(35.6cm) IPS Micro-Edge FHD Laptop/Intel Iris Xe Graphics/...,Warehouse A,56,48,2025-02-20 02:10:00,8
12275,ORD_12276,23309,Vimcv 500mg/125mg Tablet,Warehouse B,21,11,2025-02-20 18:52:00,10
12276,ORD_12277,6362,MorningVale Mini Multipurpose Wall Holder with Mobile Charging Point/Stationary Storage/Bathroom acceceries/Remote Holder/...,Warehouse A,19,7,2025-02-20 10:19:00,12
12277,ORD_12278,25600,Rabidix A 200mg/20mg Capsule SR,Warehouse A,56,48,2025-02-20 06:03:00,8
12278,ORD_12279,37032,"Gatsby Set & Keep Hair Spray - Extreme Hold 250ml | Quick Drying, Long Lasting Hold, No Flaking & Natural Shine | Non Stic...",Warehouse C,30,25,2025-02-20 00:49:00,5
12279,ORD_12280,2161,"HEMIZA Jawline Exerciser Jaw, Face, and Neck Exerciser - Define Your Jawline, Slim and Tone Your Face, Look Younger and He...",Warehouse C,17,7,2025-02-20 00:21:00,10
12280,ORD_12281,7703,Andoset-MD Tablet,Warehouse A,79,64,2025-02-20 04:23:00,15
12281,ORD_12282,21689,Reequil Atorep Body Lotion For Atopic Skin 120 ml,Warehouse A,93,84,2025-02-20 02:39:00,9
12282,ORD_12283,23085,The Moms Co. Body Butter 100 gm,Warehouse C,110,97,2025-02-20 09:52:00,13
12283,ORD_12284,21201,"N95 Washable Face Mask - Blue, Medium",Warehouse B,18,12,2025-02-20 23:30:00,6
12284,ORD_12285,25734,Allure classic Eye groomer & Eye Shadow Brush combo 1's,Warehouse B,53,36,2025-02-20 13:31:00,17
12285,ORD_12286,25829,Zyromet G 3mg/500mg Tablet,Warehouse B,96,89,2025-02-20 11:26:00,7
12286,ORD_12287,8855,All Rounder Eye Liner Retractable Arp002 0.29 Gm,Warehouse A,26,17,2025-02-20 08:53:00,9
12287,ORD_12288,3156,Ivana's Set of 2 Pieces Henna Tattoo Stencil Set for Women Girls Hand Finger Body Paint Temporary Tattoo -(Niv-21),Warehouse A,104,91,2025-02-20 07:01:00,13
12288,ORD_12289,25808,House of Aroma Alive Fragrance Oil 10 ml,Warehouse C,30,21,2025-02-20 00:44:00,9
12289,ORD_12290,25810,Zilo M 5mg/10mg Tablet,Warehouse A,86,76,2025-02-20 07:31:00,10
12290,ORD_12291,34137,"HUDA BB Beauty Makeup All Skin Type Fauxfilter Foundation And Skin base Primer With Face Makeup Fixer Setting Spray, Pack ...",Warehouse B,30,17,2025-02-20 11:29:00,13
12291,ORD_12292,1410,Avgesic-MR Tablet,Warehouse B,37,21,2025-02-20 19:49:00,16
12292,ORD_12293,26778,Charmacy Milano Soft Satin Matte Lipstick (Shimmering Blush) 3.8 gm,Warehouse B,46,30,2025-02-20 07:04:00,16
12293,ORD_12294,7904,Total Derm Plus Cream,Warehouse C,57,52,2025-02-20 12:28:00,5
12294,ORD_12295,34140,"Amazon Basics High-Speed HDMI Cable - 10 Feet (Latest Standard) - Supports Ethernet, 3D, 4K video,Black",Warehouse A,19,12,2025-02-20 03:21:00,7
12295,ORD_12296,36875,Coconut Water & Aloe Vera Volume Hair Shampoo,Warehouse C,31,20,2025-02-20 03:38:00,11
12296,ORD_12297,6249,AKG P120 High-Performance General Purpose Recording Microphone,Warehouse A,21,6,2025-02-20 03:18:00,15
12297,ORD_12298,25836,Amozo Ultra Hybrid Camera and Drop Protection Back Cover Case for iPhone 13 (TPU + Polycarbonate | Crystal Transparent),Warehouse A,32,15,2025-02-20 03:40:00,17
12298,ORD_12299,22898,Robustrion Deer Pattern Flip Stand Case Cover for Samsung Tab A7 Lite Cover 8.7 Inch Samsung Galaxy Tab A7 Lite Back Cover...,Warehouse B,55,46,2025-02-20 21:02:00,9
12299,ORD_12300,1719,Portronics Konnect L 1.2M POR-1401 Fast Charging 3A 8 Pin USB Cable with Charge & Sync Function (White),Warehouse B,47,29,2025-02-20 07:51:00,18
12300,ORD_12301,7914,Dipcad 5mg Tablet,Warehouse C,113,94,2025-02-20 23:23:00,19
12301,ORD_12302,25846,Brightening Masksheet (Pack of 3),Warehouse C,38,20,2025-02-20 09:09:00,18
12302,ORD_12303,14114,Faber-Castell Fabric Color - Pack of 6 (Assorted),Warehouse B,30,25,2025-02-20 21:32:00,5
12303,ORD_12304,2058,"FLiX (Beetel USB to Micro USB PVC Data Sync & 2A Fast Charging Cable, Made in India, 480Mbps Data Sync, Solid Cable, 1 Met...",Warehouse C,89,80,2025-02-20 01:39:00,9
12304,ORD_12305,21677,Cona Standy Multiplug 3+2 with USB - (White) - (Material -PC) - Unit 1 No,Warehouse C,53,37,2025-02-20 00:58:00,16
12305,ORD_12306,6832,Duopil 2 Forte Tablet PR,Warehouse A,20,13,2025-02-20 09:44:00,7
12306,ORD_12307,24930,Azim Suspension,Warehouse A,50,35,2025-02-20 01:23:00,15
12307,ORD_12308,1333,Livafin -O 100 Capsule,Warehouse A,101,86,2025-02-20 05:25:00,15
12308,ORD_12309,2008,Ignitate Party Mini Laser Projector Stage Lighting Sound Activated Laser Light for Party and DJ with Mini-Tripod Stand,Warehouse C,9,1,2025-02-20 14:51:00,8
12309,ORD_12310,20660,NMFe Moisturising Lotion 450ml With 1 Free Sample Of Moisturising Body Wash 30 ml,Warehouse B,95,79,2025-02-20 21:09:00,16
12310,ORD_12311,24262,Moroccan Argan Oil & Raw Honey Face Wash,Warehouse B,31,13,2025-02-20 00:36:00,18
12311,ORD_12312,20794,T.O.G. Nail Biting Thumb Sucking Deterrent Deeply Nourish for Toddlers Children,Warehouse C,60,45,2025-02-20 13:32:00,15
12312,ORD_12313,25093,Urcol 150mg Tablet,Warehouse B,69,52,2025-02-20 13:59:00,17
12313,ORD_12314,20847,Cold Processed Sweet Rose Handmade Soap For Dry Sensitive Skin,Warehouse B,36,27,2025-02-20 19:08:00,9
12314,ORD_12315,7007,Asus ROG BP1501 39.62 cm (15.6-inch) Gaming Laptop Backpack (Black),Warehouse A,21,12,2025-02-20 10:34:00,9
12315,ORD_12316,6945,"Kent Cam Wired 10 feet Long 360 Security Wall Mounting Kit Camera with Multiple Installation Options , USB Cable with Indo...",Warehouse B,30,14,2025-02-20 07:11:00,16
12316,ORD_12317,33605,Kecix 200 LB Tablet,Warehouse A,69,61,2025-02-20 08:03:00,8
12317,ORD_12318,6768,Obrin Eye Drop,Warehouse C,62,46,2025-02-20 21:33:00,16
12318,ORD_12319,6955,Glucowave MV 2mg/500mg/0.2mg Tablet,Warehouse A,91,76,2025-02-20 00:29:00,15
12319,ORD_12320,24132,Imediab MP 1 Tablet SR,Warehouse A,46,39,2025-02-20 07:07:00,7
12320,ORD_12321,7235,Edirose 20mg Tablet,Warehouse A,49,43,2025-02-20 09:21:00,6
12321,ORD_12322,20836,Ajmal 1 Shadow Him And 3 Persuade Deodorants Pack of 4 200 ml,Warehouse A,46,40,2025-02-20 14:24:00,6
12322,ORD_12323,13280,"Fossil Gen 6 Smartwatch with AMOLED Screen, Snapdragon 4100+ Wear Platform, Wear OS by Google, Google Assistant, SpO2, Wel...",Warehouse C,67,51,2025-02-20 23:37:00,16
12323,ORD_12324,13409,Belora Paris Leave No Evidence Liquid Matte Lipstick Nudie Mystery 4.5 gm,Warehouse C,91,79,2025-02-20 08:03:00,12
12324,ORD_12325,13352,FriendZon 9H Nano Speedometer Scratch Guard Screen Protector Compatible with TVS Raider 125 (Pack of 1),Warehouse B,88,72,2025-02-20 19:04:00,16
12325,ORD_12326,6996,Tellin M 500mg/20mg Tablet,Warehouse C,56,50,2025-02-20 01:57:00,6
12326,ORD_12327,13479,Vermor 30mg Tablet,Warehouse A,38,19,2025-02-20 00:22:00,19
12327,ORD_12328,31434,"Gift Set - Deodorant + Body Wash, Black for Men 2",Warehouse B,46,41,2025-02-20 20:48:00,5
12328,ORD_12329,37097,Ofbid 200mg Tablet,Warehouse B,40,28,2025-02-20 16:45:00,12
12329,ORD_12330,33603,"Cosmic Byte CB-GK-21 Themis 61 Key Mechanical Per Key RGB Gaming Keyboard with Outemu Blue Switches and Software (Black, U...",Warehouse C,37,21,2025-02-20 16:37:00,16
12330,ORD_12331,33548,Kare in Adult Under Pads Large,Warehouse C,90,85,2025-02-20 02:04:00,5
12331,ORD_12332,27074,Famogreat 40mg Tablet,Warehouse B,100,87,2025-02-20 16:25:00,13
12332,ORD_12333,24291,L'Oreal Paris Men's Expert Hydra Power Mountain Water Shower Gel (300ml),Warehouse B,90,74,2025-02-20 03:38:00,16
12333,ORD_12334,12797,"Xiaomi Pad 5| Qualcomm Snapdragon 860| 120Hz Refresh Rate| 6GB, 256GB| 2.5K+ Display (10.95-inch/27.81cm)|1 Billion Colour...",Warehouse B,30,11,2025-02-20 06:18:00,19
12334,ORD_12335,5620,"American Tourister VALEX BLACK LAPTOP BACKPACK 28 Ltrs,Volume, LAPTOP COMPARTMENT, BOTTLE POCKET, FRONT ORGANIZER",Warehouse A,30,25,2025-02-20 09:13:00,5
12335,ORD_12336,1915,TVS ELECTRONICS Gold Prime Mechanical Wired Keyboard | Dustproof Key switches | Guaranteed 50 Million keystrokes | 1.5 Met...,Warehouse C,101,82,2025-02-20 06:43:00,19
12336,ORD_12337,2015,Cefimex 200mg Tablet,Warehouse C,87,69,2025-02-20 15:43:00,18
12337,ORD_12338,9128,"Fashion Colour Makeup Fixer, MF01 100 ml",Warehouse A,85,68,2025-02-20 04:56:00,17
12338,ORD_12339,24078,Newvent Eye Brow Hair Liner With Stencil One Handed Instant Hair Colour For Women Eye Brow Stamp (pack Of 1),Warehouse C,21,6,2025-02-20 19:48:00,15
12339,ORD_12340,2076,Oboe Silicone TV Remote Cover Compatible with LG TV Remote LG AN-MR21GA (2021) LG MR22GA (2022) LG Magic Remote Case with ...,Warehouse A,51,35,2025-02-20 11:48:00,16
12340,ORD_12341,9054,Lapster USB all types smartwatch charger cable for boat watch charger & boat xtend watch charger & boat storm watch charge...,Warehouse B,54,40,2025-02-20 05:09:00,14
12341,ORD_12342,34874,Nandika Beauty Peel Off Face Mask - Aloevera 100 ml,Warehouse C,28,17,2025-02-20 09:44:00,11
12342,ORD_12343,24496,Tumodox 50mg Injection,Warehouse B,56,44,2025-02-20 14:55:00,12
12343,ORD_12344,25130,Sitabite D 10mg/100mg Tablet,Warehouse B,45,38,2025-02-20 13:20:00,7
12344,ORD_12345,6843,Plush Peachy Puff Microfiber Beauty Blender with Case | Makeup Sponge That Saves Up to 60% Makeup | Teardrop Cut | For All...,Warehouse B,84,75,2025-02-20 12:33:00,9
12345,ORD_12346,9035,Rapid Reviver Total Repair 5 Deep Conditioner,Warehouse B,49,41,2025-02-20 00:12:00,8
12346,ORD_12347,31466,Delpizin M 10mg/500mg Tablet SR,Warehouse C,37,24,2025-02-20 05:42:00,13
12347,ORD_12348,24694,Allure Lip Filler Brush (c-22)( 1's,Warehouse B,44,25,2025-02-20 00:18:00,19
12348,ORD_12349,24359,Cotrizole Injection,Warehouse B,108,97,2025-02-20 15:02:00,11
12349,ORD_12350,33693,Romantic Hand & Body Lotion - For Women,Warehouse C,103,95,2025-02-20 11:48:00,8
12350,ORD_12351,24345,Classmate Octane Colour Burst-Multicolour Gel Pens (Pack of 10) | Gold & Silver Glitter Sparkle Pens|10 colour ink shades ...,Warehouse A,64,54,2025-02-20 17:24:00,10
12351,ORD_12352,24180,Hycef 50mg Dry Syrup,Warehouse C,31,25,2025-02-20 02:44:00,6
12352,ORD_12353,24662,Belora Paris Paint & Pout- Lip & Cheek - Panda Nude 3 ml,Warehouse B,99,87,2025-02-20 11:31:00,12
12353,ORD_12354,1974,Toshiba 108 cm (43 inches) Bezelless Series 4K Ultra HD Smart LED Google TV 43C350LP (Silver),Warehouse A,22,3,2025-02-20 09:29:00,19
12354,ORD_12355,9153,100% Pure US Cotton Ultra Thin Sanitary Pads,Warehouse A,40,27,2025-02-20 12:58:00,13
12355,ORD_12356,3220,Thyroloc 100mcg Tablet,Warehouse B,90,81,2025-02-20 21:04:00,9
12356,ORD_12357,24342,L'Occitane Rose Shower Gel Refill,Warehouse B,73,59,2025-02-20 05:18:00,14
12357,ORD_12358,24667,Spigen Ultra Hybrid Back Cover Case for iPhone 13 Pro (TPU + Poly Carbonate | Sierra Blue),Warehouse B,95,85,2025-02-20 13:58:00,10
12358,ORD_12359,27066,"Saregama Carvaan Mini+ (Plus) Portable Music Player with 1000 Preloaded Songs, 10 Watt Speaker, Handsfree Calling, Bluetoo...",Warehouse B,61,47,2025-02-20 04:42:00,14
12359,ORD_12360,24554,Flormar Kiss Me More Lip Tattoo 12 Garnet 3.8 gm,Warehouse B,34,18,2025-02-20 23:27:00,16
12360,ORD_12361,26985,"Prolite Heavy-Duty Light Stand (9 feet) for Ring Light, Flash, Reflector, Diffuser, Photo & Video Studio Shooting (Portabl...",Warehouse C,86,68,2025-02-20 05:27:00,18
12361,ORD_12362,25114,"Duracell Specialty 1632 Lithium Coin Battery 3V, Pack of 5 (DL1632/CR1632) Designed for use in keyfobs, Scales, wearables ...",Warehouse A,56,44,2025-02-20 05:30:00,12
12362,ORD_12363,6806,Prelin 75 Capsule,Warehouse C,98,90,2025-02-20 21:53:00,8
12363,ORD_12364,24788,Mothercare Non-Spill Trainer Cup - Pink,Warehouse A,82,66,2025-02-20 12:44:00,16
12364,ORD_12365,7012,AmazonBasics 27 Inch Nylon Foldable Travel Duffel Bag - Black,Warehouse B,36,17,2025-02-20 06:25:00,19
12365,ORD_12366,13526,Tough Lee Boy's and Girl's and Men's and Women's Silicone Mobile Phone Pouch Back Cover for Samsung Galaxy F23 5G (Transpa...,Warehouse B,112,93,2025-02-20 14:43:00,19
12366,ORD_12367,13519,"Gizga Essentials Carrying Case for JioFi 4G M2S and JioFI3 WiFi Hotspot Dongle, Shock Asbsorber Protective Carbon Fibre Ma...",Warehouse A,38,23,2025-02-20 00:48:00,15
12367,ORD_12368,6818,Brillare Multi-Protection Sunscreen SPF 40 50 ml,Warehouse A,9,2,2025-02-20 22:07:00,7
12368,ORD_12369,13381,Real Nature Cucumber Face Mask,Warehouse A,49,42,2025-02-20 02:54:00,7
12369,ORD_12370,30866,Zomelis SG Tablet,Warehouse B,96,78,2025-02-20 08:59:00,18
12370,ORD_12371,25152,"Schwarzkopf Professional Bonacure Keratin Smooth Perfect Treatment(200ml), Conditioner(200ml) and Micellar Shampoo(250ml)",Warehouse C,97,88,2025-02-20 14:43:00,9
12371,ORD_12372,1990,CEDO Back Cover Samsung M33 5G | Matte Soft Silicon Flexible | Camera Bump Protection | All Side Shock Proof Rubberised Ba...,Warehouse B,36,22,2025-02-20 07:31:00,14
12372,ORD_12373,27098,Colorbar Wild At Heart - 003 250 ml,Warehouse C,76,68,2025-02-20 04:34:00,8
12373,ORD_12374,9126,Albewill-Plus Tablet,Warehouse C,40,30,2025-02-20 08:21:00,10
12374,ORD_12375,20735,"pTron Bassbuds Sports V2 Bluetooth 5.3 Wireless Over Ear Headphone with Mic, Earhooks, 48Hrs Playtime, Snug-fit Design, EN...",Warehouse A,82,67,2025-02-20 03:40:00,15
12375,ORD_12376,13341,I-Trax-SB 375mg Injection,Warehouse B,54,47,2025-02-20 15:41:00,7
12376,ORD_12377,2028,Bactin 50mg Tablet,Warehouse C,62,48,2025-02-20 03:42:00,14
12377,ORD_12378,34865,Superdrug Vitamin E Toning Facial Mist 150 ml,Warehouse A,28,23,2025-02-20 02:08:00,5
12378,ORD_12379,25046,"Canon PIXMA G3000 Wi-Fi Mono/Colour, Print,Scan,Copy,High Volume Printing, User Replaceable Print Heads, Additional 2 Blac...",Warehouse C,95,88,2025-02-20 15:08:00,7
12379,ORD_12380,27040,Flormar Loose Powder 002 Light Sand 18 gm,Warehouse B,32,16,2025-02-20 00:42:00,16
12380,ORD_12381,13283,Vama Fashions Golden Crystal Kundan Diamond Bindi kumkum Stone sticker stick Round bindiya Set Bindis For Ladies (Pack of ...,Warehouse C,95,87,2025-02-20 11:11:00,8
12381,ORD_12382,7285,Valasivir 500 Tablet,Warehouse A,35,24,2025-02-20 11:52:00,11
12382,ORD_12383,24422,"Artis PS-600VA 600VA Line Interactive UPS for Personal Computers , Desktop PCs, Laptops, Routers, Networking Devices and G...",Warehouse B,89,77,2025-02-20 16:57:00,12
12383,ORD_12384,24782,Maryaj Deuce Homme EDP Spicy Woody Perfume And Ajmal Wisal Dhahab Deodorant Fruity Floral Fragrance 300 ml,Warehouse A,88,82,2025-02-20 19:32:00,6
12384,ORD_12385,20685,"Homeboss 7 in 1 Screen Cleaner and Gadget Sanitizer Spray Kit for Smartphone, Labtop, Camera (Incl: 100ml Spray, Microfibr...",Warehouse B,87,72,2025-02-20 11:01:00,15
12385,ORD_12386,24967,Fastrack Core Analog Black Dial Women's Watch-NL2298SL04/NP2298SL04,Warehouse B,108,91,2025-02-20 04:58:00,17
12386,ORD_12387,24002,Hyliv 5mg Tablet,Warehouse A,31,18,2025-02-20 19:25:00,13
12387,ORD_12388,24497,Robustrion Pack of 2 Tempered Glass Screen Protector for iPad Air 5 / iPad Air 4 10.9 inch/iPad Pro 11 inch 2018 and and 2021,Warehouse B,109,92,2025-02-20 17:07:00,17
12388,ORD_12389,27065,Charmacy Milano Cheek Enhancer 3 4 gm,Warehouse C,63,45,2025-02-20 15:19:00,18
12389,ORD_12390,20692,Domli-CZ Tablet,Warehouse A,29,10,2025-02-20 03:10:00,19
12390,ORD_12391,6892,"Fashion Colour Super Matte Lipstick, Grape Game 4 gm",Warehouse B,34,18,2025-02-20 20:37:00,16
12391,ORD_12392,7050,Levzer 5mg Tablet,Warehouse A,44,37,2025-02-20 01:05:00,7
12392,ORD_12393,24706,URBN 10000 mAh 20W Super Fast Charging Metal Power Bank | Type C PD (Input& Output) QC 3.0 Dual USB Output | Two-Way Fast ...,Warehouse C,33,21,2025-02-20 06:25:00,12
12393,ORD_12394,20758,Esomefa-DSR Capsule,Warehouse A,23,12,2025-02-20 02:17:00,11
12394,ORD_12395,25062,Olmefast CH 20mg/5mg/12.5mg Tablet,Warehouse A,65,54,2025-02-20 19:14:00,11
12395,ORD_12396,1316,"Hangable Dress Shaped Hand/Basin Towel - Cream, Bh-037 Crm",Warehouse C,66,60,2025-02-20 21:19:00,6
12396,ORD_12397,24885,Nortylast 75mg/10mg Tablet,Warehouse B,25,15,2025-02-20 18:20:00,10
12397,ORD_12398,197,Gemblue Biocare Mango Scrub 500 ml,Warehouse C,30,21,2025-02-20 11:56:00,9
12398,ORD_12399,13361,ProElite Smart Deer Flip case Cover for iPad 9.7 inch 2018/2017 / Air 2 / Air 1 5th/6th Generation (A1822/A1823/A1893/A195...,Warehouse B,91,82,2025-02-20 20:25:00,9
12399,ORD_12400,1886,"Fashion Colour Non - Transfer Matt Waterproof Lipstick, 50 Bordeaux 2.6 gm",Warehouse C,45,40,2025-02-20 01:17:00,5
12400,ORD_12401,34833,Cadbury by C12 Hot Chocolate,Warehouse A,16,7,2025-02-20 22:19:00,9
12401,ORD_12402,9025,Defzamick 6mg Tablet,Warehouse C,55,45,2025-02-20 00:17:00,10
12402,ORD_12403,2412,Parker Vector Standard CT Fountain Pen (Blue Ink),Warehouse C,77,65,2025-02-20 06:59:00,12
12403,ORD_12404,5635,Vellpodox 50mg Tablet DT,Warehouse A,29,22,2025-02-20 17:20:00,7
12404,ORD_12405,1929,Lakme Absolute Infinity Eye Shadow Palette Coral Sunset 12 Gm,Warehouse A,69,52,2025-02-20 22:28:00,17
12405,ORD_12406,23985,Bonjour Paris Just Matte Lip Crayon - Red 3.2 gm,Warehouse A,73,60,2025-02-20 07:01:00,13
12406,ORD_12407,20902,Quench Botanics Mon Cherry Brightening Foam Cleanser 100 ml,Warehouse C,55,40,2025-02-20 19:38:00,15
12407,ORD_12408,24526,"Sanitary Pads - Advanced All Nights Soft Ultra-Thin Xl, with Wings",Warehouse B,62,50,2025-02-20 20:12:00,12
12408,ORD_12409,13448,"Nyx Professional Makeup Jumbo Eye Pencil, Black Bean, 5g",Warehouse A,83,78,2025-02-20 04:13:00,5
12409,ORD_12410,2071,"Maybelline New York City Mini Eyeshadow Palette, Brunch Neutrals 6.1 gm",Warehouse B,72,59,2025-02-20 16:24:00,13
12410,ORD_12411,13338,Gentle Exfoliating Apricot Scrub,Warehouse C,108,97,2025-02-20 23:09:00,11
12411,ORD_12412,34808,Careflection M10 in-Ear TWS Wireless Touch Bluetooth Earplugs in The Ear Stereo Sport Headsets Earphone Noise Reduction He...,Warehouse A,50,44,2025-02-20 07:40:00,6
12412,ORD_12413,23986,Combo - Precision Safety Razor & 10 Feather Blades,Warehouse B,42,28,2025-02-20 01:42:00,14
12413,ORD_12414,25176,"(Renewed) Dell Windows .Optiplex 3040 Tiny Desktop - Core I5 6Th Gen, 16 Gb Ram, 480Gb Ssd, - Win 11 Upgraded, Ms Office/ ...",Warehouse A,52,43,2025-02-20 08:01:00,9
12414,ORD_12415,33745,Ordiclav 625 Tablet,Warehouse A,43,32,2025-02-20 16:43:00,11
12415,ORD_12416,37114,"Tabelito Hybrid Polyester Foam, Nylon Laptop Bag Sleeve Case Cover Pouch for laptops (Black, 15.6 Inches/39.6Cm)",Warehouse A,24,8,2025-02-20 15:14:00,16
12416,ORD_12417,6881,Acne Face Wash For Oily & Acne Prone Skin -  With Magnolia Bark Power,Warehouse C,32,23,2025-02-20 13:49:00,9
12417,ORD_12418,26975,Noise Buds VS201 V2 in-Ear Truly Wireless Earbuds with Dual Equalizer | Total 14-Hour Playtime | Full Touch Control | with...,Warehouse A,100,83,2025-02-20 06:02:00,17
12418,ORD_12419,30865,Global Desi MythiB EDP & StarG Mist Pack of 2 250 ml,Warehouse A,60,46,2025-02-20 21:49:00,14
12419,ORD_12420,33437,Enflamo Soft Silicone Slim Back Cover Case for iPhone 6 & 6S (Blue),Warehouse B,97,85,2025-02-20 21:27:00,12
12420,ORD_12421,24393,Meb C 135mg/5mg Tablet,Warehouse B,16,9,2025-02-20 12:38:00,7
12421,ORD_12422,25212,Coxitryp-BRD Tablet,Warehouse A,17,10,2025-02-20 15:16:00,7
12422,ORD_12423,34830,Ajmal Tempest Concentrated Perfume Oil Floral Attar And Jannatul Firdaus Concentrated Perfume Oil Oriental Attar 22 ml,Warehouse B,93,80,2025-02-20 21:05:00,13
12423,ORD_12424,33511,Yavisc Injection,Warehouse C,56,48,2025-02-20 21:51:00,8
12424,ORD_12425,33429,Glimulin 2 Tablet,Warehouse A,66,60,2025-02-20 09:55:00,6
12425,ORD_12426,13445,Helinase 10mg Tablet,Warehouse B,46,27,2025-02-20 22:55:00,19
12426,ORD_12427,24411,Codilab DX Syrup,Warehouse A,71,66,2025-02-20 04:15:00,5
12427,ORD_12428,32866,"Ceptics India us Converter Plug, India to USA, Japan, Canada & More - Type B Universal Travel Adapter Plug - CE Certified...",Warehouse B,99,93,2025-02-20 21:02:00,6
12428,ORD_12429,33435,Stbotanica Holiday Body Wash - With Shea & Vitamin E 250 ml,Warehouse A,55,50,2025-02-20 18:56:00,5
12429,ORD_12430,1345,ONSITEGO 2 Year Extended Warranty for Audio Systems,Warehouse B,58,53,2025-02-20 15:03:00,5
12430,ORD_12431,24235,Oxeogaba 750mcg/75mg Capsule,Warehouse A,59,52,2025-02-20 16:38:00,7
12431,ORD_12432,24160,Ishderm-CN Cream,Warehouse B,73,54,2025-02-20 18:06:00,19
12432,ORD_12433,26510,Amazon Brand- Solimo Basic Case for Samsung Galaxy M04 4G (Thermoplastic Polyurethane_Clear),Warehouse B,57,47,2025-02-20 05:26:00,10
12433,ORD_12434,22542,VOLTAS AC REMOTE control ( please match your old remote ),Warehouse C,104,94,2025-02-20 09:50:00,10
12434,ORD_12435,8057,SMS 1000mg Injection,Warehouse B,30,23,2025-02-20 01:59:00,7
12435,ORD_12436,8071,Doltam 500mg Syrup,Warehouse C,107,94,2025-02-20 20:28:00,13
12436,ORD_12437,26744,"Plixio Plastic Desktop Mobile Phone Tabletop Stand, Mobile Holder Adjustable & Foldable Mobile Stand for Mobile Phone and ...",Warehouse B,37,27,2025-02-20 07:59:00,10
12437,ORD_12438,34228,Swich-XP 500 Injection,Warehouse C,19,4,2025-02-20 23:35:00,15
12438,ORD_12439,13933,Ajmal Blu Dreams EDP Citurs Fruity Perfume And Avid Homme Deodorant Aquatic Woody Fragrance 300 ml,Warehouse A,74,64,2025-02-20 22:12:00,10
12439,ORD_12440,129,Makeup Revolution Super Serum Foundation F10.5 25 ml,Warehouse A,95,77,2025-02-20 13:09:00,18
12440,ORD_12441,26008,Kosace-SP Tablet,Warehouse C,42,36,2025-02-20 12:25:00,6
12441,ORD_12442,22595,Telmiral 40 Tablet,Warehouse B,74,59,2025-02-20 06:45:00,15
12442,ORD_12443,8091,"Aam Pachak Churna - Quick Ayurvedic Relief In Digestive Disorders, Acidity & Gastric Formation",Warehouse A,29,17,2025-02-20 03:35:00,12
12443,ORD_12444,21361,I AM EYECONIC FINE GLITTER PINA CALODA 4 gm,Warehouse A,109,99,2025-02-20 11:30:00,10
12444,ORD_12445,2243,Teno 50mg Tablet,Warehouse A,76,68,2025-02-20 13:12:00,8
12445,ORD_12446,13946,AMDAC AT 5 MG/50 MG TABLET,Warehouse C,69,54,2025-02-20 20:34:00,15
12446,ORD_12447,21367,Man - On Fire Eau De Toilette,Warehouse B,71,55,2025-02-20 15:55:00,16
12447,ORD_12448,22535,Ajmal Aura Concentrated Perfume Oil Floral Fruity Attar And CD 99 Mukhallat Concentrated Perfume Oil Floral Oriental Attar 24 ml,Warehouse A,30,23,2025-02-20 01:08:00,7
12448,ORD_12449,34641,"Belkin 37W Dual Port Fast Car Charger, USB Type C 25W PPS Port and USB A 12W Port for Galaxy S22, S21, Plus, Ultra, 5G, Pl...",Warehouse C,83,71,2025-02-20 22:43:00,12
12449,ORD_12450,26044,Ashwagandha - For Strength & Vitality,Warehouse C,80,68,2025-02-20 01:12:00,12
12450,ORD_12451,25976,Spa Essence Enriching Cream Mask,Warehouse C,74,63,2025-02-20 09:03:00,11
12451,ORD_12452,8047,Cinndav D 15mg/20mg Tablet,Warehouse A,94,80,2025-02-20 10:43:00,14
12452,ORD_12453,22690,Atrotin 20mg Tablet,Warehouse A,106,89,2025-02-20 19:46:00,17
12453,ORD_12454,31553,"WOW IMAGINE for Samsung Galaxy F23 5G Ultra Slim Soft Rubberised Back Cover, Inner Velvet Fabric Lining, Matte Silicone Fl...",Warehouse B,25,19,2025-02-20 02:14:00,6
12454,ORD_12455,1710,Transset 500mg Injection,Warehouse B,66,56,2025-02-20 23:41:00,10
12455,ORD_12456,8840,Higrin 10mg Tablet,Warehouse B,44,29,2025-02-20 02:55:00,15
12456,ORD_12457,25877,Vaadi Herbals Foot Cream - Clove Oil & Sandalwood 30 gm,Warehouse A,27,20,2025-02-20 17:03:00,7
12457,ORD_12458,13087,"MACPLUS Eye Shadow Makeup Brushes- Black, Set 8 pc",Warehouse A,42,36,2025-02-20 16:32:00,6
12458,ORD_12459,22781,"SanDisk Ultra USB 3.0 256 GB Pen Drive (SDDD3-256G-I35, Black, Silver)",Warehouse B,24,13,2025-02-20 19:49:00,11
12459,ORD_12460,6212,Ayurveda Multani Mitti Face Pack,Warehouse C,104,87,2025-02-20 11:58:00,17
12460,ORD_12461,13080,"Lunar's Unisex 50L Water Resistant Office/Travel/Business Laptop Backpack, Bag for up to 17.3 inch Laptop/MacBook with rai...",Warehouse C,72,56,2025-02-20 02:16:00,16
12461,ORD_12462,7998,Tenespec M Forte 1000mg/20mg Tablet,Warehouse A,36,23,2025-02-20 06:56:00,13
12462,ORD_12463,13063,AND MystE EDP & DaintyG Mist Pack of 2 250 ml,Warehouse A,51,38,2025-02-20 05:44:00,13
12463,ORD_12464,3191,Osiris Tablet,Warehouse A,65,53,2025-02-20 23:57:00,12
12464,ORD_12465,26450,Rosugard 5mg Tablet,Warehouse A,65,48,2025-02-20 21:11:00,17
12465,ORD_12466,12957,NOTE ULTRA VOLUME MASCARA 6 ml,Warehouse C,76,62,2025-02-20 04:48:00,14
12466,ORD_12467,31042,Ecopraj 40mg Injection,Warehouse C,76,57,2025-02-20 08:34:00,19
12467,ORD_12468,36913,Lizacet-M Syrup,Warehouse C,25,16,2025-02-20 19:27:00,9
12468,ORD_12469,12954,Qubo Car Dash Camera Pro Dash Cam from Hero Group | Made in India Dashcam | Full HD 1080p | Wide Angle View | G-Sensor | W...,Warehouse A,55,44,2025-02-20 11:17:00,11
12469,ORD_12470,1521,OH! Pleasure Gel for Women,Warehouse A,42,34,2025-02-20 16:23:00,8
12470,ORD_12471,21719,Telgo-AM 80mg/5mg Tablet,Warehouse C,52,44,2025-02-20 01:50:00,8
12471,ORD_12472,8564,Prometil -MD Tablet,Warehouse B,37,20,2025-02-20 15:58:00,17
12472,ORD_12473,5907,Cutcold D 5mg/2mg/10mg Tablet,Warehouse C,24,15,2025-02-20 17:12:00,9
12473,ORD_12474,31065,Jovees Green Tea Toner 100 ml,Warehouse C,96,90,2025-02-20 02:42:00,6
12474,ORD_12475,1539,"Loofah/Sponge Scrubber/Body Bath - Dual Side, Hangable, Brown, BH-030 BR",Warehouse B,27,13,2025-02-20 15:51:00,14
12475,ORD_12476,21904,"COSLUXE UCANBE Nostalgic Eyeshadow Makeup Palette, 48 Color Rainbow Eyeshadow Highly Pigmented Matte Shimmer Metallic Eye ...",Warehouse C,20,13,2025-02-20 12:50:00,7
12476,ORD_12477,26411,Ethvom 4mg Tablet MD,Warehouse B,44,34,2025-02-20 15:24:00,10
12477,ORD_12478,5927,"Boltove® 6FTX9FT Green Backdrop Background Rod Pocket for Photography Backdrop,Photoshoot Background,Video Production, Hom...",Warehouse A,98,89,2025-02-20 17:01:00,9
12478,ORD_12479,8532,Trixonid 1gm Injection,Warehouse C,74,69,2025-02-20 09:47:00,5
12479,ORD_12480,14080,(Renewed) boAt Rockerz Bluetooth Wireless Over Ear Headphones with Mic (Raging Red),Warehouse B,28,15,2025-02-20 07:36:00,13
12480,ORD_12481,7946,"ClubComfort 5 Pair Eyelash, 1 Eyelash Glue, 1 Eyelash Curler, Gel eyeliner Black & Brown",Warehouse B,75,57,2025-02-20 20:38:00,18
12481,ORD_12482,34467,Anti-Pimple Natural Ayurvedic Turmeric Face Wash,Warehouse C,64,50,2025-02-20 07:03:00,14
12482,ORD_12483,21632,Doloroff Asp 100 mg/500 mg/15 mg Tablet,Warehouse A,39,26,2025-02-20 10:30:00,13
12483,ORD_12484,3438,Blisulide 100mg Tablet,Warehouse A,62,56,2025-02-20 10:13:00,6
12484,ORD_12485,5909,REVLON Colorstay Overtime Glossy Finish Lip Color (Always Sienna),Warehouse B,44,39,2025-02-20 07:00:00,5
12485,ORD_12486,31597,Kinedol-EF Effervescent Tablet,Warehouse B,26,16,2025-02-20 12:24:00,10
12486,ORD_12487,34530,Glimmer Nail Polish Tree Brwon 5 ml,Warehouse C,102,86,2025-02-20 14:19:00,16
12487,ORD_12488,26464,ENVIE® (ECR11+AA2800 4PL) Speedster Rechargeable Batteries Charger for AA & AAA with 4x2800mah Batteries (with LCD Displa...,Warehouse B,58,44,2025-02-20 09:27:00,14
12488,ORD_12489,8550,Vitamin C SPF 75 Dry Touch Sunscreen UVA/UVB PA+++,Warehouse C,103,85,2025-02-20 11:43:00,18
12489,ORD_12490,26572,Voglider M 500mg/0.3mg Tablet,Warehouse A,18,3,2025-02-20 09:03:00,15
12490,ORD_12491,5854,Mi Power Bank Boost Pro 30000mAh 18W,Warehouse B,64,49,2025-02-20 23:05:00,15
12491,ORD_12492,34527,"SIDRUM DSLR/SLR Camera Shoulder Bag Case with Adjustable Shoulder Strap & Rain Cover, Compatible for Nikon, Canon, Sony Mi...",Warehouse A,23,18,2025-02-20 20:03:00,5
12492,ORD_12493,21806,Gaba OD 300mg Tablet,Warehouse A,42,34,2025-02-20 16:19:00,8
12493,ORD_12494,26237,Combinam 400 mg/325 mg Tablet,Warehouse C,79,67,2025-02-20 23:06:00,12
12494,ORD_12495,21505,Glorimet VG2 Tablet SR,Warehouse A,65,48,2025-02-20 09:07:00,17
12495,ORD_12496,22703,Licexim 250mg Tablet,Warehouse C,46,28,2025-02-20 20:38:00,18
12496,ORD_12497,32937,"Dabur Gulabari Premium Rose Water with No Paraben for Cleansing and Toning, 250ml",Warehouse B,53,35,2025-02-20 03:46:00,18
12497,ORD_12498,34319,Garnier Men Shampoo Color Shade 3 Brown Black 20 gm,Warehouse A,75,61,2025-02-20 06:32:00,14
12498,ORD_12499,8162,Insoles - Shock Absorbing,Warehouse C,51,39,2025-02-20 04:40:00,12
12499,ORD_12500,26078,Spigen Glass.tR Platinum Liquid UV Tempered Glass Screen Protector Guard for Galaxy S23 Ultra - 1 Pack,Warehouse A,49,36,2025-02-20 07:42:00,13
12500,ORD_12501,13957,Real Nature Potato Face Mask,Warehouse B,14,1,2025-02-20 10:03:00,13
12501,ORD_12502,14198,Dibicar-NT Tablet,Warehouse B,83,74,2025-02-20 20:05:00,9
12502,ORD_12503,21409,"Fashion Colour Kiss Lip No Transfer Lipstick, 15 Deep Plum 2.6 gm",Warehouse C,21,16,2025-02-20 15:13:00,5
12503,ORD_12504,8758,"70mai M300 DashCam, 1.5K 1296P Full HD+, 3D-DNR, WDR, G-Sensor, Wi-Fi, App Playback & Share, Optional Parking Monitoring (...",Warehouse A,31,24,2025-02-20 02:42:00,7
12504,ORD_12505,31126,Paco Rabanne Invictus Victory Eau De Parfum for Men 50ml,Warehouse A,22,10,2025-02-20 00:44:00,12
12505,ORD_12506,8737,Fashionury Back Cover Case for Samsung Galaxy M51 (Shockproof | Hybrid TPU & PC | Transparent | Black Bumper),Warehouse A,75,66,2025-02-20 10:18:00,9
12506,ORD_12507,36966,Nopark 5mg Tablet,Warehouse C,101,93,2025-02-20 13:48:00,8
12507,ORD_12508,26698,Shake & Spray Serum,Warehouse A,77,58,2025-02-20 11:49:00,19
12508,ORD_12509,34597,Vega Fan Brush (MBP - 13) 28 gm,Warehouse A,101,96,2025-02-20 21:30:00,5
12509,ORD_12510,36961,Xibactin Dry Syrup,Warehouse C,43,38,2025-02-20 09:32:00,5
12510,ORD_12511,92,Glicisa-M 2 Forte Tablet PR,Warehouse C,23,15,2025-02-20 22:02:00,8
12511,ORD_12512,13981,Himalaya Purifying Neem Scrub 50 gm,Warehouse A,53,45,2025-02-20 09:22:00,8
12512,ORD_12513,13901,"HP 150 Wired Mouse- Elegant Ergonomic Design, 1600 DPI Optical Tracking, USB Plug & Play / 3 Years Warranty (240J6AA), Black",Warehouse B,30,14,2025-02-20 02:13:00,16
12513,ORD_12514,13249,"Xiaomi Wired in-Ear Earphones with Mic, Ultra Deep Bass & Metal Sound Chamber (Red)",Warehouse A,51,43,2025-02-20 04:51:00,8
12514,ORD_12515,31229,Xtend 250 mg/125 mg Tablet,Warehouse C,59,44,2025-02-20 06:11:00,15
12515,ORD_12516,1913,Allure Classic Ack-05 (Pack Of 5) Makeup Brush 1's,Warehouse A,71,64,2025-02-20 04:01:00,7
12516,ORD_12517,7013,Beauty People Pure Matte Lipstick - Unique - Purity - 507 3.8 gm,Warehouse A,50,38,2025-02-20 12:27:00,12
12517,ORD_12518,33642,"Fashion Colour Pro Hd Eyeshadow Palette 15 Shades, Shade 02 18 gm",Warehouse C,74,68,2025-02-20 00:09:00,6
12518,ORD_12519,24563,Rosclox 250mg/250mg Capsule,Warehouse A,101,95,2025-02-20 10:54:00,6
12519,ORD_12520,6678,RD Capsule,Warehouse C,107,91,2025-02-20 23:40:00,16
12520,ORD_12521,13282,Underarm Roll On Deodorant For Women - Shower Fresh,Warehouse C,90,84,2025-02-20 07:01:00,6
12521,ORD_12522,24441,Levocin 5mg Tablet,Warehouse A,58,53,2025-02-20 04:23:00,5
12522,ORD_12523,13470,PROSTEEZ,Warehouse C,80,65,2025-02-20 13:00:00,15
12523,ORD_12524,25122,Ananda GB 400mg/10mg Tablet,Warehouse A,14,3,2025-02-20 08:48:00,11
12524,ORD_12525,20807,"Selfie Stick with Fill Light, All in One Portable Selfie Stick Tripod Phone Holder with Detachable Wireless Remote, Compat...",Warehouse B,85,76,2025-02-20 21:31:00,9
12525,ORD_12526,7244,Nakupan D 10mg/40mg Tablet,Warehouse B,45,32,2025-02-20 04:20:00,13
12526,ORD_12527,22480,I AM EYECONIC 3D GLITTER CHAMELEON COPPER 4 gm,Warehouse C,38,31,2025-02-20 19:07:00,7
12527,ORD_12528,8153,Arata Natural Body Care Set For Women & Men With Body Lotion & Body Wash 600 ml,Warehouse B,92,86,2025-02-20 13:14:00,6
12528,ORD_12529,22495,Clopichis 75mg Tablet,Warehouse B,45,35,2025-02-20 16:43:00,10
12529,ORD_12530,86,"Samsung Galaxy Tab A7 Lite 8.7 inches with Calling, Slim Metal Body, Dolby Atmos Sound, RAM 3 GB, ROM 32 GB Expandable, W...",Warehouse B,70,65,2025-02-20 23:19:00,5
12530,ORD_12531,34648,Moncel LC Syrup,Warehouse C,64,46,2025-02-20 16:23:00,18
12531,ORD_12532,22715,"Doodle - Initial N Lasercut Soft Bound Diary (6.69 X 4.72 X 0.5-inches, 80 GSM, 192 Pages) Notebook for Girls",Warehouse C,61,47,2025-02-20 12:59:00,14
12532,ORD_12533,3464,Insight Cosmetics Mousse Foundation - Creamy Beige 30 gm,Warehouse A,107,94,2025-02-20 02:04:00,13
12533,ORD_12534,8816,Lanopin 2.5mg Tablet MD,Warehouse C,92,75,2025-02-20 11:34:00,17
12534,ORD_12535,26048,"Godrej Security Solutions WiFi 1080p FHD 2MP 360° Viewing Area Security Camera, White",Warehouse B,8,2,2025-02-20 21:25:00,6
12535,ORD_12536,21384,"HP GK320 Wired Full Size RGB Backlight Mechanical Gaming Keyboard, 4 LED Indicators, Mechanical Switches, Double Injection...",Warehouse A,42,31,2025-02-20 10:57:00,11
12536,ORD_12537,21461,Bonjour Paris Metallic Eye Pencil cum Eye Shadow - Waterproof Cool Purple 1.8 gm,Warehouse C,68,58,2025-02-20 20:00:00,10
12537,ORD_12538,22334,Eyeshadow Shields Under Eye Patches Disposable Eyelash Extensions Pads and Eye Tips Sticker Make Up Tools (20 Pcs),Warehouse A,42,25,2025-02-20 16:19:00,17
12538,ORD_12539,21471,Temper 325mg/37.5mg Tablet,Warehouse B,92,82,2025-02-20 11:52:00,10
12539,ORD_12540,21472,"STRIFF Spiral Cable Protector Cord Saver for Mac Charger, iPhone Charger, Wire Protector, Lightweight Durable Flexible Wir...",Warehouse A,24,9,2025-02-20 12:34:00,15
12540,ORD_12541,22302,"Long lasting, Non Transfer Matte Liquid Lipstick For Upto 12 Hour",Warehouse B,21,8,2025-02-20 07:09:00,13
12541,ORD_12542,6061,Uastin 20mg Tablet,Warehouse A,36,29,2025-02-20 14:31:00,7
12542,ORD_12543,8712,Deodorant Body Spray - Original,Warehouse A,63,45,2025-02-20 05:01:00,18
12543,ORD_12544,13987,Mepril MF 1mg/500mg Tablet,Warehouse A,93,81,2025-02-20 19:14:00,12
12544,ORD_12545,22263,Rabstep-DSR Capsule,Warehouse B,46,28,2025-02-20 04:24:00,18
12545,ORD_12546,26203,"Eau De Parfum - Hydra Energy, For Men",Warehouse C,95,78,2025-02-20 10:17:00,17
12546,ORD_12547,22246,AmazonBasics 3.5mm to 2-Male RCA Adapter cable - 4 feet,Warehouse A,49,36,2025-02-20 04:59:00,13
12547,ORD_12548,26664,Vitamin C Face Serum - Skin Brightening & Anti Ageing,Warehouse C,27,16,2025-02-20 11:43:00,11
12548,ORD_12549,31099,"Belkin Quick Charge Magnetic Wireless Lithium_ion Power Bank 2500mAh, Sleek Design for All iPhone 14, Iphone13, iPhone 12 ...",Warehouse C,44,38,2025-02-20 21:25:00,6
12549,ORD_12550,21493,Ultra New Series Ultra Smart Watch Ultra Smartwatch Men Women Bluetooth Call Waterproof Wireless Charging HD Screen (Black),Warehouse A,42,27,2025-02-20 14:45:00,15
12550,ORD_12551,6032,Deep Cleansing Charcoal Bath Soap,Warehouse A,75,64,2025-02-20 01:29:00,11
12551,ORD_12552,8308,Wellnerve 2500mcg Injection,Warehouse A,9,3,2025-02-20 11:56:00,6
12552,ORD_12553,8229,Energizer Max Alkaline AAA Batteries - Pack of 6,Warehouse C,95,87,2025-02-20 03:36:00,8
12553,ORD_12554,22351,Betty Barclay Tender Blossom Shower Cream 150 ml,Warehouse C,65,50,2025-02-20 22:08:00,15
12554,ORD_12555,10140,Stridimmune 50mg Capsule,Warehouse C,31,18,2025-02-20 22:02:00,13
12555,ORD_12556,28759,Ajmal 1 Silver Shade And 3 Magnetize Deodorants Pack of 4 200 ml,Warehouse B,81,75,2025-02-20 17:53:00,6
12556,ORD_12557,28524,Celor Plus 0.5 mg/10 mg Tablet,Warehouse C,42,30,2025-02-20 09:37:00,12
12557,ORD_12558,15762,Facer Sera Tablet,Warehouse C,16,9,2025-02-20 21:43:00,7
12558,ORD_12559,11333,"MEENA ELEMENTS Khaki Powder 200 gm X 2 for skin Brightening, Instant Glow, Skin Tone, Long Lasting Fragrance, Oil Control ...",Warehouse C,114,96,2025-02-20 00:48:00,18
12559,ORD_12560,15761,Nokia 150 (2020) (Red),Warehouse B,13,3,2025-02-20 04:41:00,10
12560,ORD_12561,36439,Cello Marky Permanent Marker- Pack of 8 | Permanent Marker Pens | Set of 8 Ink Colors Marker Pen | Stationery Markers markers,Warehouse B,84,69,2025-02-20 18:56:00,15
12561,ORD_12562,29565,Transcend TS-RDF5K USB 3.1 Gen 1 Card Reader (Black),Warehouse C,50,40,2025-02-20 20:25:00,10
12562,ORD_12563,4779,Fixital-O Tablet,Warehouse B,66,56,2025-02-20 19:38:00,10
12563,ORD_12564,18509,"Maybelline New York Lip Studio Lip Color Palette, Matte Finish, 0.14 Ounce - Multicolor",Warehouse C,100,85,2025-02-20 10:15:00,15
12564,ORD_12565,12290,Allure Eyeliner Brush (ASB310) 1's,Warehouse A,94,87,2025-02-20 09:20:00,7
12565,ORD_12566,11227,Ginger Pure Essential Oil,Warehouse C,81,74,2025-02-20 17:28:00,7
12566,ORD_12567,2850,Met PG 2mg/500mg/15mg Tablet SR,Warehouse B,59,54,2025-02-20 13:11:00,5
12567,ORD_12568,959,Oftas-OZ Tablet,Warehouse C,68,50,2025-02-20 13:11:00,18
12568,ORD_12569,10377,Maryaj Dynamic EDP Spicy Woody Perfume And Ajmal Sacrifice II For Him Deodorant Fruity Aromatic Fragrance 300 ml,Warehouse B,62,52,2025-02-20 14:59:00,10
12569,ORD_12570,2936,Walkalarm 150mg Tablet,Warehouse A,111,92,2025-02-20 12:13:00,19
12570,ORD_12571,32408,Elecsera Stainless Steel Makeup Mixing Plate Foundation Eyeshadow Eye Shadow Palette,Warehouse A,100,85,2025-02-20 14:18:00,15
12571,ORD_12572,34979,"Philips Audio IN-MMS6080B/94 2.1 Channel 60W Multimedia Bluetooth Speakers with 2x17W Satellite Speakers, LED Display, Rem...",Warehouse B,82,65,2025-02-20 20:35:00,17
12572,ORD_12573,1237,Formin Forte 2mg/500mg Tablet ER,Warehouse B,72,57,2025-02-20 02:06:00,15
12573,ORD_12574,14941,Duokast-M Tablet,Warehouse C,27,21,2025-02-20 14:04:00,6
12574,ORD_12575,10376,"iQOO Z6 Lite 5G by vivo (Mystic Night, 4GB RAM, 64GB Storage) | World's First Snapdragon 4 Gen 1 | 120Hz Refresh Rate | 50...",Warehouse A,101,84,2025-02-20 18:46:00,17
12575,ORD_12576,5468,"DIZO Buds P with Fast Charge, 40HPlaytime & 13mm Driver (by realme TechLife) Bluetooth Headset  (Dynamo Black, True Wireless)",Warehouse A,38,28,2025-02-20 14:58:00,10
12576,ORD_12577,36634,Body Massage Oil For Stress Relief,Warehouse A,101,95,2025-02-20 01:38:00,6
12577,ORD_12578,15825,Flormar OMLashes High Definition Mascara 12 ml,Warehouse B,22,13,2025-02-20 15:12:00,9
12578,ORD_12579,15028,Sadhev Rose Water Toner 150 ml,Warehouse B,63,53,2025-02-20 17:44:00,10
12579,ORD_12580,28616,"TAGG Kronos II Smartwatch with 1.32"" Large Crystal HD Display, 360° Health Suite, Activity Tracker, 24 Sports Modes, Live ...",Warehouse B,40,32,2025-02-20 18:15:00,8
12580,ORD_12581,2678,"realme Buds Air 3S True Wireless in Ear Earbuds, 11mm Triple Titanium Driver, Quad Mic AI ENC for Calls, Dual Device Pairi...",Warehouse B,64,52,2025-02-20 05:12:00,12
12581,ORD_12582,27201,Diarlop 2mg Capsule,Warehouse A,93,74,2025-02-20 14:23:00,19
12582,ORD_12583,35505,Coflet Syrup,Warehouse B,102,88,2025-02-20 09:52:00,14
12583,ORD_12584,17992,Flormar Full Color Nail Enamel FC43 Chunky Cocoa 8 ml,Warehouse C,99,92,2025-02-20 10:36:00,7
12584,ORD_12585,35504,boAt Immortal IM-200 7.1 Channel Wired Over Ear USB Gaming Headphone with RGB Breathing LEDs & 50mm Drivers with mic (Furi...,Warehouse A,91,83,2025-02-20 12:38:00,8
12585,ORD_12586,29435,Histano-D Tablet,Warehouse B,103,87,2025-02-20 04:45:00,16
12586,ORD_12587,20480,Cefaur 100mg Tablet,Warehouse C,36,25,2025-02-20 02:06:00,11
12587,ORD_12588,20498,Ajmal Raindropss & Blu & Aurum & Wisal Deo & Yearn EDP Pack of 5 20 ml,Warehouse B,45,33,2025-02-20 10:20:00,12
12588,ORD_12589,9725,Peppa Pig Flashhh Kids Toothbrush With Rinsing Cup - Blue,Warehouse C,68,60,2025-02-20 15:31:00,8
12589,ORD_12590,15757,Osia Osia Turmeric & Sandalwood Ubtan Body Polisher 125 gm,Warehouse B,56,46,2025-02-20 10:43:00,10
12590,ORD_12591,12207,Shambose 0.3mg Tablet,Warehouse C,38,22,2025-02-20 08:42:00,16
12591,ORD_12592,4773,Zimcin 250 Tablet,Warehouse C,83,70,2025-02-20 02:09:00,13
12592,ORD_12593,14990,Ajmal 2 Distraction & 2 Magnetize Deo & Yearn EDP Pack of 3 20 ml,Warehouse B,60,55,2025-02-20 21:59:00,5
12593,ORD_12594,4839,Cefiget 50mg Dry Syrup,Warehouse C,18,12,2025-02-20 20:49:00,6
12594,ORD_12595,10447,Robustrion Smart Trifold Hard Back Flip Stand Case Cover for Lenovo Tab M10 HD 2nd Gen TB-X306X / Smart Tab M10 HD 2nd Gen...,Warehouse C,23,17,2025-02-20 01:34:00,6
12595,ORD_12596,35669,Akpod 100mg Tablet DT,Warehouse B,97,90,2025-02-20 06:38:00,7
12596,ORD_12597,4361,"Samsung Galaxy A14 5G (Light Green, 8GB, 128GB Storage) | Triple Rear Camera (50 MP Main) | Upto 16 GB RAM with RAM Plus |...",Warehouse A,53,39,2025-02-20 02:07:00,14
12597,ORD_12598,682,Syproliv Syrup,Warehouse B,54,47,2025-02-20 18:24:00,7
12598,ORD_12599,10556,Delpizin M 5mg/500mg Tablet SR,Warehouse B,59,48,2025-02-20 23:56:00,11
12599,ORD_12600,4841,Karpooradi Shower Cream,Warehouse C,100,81,2025-02-20 23:18:00,19
12600,ORD_12601,28543,"AFRITEE Desk Pad Desk Protector Mat - Dual Side PU Leather Desk Mat Large Mouse Pad, Writing Mat Waterproof Desk Cover Org...",Warehouse C,68,55,2025-02-20 02:22:00,13
12601,ORD_12602,11268,Telmivas 80mg Tablet,Warehouse C,56,50,2025-02-20 03:28:00,6
12602,ORD_12603,14934,Sandon 4 DT Tablet,Warehouse C,92,80,2025-02-20 14:04:00,12
12603,ORD_12604,32072,"FACTOR NOTES Notebook: 90 GSM, B6, Ruled, 112 Pages Journal Diary (Idea)",Warehouse B,104,87,2025-02-20 00:17:00,17
12604,ORD_12605,18499,Amazon Brand - Solimo Pouch for Mi Redmi Note 10 Pro Max (Silicone_Clear),Warehouse B,60,49,2025-02-20 00:05:00,11
12605,ORD_12606,16966,"USB C Hub Multiport Adapter, Dockteck 7-in-1 USB C Hub Metal Shell with 4K 60Hz HDMI, 1Gbps RJ45 Ethernet, 100W Power Deli...",Warehouse A,21,7,2025-02-20 09:10:00,14
12606,ORD_12607,28557,Emonac P Oral Suspension,Warehouse C,23,6,2025-02-20 00:06:00,17
12607,ORD_12608,5454,ROSUCORT Tablet,Warehouse B,38,33,2025-02-20 08:37:00,5
12608,ORD_12609,35949,Levoriz-MK 5mg/10mg Tablet,Warehouse B,61,53,2025-02-20 10:17:00,8
12609,ORD_12610,4403,Servil LS Syrup,Warehouse B,47,30,2025-02-20 00:25:00,17
12610,ORD_12611,17235,Fucross 100 Capsule,Warehouse C,67,49,2025-02-20 23:01:00,18
12611,ORD_12612,14425,INSIGHT Concealer Foundation - 20 ML (Cream Natural),Warehouse A,16,4,2025-02-20 21:43:00,12
12612,ORD_12613,11274,Flutas 150 Tablet,Warehouse C,66,58,2025-02-20 11:12:00,8
12613,ORD_12614,15447,"L'Oréal Paris Anti-Hair Fall Shampoo, Reinforcing & Nourishing for Hair Growth, For Thinning & Hair Loss, With Arginine Es...",Warehouse B,107,98,2025-02-20 13:49:00,9
12614,ORD_12615,15748,Arogyam ChyawanAmrut Awaleha - Goodness of Chyawanprash & Ayush Kwath,Warehouse C,85,67,2025-02-20 20:58:00,18
12615,ORD_12616,10561,Biosoft Aloevera Paraffin Wax 500 S gm,Warehouse C,51,44,2025-02-20 07:43:00,7
12616,ORD_12617,32315,Mainstay 25mg Tablet,Warehouse A,73,54,2025-02-20 23:07:00,19
12617,ORD_12618,35200,Summer Comb,Warehouse A,47,36,2025-02-20 14:59:00,11
12618,ORD_12619,16320,Flormar Waterproof Lipliner 231 Berry Stain 1.14 gm,Warehouse A,84,77,2025-02-20 21:28:00,7
12619,ORD_12620,32658,LAPSTER Accessories Power Cable Cord 2 Pin Laptop Adapter and Tape Recorder 1.5M,Warehouse A,64,53,2025-02-20 01:16:00,11
12620,ORD_12621,16124,MANISH CONSTRUCTION Color Match BB Foundation SPF15 I Dual Purpose of Foundation & Sunscreen Blemish-free Glow | Non-cakey...,Warehouse A,22,15,2025-02-20 08:26:00,7
12621,ORD_12622,16840,"Oppo Reno8 5G (Shimmer Gold, 128 GB) (8 GB RAM)",Warehouse A,12,4,2025-02-20 11:57:00,8
12622,ORD_12623,4528,Ajmal Blu EDP 90ML Long Lasting Scent Spray Citrus Perfume Gift For Men - Made In Dubai,Warehouse B,22,11,2025-02-20 04:19:00,11
12623,ORD_12624,19118,Moxynek-CV 375 Tablet,Warehouse A,93,76,2025-02-20 18:57:00,17
12624,ORD_12625,28071,The Natural Wash Skinfix Ayurvedic D-Tan & D-Pigmentation Pack For Face & Body 120 Gm,Warehouse B,96,91,2025-02-20 11:49:00,5
12625,ORD_12626,36104,Gatimore OZ Dry Syrup,Warehouse A,44,27,2025-02-20 10:03:00,17
12626,ORD_12627,36458,Hubazon-S Injection,Warehouse A,89,76,2025-02-20 04:19:00,13
12627,ORD_12628,28110,"Parker Vector Standard Chrome Trim Ball Pen, Red Body, 1 Count (Pack of 1) (9000017253)",Warehouse C,29,17,2025-02-20 00:21:00,12
12628,ORD_12629,12571,Favros 5mg Tablet,Warehouse C,95,87,2025-02-20 06:19:00,8
12629,ORD_12630,16065,Nsul Kid 50mg Tablet,Warehouse A,32,25,2025-02-20 17:37:00,7
12630,ORD_12631,10772,Unipride 10mg Tablet,Warehouse A,26,11,2025-02-20 14:53:00,15
12631,ORD_12632,19010,Nervegab 1500mcg/75mg Tablet,Warehouse B,85,66,2025-02-20 10:36:00,19
12632,ORD_12633,19690,Olabol 200mg Tablet,Warehouse A,56,51,2025-02-20 18:46:00,5
12633,ORD_12634,32537,Papaya Leaves Powder - Helpful As An Immunity Booster & Supports Blood Platelets Health,Warehouse B,40,30,2025-02-20 20:07:00,10
12634,ORD_12635,16287,Anti-Dandruff Shampoo - Smooth & Silky,Warehouse B,102,88,2025-02-20 23:22:00,14
12635,ORD_12636,27687,Cofnar Syrup,Warehouse C,14,1,2025-02-20 22:20:00,13
12636,ORD_12637,18993,I AM EYECONIC FINE GLITTER ITS LIT 4 gm,Warehouse B,81,72,2025-02-20 15:08:00,9
12637,ORD_12638,11399,LOVERIGHT Prep + Prime BB Beauty Balm Cream SPF 35 (40 ML) All Skin Type For Women & Girls.,Warehouse B,107,98,2025-02-20 13:50:00,9
12638,ORD_12639,27719,"Fashion Colour Non - Transfer Matt Waterproof Lipstick, 2 Orange 2.6 gm",Warehouse A,56,40,2025-02-20 13:16:00,16
12639,ORD_12640,15211,Bathing Soap - Glycerine,Warehouse C,60,54,2025-02-20 20:20:00,6
12640,ORD_12641,12564,Aloe Veda Distil Extra Virgin Olive Oil 200 ml,Warehouse B,87,82,2025-02-20 05:03:00,5
12641,ORD_12642,16064,Vega Sponge Relaxer (BA - 3/1) 37 gm,Warehouse B,22,5,2025-02-20 20:05:00,17
12642,ORD_12643,27682,Telmach 40mg Tablet,Warehouse C,92,84,2025-02-20 21:21:00,8
12643,ORD_12644,29421,Xspore-L Cream,Warehouse A,71,54,2025-02-20 21:25:00,17
12644,ORD_12645,19706,Conbre MultipleXR2 Pro {Upgraded} HD Smart WiFi Wireless IP CCTV Security Camera | Night Vision | 2-Way Audio | Support 64...,Warehouse B,25,6,2025-02-20 02:17:00,19
12645,ORD_12646,35174,"Wireless Portable Power Bank 5000mAh Wireless Charging Battery Pack Compatible with iPhone 8, 8+, X, XS, XSMAX, 11,11PRO, ...",Warehouse B,41,34,2025-02-20 08:55:00,7
12646,ORD_12647,9684,Orasafe Dental Gel,Warehouse B,48,37,2025-02-20 19:03:00,11
12647,ORD_12648,10107,Onida 80 cm (32 inches) HD Ready Smart LED Fire TV 32HIF3 (Black),Warehouse C,90,78,2025-02-20 21:05:00,12
12648,ORD_12649,31878,"Nokia 5710 XpressAudio keypad Phone, with inbuilt Wireless Earbuds, MP3 Player, Wireless FM Radio, Dedicated Music Button...",Warehouse B,80,71,2025-02-20 17:04:00,9
12649,ORD_12650,9736,Bestmont-DM Tablet,Warehouse B,114,95,2025-02-20 07:26:00,19
12650,ORD_12651,35356,"Wayona Usb Nylon Braided Data Sync And Charging Cable For Iphone, Ipad Tablet (Red, Black)",Warehouse C,47,36,2025-02-20 19:05:00,11
12651,ORD_12652,4281,House of Aroma Amber Rose Fragrance Oil 10 ml,Warehouse B,22,12,2025-02-20 09:17:00,10
12652,ORD_12653,29719,Levotec 500mg Tablet,Warehouse B,85,74,2025-02-20 20:32:00,11
12653,ORD_12654,32645,"Meilin (Hong Kong) Non Transfer Lipstick, Matte Finish, 4g - In Gold Bordeaux",Warehouse C,64,49,2025-02-20 21:21:00,15
12654,ORD_12655,16756,Olsa 10mg Tablet,Warehouse A,46,39,2025-02-20 03:09:00,7
12655,ORD_12656,5009,Hajmola Maha Candy - Aam+Imli,Warehouse C,43,33,2025-02-20 04:33:00,10
12656,ORD_12657,27734,Jannatul Firdaus Concentrated Oriental Perfume Free From Alcohol For Unisex,Warehouse A,61,43,2025-02-20 04:27:00,18
12657,ORD_12658,28999,Astigo Compatible Remote for Airtel Digital Set Top Box (Pairing Required with TV Remote),Warehouse A,67,50,2025-02-20 21:10:00,17
12658,ORD_12659,19109,Lezlox 750mg Tablet,Warehouse C,76,70,2025-02-20 13:48:00,6
12659,ORD_12660,5224,ZapcaseThermoplastic Polyurethane Back Case Cover for iPhone 12 | Compatible for iPhone 12 Back Case Cover | Scratch-Resis...,Warehouse B,53,47,2025-02-20 04:06:00,6
12660,ORD_12661,5225,Sandal Cleansing Milk,Warehouse B,66,48,2025-02-20 05:52:00,18
12661,ORD_12662,19068,"boAt Rockerz 550 Bluetooth Wireless Over Ear Headphones with Mic Upto 20 Hours Playback, 50MM Drivers, Soft Padded Ear Cus...",Warehouse A,9,1,2025-02-20 19:06:00,8
12662,ORD_12663,6866,Omron AC Adapter for Omron Blood Pressure Monitors - 240 Volts,Warehouse A,20,5,2025-02-20 22:59:00,15
12663,ORD_12664,16304,Tranil Plus Tablet,Warehouse C,79,60,2025-02-20 02:18:00,19
12664,ORD_12665,15420,"Makeup Mania Metallic Shine Glitter Eyeliner, Light Purple & Grey - Shade 16-18",Warehouse A,23,6,2025-02-20 13:40:00,17
12665,ORD_12666,15529,SYGA Headphone Replacement Ear Cushion Pads Compatible with Bose Quiet Comfort QC15 QC25 QC35 AE2 AE2i AE2 AE2-W (Black),Warehouse C,62,52,2025-02-20 12:45:00,10
12666,ORD_12667,29714,DeBelle Gel Nail Lacquer Ophelia Lavender With Holo Glitter Nail Polish 8 ml,Warehouse B,95,77,2025-02-20 02:02:00,18
12667,ORD_12668,35352,HP USB 3.1 Flash Drive 128GB 796L,Warehouse C,60,51,2025-02-20 08:26:00,9
12668,ORD_12669,29720,Revlon Nail Enamel - Choco Celebration 8 Ml,Warehouse B,46,40,2025-02-20 16:42:00,6
12669,ORD_12670,4137,Tattoo Foot Pedal Durable Plastic 9 x 6 x 1.3 for Tattoo Machine,Warehouse B,76,63,2025-02-20 05:31:00,13
12670,ORD_12671,12117,Techflox 200mg Tablet,Warehouse C,106,96,2025-02-20 14:44:00,10
12671,ORD_12672,19135,"Sery Colorflirt Nail Paint Sea Bed, Light Grey 10 ml",Warehouse C,52,39,2025-02-20 14:48:00,13
12672,ORD_12673,15140,Amazon Brand - Solimo Back Cover for Oneplus 7T (Silicone_Transparent),Warehouse B,111,99,2025-02-20 05:39:00,12
12673,ORD_12674,19581,Glycozide 40mg Tablet,Warehouse B,68,58,2025-02-20 10:59:00,10
12674,ORD_12675,19585,Bathing Soap - Storm,Warehouse C,35,18,2025-02-20 19:03:00,17
12675,ORD_12676,15139,"Action Pro 9H Nano Tempered Glass Screen Protector Compatible with KTM Duke 390 2017+, 390 Adventure 2020, Transparent",Warehouse A,95,79,2025-02-20 12:25:00,16
12676,ORD_12677,9742,Nervijen-P Capsule,Warehouse A,100,83,2025-02-20 22:35:00,17
12677,ORD_12678,30713,Unifixime 200mg Tablet,Warehouse A,83,66,2025-02-20 09:18:00,17
12678,ORD_12679,29814,Cetphar-M Kid Tablet,Warehouse A,81,67,2025-02-20 16:26:00,14
12679,ORD_12680,16129,TP-Link Tapo 3MP 1296p High Definition Outdoor CCTV Security Wi-Fi Smart Camera | Alexa Enabled | Weatherproof | Night Vis...,Warehouse A,48,30,2025-02-20 02:40:00,18
12680,ORD_12681,16127,Hair Wax - Styling With Strong Hold & Gloss Finish,Warehouse A,55,47,2025-02-20 21:52:00,8
12681,ORD_12682,32365,Cefzone 1gm Injection,Warehouse C,37,27,2025-02-20 08:40:00,10
12682,ORD_12683,16618,Arbutin Anti Pigmentation Face Mask Sheet,Warehouse B,15,7,2025-02-20 15:37:00,8
12683,ORD_12684,12488,"ZEBRONICS Sound Feast 50, 14 W Portable Speaker Supporting Bluetooth, Pendrive Slot, mSD Card, FM, Call Function (Black)",Warehouse A,84,77,2025-02-20 08:47:00,7
12684,ORD_12685,36482,Faces Canada Hi Shine Nail Enamel Pistachio Almond 218 9 Ml,Warehouse C,10,1,2025-02-20 09:22:00,9
12685,ORD_12686,9430,Portronics Power Plate 5 1500W Power Converter with USB Charger & Mobile Holder 3AC Socket + 3USB Ports I 1.5 m Cord Lengt...,Warehouse C,80,72,2025-02-20 14:13:00,8
12686,ORD_12687,2930,"Amazon Basics Wired Gaming Keyboard and Mouse Set| Multicolor RGB LED Backlight Effects, Multimedia Keys, Durable Aluminum...",Warehouse A,31,20,2025-02-20 07:28:00,11
12687,ORD_12688,9402,Contemporary Eau De Toilette,Warehouse A,16,3,2025-02-20 04:27:00,13
12688,ORD_12689,713,Physicians Formula Sexy Booster Cat Eye Collection Mascara - Ultra Black 7.9 gm,Warehouse A,12,4,2025-02-20 00:04:00,8
12689,ORD_12690,9218,"TP-Link UE300C USB Type-C to RJ45 Gigabit Ethernet Network Adapter/RJ45 LAN Wired Adapter for Ultrabook, Chromebook, Lapto...",Warehouse B,86,74,2025-02-20 16:32:00,12
12690,ORD_12691,11632,Bala Thailam,Warehouse A,72,63,2025-02-20 05:15:00,9
12691,ORD_12692,2465,Thioser D 2mg/37.5mg Injection,Warehouse B,32,15,2025-02-20 04:59:00,17
12692,ORD_12693,5444,mCaffeine Oil-Free Coffee Moisturizer with Hyaluronic Acid & Pro Vitamin B5 50 ml,Warehouse C,29,15,2025-02-20 15:15:00,14
12693,ORD_12694,17058,Pierre Cardin Paris - Magnetic Dream Lipstick 253-Spice Rose,Warehouse B,65,59,2025-02-20 06:13:00,6
12694,ORD_12695,14412,Serviflox 250mg Tablet,Warehouse C,70,57,2025-02-20 13:22:00,13
12695,ORD_12696,15863,Ayurvedic Vitamin C Brightening Face Mask,Warehouse A,46,30,2025-02-20 03:03:00,16
12696,ORD_12697,30315,Trizi-Cold Tablet,Warehouse C,72,55,2025-02-20 00:29:00,17
12697,ORD_12698,16588,Nocaf Expectorant,Warehouse B,40,28,2025-02-20 23:41:00,12
12698,ORD_12699,29652,Wet N Wild Color Icon Eyeshadow Quads - Silent Treatment 4.5 gm,Warehouse A,105,92,2025-02-20 12:11:00,13
12699,ORD_12700,28577,Fozone SL 1gm/0.5gm Injection,Warehouse A,45,34,2025-02-20 00:28:00,11
12700,ORD_12701,11362,Inliv-M Syrup,Warehouse A,68,62,2025-02-20 21:42:00,6
12701,ORD_12702,20572,"boAt BassHeads 100 Delhi Capitals Edition Wired in Ear Earphones with Super Extra Bass, with mic, Hawk Inspired Design and...",Warehouse B,84,73,2025-02-20 01:43:00,11
12702,ORD_12703,10340,Graz 500mg Tablet,Warehouse C,26,9,2025-02-20 19:14:00,17
12703,ORD_12704,28607,Typteez 10mg Tablet,Warehouse A,24,19,2025-02-20 18:03:00,5
12704,ORD_12705,4229,Ottamec PG 750mcg/75mg Tablet,Warehouse A,16,10,2025-02-20 20:36:00,6
12705,ORD_12706,20598,"All-new Kindle Paperwhite (16 GB) – Now with a 6.8"" display and adjustable warm light",Warehouse B,104,93,2025-02-20 09:32:00,11
12706,ORD_12707,14500,Arteviz Injection,Warehouse A,80,66,2025-02-20 21:19:00,14
12707,ORD_12708,35608,Dyzithro 250mg Tablet,Warehouse B,33,18,2025-02-20 03:33:00,15
12708,ORD_12709,28600,Trichup Keratin Hair Conditioner 200 ml (Pack of 2),Warehouse B,39,25,2025-02-20 23:27:00,14
12709,ORD_12710,30098,Spantra Sheabutter Sugar Scrub 125 gm,Warehouse C,62,54,2025-02-20 18:23:00,8
12710,ORD_12711,17057,"Eau De Parfum - Femme, Women",Warehouse B,74,63,2025-02-20 23:08:00,11
12711,ORD_12712,576,HP 64GB Class 10 MicroSD Memory Card (HP-MSDCWAU1-64GB),Warehouse C,48,34,2025-02-20 15:56:00,14
12712,ORD_12713,12435,Mositra 200mg Capsule,Warehouse C,79,68,2025-02-20 07:55:00,11
12713,ORD_12714,36625,Spigen Ultra Hybrid Cover Case for Apple Watch SE2 / 6 / SE / 5/4 (40mm) - Crystal Clear (Watch not Included),Warehouse B,106,92,2025-02-20 15:21:00,14
12714,ORD_12715,11175,Glimvea-MV 1 Tablet SR,Warehouse A,91,84,2025-02-20 03:29:00,7
12715,ORD_12716,36341,Maybelline New York Tattoo Studio Gel Liner Pencil Intense Charcoal 1.24 gm,Warehouse B,63,54,2025-02-20 17:54:00,9
12716,ORD_12717,29571,ZOUK Women Laptop Bag Royal Indian Peacock Motif,Warehouse C,23,8,2025-02-20 15:05:00,15
12717,ORD_12718,35940,Glabraa Plus Syrup,Warehouse B,93,85,2025-02-20 01:08:00,8
12718,ORD_12719,29572,Soulflower Rosemary Lavender Hair Cleansing Bar Soap with Jojoba oil 150 gm,Warehouse C,17,4,2025-02-20 07:58:00,13
12719,ORD_12720,29573,SanDisk Extreme SD UHS I 256GB Card for 4K Video for DSLR and Mirrorless Cameras 180MB/s Read & 130MB/s Write,Warehouse B,30,15,2025-02-20 02:45:00,15
12720,ORD_12721,29326,Q Can 200mg Tablet,Warehouse A,28,14,2025-02-20 22:00:00,14
12721,ORD_12722,15901,Candivolt 200mg Capsule,Warehouse A,86,71,2025-02-20 08:12:00,15
12722,ORD_12723,28364,"Krayons Insta Dri Sparkling Eyeliner, Green, Golden, Grey, Waterproof, Longlasting, 7ml Each, Combo (Pack of 3)",Warehouse C,61,56,2025-02-20 08:45:00,5
12723,ORD_12724,12172,Alpha Tribe - Body Spray,Warehouse C,94,88,2025-02-20 19:13:00,6
12724,ORD_12725,20557,"proffisy 12A Toner Cartridge for HP 12A Q2612A High Yield Compatible for HP Laserjet M1005 MFP,1020,1010/1012/1018/1022/10...",Warehouse B,85,77,2025-02-20 13:24:00,8
12725,ORD_12726,16942,Vixif-O Tablet,Warehouse C,103,88,2025-02-20 13:06:00,15
12726,ORD_12727,28589,Amfirst 10mg Tablet,Warehouse C,103,89,2025-02-20 15:06:00,14
12727,ORD_12728,18086,"Redmi Note 9 (Aqua Green, 4GB RAM, 64GB Storage) - 48MP Quad Camera & Full HD+ Display",Warehouse B,79,68,2025-02-20 18:53:00,11
12728,ORD_12729,4407,"Sery Colorflirt Nail Paint Mint Affair, Green 10 ml",Warehouse B,91,77,2025-02-20 04:39:00,14
12729,ORD_12730,30090,Zoeether 150mg Injection,Warehouse A,36,31,2025-02-20 09:35:00,5
12730,ORD_12731,29166,Ajmal Raindropss & Blu & Aurum & Wisal Deo & Ascend EDP Pack of 5 20 ml,Warehouse B,116,98,2025-02-20 08:34:00,18
12731,ORD_12732,913,Tabac Original Shaving Foam 200 ml,Warehouse A,103,90,2025-02-20 17:01:00,13
12732,ORD_12733,18077,Tripod kit for All Needs from Syvo and Tygot,Warehouse A,59,47,2025-02-20 01:03:00,12
12733,ORD_12734,10343,Kairos-D Tablet,Warehouse A,28,9,2025-02-20 11:05:00,19
12734,ORD_12735,31649,Zurifin 0.25% Cream,Warehouse A,97,87,2025-02-20 11:03:00,10
12735,ORD_12736,28711,Oflabin LB Tablet,Warehouse C,90,74,2025-02-20 02:31:00,16
12736,ORD_12737,28568,Qvin 250mg Tablet,Warehouse C,15,5,2025-02-20 17:37:00,10
12737,ORD_12738,31930,Itratuf SB Capsule,Warehouse B,113,99,2025-02-20 15:19:00,14
12738,ORD_12739,4667,"Ultra-Thin Premium Panty Liners - Regular Flow, Small",Warehouse A,58,47,2025-02-20 07:23:00,11
12739,ORD_12740,10326,"Syoss - Ceramide Complex Anti-Breakage, 01 Shampoo",Warehouse A,110,92,2025-02-20 01:28:00,18
12740,ORD_12741,18301,Unipod 200mg Tablet,Warehouse B,72,63,2025-02-20 17:12:00,9
12741,ORD_12742,36803,Ceftiwin Tablet,Warehouse A,29,10,2025-02-20 09:57:00,19
12742,ORD_12743,2641,Prodin D 10mg Tablet,Warehouse A,46,31,2025-02-20 06:17:00,15
12743,ORD_12744,558,Alivher ES Tablet,Warehouse B,88,69,2025-02-20 01:16:00,19
12744,ORD_12745,15072,Barodom 10mg/20mg Capsule,Warehouse C,32,14,2025-02-20 01:56:00,18
12745,ORD_12746,16680,"Zebronics Zeb-Transformer USB Gaming Keyboard and Mouse Set (USB, Braided Cable) White with Silver",Warehouse C,12,7,2025-02-20 07:45:00,5
12746,ORD_12747,10606,Beauty People Glamour On The Go Nail Paint Remover Padsblack - Grapes 1's,Warehouse C,45,40,2025-02-20 20:12:00,5
12747,ORD_12748,9291,"Amazon Basics 128GB microSDXC Memory Card with Full Size Adapter, 100MB/s, U3",Warehouse B,57,42,2025-02-20 11:22:00,15
12748,ORD_12749,35562,"Lyon Beauty USA, Eyeliner Kajal",Warehouse B,18,10,2025-02-20 12:11:00,8
12749,ORD_12750,34940,Beauty People High Shine Nail Polish 1089 12 ml,Warehouse C,20,12,2025-02-20 13:46:00,8
12750,ORD_12751,15322,TheGiftKart Back Cover Soft Case for Samsung Galaxy A73 5G | Best Camera Protection | Inbuilt Dust Plugs & Anti-Slip Grip...,Warehouse A,85,67,2025-02-20 19:17:00,18
12751,ORD_12752,30023,Zacra 5mg Tablet,Warehouse C,65,59,2025-02-20 21:42:00,6
12752,ORD_12753,10610,Engaba M 750 mcg/75 mg Tablet,Warehouse C,61,54,2025-02-20 23:14:00,7
12753,ORD_12754,3967,CEDO Honor Pad 8 (11.9 inch) Flip Cover | Leather Finish | 360 Degree Rotate Flip Cover | Shockproof Style Back Cover Case...,Warehouse A,79,62,2025-02-20 15:08:00,17
12754,ORD_12755,1263,YOUTH MOBI Edge to Edge Tempered Glass for Samsung Galaxy M04 / A04S / M33 / F23 / M23 / A23 / M13 4G / M13 5G with Easy S...,Warehouse A,53,44,2025-02-20 02:46:00,9
12755,ORD_12756,35566,"Arata Essential Morning Regime With Facewash (50 ML), Face Serum-Cream (50 ML) & Toothpaste (50 ML) for Women & Men All Natural, Vegan & Cruelty-Free Minty Fresh Breath Radiant, Healthy Skin 150 ml",Warehouse B,10,2,2025-02-20 03:14:00,8
12756,ORD_12757,18441,Miss Claire Soft Matte Lip Cream - 64 6.5 Gm,Warehouse C,23,10,2025-02-20 17:05:00,13
12757,ORD_12758,4800,Mitapin 30mg Tablet,Warehouse C,10,3,2025-02-20 13:46:00,7
12758,ORD_12759,30472,Chambor Orosa Butter Lip Stick - Balmy 103 2.7 gm,Warehouse B,70,62,2025-02-20 07:40:00,8
12759,ORD_12760,32177,Inflameri TH 100mg/4mg Tablet,Warehouse B,72,54,2025-02-20 02:09:00,18
12760,ORD_12761,27257,"F N Finautica Wooden Italian Wooden Crafter Standard Size Tripod Floor Lamp With Jute Shade, Bulb And Holder, Pack Of 1",Warehouse A,75,60,2025-02-20 15:33:00,15
12761,ORD_12762,36491,Mexcef TZ 250mg/31.25mg Injection,Warehouse C,101,88,2025-02-20 20:06:00,13
12762,ORD_12763,11624,Yellow Chimes 5 Pieces Combo Black Thread Knot with Oxidized Single Charms Base Metal Adjustable Evil Eye Anklets for Wome...,Warehouse C,72,54,2025-02-20 19:09:00,18
12763,ORD_12764,20387,Lytix RX Tablet,Warehouse A,26,20,2025-02-20 09:55:00,6
12764,ORD_12765,17133,"The Body Shop Vegan Shea Intense Repair Shampoo, 250 Ml",Warehouse B,27,18,2025-02-20 22:26:00,9
12765,ORD_12766,12286,Komdol-P Oral Suspension Mango,Warehouse C,35,19,2025-02-20 23:16:00,16
12766,ORD_12767,4787,Makeup Revolution Colour Play Empower Eyeshadow Palette 5.2 gm,Warehouse A,47,33,2025-02-20 10:51:00,14
12767,ORD_12768,3846,Floricot Tablet,Warehouse A,107,93,2025-02-20 12:53:00,14
12768,ORD_12769,20449,Ondocos 4mg Tablet,Warehouse A,65,47,2025-02-20 08:39:00,18
12769,ORD_12770,32795,Lipicure 20 Tablet,Warehouse A,101,83,2025-02-20 15:07:00,18
12770,ORD_12771,10478,"Dot & Key CICA Face Wash for Acne Prone Skin, 2% Salicylic Acid Face Wash with Green Tea | For Oily & Sensitive Skin | Sul...",Warehouse B,41,25,2025-02-20 15:21:00,16
12771,ORD_12772,32428,Aegte Kisproof Liquid Matte Lipstick - Peppy Orange 706 5 ml,Warehouse A,111,94,2025-02-20 14:33:00,17
12772,ORD_12773,12018,Sirona Ultra-thin & Natural Black Sanitary Pad (Small) 10's,Warehouse C,104,89,2025-02-20 20:20:00,15
12773,ORD_12774,18396,Express Hydration Body Lotion For Men & Women - Fast Absorption,Warehouse C,75,57,2025-02-20 11:09:00,18
12774,ORD_12775,16552,Himalaya Nourishing Skin Cream,Warehouse B,61,48,2025-02-20 21:03:00,13
12775,ORD_12776,29266,TWC Day Sanitary Pads Value Pack of 16 180 gm,Warehouse C,24,18,2025-02-20 09:43:00,6
12776,ORD_12777,12739,"Seagate Expansion 4TB External HDD - USB 3.0 for Windows and Mac with 3 yr Data Recovery Services, Portable Hard Drive (ST...",Warehouse C,35,17,2025-02-20 11:39:00,18
12777,ORD_12778,32433,Acer 126 cm (50 inches) H Series 4K Ultra HD Android Smart LED TV AR50AR2851UDPRO (Black),Warehouse C,29,14,2025-02-20 23:23:00,15
12778,ORD_12779,12016,Fexicef-CV 325 Tablet,Warehouse A,81,63,2025-02-20 09:26:00,18
12779,ORD_12780,9400,D-Link DWA-131 300 Mbps Wireless Nano USB Adapter (Black),Warehouse A,52,36,2025-02-20 13:03:00,16
12780,ORD_12781,28670,Rabnik 20mg Tablet,Warehouse A,66,48,2025-02-20 18:31:00,18
12781,ORD_12782,18157,Sacdom 10mg/150mg Tablet,Warehouse A,100,90,2025-02-20 11:31:00,10
12782,ORD_12783,11316,Miss Rose 24 Color Matte Eyeshadow Palette 7001 - 071 MT01 26 gm,Warehouse B,99,83,2025-02-20 14:15:00,16
12783,ORD_12784,10410,"Lapster 3 in 1 Screen Cleaning Kit with Brush and Micro Cloth for PC, laptops, LCD led mobiles and TV (80ML)",Warehouse A,21,3,2025-02-20 19:21:00,18
12784,ORD_12785,17122,Omeclaz-D Capsule,Warehouse C,72,55,2025-02-20 01:16:00,17
12785,ORD_12786,14954,"Coxeer Pack of 10 Sheets Kids Temporary Tattoo Cartoon Animal Sticker Body Sticker Face Sticker,Paper,Multi color",Warehouse B,24,12,2025-02-20 08:18:00,12
12786,ORD_12787,34961,Amazon Brand - Solimo Basic Case for Apple iPhone 7 (Silicone_Transparent),Warehouse C,19,14,2025-02-20 07:06:00,5
12787,ORD_12788,11601,Revolution Pro Supreme Matte Lip Pigment-Immunity 2.5 ml,Warehouse A,47,39,2025-02-20 02:14:00,8
12788,ORD_12789,20376,Vega Hot Curl Brush Small (E16 - PRS) 104 gm,Warehouse A,100,83,2025-02-20 16:50:00,17
12789,ORD_12790,36408,MANCODE Vitamin C Face Sheet Mask 25 ml,Warehouse C,83,68,2025-02-20 14:26:00,15
12790,ORD_12791,647,Posh 1.5 Meter High Speed Gold Plated HDMI Male to Female Extension Cable (Black),Warehouse B,70,55,2025-02-20 05:41:00,15
12791,ORD_12792,10597,Kidrox 250mg Syrup,Warehouse C,42,28,2025-02-20 07:56:00,14
12792,ORD_12793,10623,Escistar 5mg Tablet,Warehouse B,34,21,2025-02-20 05:36:00,13
12793,ORD_12794,10596,rts High Speed Updated Mini Displayport Thunderbolt to HDMI Adapter for Unibody MacBook Pro iMac MacBook Air Mac Mini Lapt...,Warehouse A,78,61,2025-02-20 17:04:00,17
12794,ORD_12795,1242,Hair Oil - 7 in 1,Warehouse B,90,76,2025-02-20 09:57:00,14
12795,ORD_12796,20453,Vega Round Brush (R2 - RB) 60 gm,Warehouse B,99,83,2025-02-20 08:37:00,16
12796,ORD_12797,1240,Sonata Smart Plaid Analog Black Dial Men's Watch-NN77105SL02W/NP77105SL02W,Warehouse A,56,50,2025-02-20 15:04:00,6
12797,ORD_12798,4200,"Parachute Advansed Soft Touch Body Lotion for Women & Men, All Skin types, 400ml | Pure Coconut Milk & Honey, 100% Natura...",Warehouse C,88,79,2025-02-20 11:48:00,9
12798,ORD_12799,16989,Foot Care Cream,Warehouse B,81,62,2025-02-20 15:29:00,19
12799,ORD_12800,9346,"Kama Ayurveda Rose Jasmine Face Cleanser, 50ml",Warehouse A,56,39,2025-02-20 08:29:00,17
12800,ORD_12801,27278,Bergamot Pure Aroma Essential Oil,Warehouse A,111,93,2025-02-20 08:04:00,18
12801,ORD_12802,20466,T.O.G. 120pcs V- shape Adhensive Double-sided Eyelid Eye Tape Sticker Cosmetic Makeup Invisible,Warehouse B,10,5,2025-02-20 16:34:00,5
12802,ORD_12803,20357,"Shiseido Rouge Rouge Lipstick, RD503 Blood Stone, 4g",Warehouse C,107,89,2025-02-20 10:30:00,18
12803,ORD_12804,2798,Clomaxin LB 500mg/125mg Tablet,Warehouse C,99,83,2025-02-20 10:16:00,16
12804,ORD_12805,27286,2-In-1 Silky Smooth Care Shampoo + Conditioner,Warehouse C,80,61,2025-02-20 09:36:00,19
12805,ORD_12806,11580,POPIO Tempered Glass Compatible for Samsung Galaxy M31s / Samsung Galaxy A51 with Full Screen Coverage (except edges) and ...,Warehouse B,45,28,2025-02-20 23:07:00,17
12806,ORD_12807,12651,Nurospn Plus 75mg/10mg/1500mcg Tablet,Warehouse A,78,67,2025-02-20 12:26:00,11
12807,ORD_12808,29382,"ESR Tempered-Glass Screen Protector Compatible with iPhone 14 Pro [3 Pack], with Easy Installation Frame, Military-Grade P...",Warehouse B,49,30,2025-02-20 00:43:00,19
12808,ORD_12809,11835,House of Aroma Fragrance Oil - Violet 100 ml,Warehouse B,54,45,2025-02-20 03:27:00,9
12809,ORD_12810,29383,"Fashion Colour Jersy Girl Kiss Proof No Transfer Lipstick, 8 Dull Red 2 gm",Warehouse A,35,27,2025-02-20 10:14:00,8
12810,ORD_12811,17330,boAt BassHeads 225 Special Edition in-Ear Wired Headphones with Mic (Blue),Warehouse A,57,43,2025-02-20 12:30:00,14
12811,ORD_12812,12520,"Parker Ultra Fine Navigator Roller Ball Refill, Blue",Warehouse C,83,74,2025-02-20 13:51:00,9
12812,ORD_12813,16438,"Fire-Boltt Infinity 1.6"" Round Display Smart Watch, 400 * 400 Pixel High Resolution, Bluetooth Calling with Voice Assistan...",Warehouse B,37,23,2025-02-20 22:22:00,14
12813,ORD_12814,20143,Camlin Painting Kit 199 Combo,Warehouse A,45,36,2025-02-20 11:31:00,9
12814,ORD_12815,29156,Medimade Apple Cider Vinegar Hair Mask 200 gm,Warehouse A,78,60,2025-02-20 16:17:00,18
12815,ORD_12816,28334,Fegi 3D Kit,Warehouse B,35,28,2025-02-20 16:10:00,7
12816,ORD_12817,531,"Fashion Colour Professional Makeup Kit, 1822 - 2 109.3 gm",Warehouse C,32,26,2025-02-20 08:51:00,6
12817,ORD_12818,331,Newlike Samsung Galaxy A14 5g Bumper Transparent Back Cover Clear Thin Case - for Samsung Galaxy A14 5g,Warehouse C,52,36,2025-02-20 02:51:00,16
12818,ORD_12819,11647,Bromolin 250mg/8mg Tablet DT,Warehouse C,114,99,2025-02-20 18:38:00,15
12819,ORD_12820,29160,"CableCreation 6FT USB C to DisplayPort Cable 4K@60Hz, 2K@165Hz, 2K@144Hz, USB Type C to DP Cable Thunderbolt 3 Compatible ...",Warehouse B,81,74,2025-02-20 15:57:00,7
12820,ORD_12821,9466,Batiste Dry Hair Shampoo - Clean & Classic Original 50 ml + Fruity & Cheeky Cherry 50 ml + Floral & Flirty Blush 50 ml,Warehouse A,69,58,2025-02-20 04:52:00,11
12821,ORD_12822,29164,Up Or Down Eau De Toilette - For Woman,Warehouse A,74,56,2025-02-20 10:44:00,18
12822,ORD_12823,35501,Bluetooth Audio Receiver For Samsung Galaxy S22+ 5G Original Wireless car bluetooth Audio receiver With 3.5mm Jack Aux Cab...,Warehouse A,44,27,2025-02-20 05:49:00,17
12823,ORD_12824,36139,Ceflive O 200mg/200mg Tablet,Warehouse C,11,1,2025-02-20 11:21:00,10
12824,ORD_12825,15907,Apple Watch SE (2nd Gen) GPS 44mm Starlight Aluminium Case with Starlight Sport Band - Regular,Warehouse B,61,47,2025-02-20 08:37:00,14
12825,ORD_12826,9474,Omezec 20mg Capsule,Warehouse A,35,26,2025-02-20 14:38:00,9
12826,ORD_12827,17335,Classmate Octane Neon- Blue Gel Pens(Pack of 5)|Smooth Writing Pen|Attractive body colour for Boys & Girls|Waterproof ink ...,Warehouse A,105,96,2025-02-20 19:35:00,9
12827,ORD_12828,29149,Ajmal Viola EDP Fruity Floral Perfume And Shadow Homme Deodorant Citrus Woody Fragrance 275 ml,Warehouse A,11,3,2025-02-20 06:26:00,8
12828,ORD_12829,971,Sulbacef 250mg/125mg Injection,Warehouse C,106,90,2025-02-20 01:12:00,16
12829,ORD_12830,9489,3-In-1 Toner,Warehouse B,36,24,2025-02-20 16:02:00,12
12830,ORD_12831,11658,Fashion Colour Oil Free Pearl Primer 30 ml,Warehouse C,49,34,2025-02-20 08:00:00,15
12831,ORD_12832,31737,Fenbac 10mg Tablet XR,Warehouse A,18,4,2025-02-20 18:43:00,14
12832,ORD_12833,534,Medimade Charcoal Face Wash 160 ml,Warehouse A,81,69,2025-02-20 06:48:00,12
12833,ORD_12834,20099,"HP 15s, 12th Gen Intel Core i5 16GB RAM/512GB SSD 15.6-inch(39.6 cm) Micro-Edge Anti-Glare FHD Laptop/Win 11/Intel Iris Xe...",Warehouse A,112,97,2025-02-20 08:17:00,15
12834,ORD_12835,15942,Epigold 600mg Tablet XR,Warehouse A,67,56,2025-02-20 20:25:00,11
12835,ORD_12836,14895,"Mincerfit Oil Blotting Sheets, (Pack of 100 Sheets) Green Tea Oil Absorbing Tissues Paper, Large 10cmx7cm Oil Blotters. (2)",Warehouse C,74,60,2025-02-20 11:51:00,14
12836,ORD_12837,27431,Vincob 2500mcg Injection,Warehouse B,33,19,2025-02-20 02:23:00,14
12837,ORD_12838,2813,"Nainital | Vitamin C Serum - Brightening, Anti-Aging Skin Repair, Supercharged Face Serum, Dark Circle, Fine Line & Sun Da...",Warehouse B,108,96,2025-02-20 18:19:00,12
12838,ORD_12839,12523,VGRASSP 12 Inch Large LCD Writing Pad Tablet Toy Cum Slate with Stylus for Kids 30.4 cm (Colour as per Stock),Warehouse A,22,7,2025-02-20 09:55:00,15
12839,ORD_12840,3572,Charming Perfumed Talc - For Women,Warehouse C,39,28,2025-02-20 04:37:00,11
12840,ORD_12841,30756,"7X Beard Oil - The Woods, 7 Premium Oils Blend Supports Beard Growth & Nourishment",Warehouse B,26,9,2025-02-20 16:40:00,17
12841,ORD_12842,20070,DE LANCI Big Colorful Eyeshadow Palette Professional 54 Color Board Eye Shadow Bright Neon Glitter Makeup Pallet Highly Pi...,Warehouse A,61,45,2025-02-20 09:36:00,16
12842,ORD_12843,3760,Matce G 1mg/500mg Tablet,Warehouse C,74,58,2025-02-20 16:05:00,16
12843,ORD_12844,15643,"MELODINE Professional Flat Face Pack Applicator Brush, Multicolor - (Pack of 2)",Warehouse C,27,16,2025-02-20 14:11:00,11
12844,ORD_12845,29110,"Blue Heaven Walk Free Green Pack Mascara, Black, 12ml",Warehouse A,64,53,2025-02-20 07:11:00,11
12845,ORD_12846,30171,Linidox 200mg Tablet,Warehouse C,80,64,2025-02-20 19:03:00,16
12846,ORD_12847,14570,Hot Water Rubber Bag - One Side Ribbed,Warehouse B,67,52,2025-02-20 12:09:00,15
12847,ORD_12848,15637,"Maybelline New York Mascara, No-clumping, Fanning Brush, Waterproof, Lash Sensational, Black, 9ml",Warehouse A,25,13,2025-02-20 13:51:00,12
12848,ORD_12849,10197,Ngtel H 40mg/12.5mg Tablet,Warehouse B,57,50,2025-02-20 10:50:00,7
12849,ORD_12850,36127,After Shave Lotion - Dark Tempation,Warehouse C,45,35,2025-02-20 04:12:00,10
12850,ORD_12851,30341,"Sunblock Sport Sunscreen SPF 50, Non Greasy & Water Resistant",Warehouse B,17,2,2025-02-20 01:00:00,15
12851,ORD_12852,30594,Pentothal Injection,Warehouse A,87,74,2025-02-20 01:44:00,13
12852,ORD_12853,29102,Tulsi Tablet,Warehouse B,99,93,2025-02-20 16:04:00,6
12853,ORD_12854,30592,"SHOPEE 10 PCS Photography Backdrop Support Spring Clamp 4.3""/11cm for Background Muslin, Canvas, Paper, Chromakey Screen, ...",Warehouse A,66,48,2025-02-20 00:53:00,18
12854,ORD_12855,29396,Gugzy Kabuki Makeup Face Powder Foundation Blush Cosmetic Brush (Black Black),Warehouse A,26,17,2025-02-20 17:21:00,9
12855,ORD_12856,194,POPIO Tempered Glass Screen Protector Compatible for iPhone 14 Pro with Case Friendly Edge to Edge Coverage and Easy Insta...,Warehouse A,70,52,2025-02-20 22:16:00,18
12856,ORD_12857,18666,Glimmer Premium Nail Enamel Nude Shimmer 10 ml,Warehouse A,100,84,2025-02-20 17:27:00,16
12857,ORD_12858,4236,Amazon Brand - Solimo Thermoplastic Polyurethane Anti Dust Plug Mobile Cover Soft and Flexible Back Cover for Samsung Gala...,Warehouse A,81,65,2025-02-20 15:50:00,16
12858,ORD_12859,19992,Ajmal Shadow Homme & Sacrificeiihim & Carbon & Avid Deo & Ascend EDP Pack of 5 20 ml,Warehouse B,53,43,2025-02-20 16:17:00,10
12859,ORD_12860,12700,Ant Value Fkbri01 Wired Usb Multi-Device Keyboardâ  (Black),Warehouse A,62,45,2025-02-20 07:10:00,17
12860,ORD_12861,12101,Atorec CV 10 Capsule,Warehouse A,69,61,2025-02-20 15:30:00,8
12861,ORD_12862,15964,boAt Airdopes 441 Bluetooth Truly Wireless in Ear Earbuds with Mic with Up to 35H Total Playback Iwp Technology Immersive ...,Warehouse B,73,54,2025-02-20 14:45:00,19
12862,ORD_12863,11664,Metcold Syrup,Warehouse B,19,9,2025-02-20 00:40:00,10
12863,ORD_12864,28756,Robustrion Anti-Scratch & Smudge Proof Premium Tempered Glass Screen Protector for Lenovo Tab P11 11 inch(27.9cm) TB-J606...,Warehouse C,84,70,2025-02-20 13:04:00,14
12864,ORD_12865,35467,Faces Canada Ultime Pro Matte Lip Crayon My Desire 38 2.8 Gm,Warehouse A,81,63,2025-02-20 21:51:00,18
12865,ORD_12866,28270,Glimmer Premium Nail Enamel Red Berry 10 ml,Warehouse C,48,32,2025-02-20 07:47:00,16
12866,ORD_12867,35474,Fujifilm Instax Mini 9 Instant Camera (Cobalt Blue),Warehouse C,67,52,2025-02-20 10:00:00,15
12867,ORD_12868,28297,FORFOR® Xpression Color Changing Matte Long Lasting Waterproof Lipbalm Lipstick (5-8 hrs stay) (Natural Pink),Warehouse A,79,61,2025-02-20 12:08:00,18
12868,ORD_12869,16918,Clavihop Dry Syrup,Warehouse A,99,82,2025-02-20 23:57:00,17
12869,ORD_12870,18709,Dronol Tablet,Warehouse C,46,31,2025-02-20 15:07:00,15
12870,ORD_12871,30782,Arodox 100mg Tablet,Warehouse B,105,94,2025-02-20 15:57:00,11
12871,ORD_12872,20114,Nadoxin Cream,Warehouse A,57,47,2025-02-20 02:52:00,10
12872,ORD_12873,30101,Olancare 5mg Tablet,Warehouse A,54,36,2025-02-20 06:40:00,18
12873,ORD_12874,15375,Khaas Shampoo Bar - Beer,Warehouse B,28,19,2025-02-20 10:15:00,9
12874,ORD_12875,35166,Maryaj Direction East EDP Citrus Spicy Perfume And Ajmal Carbon Homme Deodorant Citrus Spicy Fragrance 300 ml,Warehouse C,64,46,2025-02-20 20:30:00,18
12875,ORD_12876,14633,Betnovate-N  Cream,Warehouse C,57,44,2025-02-20 15:53:00,13
12876,ORD_12877,36761,"boAt Rockerz 260 Bluetooth in Ear Earphones with Beast™ Mode, ENx™ Mode, ASAP™ Charge, Upto 25 Hours Playback, Signature S...",Warehouse B,51,33,2025-02-20 01:18:00,18
12877,ORD_12878,238,"AmazonBasics Bluetooth Speaker 5.0 Soundbar with 16W RMS, 2000mAh Battery, Upto 19 Hrs Playtime Aux/USB Port (Black)",Warehouse C,89,77,2025-02-20 20:09:00,12
12878,ORD_12879,11395,Onyazone-S Injection,Warehouse C,50,43,2025-02-20 04:31:00,7
12879,ORD_12880,16740,Skinguard Manual Shaving Razor Blades,Warehouse A,11,2,2025-02-20 06:16:00,9
12880,ORD_12881,12335,Tropieye Eye Drops,Warehouse A,81,71,2025-02-20 07:10:00,10
12881,ORD_12882,12163,"LG Ultragear Gaming- HDR 10-27Gn800, 27 Inch (68 Cm) 2K-Qhd 640 X 480 Pixels Resolution IPS with HDR 10-144Hz, 1Ms, G-Sync...",Warehouse C,22,13,2025-02-20 11:03:00,9
12882,ORD_12883,35405,Refexol 400 Tablet,Warehouse B,21,4,2025-02-20 17:17:00,17
12883,ORD_12884,19745,Belora Paris Leave No Evidence Liquid Matte Lipstick French Red 4.5 gm,Warehouse C,69,54,2025-02-20 21:38:00,15
12884,ORD_12885,27657,Syrup -Trikatu,Warehouse C,63,52,2025-02-20 17:27:00,11
12885,ORD_12886,27654,Monamox BR 250mg/8mg Capsule,Warehouse C,73,68,2025-02-20 05:48:00,5
12886,ORD_12887,29053,Soft Light Moisturising Cream - Chilled Mint,Warehouse B,86,81,2025-02-20 10:59:00,5
12887,ORD_12888,10760,Biosera 10mg Tablet,Warehouse C,38,26,2025-02-20 06:54:00,12
12888,ORD_12889,19764,"Sun Shield - Strawberry Scrub, With Walnut Grains",Warehouse C,16,4,2025-02-20 10:38:00,12
12889,ORD_12890,29938,"ZEBRONICS Zeb-Bro in Ear Wired Earphones with Mic, 3.5mm Audio Jack, 10mm Drivers, Phone/Tablet Compatible(Green)",Warehouse A,25,14,2025-02-20 15:54:00,11
12890,ORD_12891,27648,"Wings Phantom 315 Wireless Earphones with 40 Hours of Battery Backup, Low Latency 40 ms, Wireless Headphones with ENC mic...",Warehouse C,76,57,2025-02-20 06:15:00,19
12891,ORD_12892,16051,Csecurity RJ45 Inline Coupler Cat7/Cat6/Cat5e Ethernet Network Router Cable Extender Connector - Black,Warehouse B,76,59,2025-02-20 12:25:00,17
12892,ORD_12893,30733,SanDisk Ultra Dual 32 GB USB 3.0 OTG Pen Drive (Black),Warehouse B,64,57,2025-02-20 10:27:00,7
12893,ORD_12894,28208,Signature Temptation After Shave Lotion,Warehouse C,25,16,2025-02-20 08:45:00,9
12894,ORD_12895,4156,Telca Case Cover Compatible with Realme Air 3 ONLY (Silicon Cover),Warehouse C,68,49,2025-02-20 16:07:00,19
12895,ORD_12896,17714,Xolan 20mg Tablet,Warehouse A,41,29,2025-02-20 05:58:00,12
12896,ORD_12897,19940,SUGAR Cosmetics Cheat Sheet Anti Ageing Mask 24 gm,Warehouse C,58,46,2025-02-20 04:56:00,12
12897,ORD_12898,14582,"Dyazo Laptop Sleeve 15.6 inches, Durable Shockproof Neoprene Case Cover Carrying Bag Case with Pockets Compatible for HP/C...",Warehouse B,108,91,2025-02-20 23:10:00,17
12898,ORD_12899,1158,boAt Dual Port Rapid 5V Car Charger (Qualcomm Certified) Smart Charging with Quick Charge 3.0 for Cellular Phones (Black)...,Warehouse B,62,56,2025-02-20 00:45:00,6
12899,ORD_12900,19926,Ceftizone 250 Injection,Warehouse A,28,13,2025-02-20 05:34:00,15
12900,ORD_12901,29401,D-Link R03 N300 Eagle PRO AI Advance Parental Control Router with Voice Control Assistant (Alexa & Goggle Assistant) - Wi-...,Warehouse B,84,76,2025-02-20 23:55:00,8
12901,ORD_12902,3582,Ramcef O 200mg Tablet DT,Warehouse A,10,1,2025-02-20 14:55:00,9
12902,ORD_12903,32654,"Zoul Nylon Braided USB to Lightning Short Data Sync & Fast Charging Power Bank Cable for iPhones, iPad Air, iPad Mini, iPo...",Warehouse B,105,92,2025-02-20 08:17:00,13
12903,ORD_12904,32671,Lineks 600mg Tablet,Warehouse C,25,18,2025-02-20 03:21:00,7
12904,ORD_12905,5278,"Samsung Original 35W Power Adapter Duo for Tablets, White, Black 35W",Warehouse A,86,78,2025-02-20 13:20:00,8
12905,ORD_12906,2702,Ajmal 2 Sacred Love And 2 Nightingale Deodorants Pack of 4 200 ml,Warehouse C,79,66,2025-02-20 10:04:00,13
12906,ORD_12907,18932,Teneptin Tablet,Warehouse C,24,15,2025-02-20 07:40:00,9
12907,ORD_12908,844,Ajmal Silver Shade & Avid & Raindropss & Blu Deo & Ascend EDP Pack of 5 20 ml,Warehouse A,75,61,2025-02-20 17:16:00,14
12908,ORD_12909,15255,Piroxina 20mg Tablet DT,Warehouse C,104,87,2025-02-20 22:07:00,17
12909,ORD_12910,14525,Mr. Magic Powder-To-Liquid Handwash Refill,Warehouse C,60,50,2025-02-20 14:41:00,10
12910,ORD_12911,20124,Reocoxia 90mg Tablet,Warehouse C,81,73,2025-02-20 12:25:00,8
12911,ORD_12912,1194,Ajmal Raindrops Femme And Distraction Deodorants Pack of 2 200 ml,Warehouse C,58,51,2025-02-20 12:30:00,7
12912,ORD_12913,19962,Conivog MG 1mg/500mg/0.2mg Tablet SR,Warehouse C,36,30,2025-02-20 15:50:00,6
12913,ORD_12914,635,Kangaro DP-600 Paper Punch,Warehouse B,61,45,2025-02-20 21:35:00,16
12914,ORD_12915,14610,ANGEL E-COMMERCE Audio Jack Headphones with Mic | 3.5mm Audio Jack to Headphone Microphone Splitter Converter Adapter | 1 ...,Warehouse A,111,94,2025-02-20 07:31:00,17
12915,ORD_12916,29694,Densaid-QA Sachet,Warehouse A,52,37,2025-02-20 03:42:00,15
12916,ORD_12917,19807,7 Oils In One Non Sticky Hair Oil,Warehouse B,87,76,2025-02-20 01:56:00,11
12917,ORD_12918,17476,OpenTech® Tempered Glass Screen Protector Compatible for Oneplus Nord CE 2 Lite 5G (2022) with Edge to Edge Coverage and E...,Warehouse B,57,48,2025-02-20 11:38:00,9
12918,ORD_12919,32329,"Amazonbasics Micro USB Fast Charging Cable for Smartphone (3 Feet, Silver)",Warehouse C,22,14,2025-02-20 06:50:00,8
12919,ORD_12920,10747,"SanDisk Extreme microSD UHS I Card 128GB for 4K Video on Smartphones,Action Cams 190MB/s Read,90MB/s Write",Warehouse B,32,26,2025-02-20 12:55:00,6
12920,ORD_12921,4051,Srotec 50mg Tablet,Warehouse B,55,48,2025-02-20 21:03:00,7
12921,ORD_12922,17455,Incolor Maxi Pen Eyeliner Green 2 Gm,Warehouse A,52,44,2025-02-20 08:05:00,8
12922,ORD_12923,10122,Robustrion Trifold Flip Stand Back Case Cover for Realme Pad 10.4 inch - Black,Warehouse B,76,61,2025-02-20 14:07:00,15
12923,ORD_12924,32330,Lakme Absolute 3D Lipstick Explosive Purple 3.6 Gm,Warehouse A,72,56,2025-02-20 11:18:00,16
12924,ORD_12925,19831,Gebinate 60mg Injection,Warehouse C,40,29,2025-02-20 23:10:00,11
12925,ORD_12926,35424,Ephytol Lotion,Warehouse C,104,99,2025-02-20 01:28:00,5
12926,ORD_12927,11857,Myglamm Lit Matte Nail Enamel - Call It Clout 7 ML,Warehouse C,76,64,2025-02-20 12:28:00,12
12927,ORD_12928,27581,Betaflam Tablet,Warehouse B,88,72,2025-02-20 17:21:00,16
12928,ORD_12929,632,"HP x5600C 64GB OTG (Type C) usb3.2 gen 1 Pen Drive, Grey & Black",Warehouse A,89,71,2025-02-20 22:36:00,18
12929,ORD_12930,16426,Beardo Ultra Glow SPF 30 Face Cream 60 gm,Warehouse A,11,2,2025-02-20 10:00:00,9
12930,ORD_12931,19931,"HB PLUS Selfie Stick, Extendable Selfie Stick with Wireless Remote and Tripod Stand, Portable, Lightweight, Compatible wit...",Warehouse C,105,97,2025-02-20 12:51:00,8
12931,ORD_12932,4650,AmazonBasics HDMI to VGA Adapter,Warehouse A,61,53,2025-02-20 07:40:00,8
12932,ORD_12933,4561,"BEAUTYRELAY LONDON Shade Story Be Bold Eye Kohl Kajal 24hrs Long Stay, Smudgeproof, Fadeproof, (12 Shades) Infused With Al...",Warehouse B,60,55,2025-02-20 01:32:00,5
12933,ORD_12934,900,Acer Extensa 15 Lightweight Laptop Intel Core i3 11th Gen Processor - (8 GB/ 512 GB SSD/ Windows 11 Home/ 1.7kg/ Black/ El...,Warehouse C,85,72,2025-02-20 02:32:00,13
12934,ORD_12935,27883,HARISSONS Bags Delta 39 L Polyester Navy Blue 15.6 inch Laptop Backpack with Built-in Rain Cover & Anti-Sweat Air Mesh | O...,Warehouse B,22,16,2025-02-20 10:01:00,6
12935,ORD_12936,15402,Sirona Super Soft Black Sanitary Pad (Large) 10's,Warehouse A,64,56,2025-02-20 17:18:00,8
12936,ORD_12937,4102,Organic - Aloe Mild Hair And Body Shampoo,Warehouse B,95,86,2025-02-20 07:00:00,9
12937,ORD_12938,9824,Atorvance 10mg Tablet,Warehouse A,86,75,2025-02-20 17:51:00,11
12938,ORD_12939,14692,"SupCares Edge to Edge Tempered Glass for OnePlus 8T, OnePlus 9 (6.55 Inch) with Easy Self Installation Kit | Black | Pack ...",Warehouse C,73,61,2025-02-20 11:17:00,12
12939,ORD_12940,619,"Portronics Toad 23 Wireless Optical Mouse with 2.4GHz, USB Nano Dongle, Optical Orientation, Click Wheel, Adjustable DPI(B...",Warehouse C,30,23,2025-02-20 10:50:00,7
12940,ORD_12941,36739,Rainbow Dots Air Conditioner AC Remote Holder Stand Organiser Wall Mounted Pack of 1,Warehouse C,34,26,2025-02-20 13:52:00,8
12941,ORD_12942,10889,"Man Matters Advanced Hair Tonic for Men 60 mL | With Redensyl, Procapil & Baicapil | DHT Blocker, Controls Hair Fall & Bre...",Warehouse A,116,97,2025-02-20 11:10:00,19
12942,ORD_12943,15153,Urifast 50mg Tablet DT,Warehouse A,68,49,2025-02-20 02:25:00,19
12943,ORD_12944,19305,"CableCreation USB C to HDMI Cable for Home Office, USB Type C to HDMI 4K 30Hz, Thunderbolt 3/4 Compatible with Galaxy S23 ...",Warehouse B,26,14,2025-02-20 18:12:00,12
12944,ORD_12945,19307,Ozapin -MD 10 Tablet,Warehouse C,36,24,2025-02-20 10:54:00,12
12945,ORD_12946,1079,Vomyscot 4mg Tablet,Warehouse C,55,40,2025-02-20 16:30:00,15
12946,ORD_12947,14715,Revlon Flex Regular Conditioner 592 Ml,Warehouse A,80,70,2025-02-20 01:13:00,10
12947,ORD_12948,16225,Ondorin 4mg Tablet MD,Warehouse A,93,83,2025-02-20 22:06:00,10
12948,ORD_12949,36277,Kritxon S 1000mg/500mg Injection,Warehouse B,38,33,2025-02-20 00:58:00,5
12949,ORD_12950,27957,"Blue Heaven Hyper Matte Foundation (302 Honey Tan, Cream, 30 ml)",Warehouse C,44,26,2025-02-20 23:18:00,18
12950,ORD_12951,17703,Rate 3 Syrup,Warehouse A,56,46,2025-02-20 15:17:00,10
12951,ORD_12952,3788,Fersco-XT Tablet,Warehouse B,55,45,2025-02-20 02:49:00,10
12952,ORD_12953,30683,Fxson M 10mg/120mg Tablet,Warehouse C,37,22,2025-02-20 23:35:00,15
12953,ORD_12954,29464,Oxramet XR 10mg/1000mg Tablet,Warehouse A,38,27,2025-02-20 03:10:00,11
12954,ORD_12955,15561,Manflox OZ 200mg/500mg Tablet,Warehouse B,72,53,2025-02-20 20:00:00,19
12955,ORD_12956,2822,Alfadrops 0.5% Eye Drop,Warehouse A,69,52,2025-02-20 05:26:00,17
12956,ORD_12957,35282,Netgear WiFi Range Extender EX6120-Extend Your Internet Wi-Fi up to 1200 sq ft & 20 Devices with AC1200 Dual Band Wireless...,Warehouse C,11,6,2025-02-20 05:02:00,5
12957,ORD_12958,16220,"Samsung Galaxy Tab A7 Lite 8.7 inches, Slim Metal Body, Dolby Atmos Sound, RAM 3 GB, ROM 32 GB Expandable, Wi-Fi+4G Tablet...",Warehouse A,73,55,2025-02-20 08:19:00,18
12958,ORD_12959,17697,Taurflam 400mg/325mg/150mg Tablet,Warehouse B,113,95,2025-02-20 21:48:00,18
12959,ORD_12960,5089,Ajmal Shiro EDP Citrus Spicy Perfume 90ml for Men and Wisal EDP Floral Musky Perfume 50ml for Women +1 Perfume Tester FREE,Warehouse C,95,76,2025-02-20 07:49:00,19
12960,ORD_12961,1073,"TEC TAVAKKAL All in One USB Hub Combo 3 USB Ports and All in one Card Reader, USB 2.0, for Pen Drives/Cameras/Mobiles/PC/L...",Warehouse C,63,45,2025-02-20 14:43:00,18
12961,ORD_12962,12230,"Samsung Galaxy Tab S8 27.94 cm (11 inch) Display, RAM 8 GB, ROM 128 GB Expandable, S Pen in-Box, Wi-Fi Tablet, Graphite",Warehouse A,97,84,2025-02-20 08:47:00,13
12962,ORD_12963,9839,Harocin 10mg Tablet,Warehouse A,40,34,2025-02-20 05:31:00,6
12963,ORD_12964,14706,Camlin Kokuyo Student 24-Shade Water Color Paint Cake Set,Warehouse B,94,81,2025-02-20 20:25:00,13
12964,ORD_12965,15202,Nales Plus 50mg/10mg Tablet,Warehouse B,59,47,2025-02-20 08:06:00,12
12965,ORD_12966,11512,Sepdase D 50mg/10mg Tablet,Warehouse C,56,37,2025-02-20 03:08:00,19
12966,ORD_12967,10062,Revitalift Moisturizing Night Cream,Warehouse A,82,65,2025-02-20 01:42:00,17
12967,ORD_12968,1116,"Seagate One Touch 1TB External HDD with Password Protection – Black, for Windows and Mac, with 3 yr Data Recovery Service...",Warehouse C,59,47,2025-02-20 10:20:00,12
12968,ORD_12969,29839,Super Shine Medium Bristle Toothbrush,Warehouse C,92,77,2025-02-20 06:08:00,15
12969,ORD_12970,28115,"Imou IP 67 Weatherproof Outdoor Bullet Security Camera, 1080P Full HD, Night Vision, Up to 256GB SD Card, WiFi & Ethernet ...",Warehouse A,101,90,2025-02-20 18:11:00,11
12970,ORD_12971,1117,Portronics MODESK POR-122 Universal Mobile Tabletop Holder (Black),Warehouse B,86,80,2025-02-20 04:28:00,6
12971,ORD_12972,16313,"SanDisk Ultra Luxe USB 3.1 Flash Drive 128GB, Upto 150MB/s, All Metal, Metallic Silver",Warehouse C,75,56,2025-02-20 15:28:00,19
12972,ORD_12973,29011,Zavatrip BR Tablet,Warehouse C,38,20,2025-02-20 07:31:00,18
12973,ORD_12974,628,Hyzol D 30mg/40mg Capsule SR,Warehouse A,78,66,2025-02-20 09:45:00,12
12974,ORD_12975,29429,Makeup Revolution Glossy Fix Clear Brow Gel & Mascara 2 ml,Warehouse B,44,37,2025-02-20 01:48:00,7
12975,ORD_12976,17537,"Fashion Colour Oil Free Waterproof Foundation , Shade 02 40 ml",Warehouse C,90,82,2025-02-20 20:32:00,8
12976,ORD_12977,12344,Movex Tablet,Warehouse A,62,51,2025-02-20 23:09:00,11
12977,ORD_12978,27711,Liposoluble Wax - Green Apple,Warehouse A,75,57,2025-02-20 13:46:00,18
12978,ORD_12979,19029,Dozon D 10mg/20mg Tablet,Warehouse B,86,80,2025-02-20 00:21:00,6
12979,ORD_12980,30423,CETC Professional Flat Face Pack Brush - Wooden,Warehouse C,19,10,2025-02-20 21:04:00,9
12980,ORD_12981,14739,(Renewed) Jbl C50Hi Wired In Ear Earphones With Microphone Black,Warehouse A,34,17,2025-02-20 18:19:00,17
12981,ORD_12982,17882,Exo Cough Syrup,Warehouse A,95,85,2025-02-20 15:29:00,10
12982,ORD_12983,10074,Nasyle Cold DS Oral Suspension,Warehouse C,106,89,2025-02-20 10:09:00,17
12983,ORD_12984,36244,Flormar Full Color Nail Enamel FC10 Penthouse 8 ml,Warehouse B,82,70,2025-02-20 02:14:00,12
12984,ORD_12985,28053,Ley M Kid 2.5mg/5mg Tablet,Warehouse C,78,73,2025-02-20 20:21:00,5
12985,ORD_12986,35212,Bella Voste Sugar Baby Nail Paints Shade 367 10 Ml,Warehouse A,62,53,2025-02-20 07:29:00,9
12986,ORD_12987,27782,"Cosmic Byte Cyclone RGB Laptop Cooling Pad with 5 Fan, Adjustable Speed, USB Hub (Black/Blue)",Warehouse C,30,17,2025-02-20 23:47:00,13
12987,ORD_12988,27979,Fashion Colour WATERPROOF LONG LASHES MASCARA DOUBLE EFEECT (8G),Warehouse C,57,52,2025-02-20 19:01:00,5
12988,ORD_12989,27973,Kitcure 2% Cream,Warehouse B,56,48,2025-02-20 04:07:00,8
12989,ORD_12990,27974,Valus Plus 20 mg/500 mg Tablet,Warehouse B,53,43,2025-02-20 14:12:00,10
12990,ORD_12991,27898,Elnim 100mg Tablet MD,Warehouse B,103,88,2025-02-20 03:09:00,15
12991,ORD_12992,17744,Aceox CV 200mg/28.5mg Tablet,Warehouse B,38,31,2025-02-20 02:04:00,7
12992,ORD_12993,19419,"PDSPM Hair Trimmer For Men Buddha or Dragon Style Trimmer, Professional Hair Clipper, Adjustable Blade Clipper, Hair Trimm...",Warehouse A,93,86,2025-02-20 00:48:00,7
12993,ORD_12994,28899,Fresh Start Oil Clear Peach Face Wash,Warehouse A,72,62,2025-02-20 03:11:00,10
12994,ORD_12995,5088,iTronix Replacement Magnetic USB Charger for Mi Smart Band 5 / Mi Smart Band 6 (Black),Warehouse B,75,62,2025-02-20 23:44:00,13
12995,ORD_12996,28112,"pTron Newly Launched Bassbuds Nyx in-Ear Wireless Headphone, Immersive Audio, BT5.1, Stereo Calls, 50ms Movie Mode, Touch ...",Warehouse C,75,63,2025-02-20 17:40:00,12
12996,ORD_12997,36075,Garnier Men Oil Clear Clay D-Tox Deep Cleansing Icy Face Wash 100 Gm,Warehouse A,11,2,2025-02-20 03:23:00,9
12997,ORD_12998,27402,"Herbanics Pink Crush, 100% Natural Lip & Cheek Tint, Blush For Women- 8 ml",Warehouse B,102,93,2025-02-20 05:05:00,9
12998,ORD_12999,28000,"Ultra fast 5V 10W Mi Trimmer Usb Charging Cable Compatible with most mi trimmer, Shavers, Body Groomers & Multi Grooming M...",Warehouse B,64,53,2025-02-20 14:30:00,11
12999,ORD_13000,36291,"Nokia 3310 Dual SIM Keypad Phone with MP3 Player, Wireless FM Radio and Rear Camera | Grey",Warehouse B,27,13,2025-02-20 01:44:00,14
13000,ORD_13001,12628,Xacflo 200 Tablet,Warehouse A,113,95,2025-02-20 15:50:00,18
13001,ORD_13002,9946,"Duracell Ultra Alkaline 9V Battery, 1 Pc",Warehouse C,101,94,2025-02-20 10:35:00,7
13002,ORD_13003,12629,Megacool DSR 30mg/20mg Capsule,Warehouse B,67,59,2025-02-20 03:37:00,8
13003,ORD_13004,5063,Drosym 80mg/250mg Tablet,Warehouse C,75,64,2025-02-20 07:06:00,11
13004,ORD_13005,19228,Denac SP 100mg/325mg/15mg Tablet,Warehouse C,97,85,2025-02-20 07:56:00,12
13005,ORD_13006,28876,Nikhaar Hair Removal Cream For All Skin Types,Warehouse A,26,13,2025-02-20 03:35:00,13
13006,ORD_13007,221,Rejuvenating UBTAN Lip Balm - Vanilla 5 gm,Warehouse B,80,72,2025-02-20 15:53:00,8
13007,ORD_13008,15176,Nutriment Shea Buter Face and Body Scrub All Skin Type 250 gm,Warehouse B,116,98,2025-02-20 00:11:00,18
13008,ORD_13009,19215,ORCHID ENGINEERS Stylish Iron Remote Stand For Home (Black Glossy Finish),Warehouse A,19,1,2025-02-20 15:51:00,18
13009,ORD_13010,31976,Urti 500 Tablet,Warehouse A,81,73,2025-02-20 12:58:00,8
13010,ORD_13011,9673,Dicmak MR 250mg/50mg/325mg Tablet,Warehouse B,67,59,2025-02-20 00:40:00,8
13011,ORD_13012,17367,Instaglow Facial Kit 1'S,Warehouse C,38,22,2025-02-20 10:42:00,16
13012,ORD_13013,27862,"WeCool B2 One Click Button Controlled Mobile Holder for Bikes/Motorcycle/Mobile Holder for Scooty, Ideal for Maps and GPS ...",Warehouse B,17,4,2025-02-20 23:56:00,13
13013,ORD_13014,11508,"Santhosh Enterprises 5V 10W Usb Charging Cable For Mi Trimmer, Shavers, Body Groomers & Multi Grooming Models (Replacement...",Warehouse B,86,75,2025-02-20 22:27:00,11
13014,ORD_13015,20037,Scabiwon-CT Lotion,Warehouse B,108,96,2025-02-20 13:05:00,12
13015,ORD_13016,29663,Salbudox Syrup,Warehouse A,47,42,2025-02-20 23:32:00,5
13016,ORD_13017,10237,The Shield - Pollution Protect Face + Beard Wash,Warehouse A,101,93,2025-02-20 13:06:00,8
13017,ORD_13018,11101,Vega Essentials Manicure Set (MS - 13) 57 gm,Warehouse B,18,5,2025-02-20 17:01:00,13
13018,ORD_13019,29917,"Advansed Jasmine, Non Sticky Coconut Hair Oil",Warehouse B,91,85,2025-02-20 13:54:00,6
13019,ORD_13020,20047,TheGiftKart Tough Armor Bumper Back Cover Case for Realme Narzo 50 Pro 5G | Ring Holder & Kickstand in-Built | 360 Degree ...,Warehouse C,75,67,2025-02-20 09:47:00,8
13020,ORD_13021,11372,Robustrion Deer Pattern Flip Stand Case Cover for Samsung Galaxy Tab A8 10.5 inch [SM-X200/X205/X207] 2022 - Grey,Warehouse A,39,31,2025-02-20 09:23:00,8
13021,ORD_13022,15507,Cefotone 50mg Dry Syrup,Warehouse A,103,96,2025-02-20 14:06:00,7
13022,ORD_13023,35067,Casual Body Mist - For Man,Warehouse C,86,71,2025-02-20 21:22:00,15
13023,ORD_13024,11504,Gemblue Biocare 24 Carat Gold Face Wash 150 ml,Warehouse A,104,92,2025-02-20 18:22:00,12
13024,ORD_13025,27458,9 to 5 Primer + Matte Powder Foundation Compact,Warehouse B,101,92,2025-02-20 11:32:00,9
13025,ORD_13026,5149,"Regenerist - Advanced Anti-Ageing, Revitalizing Face Wash Cleanser",Warehouse B,103,86,2025-02-20 21:56:00,17
13026,ORD_13027,20060,Acelive P Syrup,Warehouse B,77,69,2025-02-20 10:02:00,8
13027,ORD_13028,478,"Storite 3 Meter USB 3.0 Male to Female Extension Cable High Speed 5GBps Extension Cable Data Transfer for Keyboard, Mouse,...",Warehouse C,92,82,2025-02-20 08:24:00,10
13028,ORD_13029,29126,"Quantum 4 Port USB Hub (1 Port 3.0 & 3 Port 2.0) with High Speed Data Transfer, Plug Play Usage, Compatible with Laptop, P...",Warehouse A,99,88,2025-02-20 21:07:00,11
13029,ORD_13030,9814,Cilarite 50mg Tablet,Warehouse C,61,43,2025-02-20 07:33:00,18
13030,ORD_13031,4135,"Turmeric Cream - Anti-Acne, Ayurvedic, For Women",Warehouse B,105,96,2025-02-20 04:22:00,9
13031,ORD_13032,15416,Flormar Diamonds Baked Eye Shadow D08 Golden Brown 5 gm,Warehouse A,83,70,2025-02-20 10:30:00,13
13032,ORD_13033,27801,Apricot Scrub Face Pack,Warehouse C,65,46,2025-02-20 09:49:00,19
13033,ORD_13034,9771,Endol Plus Oral Suspension,Warehouse A,63,57,2025-02-20 17:24:00,6
13034,ORD_13035,16265,TWC Day Sanitary Pads Value Pack of 32 180 gm,Warehouse B,65,55,2025-02-20 19:23:00,10
13035,ORD_13036,35326,Lush Strawberry Bathing Bar,Warehouse A,65,52,2025-02-20 16:49:00,13
13036,ORD_13037,16267,Maryaj Dynamic EDP Spicy Woody Perfume And Ajmal Wisal Dhahab Deodorant Fruity Floral Fragrance 300 ml,Warehouse C,23,5,2025-02-20 09:06:00,18
13037,ORD_13038,35328,Vexdin 120mg Tablet,Warehouse B,62,55,2025-02-20 01:42:00,7
13038,ORD_13039,19178,Ayurvedic Ashwagandha Powder,Warehouse B,51,34,2025-02-20 23:55:00,17
13039,ORD_13040,19177,Vaycef 500 Injection,Warehouse C,38,26,2025-02-20 03:31:00,12
13040,ORD_13041,492,Tenumet 500mg/20mg Tablet ER,Warehouse B,74,58,2025-02-20 22:01:00,16
13041,ORD_13042,28964,Zycoxia MR 60mg/4mg Tablet,Warehouse C,71,58,2025-02-20 02:34:00,13
13042,ORD_13043,9765,Alcohol Based Hand Sanitizer,Warehouse B,67,52,2025-02-20 13:09:00,15
13043,ORD_13044,16230,Flormar Quick Dry Nail Enamel QD18 Only VIP 11 ml,Warehouse B,65,54,2025-02-20 09:54:00,11
13044,ORD_13045,19505,Urban Musk Eau De Toilette Deodorant - For Man,Warehouse A,7,1,2025-02-20 15:01:00,6
13045,ORD_13046,1096,Arxona Metallic camera ring lens protector (Tempered Glass) Black Colour for Apple Iphone 11/12/12 Mini to Protect the cam...,Warehouse B,58,41,2025-02-20 11:24:00,17
13046,ORD_13047,15181,"Waterproof D20 Touchscreen Smart Watch Bluetooth Smartwatch with Blood Pressure Tracking, Heart Rate Sensor and Basic Func...",Warehouse A,45,37,2025-02-20 20:39:00,8
13047,ORD_13048,1095,Vama Fashions Maroon Round Velvet Small Bindis Tilak Kumkum Bindi Tikka for Girls Women Ladies (bindis for ladies maroon),Warehouse A,28,11,2025-02-20 23:01:00,17
13048,ORD_13049,5059,"ZEBRONICS Zeb-Dash Plus 2.4GHz High Precision Wireless Mouse with up to 1600 DPI, Power Saving Mode, Nano Receiver and Plu...",Warehouse B,110,92,2025-02-20 01:22:00,18
13049,ORD_13050,19504,boAt Bassheads 220 Wired in Ear Earphones with Mic(Raging Red),Warehouse B,92,75,2025-02-20 10:38:00,17
13050,ORD_13051,12360,"Note Mattever Lipstick 18, Heartbeat Red, 4 g",Warehouse A,109,92,2025-02-20 09:07:00,17
13051,ORD_13052,17790,SiSAH 4 Channel 220V Wireless Remote Control Switch,Warehouse A,33,25,2025-02-20 02:14:00,8
13052,ORD_13053,30709,"Peppermint Exfol Gel - Treats Blackheads, Refreshes & Brightens",Warehouse A,55,38,2025-02-20 15:49:00,17
13053,ORD_13054,31710,"AGLEY  NATURAL COLOR CHANGING GEL WATER PROOF LIPSTICK  (ORANGE, 3.6 g)",Warehouse A,51,39,2025-02-20 15:06:00,12
13054,ORD_13055,17613,Grapzone-S Injection,Warehouse B,38,23,2025-02-20 10:03:00,15
13055,ORD_13056,19147,Fashion Colour Papaya Face Mask 130 gm,Warehouse B,97,81,2025-02-20 08:22:00,16
13056,ORD_13057,25608,"KINGONE Upgraded Stylus Pen, iPad Pencil, Ultra High Precision & Sensitivity, Palm Rejection, Prevents False ON/Off Touch,...",Warehouse A,82,71,2025-02-19 19:24:00,11
13057,ORD_13058,24203,Nutriment Milk Extract Kertain Hair Mask 250 gm,Warehouse C,20,11,2025-02-19 23:19:00,9
13058,ORD_13059,31231,Trimox 500mg Capsule,Warehouse A,49,42,2025-02-19 13:29:00,7
13059,ORD_13060,34030,Romlex 2mg Injection,Warehouse C,101,92,2025-02-19 07:12:00,9
13060,ORD_13061,4488,"Zollyss 6-Slot Acrylic Rectangular Home Desk TV Air-Conditioner Remote Control Storage Holder Organizer Stand (Clear, Stan...",Warehouse A,60,49,2025-02-19 09:50:00,11
13061,ORD_13062,15223,"boAt Rockerz 450 Captain America Edition 15 Hours Battery, 40mm Drivers, Padded Ear Cushions, Easy Access Controls and Voi...",Warehouse C,81,69,2025-02-19 05:54:00,12
13062,ORD_13063,12167,"TAGG Verve Connect Ultra 1.78"" AMOLED Display Bluetooth Calling Smartwatch | Always on Display | Password Protection| Func...",Warehouse B,87,79,2025-02-19 17:42:00,8
13063,ORD_13064,17467,"Garnier Hair Color (70 ml + 60 g) Shade 4, Brown+Loreal Paris Shampoo 75 ml",Warehouse C,70,63,2025-02-19 23:01:00,7
13064,ORD_13065,24196,Welcoat 12mg Tablet,Warehouse B,102,97,2025-02-19 22:00:00,5
13065,ORD_13066,24221,Quantum QHM6633 4-Port Hi-Speed USB Hub with 480 Mbps Speed (Multicolor),Warehouse A,45,32,2025-02-19 07:24:00,13
13066,ORD_13067,33741,Stbotanica Bubble Gum Body Wash With Shea & Vitamin E 250 ml,Warehouse A,60,44,2025-02-19 07:10:00,16
13067,ORD_13068,3330,Doel 650mg Tablet,Warehouse C,113,96,2025-02-19 01:27:00,17
13068,ORD_13069,13486,Azivent-XL 200mg Rediuse Oral Suspension,Warehouse B,70,52,2025-02-19 16:10:00,18
13069,ORD_13070,3236,"Zebronics Zeb-Power Wired USB Mouse, 3-Button, 1200 DPI Optical Sensor, Plug & Play, for Windows/Mac",Warehouse A,85,74,2025-02-19 03:46:00,11
13070,ORD_13071,31412,Brain Freezer Silicone Cover/Case for Fire TV 4K/Fire TV /Compatible with All 2nd Gen Alexa Voice Remote Control Black (Re...,Warehouse B,43,26,2025-02-19 16:50:00,17
13071,ORD_13072,33722,"Sounce 8 in 1 Soft Brush Cleaning Tools Kit for Keyboard, Earphone, Laptop, Camera & Lens, LED LCD Screen Display Cleaner ...",Warehouse C,57,51,2025-02-19 01:19:00,6
13072,ORD_13073,37101,Joecold Kid Oral Suspension,Warehouse B,70,56,2025-02-19 09:46:00,14
13073,ORD_13074,6326,Jovees Hair Conditioning Shampoo - Honey & Apple 250 ml,Warehouse A,80,75,2025-02-19 16:02:00,5
13074,ORD_13075,2178,"(Renewed) OnePlus 5T (Midnight Black, 6GB RAM, 64GB Storage)",Warehouse B,22,5,2025-02-19 05:31:00,17
13075,ORD_13076,10880,"Fashion Colour Eyeshadow Palette 6 Colours, Shade 03 12 gm",Warehouse B,37,26,2025-02-19 16:36:00,11
13076,ORD_13077,7124,Liv-12 Tablets,Warehouse C,67,53,2025-02-19 13:23:00,14
13077,ORD_13078,2063,Argisept 1%/0.2% Cream,Warehouse C,87,78,2025-02-19 02:03:00,9
13078,ORD_13079,11714,Zolecus Itr 100mg Capsule,Warehouse A,26,14,2025-02-19 19:18:00,12
13079,ORD_13080,17716,"Xiran Plastic Wall Hanging Mobile Phone Holder Stand for Home & Office Use Charging Stand, Charging Stand for All Smartpho...",Warehouse A,24,12,2025-02-19 12:54:00,12
13080,ORD_13081,23083,DeBelle Gel Nail Lacquer Apricot Brulee Dusty Orange Nail Polish 8 ml,Warehouse C,26,8,2025-02-19 17:54:00,18
13081,ORD_13082,1941,Dynotrek Arrival 13-13.3 Inch Laptop Sleeve Case Coverwith Handle Compatible for MacBook Pro 13 M2/M1 Pro/M1 Max 14.2 202...,Warehouse A,7,1,2025-02-19 12:18:00,6
13082,ORD_13083,23082,Planet Waves Lemon Oil_Natural cleaner and conditioner Protects your (Guitar),Warehouse B,64,55,2025-02-19 06:11:00,9
13083,ORD_13084,29070,"Antibacterial Germ Kill Spray - No Gas, Safe On Skin & Surfaces",Warehouse B,80,71,2025-02-19 06:00:00,9
13084,ORD_13085,34010,"Redmi Note 11 (Space Black, 4GB RAM, 64GB Storage)|90Hz FHD+ AMOLED Display | Qualcomm® Snapdragon™ 680-6nm | 33W Charger ...",Warehouse A,62,50,2025-02-19 02:56:00,12
13085,ORD_13086,34017,Jovees Ayurveda Anti Acne & Pimple Cream - Neem & Long Pepper 60 gm,Warehouse A,75,56,2025-02-19 11:35:00,19
13086,ORD_13087,16344,Cypnex Syrup,Warehouse A,38,29,2025-02-19 22:59:00,9
13087,ORD_13088,13772,"Dyazo Capacitive Stylus Pen for All Touch Screens Devices, Fine Point, Lightweight Aluminum Body Compatible with All Andro...",Warehouse C,44,35,2025-02-19 02:42:00,9
13088,ORD_13089,12339,Hydrox 6mg Drop,Warehouse B,21,6,2025-02-19 22:16:00,15
13089,ORD_13090,29025,Eyetex Dazller Classique Compact Powder- 8008 Coffee 9 gm,Warehouse C,17,6,2025-02-19 18:19:00,11
13090,ORD_13091,13773,Sunscreen Lotion SPF 30,Warehouse C,52,44,2025-02-19 08:30:00,8
13091,ORD_13092,2749,"UBON BT-5100 Bluetooth 5.0 Wireless in Ear Earphones with Hi-Fi Stereo Sound, 10Hrs Playtime, Lightweight Ergonomic Neckba...",Warehouse A,82,67,2025-02-19 06:31:00,15
13092,ORD_13093,35852,Milk Delights Face Wash With Honey For Dry Skin,Warehouse C,89,74,2025-02-19 23:22:00,15
13093,ORD_13094,6690,I AM EYECONIC FINE GLITTER PRESTIGE 4 gm,Warehouse C,81,76,2025-02-19 18:33:00,5
13094,ORD_13095,4513,"AmazonBasics microSDHC Memory Card with Full Size Adapter, A1, U1, Read Speed up to 98 MB/s, 32GB",Warehouse C,34,26,2025-02-19 05:29:00,8
13095,ORD_13096,1775,"HUDA BB Professional Makeup Combo Red Edition Lipstick, Eyeshadow, Primer,Foundation, Eyeliner, Mascara, Eyebrow Pencil, C...",Warehouse C,105,86,2025-02-19 20:03:00,19
13096,ORD_13097,29016,"Fashion Colour German Eyeshadow, 07 Forest Green 1.4 gm",Warehouse C,71,59,2025-02-19 18:30:00,12
13097,ORD_13098,25635,Beauty Cream,Warehouse A,73,62,2025-02-19 18:46:00,11
13098,ORD_13099,29009,Rosloy-CV 20 Capsule,Warehouse B,70,52,2025-02-19 03:23:00,18
13099,ORD_13100,25645,Cilblock 10mg Tablet,Warehouse C,90,83,2025-02-19 11:14:00,7
13100,ORD_13101,35837,"SATYAM KRAFT 50 Pcs Paper Small Traditional Printed Gift Tag for Notecards, Gifting, Anniversary, Christmas, Birthday Than...",Warehouse C,39,20,2025-02-19 06:09:00,19
13101,ORD_13102,17575,Daily Life Forever52 Slanted Flat Top Foundation Brush Nx001 1's,Warehouse A,64,55,2025-02-19 01:12:00,9
13102,ORD_13103,15516,"HIKVISION 8 Channel DVR 1080P Lite H.265Pro+ 2MP DVR DS-7108HGHI-K1 with USEWELL HDMI (Without Hard Drive), White",Warehouse A,44,35,2025-02-19 11:49:00,9
13103,ORD_13104,32257,"Bath Loofah - White, Colour May Vary",Warehouse C,68,54,2025-02-19 07:54:00,14
13104,ORD_13105,32258,Schwarzkopf Professional Bonacure pH4.5 Color Freeze Deep Conditioning Treatment | For Colored Hair | 200ml,Warehouse C,49,30,2025-02-19 21:28:00,19
13105,ORD_13106,773,"Fashion Colour Cover Up Liquid Concealer, Shade 06 11 gm",Warehouse C,56,50,2025-02-19 01:53:00,6
13106,ORD_13107,6348,Ajmal Wisal & Wisal Dhahab & Sacred Love & Silver Shade Deo & Yearn EDP Pack of 5 820 ml,Warehouse B,12,2,2025-02-19 02:01:00,10
13107,ORD_13108,13294,"SKYTONE USB Universal Travel Adapter, International All in One Worldwide Travel Adapter and Wall Charger with USB Ports wi...",Warehouse A,111,93,2025-02-19 15:21:00,18
13108,ORD_13109,25591,Gandha Thailam,Warehouse A,11,2,2025-02-19 04:32:00,9
13109,ORD_13110,32225,Skin Whitening Hair Remover Cream,Warehouse C,26,19,2025-02-19 15:51:00,7
13110,ORD_13111,4463,Camel Oil Pastel with Reusable Plastic Box - 50 Shades,Warehouse C,77,59,2025-02-19 13:48:00,18
13111,ORD_13112,33316,SNDIA 2-Set Multipurpose Transparent Travel Pouch Makeup Toiletry Kit Bag Cosmetic Pouch for Women Makeup Organizer Bag Pl...,Warehouse A,94,86,2025-02-19 08:03:00,8
13112,ORD_13113,32230,Starstat 10mg Tablet,Warehouse A,77,71,2025-02-19 22:38:00,6
13113,ORD_13114,35885,"BELLAS TYA 6155 Makeup Kit and 7 Black Makeup Brushes,Contour Stick,Primer,Fixer,Foundation,Kajal, 36H Eyeliner,Eyelashes...",Warehouse C,73,64,2025-02-19 23:06:00,9
13114,ORD_13115,3325,ANCHOR by Panasonic 5219 6A Cherry Flecicord Socket 2 Pin 8M (White),Warehouse C,104,97,2025-02-19 17:45:00,7
13115,ORD_13116,7156,LYF Earth 1 (White),Warehouse C,95,82,2025-02-19 06:43:00,13
13116,ORD_13117,37020,"HP 15s,11th Gen Intel Core i3-1115G4 8GB RAM/512GB SSD 15.6""(39.6 cm) FHD/Alexa Built-in/Win 11/Intel UHD Graphics/MSO 202...",Warehouse B,46,34,2025-02-19 22:04:00,12
13117,ORD_13118,25731,Acidom O 4 mg/150 mg Tablet,Warehouse C,45,34,2025-02-19 00:54:00,11
13118,ORD_13119,19592,Maryaj Lilas EDP Citrus Floral Perfume And Ajmal Raindrops Femme Deodorant Floral Chypre Fragrance 300 ml,Warehouse C,29,14,2025-02-19 02:10:00,15
13119,ORD_13120,21150,Eradiplate-AV Tablet,Warehouse A,84,70,2025-02-19 17:47:00,14
13120,ORD_13121,1352,Amazon Brand - Solimo Thermoplastic Polyurethane Back Cover For Samsung Galaxy Note 9 (Transparent),Warehouse C,32,26,2025-02-19 22:13:00,6
13121,ORD_13122,8719,Amazon Brand - Solimo Thermoplastic Polyurethane Mobile Cover Soft & Flexible Shockproof Back Cover with Cushioned Edges T...,Warehouse A,73,65,2025-02-19 16:34:00,8
13122,ORD_13123,3092,Badam Tail - 100% Pure Almond Oil 100 ml + 50 ml,Warehouse C,37,18,2025-02-19 07:14:00,19
13123,ORD_13124,12644,Makeup Revolution H2O Hydrate Fix Mist 50 ml,Warehouse A,72,61,2025-02-19 11:50:00,11
13124,ORD_13125,34583,Rp-Clav 625 Tablet,Warehouse B,44,32,2025-02-19 03:40:00,12
13125,ORD_13126,14690,TLC Soft Gel Hair Colour - Dark Brown,Warehouse A,90,84,2025-02-19 19:08:00,6
13126,ORD_13127,1380,Prolomet XL 50 Tablet,Warehouse C,41,36,2025-02-19 01:20:00,5
13127,ORD_13128,34547,Mcrofy 25mg Suspension,Warehouse A,52,37,2025-02-19 21:15:00,15
13128,ORD_13129,9635,"GUFFI G33 Premium Smart Foldable Mobile Stand for Table and Bed, Height Adjustable Universal Tabletop Phone Holder for All...",Warehouse A,65,46,2025-02-19 08:27:00,19
13129,ORD_13130,20422,Spigen EZ Fit Privacy Tempered Glass Screen Protector for iPhone 14 Pro Max - 2 Pack,Warehouse C,68,54,2025-02-19 11:07:00,14
13130,ORD_13131,27302,Ajmal 3 Blu Deo & Aretha EDP Pack of 4 20 ml,Warehouse A,80,66,2025-02-19 02:48:00,14
13131,ORD_13132,30760,Ilift Eye Repair Gel | Eye Gel For Reducing Fine Lines And Wrinkles | Eye Gel For Sign Of Ageing | Under Eye Puffiness Rem...,Warehouse A,99,82,2025-02-19 08:38:00,17
13132,ORD_13133,8726,Levamra 500mg Tablet,Warehouse C,78,63,2025-02-19 07:36:00,15
13133,ORD_13134,15534,Tukzer 4G LTE Wireless Dongle with All SIM Network Support | Plug & Play Data Card Stick with up to 150Mbps WiFi Hotspot |...,Warehouse C,44,32,2025-02-19 04:05:00,12
13134,ORD_13135,3469,Genuinebattery Maxell LR41 AG3 LR736 392 392a 192 SR41 Button Coin Cell Battery - Pack of 10,Warehouse A,74,65,2025-02-19 05:13:00,9
13135,ORD_13136,5140,Uribid Tablet,Warehouse C,36,29,2025-02-19 19:53:00,7
13136,ORD_13137,27127,Power 10 Formula WR Effector,Warehouse B,24,19,2025-02-19 13:33:00,5
13137,ORD_13138,20246,Timanol 0.25% Eye Drop,Warehouse C,29,20,2025-02-19 18:27:00,9
13138,ORD_13139,3508,Medimade Goat Milk Premium Soap 100 gm,Warehouse B,53,43,2025-02-19 03:05:00,10
13139,ORD_13140,5207,Apgest Syrup,Warehouse B,56,40,2025-02-19 07:49:00,16
13140,ORD_13141,5151,"insta360 Invisible Selfie Stick for ONE X, ONE R Action Camera - Black",Warehouse A,40,26,2025-02-19 02:06:00,14
13141,ORD_13142,27328,Argan Oil & Avocado Butter Body Lotion For Very Dry Skin - Autumn Edition,Warehouse A,83,67,2025-02-19 10:03:00,16
13142,ORD_13143,27165,Dreamflower Fragrant Talc,Warehouse C,54,35,2025-02-19 20:18:00,19
13143,ORD_13144,14349,Nokia 105 Single SIM (Pink),Warehouse A,81,66,2025-02-19 02:36:00,15
13144,ORD_13145,34794,Tpmol 37.5mg/325mg Tablet,Warehouse B,38,21,2025-02-19 04:07:00,17
13145,ORD_13146,21095,KAPAVER® Transparent Back Cover Case with [Edge-to-Edge] [Full Glue] [Anti-Scratch] Tempered Glass for Nothing Phone 1 5G...,Warehouse A,87,69,2025-02-19 04:10:00,18
13146,ORD_13147,26670,Cefwar 200mg Tablet,Warehouse B,89,82,2025-02-19 23:27:00,7
13147,ORD_13148,25952,St.Botanica Body Wash - Indian Vetiver Grass Cooler 250 ml,Warehouse B,105,94,2025-02-19 11:29:00,11
13148,ORD_13149,21693,Fashion Colour Charcoal Face Wash 130 gm,Warehouse A,100,91,2025-02-19 13:57:00,9
13149,ORD_13150,32027,Crucial BX500 1TB 3D NAND SATA 6.35 cm (2.5-Inch) Internal SSD - CT1000BX500SSD1,Warehouse C,106,87,2025-02-19 23:02:00,19
13150,ORD_13151,17664,GLOMIC Diamond Hydrating Glitter Lip Balm Lipstick (Pack Of 4),Warehouse C,14,9,2025-02-19 08:22:00,5
13151,ORD_13152,31204,Coolora Mouth Wash,Warehouse B,64,55,2025-02-19 07:05:00,9
13152,ORD_13153,16291,Fructis - Long & Strong Strengthening Shampoo,Warehouse B,56,44,2025-02-19 08:19:00,12
13153,ORD_13154,24273,"Anti-Pollution Daily Face Cream, For Dry & Oily Skin, For a Bright Glowing Skin",Warehouse A,29,19,2025-02-19 18:51:00,10
13154,ORD_13155,499,Glycodac 80 Tablet,Warehouse A,25,7,2025-02-19 13:25:00,18
13155,ORD_13156,31197,Raulaz 500mg Tablet,Warehouse C,81,65,2025-02-19 19:01:00,16
13156,ORD_13157,6306,Teniley 20mg Tablet,Warehouse B,12,3,2025-02-19 06:47:00,9
13157,ORD_13158,28928,Itrawall 100 Capsule,Warehouse C,41,27,2025-02-19 11:24:00,14
13158,ORD_13159,17680,Supra 20mg Capsule DR,Warehouse A,34,25,2025-02-19 05:16:00,9
13159,ORD_13160,10945,Cynoxil 250mg Tablet,Warehouse A,95,81,2025-02-19 13:45:00,14
13160,ORD_13161,23173,Cureclav 500 mg/125 mg Tablet,Warehouse B,45,39,2025-02-19 20:57:00,6
13161,ORD_13162,31410,Pikkme Redmi 9A / 9i / 9A Sport Leather Flip Cover Wallet Case for Redmi 9A / 9i / 9A Sport (Blue),Warehouse C,80,65,2025-02-19 03:00:00,15
13162,ORD_13163,35827,5-In-1 Body & Face Massager - Colour May Vary,Warehouse B,91,86,2025-02-19 01:52:00,5
13163,ORD_13164,28979,Ajmal Deep Earth Edt Of 2 & Nightingale Deodorant Pack of 2 450 ml,Warehouse A,41,25,2025-02-19 12:29:00,16
13164,ORD_13165,28976,"Cetaphil PRO Oil Control Moisturising Lotion, Matte Finish for Oily & Acne Prone Skin WITH SPF 30 120ml",Warehouse C,116,99,2025-02-19 00:45:00,17
13165,ORD_13166,35824,Telpart 40mg Tablet,Warehouse C,34,24,2025-02-19 14:24:00,10
13166,ORD_13167,23181,Panasonic CR-2025/5BE Lithium Coin Battery - Pack of 5,Warehouse C,11,4,2025-02-19 00:08:00,7
13167,ORD_13168,36238,Uncle Tony Shaving Razor - Blue,Warehouse C,86,72,2025-02-19 12:58:00,14
13168,ORD_13169,4540,Archies Parfum NEW GIRLS PARFUM ORIGINAL 50 ml,Warehouse B,89,71,2025-02-19 14:11:00,18
13169,ORD_13170,28935,Miss Claire Tinted Lip Balm 03 3 Gm,Warehouse B,105,86,2025-02-19 01:31:00,19
13170,ORD_13171,25678,Miczone 250 Injection,Warehouse A,81,63,2025-02-19 19:06:00,18
13171,ORD_13172,13792,JGD PRODUCTS OG Shock Proof Protective Soft Back Case Cover for iPhone 6 / iPhone 6S (Transparent) [Bumper Corners with Ai...,Warehouse A,20,10,2025-02-19 12:04:00,10
13172,ORD_13173,13795,Lulibrut Lotion,Warehouse C,78,63,2025-02-19 14:19:00,15
13173,ORD_13174,10915,Beardo Vitamin C Body Yogurt Moisturizer Cream 120 gm,Warehouse B,55,47,2025-02-19 19:56:00,8
13174,ORD_13175,23154,Umoxtif CL 500mg/125mg Tablet,Warehouse C,22,8,2025-02-19 21:25:00,14
13175,ORD_13176,6335,Ondinet Syrup,Warehouse A,70,58,2025-02-19 09:08:00,12
13176,ORD_13177,24234,"Fashion Colour Dual Face Powder & Blusher, Shade 10 7.5 gm",Warehouse B,31,26,2025-02-19 09:12:00,5
13177,ORD_13178,23257,Samsung 970 EVO Plus 500GB PCIe NVMe M.2 (2280) Internal Solid State Drive (SSD) (MZ-V7S500),Warehouse A,102,87,2025-02-19 15:39:00,15
13178,ORD_13179,35755,Clonapsy 0.5mg Tablet MD,Warehouse C,86,77,2025-02-19 05:17:00,9
13179,ORD_13180,31534,Pure Radiance Under Eye Serum,Warehouse C,84,72,2025-02-19 09:37:00,12
13180,ORD_13181,24333,Domriv C 15mg/20mg Tablet,Warehouse B,57,46,2025-02-19 05:23:00,11
13181,ORD_13182,7871,"Jade Roller Massager For Face, Neck & Head - Colour May Vary",Warehouse A,20,9,2025-02-19 02:12:00,11
13182,ORD_13183,13105,Miss Claire Nature Essence Face Mask - Volcanic 25 Ml,Warehouse B,26,12,2025-02-19 23:00:00,14
13183,ORD_13184,24996,Ajmal Blu & Silver Shade & Evoke silver Edition Homme & Shadow Homme Deo & Neea EDP Pack of 5 20 ml,Warehouse A,90,82,2025-02-19 18:14:00,8
13184,ORD_13185,7879,cauvery Saffron Sandal Soap - Pack of 3(125g),Warehouse C,57,51,2025-02-19 09:22:00,6
13185,ORD_13186,16233,Sertan 50mg Tablet,Warehouse B,107,93,2025-02-19 01:51:00,14
13186,ORD_13187,25805,Psypid 1 Tablet,Warehouse B,87,73,2025-02-19 05:05:00,14
13187,ORD_13188,28807,Aljid Cold Oral Suspension,Warehouse C,75,61,2025-02-19 22:22:00,14
13188,ORD_13189,32322,Locas H 50mg/12.5mg Tablet,Warehouse B,76,61,2025-02-19 05:37:00,15
13189,ORD_13190,13308,Arata Natural Damage Repair Duo With Hydrating Shampoo & Conditioner Daily Damage Repair 600 ml,Warehouse A,103,88,2025-02-19 11:29:00,15
13190,ORD_13191,24993,Aecef 1000mg Injection,Warehouse C,51,40,2025-02-19 01:08:00,11
13191,ORD_13192,33504,Aztic 200mg Oral Suspension,Warehouse A,68,52,2025-02-19 04:43:00,16
13192,ORD_13193,17908,Day & Night Cream Skin Care Combo,Warehouse C,49,42,2025-02-19 06:32:00,7
13193,ORD_13194,12143,"Epson 005 120 ml Black Ink Bottle, Compatible with M1100/M1120/M2140 Epson Printer Models",Warehouse B,100,86,2025-02-19 23:20:00,14
13194,ORD_13195,31489,Emt D 30mg/40mg Capsule,Warehouse B,23,18,2025-02-19 20:53:00,5
13195,ORD_13196,32014,Arata Green Tea Seed Serum For Radiance & Enhanced Elasticity Infused With Pure Green Tea Seed Oil 30 ml,Warehouse B,13,8,2025-02-19 22:52:00,5
13196,ORD_13197,28826,Man Deodorant Spray,Warehouse B,104,87,2025-02-19 18:15:00,17
13197,ORD_13198,12146,"OREI US to India Converter Plug, Universal Adapter Plug India, USA, UK to India Adapter Plug - Type D Adapter - 2 in 1 Can...",Warehouse C,62,51,2025-02-19 20:59:00,11
13198,ORD_13199,29747,"Gizga Essentials Laptop Bag Sleeve Case Cover Pouch for 14.1 Inch Laptop/MacBook, Office/ College Laptop Bag for Men & Wom...",Warehouse A,21,8,2025-02-19 16:44:00,13
13199,ORD_13200,17849,"KINGONE Wireless Charging Pencil (2nd Generation) for iPad with Magnetic and Tilt Sensitive, Palm Rejection, Compatible wi...",Warehouse B,33,20,2025-02-19 23:19:00,13
13200,ORD_13201,24297,Aegte Oil Free Anti Acne Treatment Facial Skin Perfection Gel 50 ml,Warehouse B,99,81,2025-02-19 15:16:00,18
13201,ORD_13202,2183,Aloe Veda Handwash - Orange & Sweet Lemon Oil 250 ml,Warehouse C,99,86,2025-02-19 16:23:00,13
13202,ORD_13203,23027,Azitime-DT Tablet,Warehouse C,14,6,2025-02-19 04:09:00,8
13203,ORD_13204,3229,Lynoral 0.01 Tablet,Warehouse B,64,57,2025-02-19 20:59:00,7
13204,ORD_13205,23019,"IKALL K100 Mobile (1.8 Inch, Dual Sim) (Blue)",Warehouse C,81,70,2025-02-19 20:17:00,11
13205,ORD_13206,3783,Oncophos 200mg Injection,Warehouse A,94,84,2025-02-19 00:36:00,10
13206,ORD_13207,15544,"Foot Scrubber for Dead Skin,Pedicure Tools for Feet,Foot File for Women,Foot Cleaner Brush,Foot Scraper Callus Remover,Hee...",Warehouse B,37,22,2025-02-19 09:28:00,15
13207,ORD_13208,35769,"POPIO Tempered Glass Compatible for iPhone 13 Pro Max (Transparent) Full Screen Coverage except edges, Pack Of 1",Warehouse C,62,45,2025-02-19 07:10:00,17
13208,ORD_13209,17801,"Lotus Herbals Whiteglow Advanced Pink Glow Face Wash, 100 g",Warehouse B,77,68,2025-02-19 14:45:00,9
13209,ORD_13210,33706,"Reversible Unisex Cotton Mask - 2 Layer, Assorted Colors, Assorted Checks & Stripes",Warehouse C,48,31,2025-02-19 12:48:00,17
13210,ORD_13211,10814,Wayona 20W Dual Port USB C+USB A Fast Charging PD/QC 3.0 Charger Compatible with iPhone 14 13 12 11 Pro/Max/Mini Samsung G...,Warehouse A,80,63,2025-02-19 18:50:00,17
13211,ORD_13212,2192,Tampros MR 0.4mg Tablet,Warehouse B,66,50,2025-02-19 02:27:00,16
13212,ORD_13213,28820,Cef Rich O Tablet,Warehouse A,21,6,2025-02-19 15:01:00,15
13213,ORD_13214,34125,Vega Round Brush (H6 - RB) 103 gm,Warehouse C,89,71,2025-02-19 02:23:00,18
13214,ORD_13215,7866,Gabantin 400 Capsule,Warehouse C,41,24,2025-02-19 12:15:00,17
13215,ORD_13216,16592,EGOTUDE Slim Fit Silicone Soft Logo Cut Matte Back Cover Case for iPhone 14 (Sierra Blue),Warehouse C,47,37,2025-02-19 23:17:00,10
13216,ORD_13217,14688,mCaffeine Body Toning & Polishing Kit 400 gm,Warehouse C,51,32,2025-02-19 21:45:00,19
13217,ORD_13218,7448,Datrix 250mg Injection,Warehouse B,70,60,2025-02-19 06:05:00,10
13218,ORD_13219,13229,M Lev Kid 2.5mg/4mg Tablet MD,Warehouse B,26,8,2025-02-19 20:18:00,18
13219,ORD_13220,25354,"ViewSonic VA2215-H Full HD 1080p 22 Inch LED Backlit Display Gaming Monitor, AMD FreeSync™ 75Hz, SuperClear®, 3 Side Borde...",Warehouse A,72,55,2025-02-19 16:16:00,17
13220,ORD_13221,12250,Gizga Essentials Laptop Bag Sleeve Case Cover Pouch for 13.3-Inch Laptop for Men & Women Reversible Neoprene (Black + Red),Warehouse C,66,49,2025-02-19 14:01:00,17
13221,ORD_13222,11574,The Skin Story Facewash - French Red Clay & Rose Hip 100 gm,Warehouse B,86,69,2025-02-19 13:00:00,17
13222,ORD_13223,1850,Mdryl Syrup,Warehouse C,76,61,2025-02-19 05:06:00,15
13223,ORD_13224,7452,Asnac TH 100mg/8mg Tablet,Warehouse B,72,61,2025-02-19 08:35:00,11
13224,ORD_13225,16571,Aravi Organic Rosemary Essential Oil for Hair Growth - 30 ml | 100% Pure and Natural - Premium Therapeutic Grade,Warehouse C,49,40,2025-02-19 13:32:00,9
13225,ORD_13226,23705,Herbal Coconut Milk & Honey Soap,Warehouse A,67,59,2025-02-19 12:04:00,8
13226,ORD_13227,30199,Teggo 8mg Tablet,Warehouse A,99,89,2025-02-19 13:20:00,10
13227,ORD_13228,15473,Faber-Castell Castell 9000 Pencil Set - Pack of 12,Warehouse B,25,10,2025-02-19 20:59:00,15
13228,ORD_13229,25150,Belkind 500mg Tablet,Warehouse B,20,5,2025-02-19 06:17:00,15
13229,ORD_13230,13548,Fairness Kesar Face Pack,Warehouse C,33,21,2025-02-19 01:55:00,12
13230,ORD_13231,33786,Bio Aloe Vera Sunscreen - SPF 30,Warehouse A,116,97,2025-02-19 02:49:00,19
13231,ORD_13232,321,OpenTech® Tempered Glass Screen Protector Compatible for Nothing Phone 1 with Edge to Edge Coverage and Easy Installation kit,Warehouse B,61,48,2025-02-19 23:44:00,13
13232,ORD_13233,23682,Plantas Tan Defence Organic Face Cream 30 gm,Warehouse A,66,58,2025-02-19 06:53:00,8
13233,ORD_13234,36044,Bonacure Conditioner - Repair Rescue,Warehouse A,103,85,2025-02-19 06:34:00,18
13234,ORD_13235,23680,Wayona Usb C 65W Fast Charging Cable Compatible For Tablets Samsung S22 S20 S10 S20Fe S21 S21 Ultra A70 A51 A71 A50S M31 M...,Warehouse A,81,62,2025-02-19 12:24:00,19
13235,ORD_13236,16944,Kapiclav Syrup,Warehouse A,84,74,2025-02-19 17:00:00,10
13236,ORD_13237,16945,Onsitego 1 Year Extended Warranty for Small Household Appliances from Rs. 9001-10000 (Email Delivery - No Physical Kit),Warehouse A,66,60,2025-02-19 07:44:00,6
13237,ORD_13238,30339,Neem Leaves Powder - Supports Blood Purification & Immunity,Warehouse C,82,77,2025-02-19 13:50:00,5
13238,ORD_13239,7661,Acycop 800mg Tablet,Warehouse B,19,8,2025-02-19 23:55:00,11
13239,ORD_13240,22726,Itrovent 200mg Capsule,Warehouse A,47,37,2025-02-19 02:10:00,10
13240,ORD_13241,28883,"Fashion Colour Kiss Lip No Transfer Lipstick, 88 Ocher 2.6 gm",Warehouse C,76,64,2025-02-19 23:24:00,12
13241,ORD_13242,6283,Serie Expert Inforcer Masque,Warehouse A,90,85,2025-02-19 00:27:00,5
13242,ORD_13243,10790,Rainbow Touch Eyeshadow Palette (Natural),Warehouse B,78,69,2025-02-19 01:20:00,9
13243,ORD_13244,13112,Cadglib M 5mg/500mg Tablet,Warehouse C,62,43,2025-02-19 20:48:00,19
13244,ORD_13245,37107,Boult Audio BassBuds X1 in-Ear Wired Earphones with 10mm Extra Bass Driver and HD Sound with mic(Red),Warehouse B,97,86,2025-02-19 23:45:00,11
13245,ORD_13246,17820,"Ajmal 1 Shadow Homme, 1 Wisal, 1 Nightingale And 1 Distraction Deodorants Pack of 4 200 ml",Warehouse A,93,85,2025-02-19 23:53:00,8
13246,ORD_13247,11005,SwooK EVA Shockproof Hard Laptop Sleeve Case Bag Compatible for 13 inch Laptop Sleeve Bags for MacBook Pro M1 14 inch 2021...,Warehouse A,83,72,2025-02-19 05:36:00,11
13247,ORD_13248,17979,Maryaj Wild Stripes EDP Aromatic Oriental Perfume And Ajmal Wisal Dhahab Deodorant Fruity Floral Fragrance 300 ml,Warehouse C,41,26,2025-02-19 14:15:00,15
13248,ORD_13249,36991,Sounce 38W Car Charger Type-C 20W PD & 18W 3.0 Qualcomm Certified Dual USB Car Charger Compatible with All Smartphones & T...,Warehouse C,81,65,2025-02-19 15:41:00,16
13249,ORD_13250,18029,Dinpod CV 200mg/125mg Tablet,Warehouse C,31,20,2025-02-19 15:40:00,11
13250,ORD_13251,31874,"Tygot 3366 Aluminum Tripod (55-Inch), Universal Lightweight Tripod with Mobile Phone Holder Mount & Carry Bag for All Smar...",Warehouse C,39,21,2025-02-19 11:30:00,18
13251,ORD_13252,24375,House of Beauty ICE Roller- Blue 1's,Warehouse A,59,54,2025-02-19 14:21:00,5
13252,ORD_13253,16195,"boAt AAVANTE Bar 1198 90W 2.2 Channel Bluetooth Soundbar, Built-in Active Subwoofers, Multiple Connectivity Modes, Enterta...",Warehouse C,60,55,2025-02-19 10:48:00,5
13253,ORD_13254,32333,Hive 20 Injection,Warehouse C,56,45,2025-02-19 16:50:00,11
13254,ORD_13255,32334,"JOTO TPU Waterproof Phone Case Holder Pouch, Underwater Transparent Cellphone Dry Bag Compatible For iPhone 13 12 11 Pro M...",Warehouse C,111,97,2025-02-19 12:43:00,14
13255,ORD_13256,4635,Vitamin C SPF 50 Sunblock Face & Body Mist Sunscreen UVA/UVB PA+++,Warehouse A,101,89,2025-02-19 02:23:00,12
13256,ORD_13257,12406,Moroccan Argan Oil Anti Wrinkle Regenerating Night Cream,Warehouse A,66,60,2025-02-19 01:44:00,6
13257,ORD_13258,24364,"Syoss - Color Salon Protect Anti Fade, 01 Shampoo",Warehouse C,91,78,2025-02-19 00:56:00,13
13258,ORD_13259,76,Izicin 250mg Tablet,Warehouse A,59,45,2025-02-19 14:26:00,14
13259,ORD_13260,11769,DeBelle Gel Nail Lacquer Roseate Gold Metallic Gold Nail Polish 8 ml,Warehouse C,99,84,2025-02-19 09:37:00,15
13260,ORD_13261,13096,OFIXO Creative Colorful 400 Sheets Memo Pad Note N Times Post Note Paper Free Stickers Post Sticky Notes Stationary,Warehouse B,52,36,2025-02-19 22:06:00,16
13261,ORD_13262,33234,Shot Body Spray - Red Stallion,Warehouse B,102,84,2025-02-19 08:04:00,18
13262,ORD_13263,2206,Beauty People Velvet Matte Nail Polish Matte - Me - Grey - 370 9.9 ml,Warehouse A,41,27,2025-02-19 12:34:00,14
13263,ORD_13264,809,Razor - Black,Warehouse B,39,29,2025-02-19 19:54:00,10
13264,ORD_13265,17980,ALCRAFT Real Leather Green Stone Brown Embossed Handmade Diary with Metal Lock -Size of (H) 6*(L) 4.5 Brown,Warehouse A,78,60,2025-02-19 18:55:00,18
13265,ORD_13266,35711,Colorbar Bewitching Eye Shadow Palette Bep003 6.4 Gm,Warehouse A,92,84,2025-02-19 06:08:00,8
13266,ORD_13267,32342,Decpent 40mg Tablet,Warehouse B,48,40,2025-02-19 11:28:00,8
13267,ORD_13268,32009,Ketonext CT Shampoo,Warehouse A,109,98,2025-02-19 09:59:00,11
13268,ORD_13269,31552,Soclox D 250mg/250mg Tablet,Warehouse B,76,69,2025-02-19 05:16:00,7
13269,ORD_13270,15087,"Tattoo Gizmo Nova Rotary Tattoo Machine Kit For Beginners with Power Supply, Needles Complete Tattoo Kit-Rotary Machine Ta...",Warehouse A,63,53,2025-02-19 21:42:00,10
13270,ORD_13271,13878,Penvir 250 Tablet,Warehouse A,24,6,2025-02-19 20:49:00,18
13271,ORD_13272,25875,Belora Paris Eye-Scream Kajal Black- Longstay Smudgeproof Matte Deeply pigmented |Non-Toxic| Lightweight | Vegan | 24x7 Lo...,Warehouse B,116,98,2025-02-19 00:54:00,18
13272,ORD_13273,33226,"Refresh Skin Science Under Eye Cream Roll-on for Dark Circles, Under Eye Puffiness - Reduces Fine Lines and Wrinkle - For ...",Warehouse B,32,22,2025-02-19 09:56:00,10
13273,ORD_13274,7046,"AYU HINA Henna, Black, 40 g, Pack of 4 (orginal)",Warehouse C,101,87,2025-02-19 04:47:00,14
13274,ORD_13275,23036,Terbid Cream,Warehouse A,59,40,2025-02-19 09:55:00,19
13275,ORD_13276,7113,"Fashion Colour Oil Free Foundation, Shade 01 30 ml",Warehouse A,95,90,2025-02-19 08:35:00,5
13276,ORD_13277,6683,Jycep CV 200mg/125mg Tablet,Warehouse B,98,82,2025-02-19 23:32:00,16
13277,ORD_13278,7115,Amazon Basics HL-007289 RJ45 Cat7 Network Ethernet Patch/LAN Cable for Security Camera - 15 Feet (White),Warehouse C,68,52,2025-02-19 12:36:00,16
13278,ORD_13279,22729,"TP-Link Nano AC600 USB Wi-Fi Adapter(Archer T2U Nano)- 2.4G/5G Dual Band Wireless Network Adapter for PC Desktop Laptop, M...",Warehouse A,60,47,2025-02-19 04:58:00,13
13279,ORD_13280,31995,Lozipam Injection,Warehouse A,14,9,2025-02-19 14:21:00,5
13280,ORD_13281,3753,Crysendo Headphone Cushion for Boat Rockers 510 Headphones | Replacement Ear Cushion Foam Cover Ear Pads Soft Cushion | PU...,Warehouse B,95,81,2025-02-19 07:38:00,14
13281,ORD_13282,22739,Fasrose Asf Capsule,Warehouse A,12,4,2025-02-19 14:59:00,8
13282,ORD_13283,4132,RONEMOX 250 MG TABLET,Warehouse B,80,65,2025-02-19 11:08:00,15
13283,ORD_13284,11733,"iQOO Z6 Pro 5G by vivo (Phantom Dusk, 8GB RAM, 128GB Storage) | Snapdragon 778G 5G | 66W FlashCharge | 1300 nits Peak Brig...",Warehouse B,90,82,2025-02-19 13:45:00,8
13284,ORD_13285,22983,Lazocin 250mg Tablet,Warehouse C,39,29,2025-02-19 02:55:00,10
13285,ORD_13286,4130,"Enter Black HD LED Backlit 15.4"" inch Monitor with HDMI and VGA (E-MO-A06(N))",Warehouse A,24,9,2025-02-19 12:21:00,15
13286,ORD_13287,31872,FOZZBYMini 18 Colors Eyeshadow Palette Matte Rainbow Shimmer High Pigmentation Eye Shadow Waterproof Long Lasting Colorful...,Warehouse C,93,81,2025-02-19 14:25:00,12
13287,ORD_13288,17835,Avinova 20mg Capsule,Warehouse C,59,41,2025-02-19 06:28:00,18
13288,ORD_13289,28827,On Deodorant Spray - Men,Warehouse B,77,68,2025-02-19 11:58:00,9
13289,ORD_13290,25831,Ajmal Bastion EDP Woody Aromatic Perfume And Selfie Concentrated Perfume Oil Woody Aromatic 110 ml,Warehouse A,60,52,2025-02-19 07:39:00,8
13290,ORD_13291,36606,"pTron Bassbuds Pixel with Dedicated Movie/Gaming Mode, 50ms Low Latency, 35Hrs Total Playback Time, Truly Wireless Bluetoo...",Warehouse A,105,90,2025-02-19 00:04:00,15
13291,ORD_13292,4627,Phyto-Rx Whitening & Brightening Face Wash,Warehouse A,67,49,2025-02-19 01:19:00,18
13292,ORD_13293,3374,Regenerist Micro-Sculpting Cream,Warehouse B,67,55,2025-02-19 12:21:00,12
13293,ORD_13294,18035,Ajit 500mg Tablet,Warehouse B,86,68,2025-02-19 03:48:00,18
13294,ORD_13295,22806,Efloxim CV Dry Syrup,Warehouse B,63,53,2025-02-19 00:55:00,10
13295,ORD_13296,270,Cream - Anti Hair Loss,Warehouse A,89,70,2025-02-19 21:15:00,19
13296,ORD_13297,15077,"Realme C30 (Bamboo Green, 2GB RAM, 32GB Storage)",Warehouse C,7,1,2025-02-19 23:42:00,6
13297,ORD_13298,24964,Ajmal Sacrifice II & Silver Shade & Wisal Dahab Deo & Aretha EDP Pack of 4 20 ml,Warehouse A,104,93,2025-02-19 13:20:00,11
13298,ORD_13299,18063,Hair Repair Conditioner,Warehouse B,69,61,2025-02-19 14:06:00,8
13299,ORD_13300,80,Azidor 250mg Tablet,Warehouse C,63,45,2025-02-19 06:15:00,18
13300,ORD_13301,36989,Evaflor Whisky Black Deodorant 200 ml,Warehouse A,87,68,2025-02-19 09:43:00,19
13301,ORD_13302,7041,Gudgesic Aqua 75mg Injection,Warehouse A,46,33,2025-02-19 12:01:00,13
13302,ORD_13303,3189,Pre QM 1500mcg/75mg Capsule,Warehouse C,29,14,2025-02-19 18:31:00,15
13303,ORD_13304,22810,Forest Essentials Soundarya Advanced Age Defying Serum|With 24 Karat Gold|Unisex Night Facial Serum,Warehouse A,17,3,2025-02-19 20:33:00,14
13304,ORD_13305,18082,Gabalite M 300mg/500mcg Tablet,Warehouse C,80,65,2025-02-19 17:43:00,15
13305,ORD_13306,25917,"HUMBLE Soft Silicone 19mm Smartwatch Dotted Strap Metal Buckle Compatible with Noise Colorfit Pro 2/Oxy/Pulse/Beat, Boat S...",Warehouse C,58,51,2025-02-19 02:16:00,7
13306,ORD_13307,8002,Picolin 5mg Syrup,Warehouse C,75,58,2025-02-19 18:08:00,17
13307,ORD_13308,33678,ZigZag Neem Soft Bristle Toothbrush,Warehouse A,32,14,2025-02-19 03:57:00,18
13308,ORD_13309,34196,"CHITROSE 3in1 Long-lasting Liquid Eyeliner, Mascara, Eyebrow Pencil, 36H Eyeliner Pencil and Kajal - (Pack of 5)",Warehouse B,79,62,2025-02-19 22:48:00,17
13309,ORD_13310,5822,Glimmer Premium Nail Enamel Golden Petal 10 ml,Warehouse A,112,98,2025-02-19 11:59:00,14
13310,ORD_13311,9247,Jiaoer BEAUTY WoW 6 Colors Tattoo Magic Color Peel Off Mask Lipstick Long Lasting Waterproof Lip Gloss,Warehouse C,64,46,2025-02-19 23:46:00,18
13311,ORD_13312,5559,Serdoloc 4mg Tablet,Warehouse C,73,63,2025-02-19 21:53:00,10
13312,ORD_13313,20160,Raberen D 30mg/20mg Capsule SR,Warehouse C,9,4,2025-02-19 13:40:00,5
13313,ORD_13314,3524,Histabus 8mg Tablet,Warehouse C,41,35,2025-02-19 12:40:00,6
13314,ORD_13315,20734,"OnePlus Nord 2T 5G (Gray Shadow, 8GB RAM, 128GB Storage)",Warehouse B,82,71,2025-02-19 17:10:00,11
13315,ORD_13316,26564,StayHappi Ramipril+Hydrochlorothiazide 2.5mg/12.5mg Tablet,Warehouse A,64,50,2025-02-19 02:57:00,14
13316,ORD_13317,27716,Rosuless-Gold Capsule,Warehouse B,106,88,2025-02-19 22:44:00,18
13317,ORD_13318,8771,Include-L Capsule,Warehouse C,38,19,2025-02-19 01:20:00,19
13318,ORD_13319,35024,Roxim 150mg Tablet,Warehouse A,48,37,2025-02-19 08:11:00,11
13319,ORD_13320,27710,FANASSYY Clear Acrylic Dust Proof Makeup Storage Box With Cover Large Capacity Brush Organizer for Vanity Bathroom Bedroom...,Warehouse A,110,93,2025-02-19 09:20:00,17
13320,ORD_13321,8794,Oqueen 200mg Tablet,Warehouse B,74,65,2025-02-19 22:04:00,9
13321,ORD_13322,19729,"Arata Natural Mini Deep Hydration Bath And Hair Gift Box with Hydrating Shampoo (75 Ml), Conditioner (75 Ml), Body Wash (75 Ml) 225 ml",Warehouse B,61,52,2025-02-19 01:23:00,9
13322,ORD_13323,12723,Xadomet GP 2mg/500mg/15mg Tablet,Warehouse C,100,94,2025-02-19 03:33:00,6
13323,ORD_13324,5576,PULOKA Multi-Functional Belt Clip Holster Pouch | Unisex Leather Mobile Pouch with Belt Loop ( Black ),Warehouse B,60,55,2025-02-19 05:27:00,5
13324,ORD_13325,21320,NIMULID SAFE 75MG INJECTION,Warehouse B,44,27,2025-02-19 08:06:00,17
13325,ORD_13326,19378,"Loofah/Sponge Scrubber/Body Bath - Cream, BH-064D CRM",Warehouse C,95,77,2025-02-19 02:46:00,18
13326,ORD_13327,3493,"Duracell USB Type C, 3A Braided Sync & Quick Charging Cable, 3.9 Feet (1.2M), QC 2.0/3.0 Fast Charging, Compatible with Sa...",Warehouse B,95,90,2025-02-19 13:01:00,5
13327,ORD_13328,21397,"ENVIE® (AA10004PLNi-CD) AA Rechargeable Batteries, Low Self Discharge, AA 1000mAh Ni-CD (Pack of 4)",Warehouse B,66,47,2025-02-19 03:37:00,19
13328,ORD_13329,1313,Deposet 40mg Injection,Warehouse A,40,21,2025-02-19 14:56:00,19
13329,ORD_13330,34889,Germ Kill Spray Foam,Warehouse C,95,78,2025-02-19 16:37:00,17
13330,ORD_13331,19345,Spigen EZ Fit Tempered Glass Screen Guard Protector for iPad Pro 12.9 inch M2 (2022) / iPad Pro 12.9 inch (2021/2020/2018)...,Warehouse B,70,54,2025-02-19 06:35:00,16
13331,ORD_13332,26719,House of Beauty Hydra Oxy Gel Cream 100 ml,Warehouse B,53,39,2025-02-19 14:37:00,14
13332,ORD_13333,26932,Tcin OZ Oral Suspension,Warehouse A,99,81,2025-02-19 04:39:00,18
13333,ORD_13334,14315,Moximark D Eye Drop,Warehouse A,76,58,2025-02-19 00:07:00,18
13334,ORD_13335,27132,"TP-LINK AC1300 Archer T3U Plus High Gain USB 3.0 Wi-Fi Dongle, Wireless Dual Band MU-MIMO WiFi Adapter with High Gain Ante...",Warehouse C,42,30,2025-02-19 03:32:00,12
13335,ORD_13336,5250,Beauty People Liquid Illuminator 06 Elegant Pink 25 ml,Warehouse B,60,48,2025-02-19 06:02:00,12
13336,ORD_13337,20951,"HP 200 USB Wireless Mouse with 1000 DPI optical sensor, 2.4 GHz wireless connectivity, built-in scrolling and ambidextrous...",Warehouse B,95,80,2025-02-19 05:58:00,15
13337,ORD_13338,5425,Benlevo 250mg Tablet,Warehouse B,96,82,2025-02-19 09:49:00,14
13338,ORD_13339,5449,"Maybelline New York Super Stay 24H Full coverage Liquid Foundation,Sun Beige 310 30 gm",Warehouse B,103,98,2025-02-19 13:21:00,5
13339,ORD_13340,1504,Hot Water - Bag,Warehouse A,57,52,2025-02-19 15:34:00,5
13340,ORD_13341,5573,"Amazonbasics Nylon Braided Usb-C To Lightning Cable, Fast Charging Mfi Certified Smartphone, Iphone Charger (3-Foot, Dark ...",Warehouse A,80,74,2025-02-19 02:10:00,6
13341,ORD_13342,31630,Lonazep 0.25mg Tablet MD,Warehouse B,33,20,2025-02-19 09:31:00,13
13342,ORD_13343,26736,Telmicalm 40mg Tablet,Warehouse C,106,87,2025-02-19 21:27:00,19
13343,ORD_13344,5122,B7000 Glue for Mobile Phone 50ML,Warehouse C,29,22,2025-02-19 14:12:00,7
13344,ORD_13345,26941,"Creme Multi-Purpose Moisturiser - Protective Skin Care Cream For Men, Women & Family",Warehouse A,70,59,2025-02-19 23:18:00,11
13345,ORD_13346,26976,"WeCool S2 Bluetooth Extendable Selfie Stick with Wireless Remote, 103 Cms Long Selfie Stick , Adjustable and Rotatable Des...",Warehouse C,56,43,2025-02-19 13:03:00,13
13346,ORD_13347,19560,Vega Wooden Paddle Brush (E2 - PBS) 123 gm,Warehouse B,10,3,2025-02-19 14:38:00,7
13347,ORD_13348,27283,LOHAYA Remote Compatible for Lloyd Split AC Remote Control Model No :- ZH/JT-03 [ Compatible for Lloyd AC Remote Control ]...,Warehouse A,81,65,2025-02-19 01:18:00,16
13348,ORD_13349,14279,Letin 5mg Tablet,Warehouse A,38,24,2025-02-19 23:51:00,14
13349,ORD_13350,20349,Eyetex Dazller Nail Glitter - DR14 (Redood City) 12 ml,Warehouse B,92,78,2025-02-19 23:06:00,14
13350,ORD_13351,30940,"Ohuhu Alcohol Markers, Double Tipped Brush & Chisel Sketch Markers for Artist, Coloring Art Markers for Kids, Adults Color...",Warehouse C,64,46,2025-02-19 07:32:00,18
13351,ORD_13352,30939,"Samsung Galaxy S22 5G (Phantom White, 8GB RAM, 128GB Storage) with No Cost EMI/Additional Exchange Offers",Warehouse C,88,69,2025-02-19 00:20:00,19
13352,ORD_13353,19967,Leezit MK 5mg/10mg Tablet,Warehouse A,92,85,2025-02-19 22:56:00,7
13353,ORD_13354,148,"Fashion Colour Kiss Lip No Transfer Lipstick, 86 Clay Brown 2.6 gm",Warehouse C,88,80,2025-02-19 17:41:00,8
13354,ORD_13355,20348,Oyxin 100mg Tablet,Warehouse B,23,10,2025-02-19 20:56:00,13
13355,ORD_13356,32696,Dalcuf LS Syrup,Warehouse A,68,61,2025-02-19 20:35:00,7
13356,ORD_13357,5354,Miss Diva Cover Girl Mist,Warehouse A,23,11,2025-02-19 20:04:00,12
13357,ORD_13358,26638,"ESR Tempered-Glass Screen Protector Compatible with iPhone 14 Pro Max [3 Pack], with Easy Installation Frame, Military-Gra...",Warehouse A,48,35,2025-02-19 07:08:00,13
13358,ORD_13359,5520,Sounce AirPods Pro Case Cover Portable Silicone Skin Cover with Keychain Carabiner (Supports Wireless Charging) Compatible...,Warehouse B,34,28,2025-02-19 03:33:00,6
13359,ORD_13360,27031,"mobistyle Soft Liquid Silicone, Individual Protection for Each Lens Shockproof Rubber Full Body Back Cover Case Compatible...",Warehouse A,105,88,2025-02-19 03:58:00,17
13360,ORD_13361,21551,Tifnim-S Tablet,Warehouse A,61,50,2025-02-19 05:14:00,11
13361,ORD_13362,1302,Myynti Brush Cleaning Mat Silicone Makeup Brush Scrubber Mat Portable Washing Tools Cosmetic Brush Cleaner for Home Travel...,Warehouse A,61,46,2025-02-19 03:36:00,15
13362,ORD_13363,21124,"Quantum QHM7403D Spill-Resistant Wired USB Keyboard with 104 Keys, Rupee Symbol (₹), Hotkeys and 3 LED Function Keys Compa...",Warehouse A,34,26,2025-02-19 18:29:00,8
13363,ORD_13364,27897,Brikacin 250mg Injection,Warehouse A,34,29,2025-02-19 14:03:00,5
13364,ORD_13365,14546,Kenadac 50 Injection,Warehouse B,27,14,2025-02-19 12:30:00,13
13365,ORD_13366,35172,Bonjour Paris Premium Mettalic Shine Lipstick for Women - Nude Gold 4.2 gm,Warehouse A,70,53,2025-02-19 13:53:00,17
13366,ORD_13367,32892,Ceretor 800mg Tablet,Warehouse A,16,8,2025-02-19 18:14:00,8
13367,ORD_13368,9136,Suprapod 100mg Dry Syrup,Warehouse C,49,34,2025-02-19 10:10:00,15
13368,ORD_13369,26548,"Panasonic CR2032 Coin Cell Battery Compatible with accu-chek, Air Tag, etc (Pack of 2)",Warehouse B,13,3,2025-02-19 00:29:00,10
13369,ORD_13370,14141,"Echo Dot (4th Gen, 2020 release)| Smart speaker with Alexa (White)",Warehouse B,29,23,2025-02-19 18:08:00,6
13370,ORD_13371,26733,"STRIFF Multi Angle Tablet/Mobile Stand. Holder for iPhone, Android, Samsung, OnePlus, Xiaomi. Portable,Foldable Stand.Perf...",Warehouse C,34,18,2025-02-19 23:48:00,16
13371,ORD_13372,27731,Berina A26 Natural Brown Hair Color Cream 60 gm,Warehouse B,102,97,2025-02-19 17:20:00,5
13372,ORD_13373,8769,"Itel MagicX Pro 4G (Wi-Fi Hotspot Tethering, High Speed Internet with 4G Network, 2500mAh Big Battery, 2.4inch QVGA 3D Cur...",Warehouse B,88,80,2025-02-19 06:51:00,8
13373,ORD_13374,31634,Omron HEM 7121 Fully Automatic Digital Blood Pressure Monitor With Intellisense Technology & Cuff Wrapping Guide For Most ...,Warehouse C,101,96,2025-02-19 18:48:00,5
13374,ORD_13375,26729,CP PLUS Weatherproof Outdoor Wired Bullet Security Camera | 2.4 MP| 3.6 MM Lens for Wide Angle | 1080P Full HD Recording |...,Warehouse A,71,57,2025-02-19 04:02:00,14
13375,ORD_13376,19720,"Astroghar Mini Hand Tally Counter Finger Ring Digital Electronic Head Count,Japa Counter Mini Hand Tally Counter Finger Ri...",Warehouse B,73,66,2025-02-19 06:56:00,7
13376,ORD_13377,30759,Mothercare Sail Away Dribbler Bibs - Multicolor (Pack of 3),Warehouse C,29,16,2025-02-19 11:19:00,13
13377,ORD_13378,27053,Xech Tellivibe Max Wireless Bluetooth Speaker with Phone Holder 5W with 6H Play Time Retro Radio Design with Mobile Stand ...,Warehouse C,92,82,2025-02-19 18:54:00,10
13378,ORD_13379,5134,Global Mythical Bloom & Soulful Trance Pack of 2 Eau De Parfum 50ML for Women Crafted by Ajmal,Warehouse C,21,11,2025-02-19 16:00:00,10
13379,ORD_13380,21665,Fifanac P 100mg/325mg Tablet,Warehouse A,65,49,2025-02-19 12:09:00,16
13380,ORD_13381,27054,"Samsung Galaxy S23 Ultra 5G (Green, 12GB, 256GB Storage)",Warehouse C,17,7,2025-02-19 05:39:00,10
13381,ORD_13382,3460,Yumin Polyester Handlebar Mobile Holder for Scooty Scooter Phone Pouch Bag for Activa Jupiter Ntorq Access Ather Ola-S1 Pl...,Warehouse C,87,82,2025-02-19 15:13:00,5
13382,ORD_13383,19712,Ajmal 2 Sacred Love And 2 Magnetize Deodorants Pack of 4 200 ml,Warehouse A,29,17,2025-02-19 20:41:00,12
13383,ORD_13384,20628,Voltrox 90mg Tablet,Warehouse A,44,36,2025-02-19 17:15:00,8
13384,ORD_13385,14446,"Artistix Alpine Business Class Series | Anti Theft Laptop Backpack (32 Litre, 15.6 inch) (Black)",Warehouse C,32,19,2025-02-19 16:24:00,13
13385,ORD_13386,27081,"HUSSELL Magnetic Phone Car Mount, Air Vent Phone Mount for Car 360° Adjustable Universal Magnet Phone Holder - Compatible ...",Warehouse B,80,66,2025-02-19 23:14:00,14
13386,ORD_13387,8781,Azigrand 100mg Oral Suspension,Warehouse C,18,2,2025-02-19 06:11:00,16
13387,ORD_13388,30820,7 O Clock Razor- Pii,Warehouse C,81,74,2025-02-19 16:28:00,7
13388,ORD_13389,34534,Aeda Soap - Ramacham,Warehouse C,95,90,2025-02-19 03:06:00,5
13389,ORD_13390,14717,Davalax Plus Oral Suspension,Warehouse C,24,14,2025-02-19 19:32:00,10
13390,ORD_13391,34880,Neflo P 100mg/325mg Tablet,Warehouse B,79,62,2025-02-19 17:25:00,17
13391,ORD_13392,14492,Lamiceph 125mg Tablet DT,Warehouse A,19,14,2025-02-19 23:24:00,5
13392,ORD_13393,2561,Supan-DSR Capsule,Warehouse B,67,49,2025-02-19 23:37:00,18
13393,ORD_13394,34612,Azafran Organic Rose Water Floral Water 200 ml,Warehouse B,108,92,2025-02-19 08:35:00,16
13394,ORD_13395,1270,Vega Grooming Comb (HMBC - 110) 20 gm,Warehouse C,93,84,2025-02-19 13:40:00,9
13395,ORD_13396,5232,"Fashion Colour Hand & Face Cleansing Wipes, Alovera Scents 1's",Warehouse A,68,50,2025-02-19 22:34:00,18
13396,ORD_13397,14631,Jovees Premium Night Firming Cream 50 gm,Warehouse A,100,89,2025-02-19 19:38:00,11
13397,ORD_13398,9437,Lakme Forever Matte Liquid Lip Colour Fuschia Chic 5.6 Ml,Warehouse A,109,92,2025-02-19 18:58:00,17
13398,ORD_13399,26692,"Noise ColorFit Ultra 2 Buzz 1.78"" AMOLED Bluetooth Calling Watch with 368 * 448px Always On Display, Premium Metallic Fini...",Warehouse B,79,74,2025-02-19 11:58:00,5
13399,ORD_13400,161,"(Renewed) Fire-Boltt Phoenix Pro 1.39"" Bluetooth Calling Smartwatch, AI Voice Assistant, Metal Body with 120+ Sports Mode...",Warehouse C,54,44,2025-02-19 20:55:00,10
13400,ORD_13401,8618,"MKY Tripod 3110 Stand with 3-Way Head Tripod 3110 with Mobile Phone Holder Mount Tripod Kit, (Silver, Supports Up to 1100 g)",Warehouse B,48,32,2025-02-19 14:29:00,16
13401,ORD_13402,36804,Leemka 100mg Injection,Warehouse C,106,88,2025-02-19 12:02:00,18
13402,ORD_13403,130,Axolap-S 1.5 Injection,Warehouse A,64,58,2025-02-19 01:44:00,6
13403,ORD_13404,35182,"Lapster lan splitter / rj45 splitter/ethernet splitter 1 to 2 Female 8P8C Network Plug Lan Coupler For Laptop, Router, Per...",Warehouse B,102,91,2025-02-19 05:00:00,11
13404,ORD_13405,12200,Evyphlox 200mg Tablet,Warehouse C,106,92,2025-02-19 22:40:00,14
13405,ORD_13406,35008,Apsara Disney Princess Extra Dark Pencil,Warehouse B,106,88,2025-02-19 12:16:00,18
13406,ORD_13407,14522,Qmax 200mg Infusion,Warehouse C,57,46,2025-02-19 08:46:00,11
13407,ORD_13408,27140,Global Desi CosmiC EDP & StarG Mist Pack of 2 250 ml,Warehouse C,42,26,2025-02-19 17:46:00,16
13408,ORD_13409,8620,Flucotrap 150mg Tablet,Warehouse C,47,36,2025-02-19 22:57:00,11
13409,ORD_13410,27914,Sensitive Shaving Foam,Warehouse B,32,25,2025-02-19 19:45:00,7
13410,ORD_13411,27133,Artech 150mg Injection,Warehouse B,44,29,2025-02-19 14:30:00,15
13411,ORD_13412,21647,Oxyglow Hair Conditioner - Fruit Enzyme 200 ml,Warehouse C,32,13,2025-02-19 21:50:00,19
13412,ORD_13413,21360,Schwarzkopf Gliss Hair Repair Conditioner Million Gloss 400 ml,Warehouse C,25,13,2025-02-19 12:19:00,12
13413,ORD_13414,2367,"Lenovo Legion M200 RGB Gaming Wired USB Mouse, Ambidextrous, 5-Buttons, Upto 2400 DPI with 4 Levels DPI Switch, 7-Colour R...",Warehouse B,52,44,2025-02-19 23:18:00,8
13414,ORD_13415,19385,Vega Pocket Comb (HMC - 19D) 19 gm,Warehouse B,33,24,2025-02-19 09:22:00,9
13415,ORD_13416,20613,"Luminous LMU1202, 12V/24W, Micro DC UPS for WiFi Modem & Router, Power Backup & Protection",Warehouse A,29,21,2025-02-19 09:41:00,8
13416,ORD_13417,20987,Zumik 500mg Injection,Warehouse A,95,83,2025-02-19 18:36:00,12
13417,ORD_13418,20168,Dicodyl 4 mg/10 mg Syrup,Warehouse B,42,35,2025-02-19 10:11:00,7
13418,ORD_13419,20972,KXXO® Flexible Mobile Phone Holder for Car Rear View Mirror Generation Model Anti Shake Fall Prevention | Full Rotation An...,Warehouse A,104,97,2025-02-19 04:44:00,7
13419,ORD_13420,21394,"GAIATOP Neck Fan, Rechargeable Hands Free Bladeless Personal Mini Fan,3 Speeds 48 Air Outlet, Free Adjustment Personal Coo...",Warehouse B,78,72,2025-02-19 20:25:00,6
13420,ORD_13421,26936,Turbostat 20mg Tablet,Warehouse B,67,53,2025-02-19 22:36:00,14
13421,ORD_13422,8752,Cambio 100mg Tablet,Warehouse A,58,48,2025-02-19 12:22:00,10
13422,ORD_13423,14133,Defladov 6mg Tablet,Warehouse C,97,85,2025-02-19 23:33:00,12
13423,ORD_13424,20155,Mendformin 500 SR Tablet,Warehouse B,34,23,2025-02-19 13:30:00,11
13424,ORD_13425,19663,Avicillin 250mg Capsule,Warehouse A,14,5,2025-02-19 20:08:00,9
13425,ORD_13426,5501,Lather Shaving Cream - Denim,Warehouse A,78,71,2025-02-19 04:27:00,7
13426,ORD_13427,26749,"Amazon Basics Mini Display Port to HDMI Cable - 6 Feet (Full HD - 1080P), Gold",Warehouse A,41,28,2025-02-19 04:23:00,13
13427,ORD_13428,20138,Sweet Heart Night Rommance Eau De Parfum 100 ml,Warehouse A,81,75,2025-02-19 07:36:00,6
13428,ORD_13429,9712,"Arata Natural Refreshing Face Wash With Peppermint, Lemon oil & Organic Flaxseed 150 ml",Warehouse A,19,7,2025-02-19 16:20:00,12
13429,ORD_13430,27137,"SUKHAD Audio Interface AMP iRig from for iPod Touch, iPhone, and iPad, 7 X 2 X 2 cm, Black and White",Warehouse B,29,16,2025-02-19 08:43:00,13
13430,ORD_13431,9201,"Miraan Women's Jute Cotton Saree with Blouse Piece (SRHIW10, Yellow)",Warehouse C,96,85,2025-02-19 20:18:00,11
13431,ORD_13432,26940,VW 80 cm (32 inches) Frameless Series HD Ready LED TV VW32A (Black),Warehouse B,89,77,2025-02-19 15:02:00,12
13432,ORD_13433,27418,"Samsung Galaxy A23 5G, Silver (6GB, 128GB Storage) with Offer",Warehouse A,113,99,2025-02-19 02:05:00,14
13433,ORD_13434,26968,Immunity Booster Vitamin Gummies With Vitamin C & Zinc,Warehouse C,77,65,2025-02-19 06:35:00,12
13434,ORD_13435,19710,Volga R 1mg/0.2mg Tablet,Warehouse B,79,71,2025-02-19 13:03:00,8
13435,ORD_13436,180,Mahagesic Plus Tablet,Warehouse B,78,59,2025-02-19 22:04:00,19
13436,ORD_13437,32896,Histrin-M Tablet,Warehouse A,27,14,2025-02-19 09:37:00,13
13437,ORD_13438,34950,Herbocharm Powder - Ayurvedic Facepack,Warehouse A,48,30,2025-02-19 19:16:00,18
13438,ORD_13439,5799,"ProElite Tempered Glass Screen Protector for Apple iPad 10.2"" 9th/8th/7th Generation 2021 with Auto Alignment Kit",Warehouse B,42,29,2025-02-19 18:29:00,13
13439,ORD_13440,14234,Nexporin 500 Capsule,Warehouse A,81,66,2025-02-19 07:31:00,15
13440,ORD_13441,21025,"PiBOX India - SATA to USB 3.0 Cable, USB 3.0 to SATA III Hard Drive Adapter Compatible for 2.5 3.5 Inch Desktop HDD/SSD Ha...",Warehouse B,47,30,2025-02-19 15:03:00,17
13441,ORD_13442,21305,"Yves Rocher White Botanical Exceptional Toner, 200ml",Warehouse C,95,79,2025-02-19 14:41:00,16
13442,ORD_13443,21308,Sofit O Oral Suspension,Warehouse C,90,72,2025-02-19 04:23:00,18
13443,ORD_13444,36735,Levanz 25mg Tablet,Warehouse C,30,17,2025-02-19 06:13:00,13
13444,ORD_13445,19759,"O3+ 3 in 1 Mask Combo Kit - Whitening Mask, Purifying Sulfur Cooling Facial Mask and Chamomile Hydrating and Soothing Cool...",Warehouse A,106,94,2025-02-19 11:30:00,12
13445,ORD_13446,21297,TheGiftKart Tough Armor Bumper Back Case Cover for Vivo V27 / V27 PRO 5G | Ring Holder & Kickstand in-Built | 360 Degree P...,Warehouse C,110,93,2025-02-19 17:22:00,17
13446,ORD_13447,21067,Passion Indulge MASSAGE CREAM - PEARL-CE (small) 100 gm,Warehouse C,33,16,2025-02-19 02:22:00,17
13447,ORD_13448,9837,Amoline 10mg Tablet,Warehouse C,112,96,2025-02-19 19:27:00,16
13448,ORD_13449,26682,Thiopace 8mg Tablet,Warehouse B,87,68,2025-02-19 08:57:00,19
13449,ORD_13450,1185,Oford-LB Tablet,Warehouse C,37,30,2025-02-19 04:44:00,7
13450,ORD_13451,9231,Ajmal Carbon Carbon Wisal Dahab Deodorant Spray (Pack of 3) 200 ml,Warehouse C,83,64,2025-02-19 23:34:00,19
13451,ORD_13452,27887,Stainless Steel Acne Popper - BB1236,Warehouse C,108,97,2025-02-19 07:28:00,11
13452,ORD_13453,14378,Sirona Face Serum - Depigmentation 30 ml,Warehouse B,44,27,2025-02-19 08:14:00,17
13453,ORD_13454,14259,"Lowfe Smartwatch Charger for 2 Pin (Noise Colorfit Pro 2, 3, Boat Strom, Nexfit Run) 0.2 m Magnetic Charging Cable, Black",Warehouse C,39,25,2025-02-19 12:12:00,14
13454,ORD_13455,21056,Pari 10 Tablet,Warehouse C,79,66,2025-02-19 12:54:00,13
13455,ORD_13456,20432,LINLO Tempered Glass Screen Protector Compatible for Samsung M33 5G / A23 / F23 / A13(4G) with Edge to Edge Coverage and E...,Warehouse B,105,95,2025-02-19 10:34:00,10
13456,ORD_13457,9485,Miss Claire Pearl Eyeliner - 09 - Red 5 Gm,Warehouse C,80,65,2025-02-19 20:21:00,15
13457,ORD_13458,14533,BROTHER BT5000M Ink Bottle (Magenta),Warehouse B,96,85,2025-02-19 01:47:00,11
13458,ORD_13459,20095,WOW IMAGINE Samsung Galaxy M33 5G Flexible Crystal Clear TPU Ultra Protective Back Case Cover - Transparent,Warehouse C,24,14,2025-02-19 22:46:00,10
13459,ORD_13460,35052,"HUMBLE MI Band 4 Strap,Band for MI 3/MI 4 Watch Smartwatch Wristbands Replacement Silicone Straps Bracelets for Mi Band 4 ...",Warehouse A,27,20,2025-02-19 22:39:00,7
13460,ORD_13461,21617,Revlon Love Her Madly Perfumed Body Spray 100 Ml,Warehouse B,40,22,2025-02-19 00:42:00,18
13461,ORD_13462,35051,Tizum Z57 Large Felt Desk Mat Mouse Pad for Office & Gaming with 2 Pockets – 635 * 330 mm (Grey),Warehouse A,18,3,2025-02-19 09:30:00,15
13462,ORD_13463,12702,Admark Gel,Warehouse B,46,29,2025-02-19 19:18:00,17
13463,ORD_13464,8939,Welucel Mps Syrup,Warehouse A,22,9,2025-02-19 21:23:00,13
13464,ORD_13465,32725,Tarmus Ointment,Warehouse B,93,77,2025-02-19 05:01:00,16
13465,ORD_13466,1154,Amazon Brand - Solimo Back Cover Case for Samsung Galaxy M30s / Samsung Galaxy M21 | Compatible for Samsung Galaxy M30s / ...,Warehouse A,21,5,2025-02-19 19:25:00,16
13466,ORD_13467,26977,INEFABLE Mi Band 5 and 6 Strap Original Band Strap M5/M6 - Pack of 1 - Dark Green - (Device Not Included - Not Compatible ...,Warehouse A,29,22,2025-02-19 17:56:00,7
13467,ORD_13468,5673,Beauty People Pout - Me - Matte Lipstick - Sblossom - Pink - 1016 3.8 gm,Warehouse B,98,89,2025-02-19 16:14:00,9
13468,ORD_13469,20701,Moxflox P Eye Drop,Warehouse C,47,36,2025-02-19 13:37:00,11
13469,ORD_13470,9361,Difol 75mg Injection,Warehouse B,91,80,2025-02-19 23:23:00,11
13470,ORD_13471,27592,Awnacid-D 10mg/20mg Capsule,Warehouse B,41,25,2025-02-19 00:27:00,16
13471,ORD_13472,21260,Maxell CR2032 Coin Type 3V Lithium Battery (5 Pieces),Warehouse B,85,79,2025-02-19 14:10:00,6
13472,ORD_13473,20026,Beauty People Matte Lucious Liquid Lip Colormolten - Lava - L25 ,Warehouse A,26,14,2025-02-19 02:50:00,12
13473,ORD_13474,14158,"Casio CT-S200 Casiotone 61-Key Portable Keyboard with Piano tones, Black",Warehouse B,75,61,2025-02-19 08:23:00,14
13474,ORD_13475,34716,"SUGAR Cosmetics - Mettle - Liquid Lipstick - 10 Mimosa (Deep Pinkish Red with Blue Undertone) - 7 gms - Creamy, Lightweigh...",Warehouse C,44,27,2025-02-19 13:14:00,17
13475,ORD_13476,5303,Kindcif 200mg Tablet,Warehouse A,38,31,2025-02-19 23:52:00,7
13476,ORD_13477,31016,Glibat M 80mg/500mg Tablet,Warehouse A,74,55,2025-02-19 01:26:00,19
13477,ORD_13478,27301,Elebact OF Dry Syrup,Warehouse B,107,89,2025-02-19 00:18:00,18
13478,ORD_13479,35075,Platicare 1mg Injection,Warehouse A,71,58,2025-02-19 10:33:00,13
13479,ORD_13480,9276,Losave 50mg Tablet,Warehouse C,106,87,2025-02-19 17:02:00,19
13480,ORD_13481,20763,Hydra Lip Care Kiwi,Warehouse A,109,92,2025-02-19 05:11:00,17
13481,ORD_13482,9732,Glitter Glow Mask,Warehouse A,56,41,2025-02-19 05:38:00,15
13482,ORD_13483,32873,"mCaffeine Body Care Kit for Exfoliation and Moisturization | Body Scrub, Body Butter, Body Oil and Bathing Bar Combo | For...",Warehouse A,107,90,2025-02-19 07:08:00,17
13483,ORD_13484,36906,"Vasmol Kesh Kala, 100ml",Warehouse B,12,6,2025-02-19 13:49:00,6
13484,ORD_13485,21047,Haxone 1000mg Injection,Warehouse C,101,84,2025-02-19 02:56:00,17
13485,ORD_13486,26983,Berina A23 Bright Red Hair Color Cream 60 gm,Warehouse B,68,52,2025-02-19 16:24:00,16
13486,ORD_13487,9659,Brivasure 75mg Tablet,Warehouse C,101,94,2025-02-19 18:36:00,7
13487,ORD_13488,27653,Levozin M Tablet,Warehouse A,92,83,2025-02-19 07:38:00,9
13488,ORD_13489,3118,Raminerv 5mg Tablet,Warehouse B,41,30,2025-02-19 20:35:00,11
13489,ORD_13490,34736,Set of 2 piece Mini USB LED Light Adjust Angle / bendable Portable Flexible USB Light with usb for power bank PC Laptop No...,Warehouse A,54,44,2025-02-19 13:51:00,10
13490,ORD_13491,27746,Xetizo 0.5mg Tablet,Warehouse B,22,9,2025-02-19 20:08:00,13
13491,ORD_13492,14341,"POPIO Tempered Glass Screen Protector Compatible for OnePlus 6 with Edge to Edge Coverage and Easy Installation kit, Pack ...",Warehouse A,30,21,2025-02-19 04:51:00,9
13492,ORD_13493,20115,"Samsung Galaxy S23 5G (Phantom Black, 8GB, 256GB Storage)",Warehouse B,95,80,2025-02-19 17:24:00,15
13493,ORD_13494,5265,"Logitech MK345 Wireless Keyboard and Mouse Set Full-Sized Keyboard with Palm Rest and Comfortable Right-Handed Mouse, 2.4 ...",Warehouse C,16,4,2025-02-19 05:02:00,12
13494,ORD_13495,26755,"KABEER ART Water and Light Resistant Plastic Storage Tube with ID Card Cap Telescoping for Posters, Artwork and Drawings,2...",Warehouse B,105,90,2025-02-19 06:43:00,15
13495,ORD_13496,3119,Lakmé Insta-Liner Water Resistant Eyeliner (pack of 2),Warehouse A,25,15,2025-02-19 08:11:00,10
13496,ORD_13497,1394,Herbal Lavender & Ylang Ylang Body Wash,Warehouse B,50,37,2025-02-19 19:32:00,13
13497,ORD_13498,14164,Wyurab-DSR 30mg/20mg Capsule,Warehouse A,103,90,2025-02-19 09:19:00,13
13498,ORD_13499,21233,Uronex-D Capsule PR,Warehouse B,12,7,2025-02-19 23:16:00,5
13499,ORD_13500,31646,Cefrimon 500mg/500mg Injection,Warehouse B,38,32,2025-02-19 16:03:00,6
13500,ORD_13501,19922,Nebaspor Ointment,Warehouse C,20,11,2025-02-19 01:45:00,9
13501,ORD_13502,9084,Nuronim 100mg Tablet,Warehouse C,41,27,2025-02-19 18:56:00,14
13502,ORD_13503,19526,Starcad-Beta 25 Tablet ER,Warehouse A,107,95,2025-02-19 10:53:00,12
13503,ORD_13504,27542,Bactil 250mg Tablet,Warehouse A,42,29,2025-02-19 01:46:00,13
13504,ORD_13505,31639,Amazon Brand - Solimo Back Cover Case for Mi Redmi Note 9 Pro/Redmi Note 9 Pro Max/Poco M2 Pro | (TPU | Transparent),Warehouse B,74,65,2025-02-19 02:21:00,9
13505,ORD_13506,27186,StayHappi Thiocolchicoside+Aceclofenac+Paracetamol 4mg/100mg/325mg Tablet,Warehouse B,91,84,2025-02-19 00:23:00,7
13506,ORD_13507,5154,Ofkin 200mg Tablet,Warehouse A,55,44,2025-02-19 11:45:00,11
13507,ORD_13508,26625,Xibmax 90 Tablet,Warehouse C,19,1,2025-02-19 05:52:00,18
13508,ORD_13509,3610,2 In 1 Soft Bristles Face Cleansing Brush - Colour May Vary,Warehouse C,113,95,2025-02-19 03:03:00,18
13509,ORD_13510,19990,Ufigesic T 60mg/4mg Tablet,Warehouse C,107,92,2025-02-19 23:13:00,15
13510,ORD_13511,2430,"Brustro Artists Portable Lightweight Metal Display Easel, Free Weatherproof Carry Bag. Holds Canvas Upto 32"".",Warehouse B,53,44,2025-02-19 11:33:00,9
13511,ORD_13512,27777,Organic Harvest 3 in 1 Lip Balm 6 gm,Warehouse B,23,16,2025-02-19 19:58:00,7
13512,ORD_13513,30817,Fragrance Body Spray - Marco 150 ml + Master Body Spray - Oak 150 ml,Warehouse C,55,37,2025-02-19 00:49:00,18
13513,ORD_13514,5311,Moonlight Shimmering Body Oil,Warehouse C,77,59,2025-02-19 01:51:00,18
13514,ORD_13515,19844,DZert Clasy Laptop Bag College Bag for Boys Girls 21 L Red Black,Warehouse C,76,62,2025-02-19 14:26:00,14
13515,ORD_13516,5197,Joycobal-GP Tablet,Warehouse A,96,79,2025-02-19 22:04:00,17
13516,ORD_13517,27004,Rotodic P 50mg/325mg/10mg Tablet,Warehouse C,92,84,2025-02-19 03:45:00,8
13517,ORD_13518,36892,Gaticin 200mg Tablet,Warehouse A,59,54,2025-02-19 15:45:00,5
13518,ORD_13519,14366,"Lapster 15v ultra fast USB charging cable compatible with most philips trimmer, shavers, body groomers & multi grooming mo...",Warehouse B,27,15,2025-02-19 18:01:00,12
13519,ORD_13520,21241,"ESnipe Mart Worldwide Travel Adapter with Build in Charger Dual USB Ports with 125V 6A,250V Electrical Protected Plug (White)",Warehouse A,60,47,2025-02-19 06:46:00,13
13520,ORD_13521,35082,Mobera Gel,Warehouse B,31,19,2025-02-19 01:21:00,12
13521,ORD_13522,21569,"AmazonBasics Silicone 1.9cm Replacement Band Strap with Metal Buckle For Noise Colorfit Pro 2, Storm Smart Watch (Black)",Warehouse A,63,45,2025-02-19 03:06:00,18
13522,ORD_13523,8935,"Saregama Carvaan Premium - Portable Music Player with 5000 Preloaded Songs, FM/BT/AUX (Cherrywood Red)",Warehouse B,67,55,2025-02-19 01:46:00,12
13523,ORD_13524,21108,Pikkme Samsung Galaxy J7 Prime Flip Cover Magnetic Leather Wallet Case Shockproof TPU for Samsung Galaxy J7 Prime (Blue),Warehouse A,99,86,2025-02-19 15:27:00,13
13524,ORD_13525,12674,Acer QG241Y 23.8 Inch (60.45 Cm) Full HD VA Panel Gaming LCD Monitor with LED Back Light I 75Hz Refresh Rate I 1 MS VRB Re...,Warehouse B,53,44,2025-02-19 16:15:00,9
13525,ORD_13526,5619,"DIGITEK® (LP E10) Lithium-ion Rechargeable Battery for DSLR Camera, Compatibility - EOS 1100D, EOS 1200D, EOS Rebel T3, EO...",Warehouse B,44,30,2025-02-19 23:08:00,14
13526,ORD_13527,26842,Lcetriosol-M Kid 2.5mg/5mg Tablet,Warehouse B,107,95,2025-02-19 06:22:00,12
13527,ORD_13528,8882,Jubiglim M 3mg/500mg Tablet,Warehouse A,33,20,2025-02-19 15:41:00,13
13528,ORD_13529,26656,Nicepta Cold Tablet,Warehouse B,104,87,2025-02-19 04:47:00,17
13529,ORD_13530,19895,Panpazole L 75mg/40mg Capsule SR,Warehouse B,65,47,2025-02-19 01:48:00,18
13530,ORD_13531,30887,Uzi S 500mg/500mg Injection,Warehouse C,106,92,2025-02-19 22:53:00,14
13531,ORD_13532,27523,"iClever BK10 Bluetooth Keyboard for Mac, Multi Device Wireless Keyboard Rechargeable Bluetooth 5.1 Stable Connection with ...",Warehouse B,76,60,2025-02-19 15:02:00,16
13532,ORD_13533,5344,Albiz-FX 0.25mg/20mg Tablet,Warehouse C,91,79,2025-02-19 21:06:00,12
13533,ORD_13534,122,"newtechno Tempered Glass Screen Protector designed for Apple Watch Ultra (49mm), 2 Pack",Warehouse B,28,16,2025-02-19 02:30:00,12
13534,ORD_13535,34913,Rabivas D 30mg/20mg Capsule,Warehouse A,82,72,2025-02-19 06:24:00,10
13535,ORD_13536,34970,Febulic 40mg Tablet,Warehouse B,23,9,2025-02-19 15:28:00,14
13536,ORD_13537,30837,Amigraf 0.5 Capsule,Warehouse B,53,46,2025-02-19 09:03:00,7
13537,ORD_13538,5349,Alocet 5mg/5ml Syrup,Warehouse C,29,18,2025-02-19 17:01:00,11
13538,ORD_13539,27814,Hair Oil - Almond Drops,Warehouse A,62,48,2025-02-19 08:48:00,14
13539,ORD_13540,20401,"Fashion Colour Terra Cotta Blusher, Shade 15 16 gm",Warehouse C,70,51,2025-02-19 16:26:00,19
13540,ORD_13541,5597,"iCasso MacBook Pro 13 inch Case 2022 2021 2016-2020 Release A2338 M2/M1/A2159/A1989/A1706/A1708, Plastic Hard Shell Case w...",Warehouse C,67,50,2025-02-19 13:40:00,17
13541,ORD_13542,9607,Saicid Syrup,Warehouse A,69,62,2025-02-19 09:42:00,7
13542,ORD_13543,8865,"Fashion Colour Kiss Lip No Transfer Lipstick, 85 Puce 2.6 gm",Warehouse C,101,87,2025-02-19 12:06:00,14
13543,ORD_13544,20354,Linea 4 mg Tablet,Warehouse A,69,59,2025-02-19 21:13:00,10
13544,ORD_13545,31603,S Citadelm 10mg Tablet,Warehouse A,76,63,2025-02-19 05:19:00,13
13545,ORD_13546,34693,"Fashion Colour Lip Crayon, Waterproof, Long Lasting, 25 Mauve It 2.8 gm",Warehouse B,48,30,2025-02-19 16:40:00,18
13546,ORD_13547,30879,A-Tryp Forte Tablet,Warehouse C,70,53,2025-02-19 15:22:00,17
13547,ORD_13548,27798,Cygest 200mg Capsule,Warehouse A,36,30,2025-02-19 06:06:00,6
13548,ORD_13549,34689,SanDisk 128GB High Endurance Video MicroSDXC Card with Adapter for Dash Cam and Home Monitoring Surveillance Systems - C1...,Warehouse C,31,17,2025-02-19 20:15:00,14
13549,ORD_13550,20802,Misar H 40mg/12.5mg Tablet,Warehouse A,101,85,2025-02-19 23:34:00,16
13550,ORD_13551,19537,Intagin 50 mg/325 mg Tablet,Warehouse B,28,17,2025-02-19 11:42:00,11
13551,ORD_13552,27805,TheGiftKart Back Cover For Samsung Galaxy M21 / M21 2021 Edition / M30s ( Poly Carbonate|Black ),Warehouse A,69,52,2025-02-19 13:22:00,17
13552,ORD_13553,35221,"Secure- Cottony XL, 40pcs Save Rs.10 + Secure XL Cottony Soft With Wings 20pcs",Warehouse B,75,66,2025-02-19 14:16:00,9
13553,ORD_13554,20384,Ajmal Asher Concentrated Perfume Oil Oriental Attar And Aura Concentrated Perfume Oil Floral Fruity Attar 22 ml,Warehouse B,51,45,2025-02-19 16:11:00,6
13554,ORD_13555,32794,Pentel Graphgear 1000 Drafting Pencil - 0.5 mm,Warehouse B,44,34,2025-02-19 10:45:00,10
13555,ORD_13556,9092,SP Clav 1000 mg/200 mg Injection,Warehouse B,26,19,2025-02-19 08:42:00,7
13556,ORD_13557,35222,Dolorgesic P 100mg/325mg Tablet,Warehouse C,37,31,2025-02-19 00:19:00,6
13557,ORD_13558,25346,English Rose Perfumed Talc 250 g + English Lavender Perfumed Talc 250 g,Warehouse A,63,57,2025-02-19 19:48:00,6
13558,ORD_13559,16737,Maitel 40mg Tablet,Warehouse B,106,96,2025-02-19 09:49:00,10
13559,ORD_13560,6517,"Logitech Signature M650 Wireless Mouse - for Small to Medium Sized Hands, 2-Year Battery, Silent Clicks, Customisable Side...",Warehouse C,81,65,2025-02-19 19:52:00,16
13560,ORD_13561,34428,Telefer-XT Tablet,Warehouse A,31,26,2025-02-19 13:47:00,5
13561,ORD_13562,30631,Kimayra Organic Orange + Papaya Face Pack Powder For Tan Removal | Helps In Retain Moisture & Reduce Wrinkles & Fine Lines...,Warehouse A,71,62,2025-02-19 04:17:00,9
13562,ORD_13563,19073,"Fashion Colour Terra Cotta Blusher, Shade 01 16 gm",Warehouse C,61,52,2025-02-19 07:05:00,9
13563,ORD_13564,26194,Panasonic CR2032 3V Coin Cell Batteries (Silver) - Pack of 2,Warehouse A,42,35,2025-02-19 15:19:00,7
13564,ORD_13565,35380,LYLA Breathable Tattoo Flaw Concealer Tape Invisible Scar Covers Sticker Shields,Warehouse B,103,91,2025-02-19 17:46:00,12
13565,ORD_13566,8431,Reefox 120 Tablet,Warehouse C,85,70,2025-02-19 11:03:00,15
13566,ORD_13567,32533,Hair Fruits Hair Dryness Control Conditioning Shampoo,Warehouse B,37,22,2025-02-19 01:48:00,15
13567,ORD_13568,31933,Gabasun Gel,Warehouse A,39,30,2025-02-19 11:11:00,9
13568,ORD_13569,36697,"ZEBRONICS 60.4cms 24inch Gaming Monitor, 165Hz, IPS, Ultra Slim, FHD 1920x1080 Pixels, Display Port, HDMI, 300nits, USB, B...",Warehouse C,78,70,2025-02-19 05:13:00,8
13569,ORD_13570,26346,POPIO Tempered Glass Screen Protector Compatible for Samsung Galaxy A32 4G / Samsung Galaxy M32 4G / Samsung Galaxy F22 / ...,Warehouse C,76,58,2025-02-19 02:24:00,18
13570,ORD_13571,31932,Luxor Finewriter Assorted color (Pack of 10 Pen),Warehouse B,93,85,2025-02-19 18:20:00,8
13571,ORD_13572,26353,Bestogesic Plus 100 mg/325 mg Tablet,Warehouse B,48,39,2025-02-19 17:25:00,9
13572,ORD_13573,11989,Lakme 9 To 5 Primer + Gloss Nail Color Lilac Link 6 Ml,Warehouse C,61,44,2025-02-19 02:03:00,17
13573,ORD_13574,13389,CINCH Designed for iPhone 14 Pro Max Cover| Electroplated Case Individual Camera Protection Lens Back Cover Case for iPhon...,Warehouse C,76,62,2025-02-19 15:08:00,14
13574,ORD_13575,15831,"MAHALAXMI TRADERS Oil Control Compact Powder | Lightweight Compact Powder for Matte Flawless Finish | Face Makeup , Shade...",Warehouse B,44,26,2025-02-19 09:34:00,18
13575,ORD_13576,31585,Ontis 4mg Injection,Warehouse B,32,14,2025-02-19 09:30:00,18
13576,ORD_13577,15736,Qubo Smart Cam 360 Ultra from Hero Group | Made in India | Ethernet Port | 2MP 1080p Full HD Wi-Fi Camera | 360 Coverage w...,Warehouse C,39,26,2025-02-19 08:16:00,13
13577,ORD_13578,8452,"CodersParadise Laptop Sticker for Programmer, Coder, Developer, IT Professional - Pack of 51 Stickers , Journal, Bike Helm...",Warehouse A,28,23,2025-02-19 10:14:00,5
13578,ORD_13579,36389,DO RE ME 25mg Tablet,Warehouse B,20,13,2025-02-19 01:21:00,7
13579,ORD_13580,19036,Classic Handwash,Warehouse B,99,82,2025-02-19 21:51:00,17
13580,ORD_13581,3138,Orpat OT-512GT Calculator (Black),Warehouse B,14,7,2025-02-19 18:20:00,7
13581,ORD_13582,24808,Lipistat,Warehouse B,99,90,2025-02-19 09:06:00,9
13582,ORD_13583,26381,PROLITE Background Support Kit (9ft x 9ft) for Backdrop Photography & Videography with Carry Bag (Portable & Foldable),Warehouse A,84,66,2025-02-19 18:18:00,18
13583,ORD_13584,8473,Ivifen 1000mg Infusion,Warehouse A,65,53,2025-02-19 03:47:00,12
13584,ORD_13585,28099,Defmet G Forte 1mg/1000mg Tablet,Warehouse C,17,12,2025-02-19 15:00:00,5
13585,ORD_13586,19067,Amkette Ergo View Laptop Stand with 7 Adjustment Levels for laptops up to 15.6 inches (12 inch /13 inch /14.1 inch /15.6 i...,Warehouse A,42,23,2025-02-19 04:13:00,19
13586,ORD_13587,34474,Welgab 75mg Tablet SR,Warehouse A,77,59,2025-02-19 18:45:00,18
13587,ORD_13588,15773,Defence Theory Skin Brightening Cream Multani Mitti & Coco Butter,Warehouse B,66,59,2025-02-19 14:05:00,7
13588,ORD_13589,5055,Ajmal Aurum And Aurum Deo & Neea EDP Pack of 3 20 ml,Warehouse A,63,54,2025-02-19 13:09:00,9
13589,ORD_13590,15717,"ESR Cyber Armor Tough Case with HaloLock Compatible with AirPods Pro (2022/2019), MagSafe Ready, Powerful Drop Protection,...",Warehouse B,104,90,2025-02-19 07:58:00,14
13590,ORD_13591,21816,"Lakme © Rose Face Powder, Soft Pink, 40g And Lakme © Perfecting Liquid Foundation, Pearl, 27ml",Warehouse C,87,78,2025-02-19 21:55:00,9
13591,ORD_13592,5917,Lenovo Original USB Charger for Laptop G 50-45 Series 20V 3.25 A 65W - Black,Warehouse C,99,92,2025-02-19 02:45:00,7
13592,ORD_13593,21825,"Sonia Professional White Umbrella 100cms 36 inch/91cm for Photography Studio Light Flash, Camera Flash, Video Light 2 Pcs ...",Warehouse B,11,1,2025-02-19 18:05:00,10
13593,ORD_13594,16093,"BRUSTRO Acrylic Paint set of 24, Multicolour 12ml tubes, Free 200 gsm artist journal A5 Ideal for Acrylic, watercolour and...",Warehouse B,41,34,2025-02-19 18:34:00,7
13594,ORD_13595,28527,"STRIFF UPH2W Multi Angle Tablet/Mobile Stand. Holder for iPhone, Android, Samsung, OnePlus, Xiaomi. Portable,Foldable Stan...",Warehouse B,54,41,2025-02-19 01:55:00,13
13595,ORD_13596,33664,"Gizga Essentials Laptop Bag Sleeve Case Cover Pouch for 13.3 Inch Laptop MacBook, Free Accessories Pouch, Water Repellent,...",Warehouse A,33,24,2025-02-19 16:24:00,9
13596,ORD_13597,26037,Nature's Essence Diamond Creme Bleach 43g+5g Free Aloe Vera Gel 48 gm,Warehouse B,95,81,2025-02-19 02:13:00,14
13597,ORD_13598,24449,Miss Claire Gel Effect Nail Polish - G23 5ml,Warehouse A,25,15,2025-02-19 02:37:00,10
13598,ORD_13599,13050,Sebium Gel Moussant,Warehouse B,32,19,2025-02-19 03:13:00,13
13599,ORD_13600,33662,Fixderma Cosmetic Laboratories (FCL) 'C' Scape Face Cleanser 200 ml,Warehouse C,78,67,2025-02-19 01:02:00,11
13600,ORD_13601,95,Oflac 400mg Tablet,Warehouse A,99,93,2025-02-19 11:02:00,6
13601,ORD_13602,30105,Tapdol P 37.5mg/325mg Tablet,Warehouse B,54,39,2025-02-19 04:02:00,15
13602,ORD_13603,32473,Coxitan Tablet,Warehouse A,51,33,2025-02-19 06:03:00,18
13603,ORD_13604,19089,Enflamo Soft Clear Silicone Case Back Cover for iPhone 13 (Multicolor | with Dry Real Flowers),Warehouse C,58,44,2025-02-19 00:49:00,14
13604,ORD_13605,28083,Vega Flat Brush (R10 - FB) 106 gm,Warehouse B,108,99,2025-02-19 11:14:00,9
13605,ORD_13606,31062,Panasonic CR-2032/5BE Lithium Coin Battery - Pack of 5,Warehouse B,16,1,2025-02-19 00:36:00,15
13606,ORD_13607,21891,REALCASE Designed for iPhone 14 Back Cover Case | Stylish Frameless Matte Hard Skin | Soft TPU Shock Proof Bumper Back Cov...,Warehouse C,36,19,2025-02-19 07:06:00,17
13607,ORD_13608,21884,Nova Blue Ultra Hold Long Lasting Hair Styling Mousse 200 ml,Warehouse C,36,28,2025-02-19 04:42:00,8
13608,ORD_13609,10025,"AmazFit Charger Cable for Amazfit GTS 2, GTS 2 Mini, GTS 2e, GTR 2, GTR 2e, GTS 4 Mini, T-Rex Pro, Bip 3, Bip U, Zepp E/Z,...",Warehouse C,110,95,2025-02-19 01:40:00,15
13609,ORD_13610,10023,Flormar Perfect Coverage Liquid Concealer 60 Dark 5 ml,Warehouse B,113,99,2025-02-19 22:25:00,14
13610,ORD_13611,28059,Kaifyl 400mg Tablet,Warehouse C,81,63,2025-02-19 15:35:00,18
13611,ORD_13612,8521,Luxiben Lotion,Warehouse A,44,28,2025-02-19 16:22:00,16
13612,ORD_13613,12975,Random-mac Infallible Mattifying Base Primer,Warehouse A,114,95,2025-02-19 10:48:00,19
13613,ORD_13614,34461,Sultana Roll-On,Warehouse B,17,9,2025-02-19 09:38:00,8
13614,ORD_13615,19077,"ZEBRONICS Barrel 200 Bluetooth 5.0 Portable Speaker with 40W RMS, TWS, Wired Mic, Karaoke, RGB Lights, Mobile Holder, Dual...",Warehouse A,88,81,2025-02-19 23:35:00,7
13615,ORD_13616,24679,Hello Zone Exclusive Matte Finish Soft Back Case Cover for Oneplus 7 - Black,Warehouse B,58,51,2025-02-19 03:36:00,7
13616,ORD_13617,19158,Azom 0.25mg Tablet,Warehouse A,34,17,2025-02-19 00:54:00,17
13617,ORD_13618,8533,Brosuv 5 Tablet,Warehouse A,66,61,2025-02-19 18:09:00,5
13618,ORD_13619,12967,Casio MZ-12SA Desktop Calculator with Square Root and GT Key,Warehouse C,30,18,2025-02-19 08:11:00,12
13619,ORD_13620,2022,Lakme Absolute Plump & Shine Lip Gloss Red Shine 3 Gm,Warehouse B,32,14,2025-02-19 04:37:00,18
13620,ORD_13621,30653,"After Dark - Eau De Parfum, For Him",Warehouse A,106,88,2025-02-19 19:32:00,18
13621,ORD_13622,5894,Tukzer Tabletop Tablet Stand Mobile Holder| Dual Poles Heavy Base Aluminum Fully Foldable Multi-Angle Height Adjustable St...,Warehouse B,37,19,2025-02-19 02:04:00,18
13622,ORD_13623,4917,"boAt Rockerz 330ANC Bluetooth Neckband in Ear Earphones with mic, Crystal Bionic Sound Powered by Dirac Opteo, ANC, 13mm D...",Warehouse A,55,41,2025-02-19 19:29:00,14
13623,ORD_13624,14103,Sky Ezee Dots Self Adhesive Hook & Loop Dots Tape - 13 mm Diameter White Color (50 Pairs),Warehouse B,66,47,2025-02-19 13:34:00,19
13624,ORD_13625,21783,Pefxy 100mg Dry Syrup,Warehouse A,50,45,2025-02-19 05:56:00,5
13625,ORD_13626,3954,"Body Wash - Lavender & Almond Oil, Nourishing & Moisturising Shower Crème",Warehouse B,16,5,2025-02-19 10:22:00,11
13626,ORD_13627,33560,"PINNER London Popular Mini Poket Lipstick Combo Set 12, Matte Finish - Multicolor",Warehouse B,10,4,2025-02-19 17:37:00,6
13627,ORD_13628,26488,Neurofer 1500mcg Injection,Warehouse A,19,10,2025-02-19 19:49:00,9
13628,ORD_13629,19249,Yves Rocher Energizing Bath And Shower Gel Raspberry Peppermint 400 ml,Warehouse B,67,61,2025-02-19 11:05:00,6
13629,ORD_13630,12599,Ajmal 3 Carbon And 1 Nightingale Deodorants Pack of 4 200 ml,Warehouse C,76,69,2025-02-19 10:31:00,7
13630,ORD_13631,21767,Lenovo Casual Laptop Backpack B210 39.62 cm (15.6) -inch Water Repellent Grey,Warehouse A,106,90,2025-02-19 06:06:00,16
13631,ORD_13632,6880,Vozwa Shining Eyeshadow Glitter/Shimmer Powder(24 Pcs) Multicolor Shimmery Finish,Warehouse A,36,20,2025-02-19 22:40:00,16
13632,ORD_13633,380,Vega Lilac Shampoo Com (1268) 32 gm,Warehouse B,103,85,2025-02-19 14:23:00,18
13633,ORD_13634,30623,Maono AU-B00 Pop Filter for Studio Condenser Microphone with Wind Screen and Metal Gooseneck Holder (Black),Warehouse B,52,36,2025-02-19 21:21:00,16
13634,ORD_13635,24624,Apple Lightning to USB Cable (2m),Warehouse B,110,96,2025-02-19 09:38:00,14
13635,ORD_13636,33601,Kimirica Earth Shampoo and Conditioner Hair Care Duo with Enriching Aloe and Glycerine for Shiny and Smooth Hair | No Para...,Warehouse B,35,26,2025-02-19 20:02:00,9
13636,ORD_13637,29920,Dotliv M Tablet,Warehouse C,32,15,2025-02-19 13:11:00,17
13637,ORD_13638,22195,Cefixiv-AZ-LB Tablet,Warehouse B,109,93,2025-02-19 13:49:00,16
13638,ORD_13639,30048,ProElite Smart Trifold Hard Back Flip Stand Case Cover for Apple iPad 9.7 inch 2018/2017 Air 1 Air 2 5th 6th Generation wi...,Warehouse A,61,45,2025-02-19 08:13:00,16
13639,ORD_13640,8023,Zapcase Back Case Cover for Google Pixel 6A | Compatible for Google Pixel 6A Back Case Cover | Matte Soft Flexible Silicon...,Warehouse C,110,92,2025-02-19 05:17:00,18
13640,ORD_13641,2620,"Eyetex Dazller Liquid Matte Lip Colour (DLC002 - Candy), 5g",Warehouse B,105,88,2025-02-19 04:41:00,17
13641,ORD_13642,28273,Serie Expert Lipidium Absolut Repair Shampoo,Warehouse C,39,21,2025-02-19 03:10:00,18
13642,ORD_13643,11921,Priefy 20W PD Charger for iPhone 14 | iPhone 14 Pro Type C Power Charger Adapter with USB C to Light-ning Cable Compatible...,Warehouse B,44,33,2025-02-19 02:11:00,11
13643,ORD_13644,4922,Panguard 40 Tablet,Warehouse C,84,65,2025-02-19 20:39:00,19
13644,ORD_13645,26245,Neede 50mg Tablet DT,Warehouse B,85,73,2025-02-19 13:13:00,12
13645,ORD_13646,35466,boAt Rockerz 261 in Ear Wireless Earphones with mic(Jazzy Blue),Warehouse B,61,49,2025-02-19 10:12:00,12
13646,ORD_13647,29916,Levocold Syrup,Warehouse B,65,53,2025-02-19 01:01:00,12
13647,ORD_13648,8334,"Foxin FTC 12A Laser Printer Cartridge Compatible with 1020, M1005, 1018, 1010, 1012, 1015, 1022, 1022N, 1022NW, 3015, 302...",Warehouse C,105,97,2025-02-19 16:32:00,8
13648,ORD_13649,28245,St.Botanica Hair Mask - Pro Keratin & Argan Oil 200 ml,Warehouse A,50,39,2025-02-19 17:50:00,11
13649,ORD_13650,33099,"boAt Blaze Smart Watch with 1.75” HD Display, Fast Charge(Deep Blue) & Airdopes 171 Upto 13 Hours Battery (Mysterious Blue)",Warehouse C,43,36,2025-02-19 23:50:00,7
13650,ORD_13651,10195,Philips Audio Mms8085B/94 2.1 Channel 80W USB Multimedia Speaker System with Convertible Soundbar and Multi-Connectivity O...,Warehouse B,76,59,2025-02-19 21:45:00,17
13651,ORD_13652,15936,"EvoFox Deathray RGB Gaming Keyboard, 16 Million True Prism RGB, Backlighting Effects with Custom Setting, Silent Membrane ...",Warehouse B,35,26,2025-02-19 05:09:00,9
13652,ORD_13653,19235,"Seagate Expansion 4TB Desktop External HDD - USB 3.0 for Windows and Mac with 3 yr Data Recovery Services, Portable Hard D...",Warehouse B,79,69,2025-02-19 00:36:00,10
13653,ORD_13654,5061,Bionervs-Plus Injection,Warehouse A,62,45,2025-02-19 03:10:00,17
13654,ORD_13655,32575,Coldvoiz CF Tablet,Warehouse C,44,30,2025-02-19 14:02:00,14
13655,ORD_13656,6858,TheGiftKart Tough Armor OnePlus Nord (2020) Bumper Back Case Cover | Ring Holder & Kickstand in-Built | 360 Degree Protect...,Warehouse C,52,36,2025-02-19 06:34:00,16
13656,ORD_13657,15729,Axalur 100 Tablet,Warehouse C,18,8,2025-02-19 01:03:00,10
13657,ORD_13658,36422,Cefihexa LB 200mg Tablet,Warehouse B,62,50,2025-02-19 18:20:00,12
13658,ORD_13659,24746,SoloTravel Solid 13 Cms Cosmetic Pouch (Standard_MSH0015DS - Grey_Grey),Warehouse B,25,7,2025-02-19 05:26:00,18
13659,ORD_13660,30056,Oh-Boy Capsules,Warehouse B,17,1,2025-02-19 13:58:00,16
13660,ORD_13661,33013,"Panasonic eneloop Ni‐MH AA Rechargeable Battery,low self discharge for multi use up to 2000 mAh capacity,storage life hold...",Warehouse A,63,49,2025-02-19 23:55:00,14
13661,ORD_13662,19288,"iBELL 3288HD DVD Player with Built-in Amplifier, 4 Digit Display,HDMI & USB Copy Function, Black",Warehouse C,71,62,2025-02-19 17:30:00,9
13662,ORD_13663,24783,"Honeywell Surge Protector/Spike Guard/Extension Board, Master Switch, 8 Universal Sockets, 20000Amp, 2 Mtr Cord, Device Se...",Warehouse B,65,58,2025-02-19 07:22:00,7
13663,ORD_13664,1069,"Easyfone Royale for Seniors - 2.4” Flip Phone with 20+ Elder Friendly Features Like SOS, Sound Boost, Big Keypad, Charging...",Warehouse A,56,51,2025-02-19 03:55:00,5
13664,ORD_13665,30057,"PIXELARTZ PA-15.6LS-3052 Laptop Skin, 15.6-Inches, Multicolour",Warehouse C,42,25,2025-02-19 21:31:00,17
13665,ORD_13666,19295,Glimisave M3 850 Tablet PR,Warehouse A,50,43,2025-02-19 05:39:00,7
13666,ORD_13667,19297,Nevcef CV Dry Syrup,Warehouse B,58,42,2025-02-19 23:00:00,16
13667,ORD_13668,33010,"iQOO Z6 44W by vivo (Raven Black, 4GB RAM, 128GB Storage) | 6.44"" FHD+ AMOLED Display | 50% Charge in just 27 mins | in-Di...",Warehouse C,11,6,2025-02-19 18:04:00,5
13668,ORD_13669,24753,Itbor 200mg Capsule,Warehouse B,69,52,2025-02-19 14:08:00,17
13669,ORD_13670,110,Tazogold 1000mg Injection,Warehouse A,117,99,2025-02-19 22:49:00,18
13670,ORD_13671,21698,Glimmer Nail Polish Blush Red 5 ml,Warehouse B,110,99,2025-02-19 17:30:00,11
13671,ORD_13672,35279,Kayfix 50mg Dry Syrup,Warehouse C,50,43,2025-02-19 17:54:00,7
13672,ORD_13673,12961,Ajmal Aurum EDP Fruity Floral Perfume 75ml for Women and Silver Shade EDP Citrus Woody Perfume 100ml for Men +1 Perfume Te...,Warehouse B,99,80,2025-02-19 03:54:00,19
13673,ORD_13674,8574,Monti-L 5mg/10mg Tablet,Warehouse C,79,62,2025-02-19 05:05:00,17
13674,ORD_13675,19257,PRONICS Original 2300 mAh DC024/H12348 Battery for Airtel My WiFi AMF-311WW Wireless Data Card 4G Hotspot (6 Months Warranty),Warehouse C,66,49,2025-02-19 19:11:00,17
13675,ORD_13676,33577,"Sedell Professional All In One Makeup Palette Cosmetic Contouring Kit 78 Colors Eyeshadow Palette With Blush, Face Powder ...",Warehouse A,96,81,2025-02-19 01:28:00,15
13676,ORD_13677,26472,Atozim-FR Tablet,Warehouse C,35,30,2025-02-19 08:23:00,5
13677,ORD_13678,13362,Diaglim 2 Tablet,Warehouse C,25,16,2025-02-19 20:50:00,9
13678,ORD_13679,13363,Skin Brightening Serum Mask With Vitamin E & Niacinamide,Warehouse B,97,80,2025-02-19 06:17:00,17
13679,ORD_13680,26481,"Beard Colour - Brown Black, For Men, 102",Warehouse A,94,75,2025-02-19 10:52:00,19
13680,ORD_13681,28005,Sounce Anti Fall Dust Protection Case Cover Compatible for Oppo Enco Buds Headphones case Silicone Headset case with Keych...,Warehouse C,88,73,2025-02-19 10:45:00,15
13681,ORD_13682,22550,Refreshing Menthol Bath Soap,Warehouse C,114,97,2025-02-19 20:35:00,17
13682,ORD_13683,12475,Oxlaw USB Type C to USB A Adapter USB C Male to USB3 Female Adapter Compatible with MacBook Pro 2021 iMac iPad Mini 6/Pro ...,Warehouse A,99,86,2025-02-19 22:26:00,13
13683,ORD_13684,8120,"Fitbit FB507BKBK Versa 2 Health & Fitness Smartwatch with Heart Rate, Music, Alexa Built-in, Sleep & Swim Tracking, Black/...",Warehouse B,15,3,2025-02-19 00:14:00,12
13684,ORD_13685,31974,Bisohox 2.5mg Tablet,Warehouse A,27,11,2025-02-19 20:32:00,16
13685,ORD_13686,962,Foxtine 20 Capsule,Warehouse C,100,85,2025-02-19 05:35:00,15
13686,ORD_13687,32445,Miss Rose 6 Color Shimmery Highlighter 7003 - 025 01 33 gm,Warehouse B,18,3,2025-02-19 09:45:00,15
13687,ORD_13688,24911,Thipin 25mg Tablet,Warehouse A,17,6,2025-02-19 17:21:00,11
13688,ORD_13689,4863,"Zebronics ZEB-BT3490RUCF Wireless Bluetooth Multimedia Speaker With Supporting SD Card, USB, AUX, FM & Remote Control. (50...",Warehouse C,27,8,2025-02-19 12:59:00,19
13689,ORD_13690,22305,TOSHIBA 139 cm (55 inches) 4K Ultra HD Smart QLED Google TV 55M550LP (Black),Warehouse C,112,97,2025-02-19 15:00:00,15
13690,ORD_13691,22407,ZOUK Women Office Bag Mandala Multicolor,Warehouse C,16,7,2025-02-19 19:01:00,9
13691,ORD_13692,2652,"SupCares Edge to Edge Privacy Tempered Glass for iPhone 14, iPhone 13 and iPhone 13 Pro (6.1 Inch) with Easy Self Installa...",Warehouse C,22,4,2025-02-19 18:10:00,18
13692,ORD_13693,8225,"NOCXTUN USB Type C OTG Adapter USB Mouse, Pendrive Connector & 2in1 OTG Adapter, USB 3.0 Female to Micro-USBConnector Alum...",Warehouse A,63,53,2025-02-19 16:16:00,10
13693,ORD_13694,31113,Belrin-LM 5mg/10mg Tablet,Warehouse A,92,76,2025-02-19 00:01:00,16
13694,ORD_13695,18490,Glimmer Premium Nail Enamel Ladybird 10 ml,Warehouse C,25,13,2025-02-19 11:25:00,12
13695,ORD_13696,34303,Samspas 40mg Injection,Warehouse B,17,4,2025-02-19 12:38:00,13
13696,ORD_13697,14943,Handwash Refil Pack,Warehouse A,85,79,2025-02-19 14:57:00,6
13697,ORD_13698,29539,LSARI Beauty Blender Makeup Sponge Multi Color Pack of 1,Warehouse A,104,96,2025-02-19 11:05:00,8
13698,ORD_13699,2241,Ofris 200mg Tablet,Warehouse A,54,42,2025-02-19 00:26:00,12
13699,ORD_13700,8119,Bandy-Plus Chewable Tablet,Warehouse C,100,84,2025-02-19 10:39:00,16
13700,ORD_13701,10581,Roszone S 500mg/500mg Injection,Warehouse C,25,15,2025-02-19 01:02:00,10
13701,ORD_13702,8053,"JNKC Full HD Wi-fi Wireless IP CCTV Security Camera Light Vision, Night Vision Remote Indoor 1080p V380 Pro App 360 Degree...",Warehouse B,56,51,2025-02-19 14:19:00,5
13702,ORD_13703,10571,Vega Eye Groomer Brush (MBP - 10) 18 gm,Warehouse A,88,72,2025-02-19 05:25:00,16
13703,ORD_13704,22645,"Rapidotzz Mi Band Straps - Pack of 1 (Blue, Unisex) | Removable Straps ONLY for MI Band 3 and 4 | MultiColour | Free Size...",Warehouse B,109,99,2025-02-19 22:16:00,10
13704,ORD_13705,18236,Imox Clo 125 mg/125 mg Tablet DT,Warehouse B,27,19,2025-02-19 01:44:00,8
13705,ORD_13706,22642,"Aroma® NB119 Titanium Bluetooth Wireless In Ear Neckband with Playback 48 Hrs, Smart Voice Assistant, Bluetooth V5.0, Swea...",Warehouse A,84,79,2025-02-19 23:10:00,5
13706,ORD_13707,6165,Numol Tablet,Warehouse A,91,86,2025-02-19 21:50:00,5
13707,ORD_13708,8078,Addnok 0.2mg Tablet,Warehouse C,98,80,2025-02-19 21:19:00,18
13708,ORD_13709,8086,Rabigal-DSR Capsule,Warehouse C,89,70,2025-02-19 07:36:00,19
13709,ORD_13710,4724,Doubledicestore Tempered Glass Screen Protector Compatible for Xiaomi Mi 11X / Xiaomi Mi 11X Pro with 11D Full Coverage an...,Warehouse C,96,78,2025-02-19 13:08:00,18
13710,ORD_13711,15035,Ajmal 2 Wisal And 2 Persuade Deodorants Pack of 4 200 ml,Warehouse B,85,71,2025-02-19 01:31:00,14
13711,ORD_13712,24425,Apple Watch Magnetic Charging Cable (1 m),Warehouse A,32,26,2025-02-19 18:03:00,6
13712,ORD_13713,3917,OMOTON Advanced HD+ Tempered Glass Screen Protector Compatible for Google Pixel 6a Edge to Edge with Easy Installation Kit,Warehouse B,20,13,2025-02-19 05:10:00,7
13713,ORD_13714,18271,SAI HERBS Surma Kala - Surma Black - Black Surma - Pure & Organic (100 Grams),Warehouse B,36,27,2025-02-19 12:21:00,9
13714,ORD_13715,31115,Vominos Tablet,Warehouse C,97,80,2025-02-19 11:40:00,17
13715,ORD_13716,6994,"Fairness Naturals Hair Removal Cream Fair & Soft - Sandal, Dry Skin",Warehouse A,45,34,2025-02-19 04:01:00,11
13716,ORD_13717,12491,"boAt Xtend Smartwatch Superman Edition with Alexa Built-in, 1.69” HD Display, Multiple Watch Faces, Stress Monitor, Heart...",Warehouse A,48,30,2025-02-19 22:14:00,18
13717,ORD_13718,6062,Agyl F 100 mg/300 mg Tablet,Warehouse B,107,94,2025-02-19 03:34:00,13
13718,ORD_13719,32432,Genericart Disulfiram 500mg Tablet,Warehouse C,31,19,2025-02-19 11:55:00,12
13719,ORD_13720,29876,"Duracell Ultra Alkaline AAA Batteries, Pack of 8",Warehouse B,81,69,2025-02-19 22:18:00,12
13720,ORD_13721,26099,Revolution Pro Supreme Matte Lip Pigment-Pretence 2.5 ml,Warehouse A,80,63,2025-02-19 16:14:00,17
13721,ORD_13722,24509,Ibolme Trio Tablet,Warehouse A,8,2,2025-02-19 23:28:00,6
13722,ORD_13723,36670,Sulcetis SB 1500mg Injection,Warehouse B,71,55,2025-02-19 15:58:00,16
13723,ORD_13724,2264,LOHAYA Air Conditioner Remote Compatible Samsung Split AC Remote Control [ Compatible for Samsung AC Remote Control ] [AC-...,Warehouse B,60,53,2025-02-19 07:55:00,7
13724,ORD_13725,3705,Glimfirst-M 1 Tablet SR,Warehouse C,61,46,2025-02-19 02:53:00,15
13725,ORD_13726,22452,Cefnic 50 Dry Syrup Strawberry,Warehouse C,58,44,2025-02-19 03:24:00,14
13726,ORD_13727,10418,kalpana bindi Maroon Slim Tilak Sticker kumkum | (Pack of 12) (Size-3),Warehouse C,55,39,2025-02-19 10:47:00,16
13727,ORD_13728,22293,"Fashion Colour Vivid Matte Lipstick, 11 Red Brown 3.8 gm",Warehouse A,114,96,2025-02-19 21:12:00,18
13728,ORD_13729,16022,Dilevocet 5mg Tablet,Warehouse B,13,6,2025-02-19 20:47:00,7
13729,ORD_13730,4871,"Western Digital WD Green SATA 1TB, Up to 545MB/s, 2.5 Inch/7 mm, 3Y Warranty, Internal Solid State Drive (SSD) (WDS100T3G0A)",Warehouse B,23,14,2025-02-19 10:29:00,9
13730,ORD_13731,35512,Colgate ZigZag Charcoal Medium Bristle Toothbrush - 4 Pcs,Warehouse B,18,12,2025-02-19 06:09:00,6
13731,ORD_13732,10344,Sahacharadi Thailam,Warehouse A,86,74,2025-02-19 14:16:00,12
13732,ORD_13733,26089,Street Wear Playfull Matte Lip Crayon - Insta Raisin 2.9 gm,Warehouse C,63,55,2025-02-19 12:19:00,8
13733,ORD_13734,22340,Geragen Injection,Warehouse A,92,79,2025-02-19 05:33:00,13
13734,ORD_13735,26114,"Samsung Original Travel Adapter (15W, White)",Warehouse C,33,15,2025-02-19 17:17:00,18
13735,ORD_13736,24922,Amazon Brand - Symbol Women Mask,Warehouse A,62,48,2025-02-19 12:35:00,14
13736,ORD_13737,33120,Gentleman Classic Daily Wear Perfume EDC For Men,Warehouse B,110,99,2025-02-19 14:21:00,11
13737,ORD_13738,15618,"LIRAMARK Phone Kickstand/Phone Stand/Mobile Holder, Vertical and Horizontal Stand, Adjustable Angle, Compatible with iPhon...",Warehouse C,28,10,2025-02-19 10:00:00,18
13738,ORD_13739,1639,"Fashion Colour Baked Blusher, Shade 05 8 gm",Warehouse B,108,96,2025-02-19 08:55:00,12
13739,ORD_13740,34314,Acticlav 500mg/125mg Tablet,Warehouse C,59,47,2025-02-19 08:54:00,12
13740,ORD_13741,30117,"LF KIA Sonet HTK + | HTX, Car Accessories Navigation or Music System (Stereo) Touch Screen Guard 8inch (Company Fitted) - ...",Warehouse B,71,63,2025-02-19 14:34:00,8
13741,ORD_13742,28426,S Cef 125mg Tablet DT,Warehouse B,107,93,2025-02-19 18:53:00,14
13742,ORD_13743,18594,Cefovik 500mg/500mg Injection,Warehouse A,86,73,2025-02-19 10:21:00,13
13743,ORD_13744,28411,Vega Paddle Brush (E9 - PB) 126 gm,Warehouse C,87,70,2025-02-19 17:37:00,17
13744,ORD_13745,30550,Dicospas MF 10mg/250mg Tablet,Warehouse C,45,26,2025-02-19 01:41:00,19
13745,ORD_13746,33131,Cezof 500mg Injection,Warehouse B,90,72,2025-02-19 16:09:00,18
13746,ORD_13747,29828,Itrachem 200mg Capsule,Warehouse C,34,24,2025-02-19 21:21:00,10
13747,ORD_13748,36635,"Classmate Pulse Single Line 5-Subject Notebook - 297mm x 210mm, 60 GSM, 250 Pages(Color and design may vary)",Warehouse C,33,27,2025-02-19 05:00:00,6
13748,ORD_13749,16111,Essence Mattifying Compact Powder 02 12 gm,Warehouse A,83,66,2025-02-19 07:38:00,17
13749,ORD_13750,28499,"Oraimo 5A Dual Port 34.5W Rapid Car Charger Quick Charge with Qualcomm Certified QC3.0 & PE2.0, Fast Car Charger Adapter -...",Warehouse A,94,78,2025-02-19 16:37:00,16
13750,ORD_13751,18405,Smart Shelter 2 Height Adjustable Satellite Speaker Stands Mounts Heavy Duty Floor Surround Sound Satellite Small Bookshel...,Warehouse A,100,93,2025-02-19 15:26:00,7
13751,ORD_13752,940,Opanta 40mg Powder for Injection,Warehouse C,9,1,2025-02-19 03:10:00,8
13752,ORD_13753,32416,Amator 20 Tablet,Warehouse B,85,75,2025-02-19 23:07:00,10
13753,ORD_13754,18410,"Samsung Galaxy S21 FE 5G (Graphite, 8GB, 128GB Storage)",Warehouse A,87,80,2025-02-19 06:07:00,7
13754,ORD_13755,35571,Callas Multi-Purpose Office Laptop Table Desk Organiser/Study Table/Bed Table/Foldable and Portable Wooden Desk Organiser...,Warehouse B,106,91,2025-02-19 15:16:00,15
13755,ORD_13756,4064,Amicaba 250mg Injection,Warehouse A,13,2,2025-02-19 09:21:00,11
13756,ORD_13757,30498,JAGUAR Body Spray Deodorant Spray - For Men (150 ml),Warehouse B,76,62,2025-02-19 16:20:00,14
13757,ORD_13758,3725,Novacip 1gm Injection,Warehouse A,25,8,2025-02-19 19:15:00,17
13758,ORD_13759,31436,NOTE MINERAL EYESHADOW 303 2 gm,Warehouse B,87,69,2025-02-19 00:52:00,18
13759,ORD_13760,36651,"boAt AUX 500 Indestructible Male to Male Metallic Aux Audio Cable with Gold Plated connectors for Smartphone, 1.5 Meter (5...",Warehouse B,26,17,2025-02-19 03:53:00,9
13760,ORD_13761,18435,Faber-Castell Whiteboard Broad Marker - Pack of 10 (Black),Warehouse C,71,58,2025-02-19 07:40:00,13
13761,ORD_13762,7009,Faces Canada Hi Shine Nail Enamel Natural Nude 229 9 Ml,Warehouse C,82,67,2025-02-19 08:09:00,15
13762,ORD_13763,8170,Aloevera Cucumber Body Lotion,Warehouse A,58,48,2025-02-19 00:10:00,10
13763,ORD_13764,28470,Advanced Ayurvedic Pimple Treatment,Warehouse B,34,17,2025-02-19 13:01:00,17
13764,ORD_13765,14962,The Face Shop Rice Ceramide Moisturizing Toner 150 Ml,Warehouse A,76,66,2025-02-19 06:38:00,10
13765,ORD_13766,31563,Zymoheal D Tablet,Warehouse A,76,57,2025-02-19 04:23:00,19
13766,ORD_13767,28347,Cefgree 100mg Tablet,Warehouse A,17,8,2025-02-19 12:44:00,9
13767,ORD_13768,10482,Azivid FS 150mg/1000mg/1000mg Kit,Warehouse A,22,17,2025-02-19 01:34:00,5
13768,ORD_13769,13049,"MISSLOOK Makeup Practice Face Board, face dummy for makeup practice, Practice Skin Board,for Makeup Practice Mask Skin Fac...",Warehouse C,81,69,2025-02-19 00:04:00,12
13769,ORD_13770,28572,Morning Dew Compact Perfume,Warehouse C,104,99,2025-02-19 21:15:00,5
13770,ORD_13771,8094,"Casio FX-82ES Plus 2nd Edition - Non-Programmable Scientific Calculator, 252 Functions, Black",Warehouse C,16,7,2025-02-19 20:26:00,9
13771,ORD_13772,15593,KP-12 Injection,Warehouse A,94,79,2025-02-19 21:49:00,15
13772,ORD_13773,8097,"iQOO Neo 6 5G (Cyber Rage, 8GB RAM, 128GB Storage) | Only Snapdragon 870 in The Segment | 50% Charge in Just 12 Mins | 90 ...",Warehouse A,33,26,2025-02-19 16:25:00,7
13773,ORD_13774,13942,Musk Woman Deodorant,Warehouse A,41,29,2025-02-19 17:09:00,12
13774,ORD_13775,10522,"DJI OSMO Mobile 6 Smartphone Gimbal Stabilizer, 3-Axis Phone Gimbal, Built-In Extension Rod, Portable and Foldable, Androi...",Warehouse C,81,75,2025-02-19 06:40:00,6
13775,ORD_13776,33169,"HUMBLE MI Band 3/ MI Band 4 Strap, Band for MI Band 3/ MI Band 4 Smartwatch (Fitness Tracker) Wristbands Replacement Silic...",Warehouse C,88,71,2025-02-19 16:17:00,17
13776,ORD_13777,13437,"Calming, Rose Geranium Cold Pressed Body Massage Oil",Warehouse B,20,11,2025-02-19 16:16:00,9
13777,ORD_13778,32414,"Face Mask GP95+ - Blue, Medium",Warehouse B,60,45,2025-02-19 19:02:00,15
13778,ORD_13779,10477,"CEDO 65W OnePlus Dash Warp Charge Cable, 6.5A Type-C to USB C PD Data Sync Fast Charging Cable Compatible with One Plus 8...",Warehouse A,78,64,2025-02-19 04:26:00,14
13779,ORD_13780,18293,Glavinm 2mg/500mg Tablet,Warehouse B,91,85,2025-02-19 15:11:00,6
13780,ORD_13781,8159,Oil - Maha Bhrangraj,Warehouse C,48,30,2025-02-19 13:04:00,18
13781,ORD_13782,7024,HT Guard 40mg Tablet,Warehouse B,51,40,2025-02-19 06:37:00,11
13782,ORD_13783,22591,Ozpod CV 200mg/125mg Tablet,Warehouse C,72,62,2025-02-19 22:59:00,10
13783,ORD_13784,2673,Kepodil CV 100mg/62.5mg Tablet DT,Warehouse A,35,18,2025-02-19 09:07:00,17
13784,ORD_13785,22661,Tusmox 500mg Capsule,Warehouse C,20,1,2025-02-19 22:26:00,19
13785,ORD_13786,13336,Everycom Mini Tripod with Mount Compatible with All Mobile Phones and Digital Camera - Black,Warehouse A,32,13,2025-02-19 08:46:00,19
13786,ORD_13787,15050,Okazac-D Capsule,Warehouse B,68,52,2025-02-19 05:36:00,16
13787,ORD_13788,12443,"Juarez Lindenwood Acoustic Guitar Kit, 38 Inches Cutaway, 38C With Bag, Strings, Pick And Strap, TBS Transparent (Blue Sun...",Warehouse C,106,99,2025-02-19 00:20:00,7
13788,ORD_13789,18125,Xedo 50mg Dry Syrup,Warehouse B,37,20,2025-02-19 05:52:00,17
13789,ORD_13790,32369,9to5 Natural Aloe Cleansing Wipes,Warehouse B,87,72,2025-02-19 09:34:00,15
13790,ORD_13791,28675,"Maybelline New York Face Studio Master Chrome Metallic Highlighter, Molten Gold 6.7 gm",Warehouse C,69,60,2025-02-19 11:35:00,9
13791,ORD_13792,31772,"Gizga Essentials Earphone Earpod Cleaning Pen for AirPod, Earbuds, Headphones, Wireless Earphones, 2-in-1 Multifunctional ...",Warehouse A,90,73,2025-02-19 18:11:00,17
13792,ORD_13793,18143,Casio SA-76 Musical Mini Keyboard with Free Adaptor for Kids,Warehouse C,14,8,2025-02-19 19:52:00,6
13793,ORD_13794,18150,Passion Indulge CARRIER OIL-JOJOBA 60 ml,Warehouse A,48,29,2025-02-19 00:32:00,19
13794,ORD_13795,11797,Amazon Brand - Solimo Thermoplastic Polyurethane Soft & Flexible Back Cover for Xiaomi Redmi Note 8 Pro (Transparent),Warehouse A,92,75,2025-02-19 01:40:00,17
13795,ORD_13796,13070,Moco 200mg Tablet,Warehouse C,43,34,2025-02-19 18:53:00,9
13796,ORD_13797,888,Amalaki Powder,Warehouse A,88,81,2025-02-19 05:21:00,7
13797,ORD_13798,13068,Cuzor 12V Mini ups for WiFi Router | Power Backup up to 4 Hours | Replaceable Battery | Ups for Wi-Fi Router and Modem | U...,Warehouse A,64,56,2025-02-19 22:11:00,8
13798,ORD_13799,8043,Montest Odt 10mg Tablet,Warehouse A,98,79,2025-02-19 23:54:00,19
13799,ORD_13800,30466,VBA Kajal with Colossal Kajal Revolving Pencils Pack of 12 (13 Items in the set),Warehouse C,95,76,2025-02-19 17:09:00,19
13800,ORD_13801,25965,Acefox SP Tablet,Warehouse A,53,47,2025-02-19 10:01:00,6
13801,ORD_13802,12457,"PIDILITE Fevicryl Acrylic Colours Sunflower Kit (10 Colors x 15 ml) DIY Paint, Rich Pigment, Non-Craking Paint for Canvas,...",Warehouse A,37,27,2025-02-19 04:37:00,10
13802,ORD_13803,2233,The Moms Co. Age Control Face Oil 30 ml,Warehouse C,25,19,2025-02-19 13:09:00,6
13803,ORD_13804,33673,Cremogal Syrup Mint,Warehouse A,70,55,2025-02-19 18:32:00,15
13804,ORD_13805,15038,Parasafe 125mg/12.5mg Drop,Warehouse B,23,5,2025-02-19 03:57:00,18
13805,ORD_13806,31761,Almond Oil B P,Warehouse C,24,13,2025-02-19 07:42:00,11
13806,ORD_13807,22580,"Apple Watch Series 8 [GPS 41 mm] Smart Watch w/Midnight Aluminium Case with Midnight Sport Band. Fitness Tracker, Blood Ox...",Warehouse B,52,47,2025-02-19 04:01:00,5
13807,ORD_13808,29928,Spigen Full Coverage Tempered Glass Screen Protector Guard for MacBook Pro 14 inch (M2 Pro / M2 Max / M1 Pro / M1 Max) - 1...,Warehouse C,69,55,2025-02-19 21:50:00,14
13808,ORD_13809,10335,Stbotanica Dragonfruit Vanilla Body Wash With Shea & Vitamin E 250 ml,Warehouse B,22,16,2025-02-19 06:33:00,6
13809,ORD_13810,35450,Pudin Hara Fizz,Warehouse A,97,89,2025-02-19 22:04:00,8
13810,ORD_13811,17291,Teal & Terra Hairfall And Dandruff Treatment Oil 100 ml,Warehouse B,75,59,2025-02-19 12:47:00,16
13811,ORD_13812,16441,MARS Metallic Liquid Eyeshadow 5.5 ml (Celestial comet),Warehouse A,91,79,2025-02-19 10:42:00,12
13812,ORD_13813,29204,Trp 325mg Injection,Warehouse C,59,51,2025-02-19 23:50:00,8
13813,ORD_13814,31259,IKWI SnoozePro Meltables With 5mg Melatonin & Valerian 1's,Warehouse A,65,47,2025-02-19 22:03:00,18
13814,ORD_13815,33761,Atorsim 20mg Tablet,Warehouse B,114,99,2025-02-19 04:13:00,15
13815,ORD_13816,30307,House of Aroma Meditation Fragrance Oil 100 ml,Warehouse B,38,31,2025-02-19 19:53:00,7
13816,ORD_13817,23450,Restorative Under Eye Cream,Warehouse A,106,98,2025-02-19 14:14:00,8
13817,ORD_13818,23449,Dranzen 10mg Tablet,Warehouse B,12,1,2025-02-19 05:07:00,11
13818,ORD_13819,23446,Visle Syrup,Warehouse A,77,70,2025-02-19 08:14:00,7
13819,ORD_13820,6405,Ruvotone 10 Tablet,Warehouse C,45,27,2025-02-19 00:49:00,18
13820,ORD_13821,23438,"Jovees Herbal Thyme & Tea Tree Shampoo For All Hair Types, 250 ml | Anti Dandruff Shampoo | Paraben & Alcohol Free",Warehouse C,21,2,2025-02-19 14:57:00,19
13821,ORD_13822,32199,Ofloriv-OZ Tablet,Warehouse C,17,2,2025-02-19 06:28:00,15
13822,ORD_13823,31392,Luxor Fine Writer Black Color (pack Of 10 Pen),Warehouse B,55,41,2025-02-19 20:29:00,14
13823,ORD_13824,33758,Sea Salt Texture Tonic 250 ml,Warehouse B,30,24,2025-02-19 04:33:00,6
13824,ORD_13825,7192,Ajmal Zeal EDP Aquatic Woody Perfume And Carbon Homme Deodorant Citrus Spicy Fragrance 300 ml,Warehouse A,84,75,2025-02-19 10:44:00,9
13825,ORD_13826,23486,MOROFY Stainless Steel Metal Chain Watch band Compatible with Apple Watch Strap Ultra Series 8 | 7 | 6 | 5 | 4 | 3 | 2 | 1...,Warehouse B,46,31,2025-02-19 13:56:00,15
13826,ORD_13827,3311,"Samsung 7 kg Fully-Automatic Top Loading Washing Machine (WA70A4002GS/TL, Imperial Silver, Diamond drum)",Warehouse A,28,10,2025-02-19 10:45:00,18
13827,ORD_13828,660,Rapid MF Syrup,Warehouse C,44,37,2025-02-19 15:09:00,7
13828,ORD_13829,6660,Glycirest-G2 Forte Tablet SR,Warehouse A,38,33,2025-02-19 00:03:00,5
13829,ORD_13830,13750,Baxtel 40AM Tablet,Warehouse C,98,81,2025-02-19 02:18:00,17
13830,ORD_13831,16774,Cadinik A Gel,Warehouse C,64,57,2025-02-19 12:55:00,7
13831,ORD_13832,25268,Panodar 40mg Tablet,Warehouse A,51,37,2025-02-19 01:31:00,14
13832,ORD_13833,31321,"Goochie Permanent Makeup Micro Pigment Deep Coffee 212, 15ml",Warehouse C,61,52,2025-02-19 09:45:00,9
13833,ORD_13834,16617,Ezikoz Dmr Syrup,Warehouse B,80,69,2025-02-19 02:01:00,11
13834,ORD_13835,25293,Ajmal 2 Distraction & 2 Persuade Deo & Yearn EDP Pack of 3 20 ml,Warehouse A,68,49,2025-02-19 13:33:00,19
13835,ORD_13836,23994,Ayurvedic Body Massage Oil - Abhyanga Thaila,Warehouse B,17,6,2025-02-19 22:00:00,11
13836,ORD_13837,325,Vogliboss 0.2mg Tablet,Warehouse B,62,46,2025-02-19 10:18:00,16
13837,ORD_13838,2821,GENERIC Ultra-Mini Bluetooth CSR 4.0 USB Dongle Adapter for Windows Computer ( Black:Golden),Warehouse A,86,71,2025-02-19 07:53:00,15
13838,ORD_13839,29207,Zetivas 20mg/10mg Tablet,Warehouse C,67,57,2025-02-19 05:42:00,10
13839,ORD_13840,36546,Sahwas 50 Tablet,Warehouse B,72,58,2025-02-19 13:18:00,14
13840,ORD_13841,11192,Topac Fast Gel,Warehouse B,77,72,2025-02-19 03:36:00,5
13841,ORD_13842,33338,"Carvaan Saregama Mini Kids - Pre-Loaded with Stories, Rhymes, Learnings, Mantras with Bluetooth/USB/Aux in-Out",Warehouse B,25,6,2025-02-19 21:34:00,19
13842,ORD_13843,2153,"Chemistkart MYOSTAAL LINIMENT, 110ml",Warehouse B,36,20,2025-02-19 12:02:00,16
13843,ORD_13844,33984,Belol 50mg Tablet XL,Warehouse C,17,6,2025-02-19 12:28:00,11
13844,ORD_13845,29152,"TP-Link | AC1200 WiFi Range Extender | Up to 1200Mbps Speed | Dual Band Wireless Extender, Repeater, Signal Booster, Acces...",Warehouse C,61,51,2025-02-19 23:00:00,10
13845,ORD_13846,25549,"SERY Satin Flawless Longwear Foundation| Velvety finish, Medium coverage, Light Weight, Oil free Moisturizing effect, UVA-...",Warehouse B,36,26,2025-02-19 03:11:00,10
13846,ORD_13847,6386,Winble Magnetic Case for iPhone 14 Plus Back Cover Case | Anti-Fall Clear Non-Yellow Protective Clear Shockproof Compatibl...,Warehouse A,100,90,2025-02-19 20:28:00,10
13847,ORD_13848,17346,Esizol Plus 0.5mg/10mg Tablet,Warehouse C,79,70,2025-02-19 05:46:00,9
13848,ORD_13849,11122,Spigen Ultra Hybrid Back Cover Case Compatible with iPhone 14 Pro (TPU + Poly Carbonate | Matte Black),Warehouse C,103,96,2025-02-19 07:28:00,7
13849,ORD_13850,2853,Myglamm Lit Lip & Eye Sparkles - Kween 1.1 Gm,Warehouse A,70,54,2025-02-19 17:15:00,16
13850,ORD_13851,36217,Gastrorab D 30mg/20mg Capsule SR,Warehouse C,106,87,2025-02-19 03:24:00,19
13851,ORD_13852,727,L.A Girl HD PRO Conceal Pure Beige 8 gm,Warehouse B,111,93,2025-02-19 15:31:00,18
13852,ORD_13853,3241,Zinten 10mg Tablet,Warehouse C,57,46,2025-02-19 23:08:00,11
13853,ORD_13854,17311,Full Body Roller Massager - Colour May Vary,Warehouse C,29,12,2025-02-19 13:11:00,17
13854,ORD_13855,31398,Ominoh D 10mg/20mg Capsule,Warehouse C,34,21,2025-02-19 12:09:00,13
13855,ORD_13856,17370,"ZEBRONICS Zeb-U725 600VA UPS for Desktop/PC/Computers (not for Routers) with Automatic Voltage Regulation, Black",Warehouse B,87,74,2025-02-19 09:52:00,13
13856,ORD_13857,11098,Amtilin DP 12.5mg/5mg Tablet,Warehouse B,85,80,2025-02-19 05:41:00,5
13857,ORD_13858,731,Acepar SP 100mg/325mg/15mg Tablet,Warehouse B,115,99,2025-02-19 14:06:00,16
13858,ORD_13859,15247,Setmet -DT Tablet,Warehouse A,48,30,2025-02-19 08:51:00,18
13859,ORD_13860,33998,Cyber IT 100mg Capsule,Warehouse A,85,78,2025-02-19 19:11:00,7
13860,ORD_13861,25065,"Deborah Milano Fluid Velvet Mat Lip Stick, Iconic Red, 4.5g",Warehouse A,68,63,2025-02-19 21:16:00,5
13861,ORD_13862,29113,Daily Nourish Styling Gel - Strong Hold,Warehouse B,42,32,2025-02-19 11:08:00,10
13862,ORD_13863,25064,Maped Essential Soft 17cm Scissor,Warehouse C,54,35,2025-02-19 07:39:00,19
13863,ORD_13864,17390,"Tukzer High Speed USB Type C to USB B 2.0 Printer Cable Cord| Nylon Braided Fiber Jacket, Gold Plated Connectors| Compatib...",Warehouse C,76,71,2025-02-19 14:12:00,5
13864,ORD_13865,4425,Bio Lotion Baby Honey Lotion For Disney Kids - Cars 180 Ml,Warehouse A,25,16,2025-02-19 04:40:00,9
13865,ORD_13866,7617,Skin Natutals - Gentle Soothing Face Wash,Warehouse A,48,29,2025-02-19 22:07:00,19
13866,ORD_13867,4399,Nerovit 500mcg Injection,Warehouse A,49,44,2025-02-19 22:45:00,5
13867,ORD_13868,11656,Metaz-S Ointment,Warehouse B,59,41,2025-02-19 01:59:00,18
13868,ORD_13869,35951,Strontium Nitro A1 64GB Micro SDXC Memory Card 100MB/s A1 UHS-I U3 Class 10 with High Speed Adapter for Smartphones Tablet...,Warehouse A,76,63,2025-02-19 01:09:00,13
13869,ORD_13870,12234,Parker Vector Standard CT Fountain Pen (Red) With Free Cartridge,Warehouse B,41,22,2025-02-19 05:21:00,19
13870,ORD_13871,13234,Wireless Earphones for OnePlus Nord/ 1+ /One Plus Nord Original Sports Bluetooth Wireless Earphone with Deep Bass and Neck...,Warehouse A,95,84,2025-02-19 21:43:00,11
13871,ORD_13872,29455,Enam 10 Tablet,Warehouse B,65,48,2025-02-19 08:01:00,17
13872,ORD_13873,16744,Mamaearth Everyday Matte Liquid Lipstick Combo with Vitamin C & E For Upto 12 Hour Long Stay - 01 Caramel Nude & 08 - Choc...,Warehouse B,36,27,2025-02-19 17:07:00,9
13873,ORD_13874,15423,TheGiftKart Flip Back Cover Case for Poco X5 5G / Mi Redmi Note 12 5G | Dual-Color Leather Finish | Inbuilt Stand & Pocket...,Warehouse B,20,1,2025-02-19 18:32:00,19
13874,ORD_13875,30236,Osteofos 10mg Tablet,Warehouse B,49,38,2025-02-19 19:05:00,11
13875,ORD_13876,36060,"Portronics Clean M Multifunctional 8-in-1 Gadget Cleaning Kit with Mobile Holder for Smartphone, Tablet, Laptop, Earbuds(W...",Warehouse C,60,52,2025-02-19 01:27:00,8
13876,ORD_13877,16593,Papaya Shampoo - Hair Fall Control & Volume To Hair,Warehouse A,107,96,2025-02-19 04:39:00,11
13877,ORD_13878,33783,Homocyp Syrup,Warehouse A,100,82,2025-02-19 15:40:00,18
13878,ORD_13879,7482,Maryaj Pebble Shine EDP Floral Fruity Perfume And Ajmal Wisal Deodorant Floral Musky Fragrance 300 ml,Warehouse A,21,11,2025-02-19 09:20:00,10
13879,ORD_13880,31515,Echo Dot (Black) Combo with Wipro 9W Smart Color Bulb - Smart Home Starter Kit,Warehouse B,76,59,2025-02-19 18:47:00,17
13880,ORD_13881,23671,"Park Avenue Spice Trail Deodorant for men | Natural Organic Premium Perfumes, 150ml | Contains 100% Natural Essential Oils",Warehouse B,48,34,2025-02-19 22:59:00,14
13881,ORD_13882,11587,TNW - The Natural Wash Baby Shampoo 150 ml,Warehouse C,86,69,2025-02-19 19:04:00,17
13882,ORD_13883,16964,Zerolix P Oral Suspension,Warehouse A,88,79,2025-02-19 20:27:00,9
13883,ORD_13884,29368,"Maizic Walkie Talkie UHF Emergency Alarm, Flash Light, Long Range Communication (Black)",Warehouse B,88,77,2025-02-19 08:14:00,11
13884,ORD_13885,25389,Dizeral AZ 0.25mg/20mg Tablet,Warehouse C,23,11,2025-02-19 17:23:00,12
13885,ORD_13886,15368,"Miss Hot 5 PAIR EYELASH, EYELASH GLUE, EYELASH CURLER WITH GEL EYELINER",Warehouse C,45,36,2025-02-19 00:03:00,9
13886,ORD_13887,31290,Brother DCP-B7535DW Multi-Function Monochrome Laser Printer with Auto Duplex Printing & Wi-Fi (Toner Box Technology),Warehouse B,82,73,2025-02-19 09:51:00,9
13887,ORD_13888,29604,eller santé® 15W Wireless Charger MontClad SERIES Fast charging pad| PD & Qi-Certified with Type C Cable Fireproof ABS for...,Warehouse C,98,87,2025-02-19 09:57:00,11
13888,ORD_13889,31372,"Portronics Auto One Smart Car Charger & Music Streamer with Hands Free Calling, Bluetooth 5.0, Quick Charge 3.0, 23W max O...",Warehouse B,31,18,2025-02-19 21:09:00,13
13889,ORD_13890,4197,"ESR Rebound Case with Pencil Holder for iPad 9th/8th/7th Generation Cover, iPad 10.2 Case with Pencil Holder (2021/2020/20...",Warehouse A,90,72,2025-02-19 01:25:00,18
13890,ORD_13891,16520,Triz Tablet,Warehouse C,11,6,2025-02-19 20:08:00,5
13891,ORD_13892,4327,Douxclav LB 500mg/125mg Tablet,Warehouse A,114,98,2025-02-19 15:26:00,16
13892,ORD_13893,23632,Lip Care Stick - Pomegranate,Warehouse B,101,92,2025-02-19 11:13:00,9
13893,ORD_13894,29339,"Small General Cutting Scissor - SCS-01, Colour May Vary",Warehouse A,12,6,2025-02-19 00:38:00,6
13894,ORD_13895,11318,"OREI India to Europe (Schuko) Plug - Type E/F Europe Plug Adapter - 2 in 1 Universal Adapter for Europe, Perfect for Lapto...",Warehouse A,51,41,2025-02-19 10:10:00,10
13895,ORD_13896,6473,"GOBBLER A4 All in One Lamination Machine/Laminator with Jam Release Button, Supports Hot Laminating, Plastic Body (GB-200-PL)",Warehouse C,12,2,2025-02-19 14:02:00,10
13896,ORD_13897,11312,Besure 200mg Tablet,Warehouse C,35,26,2025-02-19 07:09:00,9
13897,ORD_13898,24065,Fordcef 200mg Tablet,Warehouse B,107,98,2025-02-19 15:25:00,9
13898,ORD_13899,31836,Original 20W Fast Charger with Cable Compatible for Apple iPhone 7 iPhone 7 Plus (Adapter and Cable) – White (RVT-2023-pdc...,Warehouse A,50,45,2025-02-19 00:23:00,5
13899,ORD_13900,24578,Amset XT 5 mg/50 mg Tablet,Warehouse B,63,54,2025-02-19 08:27:00,9
13900,ORD_13901,6617,Ajmal Blu Homme & Wisal Dhahab Deo & Aretha EDP Pack of 3 20 ml,Warehouse A,35,23,2025-02-19 06:04:00,12
13901,ORD_13902,7365,Fexolar 180 Tablet,Warehouse B,106,88,2025-02-19 08:27:00,18
13902,ORD_13903,12235,Alexi 500mg/125mg Tablet,Warehouse C,57,41,2025-02-19 08:14:00,16
13903,ORD_13904,36116,Omekav-D Capsule,Warehouse B,26,19,2025-02-19 08:21:00,7
13904,ORD_13905,33401,"ESR HaloLock Universal MagSafe Ring, Magnetic Wireless Charging Conversion Kit, MagSafe Sticker, Compatible with iPhone 1...",Warehouse A,36,28,2025-02-19 00:32:00,8
13905,ORD_13906,23787,Frimov 100 mg/500 mg Tablet,Warehouse A,64,47,2025-02-19 23:54:00,17
13906,ORD_13907,29441,Montlife-FX Tablet,Warehouse C,12,3,2025-02-19 15:56:00,9
13907,ORD_13908,24005,"boAt Rockerz 330 in-Ear Bluetooth Neckband with Upto 30 Hours Playtime, ASAP Charge, Signature Sound, Dual Pairing & IPX5...",Warehouse B,83,74,2025-02-19 19:39:00,9
13908,ORD_13909,23754,Aifenac MR 250mg/50mg/325mg Tablet,Warehouse C,37,19,2025-02-19 04:37:00,18
13909,ORD_13910,29579,Amvulac Kid 200mg/28.5mg Tablet,Warehouse C,18,6,2025-02-19 18:11:00,12
13910,ORD_13911,16868,The Cosmetic Republic 0.0 Conditioner 200 ml,Warehouse A,93,88,2025-02-19 00:09:00,5
13911,ORD_13912,6627,Geemax 1000mcg/100mg/100mg Injection,Warehouse B,63,47,2025-02-19 16:05:00,16
13912,ORD_13913,11471,Inhaler,Warehouse A,95,87,2025-02-19 09:27:00,8
13913,ORD_13914,1866,Daily Life Forever52 Star Dust Eyeshadow Glitter Sd015 2.5 gm,Warehouse B,113,95,2025-02-19 04:15:00,18
13914,ORD_13915,36160,Love Eau De Toilette,Warehouse C,85,75,2025-02-19 20:44:00,10
13915,ORD_13916,23898,Laptop Table Leg mounts,Warehouse A,80,66,2025-02-19 20:53:00,14
13916,ORD_13917,7323,MotoTrance ESSENTIALS Blue Scooty Cover - Honda Activa 5G | With Storage Bag | Water Resistant | Dust and Heat Protection...,Warehouse A,58,39,2025-02-19 19:55:00,19
13917,ORD_13918,16679,Symace MR 100mg/325mg/250mg Tablet,Warehouse C,81,63,2025-02-19 18:54:00,18
13918,ORD_13919,25221,Mother Sparsh Plant Powered Natural Baby Lotion 200 ml,Warehouse A,52,34,2025-02-19 01:45:00,18
13919,ORD_13920,7335,Lakme Eyeconic Kajal Turquoise 0.35 Gm,Warehouse A,93,83,2025-02-19 12:22:00,10
13920,ORD_13921,25230,Sioxime 100mg Tablet,Warehouse C,80,65,2025-02-19 08:06:00,15
13921,ORD_13922,23945,EGOTUDE Ultra Hybrid Camera Lens Protection [Never Yellowing] Back Cover Case for iPhone 14 Plus (Sierra Blue),Warehouse A,106,92,2025-02-19 16:14:00,14
13922,ORD_13923,6615,Neurocin-P 500mcg/75mg Tablet,Warehouse B,80,66,2025-02-19 03:04:00,14
13923,ORD_13924,23911,Lifestin 20mg Tablet,Warehouse C,90,75,2025-02-19 19:25:00,15
13924,ORD_13925,16704,Cipward 250mg Tablet,Warehouse A,107,89,2025-02-19 19:06:00,18
13925,ORD_13926,3264,Dandruff Control Ayurvedic Soya Protein Shampoo,Warehouse A,102,94,2025-02-19 08:35:00,8
13926,ORD_13927,13599,Rebolic 20mg Injection,Warehouse C,59,53,2025-02-19 09:54:00,6
13927,ORD_13928,6581,"AmazonBasics High-Speed Braided HDMI Cable - 10 Feet - Supports Ethernet, 3D, 4K and Audio Return (Black)",Warehouse B,18,4,2025-02-19 15:51:00,14
13928,ORD_13929,32097,"CGG Cosmetics Rose Water Micellar Cleansing Water 4 in 1 Skin Hydration Removing Makeup, Cleanse & Minimizing Pores for Al...",Warehouse A,95,78,2025-02-19 08:02:00,17
13929,ORD_13930,33815,Genericart Telmisartan 80mg Tablet,Warehouse B,93,85,2025-02-19 03:27:00,8
13930,ORD_13931,2831,ENVIE® (ECR11MC + 2800 4PL) SprintX Ultra Fast Rechargeable Batteries Charger for AA & AAA Ni-MH with 4xAA2800mah Recharge...,Warehouse B,46,35,2025-02-19 05:21:00,11
13931,ORD_13932,4391,"Flat Hair Brush - FBP0203, Colour May Vary",Warehouse A,18,13,2025-02-19 12:23:00,5
13932,ORD_13933,16973,Meco Myoz 500mcg Injection,Warehouse B,52,42,2025-02-19 16:17:00,10
13933,ORD_13934,11258,"COAL Clean Beauty, Radiance Face Cleanser- Honey and Saffron 150 ml",Warehouse B,79,66,2025-02-19 12:02:00,13
13934,ORD_13935,11962,Jucoxia MR 60mg/4mg Tablet,Warehouse C,110,99,2025-02-19 23:07:00,11
13935,ORD_13936,31457,JGD PRODUCTS Premium Transparent Soft Silicon Back Cover for Samsung Galaxy F23 5G (2022) [Transparent] Crystal Clear,Warehouse B,98,90,2025-02-19 13:07:00,8
13936,ORD_13937,34397,Siffy 50mg Tablet DT,Warehouse A,70,54,2025-02-19 01:08:00,16
13937,ORD_13938,18938,Fekast 120mg Tablet,Warehouse B,85,71,2025-02-19 11:13:00,14
13938,ORD_13939,32520,Zerofen 200mg Tablet SR,Warehouse A,81,68,2025-02-19 05:35:00,13
13939,ORD_13940,18944,Vancof-G Syrup,Warehouse C,107,91,2025-02-19 15:48:00,16
13940,ORD_13941,24611,"Quantum RJ45 Ethernet Patch/LAN/Router Cable with Gold Plated Connectors Supports Upto 1000Mbps -16.4Feet (5 Meters), White",Warehouse A,24,17,2025-02-19 14:53:00,7
13941,ORD_13942,5992,LEDT Deodorant Spray,Warehouse B,32,24,2025-02-19 03:20:00,8
13942,ORD_13943,24615,Renim P Tablet,Warehouse A,42,36,2025-02-19 04:30:00,6
13943,ORD_13944,8362,Allure Flat Foundation Brush (ASB112) 1's,Warehouse C,104,94,2025-02-19 20:29:00,10
13944,ORD_13945,12993,"Pentonic Gel Pen (Pack of 20, Blue Ink)",Warehouse C,64,55,2025-02-19 06:58:00,9
13945,ORD_13946,26325,"LAPSTER 12pcs Spiral Cable Protectors for Charger, Wires, Data Charger Cable Protector for Computers, Cell Phones etc.(Black)",Warehouse C,80,71,2025-02-19 13:34:00,9
13946,ORD_13947,4985,Mecolin-NP Tablet,Warehouse B,35,18,2025-02-19 23:46:00,17
13947,ORD_13948,35398,"ZEBRONICS Zeb-Sound Feast 500 Bluetooth 5.0 Portable Speaker with 70W, 9H* Backup, TWS, IPX5 Waterproof, Call Function, RG...",Warehouse A,43,32,2025-02-19 08:13:00,11
13948,ORD_13949,28224,Tobica Eye Drop,Warehouse B,52,42,2025-02-19 11:22:00,10
13949,ORD_13950,26333,Azcin AM 500mg/60mg Tablet,Warehouse A,65,48,2025-02-19 21:07:00,17
13950,ORD_13951,10105,Worm Hunt 200mg Suspension,Warehouse B,103,84,2025-02-19 19:40:00,19
13951,ORD_13952,33549,"HP 15s AMD Ryzen 3-5300U 15.6inch(39.6cm) FHD Laptop (8GB RAM/512GB SSD, Micro-Edge, Anti-Glare Display/Radeon Graphics/Wi...",Warehouse A,65,56,2025-02-19 05:36:00,9
13952,ORD_13953,29978,Kumuda - Indian White Waterlily Silicone Free Conditioner,Warehouse B,95,81,2025-02-19 06:40:00,14
13953,ORD_13954,28187,Glowlev 500mg Tablet,Warehouse C,69,57,2025-02-19 15:22:00,12
13954,ORD_13955,18914,Fexoder 120mg Tablet,Warehouse B,24,15,2025-02-19 11:15:00,9
13955,ORD_13956,26296,RuenTech USB Charger Compatible with Fossil Gen 5 / Gen 4 / Sport Smartwatch Rapid Charger Magnetic (Black),Warehouse C,46,40,2025-02-19 22:02:00,6
13956,ORD_13957,28203,Halotil Plus Tablet,Warehouse C,13,1,2025-02-19 03:51:00,12
13957,ORD_13958,32503,"ON 2-In-1 Pocket Perfume - Man, Day & Night",Warehouse C,31,24,2025-02-19 05:15:00,7
13958,ORD_13959,22111,Hair Growth Lotion - Retarding Formula,Warehouse A,66,48,2025-02-19 00:54:00,18
13959,ORD_13960,24594,"TAC - The Ayurveda Co. Kumkumadi Lip Serum for Dry, Dark & Plump Lips with Saffron & Vitamin E, Moisturize & Hydrates Lip...",Warehouse B,48,39,2025-02-19 06:05:00,9
13960,ORD_13961,2288,Storite 20cm USB 3.0 Cable A to Micro B high Speed Upto 5 Gbps Data Transfer Cable for Portable External Hard Drive,Warehouse B,99,94,2025-02-19 23:54:00,5
13961,ORD_13962,34378,Oralixir Mouth Wash,Warehouse A,73,57,2025-02-19 14:11:00,16
13962,ORD_13963,24857,Clavocin Dry Syrup,Warehouse A,15,2,2025-02-19 16:49:00,13
13963,ORD_13964,15895,Theopod CLV 200mg/125mg Tablet,Warehouse A,108,89,2025-02-19 07:13:00,19
13964,ORD_13965,14831,Miss Rose 9 Color Matte & Glitter Eyeshadow Palette 7001 - 123N 01 7.5 gm,Warehouse A,47,38,2025-02-19 01:29:00,9
13965,ORD_13966,2931,"Cool, Action & Allure Avatar Deodorant Spray Perfume For Men",Warehouse A,59,47,2025-02-19 08:18:00,12
13966,ORD_13967,18980,"Extension Board, Hoteon Power Strip with 20W Fast PD/Type C, 2500W 10A Extension Cord with 3 Universal Socket, 38W USB Fas...",Warehouse B,76,71,2025-02-19 14:42:00,5
13967,ORD_13968,22134,Kofnez M Syrup,Warehouse B,73,68,2025-02-19 20:12:00,5
13968,ORD_13969,1820,"Noise ColorFit Pulse Smartwatch with 1.4"" Full Touch HD Display, SpO2, Heart Rate, Sleep Monitors & 10-Day Battery - Royal...",Warehouse C,36,20,2025-02-19 18:27:00,16
13969,ORD_13970,35446,Sennheiser CX 80S in-Ear Wired Headphones with in-line One-Button Smart Remote with Microphone Black,Warehouse C,85,76,2025-02-19 10:57:00,9
13970,ORD_13971,8315,"La Otter Nude Edition Eyeshadow Palette, 18 Highly Blendable Shades, Matte and Sheen Colours (Pink Blossom)",Warehouse B,39,33,2025-02-19 12:01:00,6
13971,ORD_13972,26234,Frontech 15.4-inch LED Backlit Computer Monitor with HDMI and VGA Port FT-1978 (Black),Warehouse B,109,98,2025-02-19 10:11:00,11
13972,ORD_13973,37123,"CableCreation USB C Hub, USB-C 7-in-1 Multiport Adapter Type C Dongle to HDMI 4K@60Hz, 2 USB 3.0 Ports, 100W PD, Gigabit E...",Warehouse B,37,24,2025-02-19 20:59:00,13
13973,ORD_13974,2626,Sun Expert SPF 24 Ultra Matte Lotion,Warehouse A,86,70,2025-02-19 16:16:00,16
13974,ORD_13975,8270,CLAW SM50 Professional Studio Monitoring DJ Headphones with 2 detachable cables (2.8m Coiled Cable & 1.2m Straight Cable w...,Warehouse B,44,28,2025-02-19 23:00:00,16
13975,ORD_13976,31961,Blenior Hair Removal Cream Normal 100 ml,Warehouse C,52,42,2025-02-19 22:13:00,10
13976,ORD_13977,33114,Shaving Cream - Fresh,Warehouse C,87,72,2025-02-19 23:06:00,15
13977,ORD_13978,36951,Revlon Nail Enamel - Copper Penny 8 Ml,Warehouse B,78,59,2025-02-19 23:25:00,19
13978,ORD_13979,18655,Signature Corporate No Gas Body Deodorant - For Men,Warehouse C,42,32,2025-02-19 19:33:00,10
13979,ORD_13980,22249,Ranopill 500 Tablet ER,Warehouse C,76,58,2025-02-19 17:51:00,18
13980,ORD_13981,33528,Listy M 50mg/5mg Tablet,Warehouse B,96,89,2025-02-19 14:06:00,7
13981,ORD_13982,4889,Rock Eau De Toilette & Deodorant Spray,Warehouse B,47,37,2025-02-19 01:31:00,10
13982,ORD_13983,13342,TWIREY Brush Egg Makeup Brush Cleaner Cleaning Tool (Color may vary),Warehouse C,81,62,2025-02-19 22:52:00,19
13983,ORD_13984,18682,Snorab-DSR Capsule,Warehouse B,19,8,2025-02-19 11:17:00,11
13984,ORD_13985,26219,Zoeclo P 100mg/325mg Tablet,Warehouse C,94,85,2025-02-19 02:48:00,9
13985,ORD_13986,28316,"ZEBRONICS Zeb-DLK01 Wired USB Multimedia Keyboard with 104 UV Coated Keys, Rupee Key, 12 Hot Keys(White)",Warehouse A,24,9,2025-02-19 08:28:00,15
13986,ORD_13987,14015,The Natural Wash Under Eye Cream With Cooling Massage Roller 15 Ml,Warehouse B,68,63,2025-02-19 01:19:00,5
13987,ORD_13988,30571,Tukzer 4G LTE Wireless USB Dongle Stick with All SIM Network Support | Plug & Play Data Card with up to 150Mbps Data Speed...,Warehouse C,38,24,2025-02-19 15:45:00,14
13988,ORD_13989,31575,"Fashion Colour Terra Cotta Blusher, Shade 05 16 gm",Warehouse B,95,80,2025-02-19 23:54:00,15
13989,ORD_13990,11,Elminova 200mg Oral Suspension,Warehouse B,93,82,2025-02-19 14:24:00,11
13990,ORD_13991,35481,Phy Nordic Sunshine Revitalizing Body Wash 300 Ml,Warehouse B,98,93,2025-02-19 11:07:00,5
13991,ORD_13992,18729,Gabastar-M 300mg/500mcg Tablet,Warehouse A,61,48,2025-02-19 19:14:00,13
13992,ORD_13993,22131,"Tukzer 4-in-1 Type-C Hub to HDMI 4K@30Hz, VGA 1080P@60Hz, USB 3.0 Data, 100W PD, MultiPort Adapter Compatible with MacBook...",Warehouse C,23,5,2025-02-19 02:57:00,18
13993,ORD_13994,18830,N Cef SB 1000mg/500mg Injection,Warehouse B,87,76,2025-02-19 19:05:00,11
13994,ORD_13995,12543,Odeon Hand Wash Aloe Vera & Neem Natural Active Bottle 250 ml,Warehouse C,103,97,2025-02-19 11:54:00,6
13995,ORD_13996,13012,Rabiloz D 10 mg/20 mg Capsule,Warehouse C,93,80,2025-02-19 05:02:00,13
13996,ORD_13997,14852,Lonacip 500 Tablet,Warehouse B,73,56,2025-02-19 17:46:00,17
13997,ORD_13998,11639,Bisotril 2.5mg Tablet,Warehouse A,40,31,2025-02-19 11:33:00,9
13998,ORD_13999,6425,Kvi 1mg Injection,Warehouse B,87,74,2025-02-19 05:54:00,13
13999,ORD_14000,11221,Fenobate 67mg Capsule,Warehouse A,17,4,2025-02-19 19:43:00,13
14000,ORD_14001,29653,Maybelline Lip Crayon Treat Yourself (Matte),Warehouse C,61,43,2025-02-19 04:59:00,18
14001,ORD_14002,7212,"Comfy Grip Toothbrush For Kids  - Orange, Ages 5+",Warehouse B,34,19,2025-02-19 21:51:00,15
14002,ORD_14003,4386,TCL 100 cm (40 inches) Full HD Certified Android Smart LED TV 40S6505 (Black),Warehouse A,22,9,2025-02-19 23:52:00,13
14003,ORD_14004,29262,Silk N Shine Hair Serum,Warehouse C,43,24,2025-02-19 16:32:00,19
14004,ORD_14005,29648,"POPIO Screen Guard Protector Compatible for Apple Watch Series 7 & 8, 45mm (Transparent) with Edge to Edge Full Screen Cov...",Warehouse C,72,60,2025-02-19 05:52:00,12
14005,ORD_14006,33950,Clinmiface A Gel,Warehouse A,101,89,2025-02-19 04:37:00,12
14006,ORD_14007,29301,Methi Hair Care Powder - Pure Herb,Warehouse B,28,17,2025-02-19 23:04:00,11
14007,ORD_14008,33926,"Tecno POP 7 Pro (Endless Black, 2GB RAM,64GB Storage) | Type C Port | 12MP Dual Camera | Up to 4GB RAM with Memory Fusion",Warehouse B,79,69,2025-02-19 16:08:00,10
14008,ORD_14009,29324,Medimade Coffee And Chocolate Body Wash 300 ml,Warehouse B,68,54,2025-02-19 01:44:00,14
14009,ORD_14010,4336,Hair Fall Control Shampoo - Paraben & SLS Free,Warehouse B,94,75,2025-02-19 13:28:00,19
14010,ORD_14011,16507,Rappi IT 20mg/150mg Capsule,Warehouse B,30,15,2025-02-19 00:08:00,15
14011,ORD_14012,31830,"3110 Tripod Combo with Selfi Remote and Collar Mic 1.5 Meter Long, Mobile Stand Holder, Fold-able, Portable Adjustable, Al...",Warehouse A,113,97,2025-02-19 08:57:00,16
14012,ORD_14013,1827,Ayurvedic Tea Tree & Activated Charcoal Face Pack,Warehouse B,103,95,2025-02-19 13:26:00,8
14013,ORD_14014,33929,Dexacee 8mg Tablet,Warehouse B,111,97,2025-02-19 10:57:00,14
14014,ORD_14015,29629,Dizithro 500mg Tablet,Warehouse B,22,16,2025-02-19 09:07:00,6
14015,ORD_14016,29632,My Dream For Him - EDP 30 ml,Warehouse B,50,31,2025-02-19 12:40:00,19
14016,ORD_14017,29303,Ospol OZ 200mg/500mg Tablet,Warehouse C,24,7,2025-02-19 20:57:00,17
14017,ORD_14018,25110,"Garnier Skin Naturals, Charcoal, Face Serum Sheet Mask (Black) 28 gm",Warehouse C,71,61,2025-02-19 01:16:00,10
14018,ORD_14019,24101,Cleansing Bar,Warehouse A,87,73,2025-02-19 07:09:00,14
14019,ORD_14020,33361,Telicraft H 40mg/12.5mg Tablet,Warehouse A,83,68,2025-02-19 12:09:00,15
14020,ORD_14021,17096,Cobsa Forte Injection,Warehouse B,80,69,2025-02-19 22:36:00,11
14021,ORD_14022,16481,"FEDUS LAN Cable cat6 Cable, cat6 LAN Cable, ethernet Cable, Network Cable Internet Cable rj45 Cable LAN Wire High Speed Pa...",Warehouse C,91,83,2025-02-19 07:22:00,8
14022,ORD_14023,3301,Vitrex 150mg Tablet,Warehouse B,75,68,2025-02-19 16:52:00,7
14023,ORD_14024,2610,Koinstec Meaningful Tattoos For Men Tiger Animal Temporary Body Tattoo Waterproof Sticker,Warehouse C,72,58,2025-02-19 03:14:00,14
14024,ORD_14025,33942,Fulstrch SP Tablet,Warehouse B,29,21,2025-02-19 21:24:00,8
14025,ORD_14026,25101,Gynonys 500 Injection,Warehouse B,82,77,2025-02-19 21:36:00,5
14026,ORD_14027,53,Shampoo - Anti-Dandruff,Warehouse C,60,43,2025-02-19 16:12:00,17
14027,ORD_14028,3293,Zucator 100 Tablet,Warehouse C,81,75,2025-02-19 02:27:00,6
14028,ORD_14029,33955,Lovolkem 500 Tablet,Warehouse A,33,19,2025-02-19 21:38:00,14
14029,ORD_14030,22093,Cefmac 2000mg Injection,Warehouse B,96,77,2025-02-19 17:21:00,19
14030,ORD_14031,18863,Formin-SR 500 Tablet,Warehouse B,27,22,2025-02-19 00:32:00,5
14031,ORD_14032,1592,Dettol Liquid Handwash Refill - Skincare Moisturizing Hand Wash- 175ml | Antibacterial Formula | 10x Better Germ Protection,Warehouse C,45,34,2025-02-19 18:05:00,11
14032,ORD_14033,6004,Rablonex 20mg Injection,Warehouse C,40,30,2025-02-19 01:17:00,10
14033,ORD_14034,4955,Ropnol 40mg Tablet SR,Warehouse A,103,84,2025-02-19 21:56:00,19
14034,ORD_14035,18889,Belora Australian Plum & Vitamin C Serum Moisturizer 50 gm,Warehouse C,80,67,2025-02-19 05:19:00,13
14035,ORD_14036,4957,AmazonBasics USB 3.1 Type-C to 4 Port USB Hub - White,Warehouse C,74,59,2025-02-19 15:53:00,15
14036,ORD_14037,22075,Robustrion Smart Trifold Hard Back Flip [Auto Sleep Wake] Case Cover for Lenovo Tab M10 FHD Plus TB-X606V / TB-X606F / TB-...,Warehouse A,18,6,2025-02-19 05:59:00,12
14037,ORD_14038,11943,"Samsung Galaxy M13 (Midnight Blue, 4GB, 64GB Storage) | 6000mAh Battery | Upto 8GB RAM with RAM Plus",Warehouse A,90,84,2025-02-19 08:10:00,6
14038,ORD_14039,25933,Organic Pitta Tea,Warehouse C,69,50,2025-02-19 03:23:00,19
14039,ORD_14040,7952,Elecious Mulethi Powder and Multani Powder Combo (200 grams + 200 grams) For Instant Glow and Brighten Complexion (Mulethi...,Warehouse C,80,68,2025-02-19 09:34:00,12
14040,ORD_14041,22725,Ajmal Aurum Raindrops Silvershade Deodorant Spray (Pack of 3) 200 ml,Warehouse B,43,28,2025-02-19 22:41:00,15
14041,ORD_14042,18882,Racy 10mg Sachet,Warehouse A,35,22,2025-02-19 22:30:00,13
14042,ORD_14043,18868,Jeflox-OZ Oral Suspension,Warehouse C,24,5,2025-02-19 11:01:00,19
14043,ORD_14044,23531,Realcort 6mg Tablet,Warehouse A,56,50,2025-02-19 19:16:00,6
14044,ORD_14045,17163,Spigen Glas.tR SLIM Anti-Glare Matte Tempered Glass Screen Protector Guard for Ather 450X / 450 Plus 7inch Display - 1 Pack,Warehouse B,55,39,2025-02-19 01:06:00,16
14045,ORD_14046,33347,"DIGITEK (DTR-320 FT) Flexible Gorillapod Tripod for All Cameras and Mobile Phones with 360° Ball Head and Phone Holder, Ma...",Warehouse B,45,39,2025-02-19 03:32:00,6
14046,ORD_14047,29649,"EAGLEHUNT MAC COMBO MAKEUP-KIT FOR GIRLS (SET OF 10) Compact, Eyelashes, 2in1 Concealer, Matte Lipstick, Nail Paint, Blend...",Warehouse C,23,12,2025-02-19 07:21:00,11
14047,ORD_14048,17156,St.Botanica Body Wash - Mojito Tango 250 ml,Warehouse A,13,8,2025-02-19 08:57:00,5
14048,ORD_14049,29253,"Duracell Specialty CR2016 Lithium Coin Battery 3V, Pack of 5 Suitable for use in keyfobs, Scales, wearables and Medical De...",Warehouse A,97,87,2025-02-19 05:10:00,10
14049,ORD_14050,7568,"D-Link DIR-615 Wi-fi Ethernet-N300 Single_band 300Mbps Router, Mobile App Support, Router | AP | Repeater | Client Modes(B...",Warehouse A,59,49,2025-02-19 06:23:00,10
14050,ORD_14051,17164,"Fullmosa Leather Bands Compatible with Apple Watch Band 38mm 40mm 41mm 42mm 44mm 45mm 49mm,Yola Leather Bracelet Apple Wat...",Warehouse B,27,20,2025-02-19 21:16:00,7
14051,ORD_14052,13193,Livfirm Injection,Warehouse C,67,49,2025-02-19 02:12:00,18
14052,ORD_14053,32180,"VEGA Premium Eye Lash Curler (EC-02), Black, 48 g & VEGA Tweezer - Rubber Grip (TW-04), Silver, 19 g",Warehouse C,49,36,2025-02-19 22:11:00,13
14053,ORD_14054,4377,Suforox 250mg Tablet,Warehouse A,34,27,2025-02-19 12:34:00,7
14054,ORD_14055,13275,"Upix® AC Remote No. 29C, Compatible for Panasonic AC Remote Control (Exactly Same Remote Will Only Work)",Warehouse A,111,94,2025-02-19 03:49:00,17
14055,ORD_14056,17140,D Par MR 250mg/50mg/325mg Tablet,Warehouse A,36,17,2025-02-19 15:35:00,19
14056,ORD_14057,25104,TheGiftKart Back Cover For OnePlus 8T ( Poly Carbonate|Black ),Warehouse B,50,31,2025-02-19 16:24:00,19
14057,ORD_14058,13213,Zelcef 1000mg Injection,Warehouse B,65,53,2025-02-18 21:53:00,12
14058,ORD_14059,16975,Faces Canada Weightless Matte Finish Foundation Sand 04 1 18 Ml,Warehouse C,91,78,2025-02-18 03:46:00,13
14059,ORD_14060,11334,Luliq Cream,Warehouse A,29,24,2025-02-18 15:05:00,5
14060,ORD_14061,5676,"Netgear R6120-100INS AC1200 Dual-Band Wi-Fi Router (Black, Not a Modem, 1200 megabits_per_second)",Warehouse C,30,11,2025-02-18 04:02:00,19
14061,ORD_14062,2807,Luminosa Cream,Warehouse C,109,98,2025-02-18 13:09:00,11
14062,ORD_14063,11571,SONATA GOLD Smart Band Wireless Sweatproof Fitness Band S6-4| Activity Tracker| Blood Pressure| Heart Rate Sensor | Step T...,Warehouse A,79,73,2025-02-18 02:15:00,6
14063,ORD_14064,23633,India's No.1 Ayurvedic Fluroide Free Paste,Warehouse A,72,66,2025-02-18 00:36:00,6
14064,ORD_14065,21012,"Maybelline New York Lash Sensational Mascara, Waterproof, Very Black 9 gm",Warehouse B,28,12,2025-02-18 08:27:00,16
14065,ORD_14066,17083,Cologne Spray Ammunition - For Men,Warehouse B,88,81,2025-02-18 14:18:00,7
14066,ORD_14067,7542,Ajmal Impress Concentrated Perfume Oil Citrus And Maryaj Grey Stone EDP Aromatic Woody Perfume 110 ml,Warehouse A,42,29,2025-02-18 19:03:00,13
14067,ORD_14068,23624,Tellzy 40 Tablet,Warehouse A,96,78,2025-02-18 02:36:00,18
14068,ORD_14069,32746,Ajmal Blu Dreams EDP And Blu Deo & Neea EDP Pack of 3 20 ml,Warehouse C,75,61,2025-02-18 02:28:00,14
14069,ORD_14070,13656,i12 Bluetooth Ear Buds Bluetooth Headset in Ear Earbuds with Mic Touch Sensor with and High Bass Level Supporting All Smar...,Warehouse B,104,97,2025-02-18 19:21:00,7
14070,ORD_14071,31516,"Portable LED Ring Selfie Light for All Smartphones, Tablets Enhancing Ring Light with 3 Level of Brightness for Photograph...",Warehouse C,73,68,2025-02-18 19:41:00,5
14071,ORD_14072,34742,Man Matters Derma Roller with Disinfectant | 540 Micro 0.5mm Titanium Alloy Needles | Reduces Hair Fall & Stimulates Hair ...,Warehouse C,35,25,2025-02-18 12:06:00,10
14072,ORD_14073,23663,Rabop 20 Tablet,Warehouse B,92,73,2025-02-18 17:28:00,19
14073,ORD_14074,20277,Tayo-M Tablet,Warehouse C,22,16,2025-02-18 13:04:00,6
14074,ORD_14075,25375,"dr.com Smart UPS Mini Size 8000mAh Battery 6 Hours uninterrupted Power Backup for Router, Home Camera, LED Lights, Smartph...",Warehouse C,101,86,2025-02-18 16:19:00,15
14075,ORD_14076,23674,Xolone 200 mg/500 mg Tablet,Warehouse A,12,6,2025-02-18 17:16:00,6
14076,ORD_14077,9392,Ulitel 40mg Tablet,Warehouse A,108,98,2025-02-18 02:08:00,10
14077,ORD_14078,27409,"Portronics Portable RuffPad E-Writer 21.59Cm (8.5-inch) LCD with App Support, 4 Magnet, Stylus Drawing Handwriting Board, ...",Warehouse C,76,58,2025-02-18 07:23:00,18
14078,ORD_14079,33344,Cobalsure Injection,Warehouse C,24,8,2025-02-18 00:14:00,16
14079,ORD_14080,23660,Elbron M Syrup,Warehouse B,98,89,2025-02-18 13:26:00,9
14080,ORD_14081,17005,Decwell 25mg Injection,Warehouse C,55,50,2025-02-18 21:31:00,5
14081,ORD_14082,29236,INSIGHT COSMETICS DIP AND GO NAIL POLISH REMOVER - GREEN APPLE 20 ml,Warehouse B,58,40,2025-02-18 12:39:00,18
14082,ORD_14083,25465,"ZEBRONICS Zeb-HAA3020 (3 Meter/9 feet) HDMI Cable Supports 3D, ARC & CEC Extension, Compatible with HDMI-Enabled TV, Blu-r...",Warehouse A,48,29,2025-02-18 15:41:00,19
14083,ORD_14084,17195,Esoloc 40mg Tablet,Warehouse B,28,15,2025-02-18 00:35:00,13
14084,ORD_14085,11596,HP 805 Tri-Color Original Ink Cartridge,Warehouse A,90,83,2025-02-18 15:27:00,7
14085,ORD_14086,25430,TheGiftKart Rugged Carbon Fibre TPU Armor Back Cover Case for OnePlus 7T (Black),Warehouse B,28,16,2025-02-18 23:23:00,12
14086,ORD_14087,7259,Penta First 40mg Injection,Warehouse B,109,97,2025-02-18 06:24:00,12
14087,ORD_14088,2799,Flormar Dewy Lip Glaze 06 Peach Smoothie 4.5 ml,Warehouse A,32,23,2025-02-18 10:42:00,9
14088,ORD_14089,12710,Khaas Deo Stick,Warehouse B,71,53,2025-02-18 17:52:00,18
14089,ORD_14090,29608,Shifix 100mg Tablet,Warehouse C,89,72,2025-02-18 16:21:00,17
14090,ORD_14091,9378,"ZEBRONICS Zeb-Evolve Wireless in Ear Neckband Earphone with mic, Supporting Bluetooth v5.0, Voice Assistant, Rapid Charge,...",Warehouse A,66,54,2025-02-18 07:27:00,12
14091,ORD_14092,7570,India Grooming Club Travel Pouch 1's,Warehouse B,17,12,2025-02-18 01:21:00,5
14092,ORD_14093,35971,Daniel Klein Analog Rose Gold Dial Women's Watch-DK11800-4,Warehouse C,91,75,2025-02-18 23:56:00,16
14093,ORD_14094,20063,mCaffeine Naked & Raw Tan Removal Coffee Face Mask 100 gm,Warehouse A,97,91,2025-02-18 05:22:00,6
14094,ORD_14095,29627,Miss Claire Pearl Eyeliner - 08 - Gold 5 Gm,Warehouse C,62,45,2025-02-18 16:55:00,17
14095,ORD_14096,29232,Apple iPhone 13 (256GB) - Midnight,Warehouse B,86,72,2025-02-18 14:33:00,14
14096,ORD_14097,21069,"Samsung Galaxy M13 (Midnight Blue, 6GB, 128GB Storage) | 6000mAh Battery | Upto 12GB RAM with RAM Plus",Warehouse B,68,57,2025-02-18 10:25:00,11
14097,ORD_14098,20080,Spigen Ultra Hybrid Back Cover Case Compatible with Oneplus Nord (TPU + PC | Black),Warehouse B,50,38,2025-02-18 20:44:00,12
14098,ORD_14099,13189,"Ant Esports KM540 Gaming Backlit Keyboard and Mouse Combo, LED Wired Gaming Keyboard, Ergonomic & Wrist Rest Keyboard, Pro...",Warehouse C,50,32,2025-02-18 16:50:00,18
14099,ORD_14100,20868,"Glow & Lovely Advanced Multivitamin Face Cream 110 g, Daily Skin Brightening Face Moisturizer for Glowing Skin, SPF 15 Wit...",Warehouse B,60,43,2025-02-18 21:55:00,17
14100,ORD_14101,15304,"DE'LANCI Palette Makeup Eyeshadow 72 Colors,Pigmented Nude Earth Eye Tone+Matte Shimmer Colorful + Neon Press Glitter Glow...",Warehouse B,61,53,2025-02-18 15:08:00,8
14101,ORD_14102,2408,"Bath Loofah - Electric Blue, Colour May Vary",Warehouse B,53,43,2025-02-18 22:32:00,10
14102,ORD_14103,32187,Robustrion Flip Stand Case Cover for Lenovo Tab M10 FHD Plus 3rd Gen 10.6 inch Tablet - Black,Warehouse A,27,12,2025-02-18 00:33:00,15
14103,ORD_14104,36544,Uncle Tony Shaving Cream - Shea Butter 100 ml,Warehouse B,37,28,2025-02-18 15:30:00,9
14104,ORD_14105,1814,Acef 250mg Tablet,Warehouse C,64,46,2025-02-18 00:30:00,18
14105,ORD_14106,8955,Loten H Tablet,Warehouse C,64,49,2025-02-18 22:33:00,15
14106,ORD_14107,2393,Calsym-Plus Soft Gel Capsule,Warehouse C,25,18,2025-02-18 08:36:00,7
14107,ORD_14108,14344,Rispond Forte 4 mg/2 mg Tablet,Warehouse A,27,15,2025-02-18 22:45:00,12
14108,ORD_14109,37047,Hystatab 16mg Tablet,Warehouse B,99,80,2025-02-18 23:25:00,19
14109,ORD_14110,9475,Trumine 20mg/500mg Tablet,Warehouse A,70,65,2025-02-18 19:48:00,5
14110,ORD_14111,31426,"Safety/Germ Free Key For Personal Use - Acrylic, 8 mm,",Warehouse C,92,81,2025-02-18 02:48:00,11
14111,ORD_14112,15339,Prexol 0.125mg Tablet,Warehouse B,55,37,2025-02-18 10:57:00,18
14112,ORD_14113,22823,"RAS Luxury Oils Nourish Coco and Vanilla Body Lotion, Moroccan Argan Oil & Vanilla; Smoothens & Softens; For Men & Women; ...",Warehouse C,51,42,2025-02-18 01:58:00,9
14113,ORD_14114,17960,Ragiz 20mg Tablet,Warehouse A,98,80,2025-02-18 15:56:00,18
14114,ORD_14115,16126,Lynacox 4H 450mg/300mg Tablet,Warehouse C,72,59,2025-02-18 00:37:00,13
14115,ORD_14116,5746,Rosejoint 50mg/750mg/250mg Tablet,Warehouse B,70,51,2025-02-18 20:02:00,19
14116,ORD_14117,12410,A-DATA 8Gb Ddr4 Modules for Notebooks 3200Mhz Laptop Memory (Ad4S320038G22-Rgn),Warehouse B,17,10,2025-02-18 02:39:00,7
14117,ORD_14118,17940,Mast FX 10mg/120mg Tablet,Warehouse A,106,94,2025-02-18 14:42:00,12
14118,ORD_14119,17939,Procef 200mg Tablet,Warehouse C,19,6,2025-02-18 14:05:00,13
14119,ORD_14120,15565,"Zebronics HAA3021 HDMI version 2.1 cable with 8K @ 60Hz, 4K @ 120Hz, eARC & CEC support, 3D compatible, 3 meters length, 4...",Warehouse C,24,15,2025-02-18 19:24:00,9
14120,ORD_14121,13868,"Dry-Max All Night XL - Sanitary Pads For Women, With Wings",Warehouse B,103,92,2025-02-18 22:22:00,11
14121,ORD_14122,17978,AILKIN Fast Dash Charger Adapter for OnePlus 11/10 9/9t/9r/Nord/8/8 pro/ 7 with Type C Dash Fast Charging Cable Compatible...,Warehouse A,22,7,2025-02-18 20:55:00,15
14122,ORD_14123,4639,Moxiz CV 1gm/0.2gm Injection,Warehouse C,95,79,2025-02-18 00:06:00,16
14123,ORD_14124,29769,Alkal Syrup,Warehouse B,59,42,2025-02-18 16:13:00,17
14124,ORD_14125,25985,MB-Plus Injection,Warehouse A,85,71,2025-02-18 03:00:00,14
14125,ORD_14126,35044,(Renewed) JBL C100SI Wired In Ear Headphone with Mic (Black),Warehouse A,27,8,2025-02-18 01:32:00,19
14126,ORD_14127,6229,Perfume Body Spray - Bleu,Warehouse B,104,96,2025-02-18 18:59:00,8
14127,ORD_14128,19795,Jonim P 100mg/500mg Tablet,Warehouse C,103,88,2025-02-18 20:00:00,15
14128,ORD_14129,2693,Zucipro 500mg Tablet,Warehouse B,72,61,2025-02-18 17:24:00,11
14129,ORD_14130,27617,LT-Mac Cream,Warehouse C,114,96,2025-02-18 22:53:00,18
14130,ORD_14131,24421,Takfa 0.5 Capsule,Warehouse B,28,11,2025-02-18 19:26:00,17
14131,ORD_14132,22836,Sports Wet Wipes,Warehouse A,64,51,2025-02-18 18:20:00,13
14132,ORD_14133,5294,Purearth Laali - Lip Paint Pot - 8Gm,Warehouse B,103,93,2025-02-18 05:41:00,10
14133,ORD_14134,30439,Irusu Monster VR Headset with Remote Controller and Conductive Touch Button for VR Supported Smartphones(New Model) (Black),Warehouse A,91,82,2025-02-18 08:16:00,9
14134,ORD_14135,24350,Ajmal Majmua And Selfie CP & Neea EDP Pack of 3 20 ml,Warehouse A,35,18,2025-02-18 12:00:00,17
14135,ORD_14136,35708,VU 108 cm (43 inches) The GloLED 84 Watt DJ Sound Series 4K Smart Google TV 43GloLED (Grey),Warehouse B,98,85,2025-02-18 09:39:00,13
14136,ORD_14137,33782,Aloe Relaxing Serum,Warehouse C,72,58,2025-02-18 00:17:00,14
14137,ORD_14138,6237,Clonik 50mg Tablet,Warehouse B,41,33,2025-02-18 17:38:00,8
14138,ORD_14139,10727,A Rex Syrup,Warehouse C,103,86,2025-02-18 05:46:00,17
14139,ORD_14140,24420,Tazohope 2000mg/250mg Injection,Warehouse B,96,78,2025-02-18 18:58:00,18
14140,ORD_14141,17967,C Col 500mg Capsule,Warehouse B,15,7,2025-02-18 12:44:00,8
14141,ORD_14142,12879,AB SALES Adjustable Computer Arm Rest Ergonomic Attachable Computer Table Arm Support Stand Desk Rests Chair Extender for ...,Warehouse C,89,75,2025-02-18 02:09:00,14
14142,ORD_14143,17068,Deflasil 6mg Tablet,Warehouse A,113,95,2025-02-18 04:38:00,18
14143,ORD_14144,679,Ulvin 250mg Tablet,Warehouse C,76,58,2025-02-18 10:29:00,18
14144,ORD_14145,21035,Mefipic Oral Suspension Mango,Warehouse B,21,7,2025-02-18 07:02:00,14
14145,ORD_14146,5399,Benefit Cosmetics Roller Lash Mascara...,Warehouse A,40,26,2025-02-18 16:21:00,14
14146,ORD_14147,30274,Generic LTT-0001 Multipurpose Wood Laptop Table with Dock Stand & Non-Slip Legs Foldable and Portable Lapdesk for Study & ...,Warehouse C,20,13,2025-02-18 02:13:00,7
14147,ORD_14148,8964,Daily Life Forever52 Glitz Waterproof Eyeliner Eyeshadow Glt009 0.6 gm,Warehouse A,71,59,2025-02-18 08:59:00,12
14148,ORD_14149,1826,Mr. Magic Powder-To-Liquid Germ Protection Handwash Empty Bottle + Refill,Warehouse A,46,33,2025-02-18 06:08:00,13
14149,ORD_14150,31280,LIMBANI BROTHERS™ (Only Eyeliner Tool) Silicone Eyeliner Guide for Parkinson Patient Anti-shake Design EyeLiner Guide Wand...,Warehouse B,31,23,2025-02-18 15:12:00,8
14150,ORD_14151,12712,Glimicer M Forte 3mg/1000mg Tablet,Warehouse B,47,37,2025-02-18 17:03:00,10
14151,ORD_14152,36006,Entrozyme-O 200mg/500mg Tablet,Warehouse C,61,42,2025-02-18 15:00:00,19
14152,ORD_14153,8965,Edmore 75mg/ml Injection,Warehouse A,80,70,2025-02-18 01:46:00,10
14153,ORD_14154,17046,Writing Pad Ohuhu 9 inch LCD Writing Tablet Electronic Slate for Kids Digital Drawing Pad Writing Pad for Kids Toys Birthd...,Warehouse B,39,32,2025-02-18 17:46:00,7
14154,ORD_14155,2995,Casio DJ-240D Plus 300 Steps Check and Correct Premium Desktop Calculator with Metallic faceplate & Bigger Screen/Keys (14...,Warehouse A,49,33,2025-02-18 08:31:00,16
14155,ORD_14156,17032,"Menstrual Cup - Wings, Pratham",Warehouse B,97,89,2025-02-18 15:47:00,8
14156,ORD_14157,35040,"TheGiftKart Back Cover for OnePlus Nord 2 5G (Poly Carbonate, Polymer | Blue)",Warehouse C,27,13,2025-02-18 22:46:00,14
14157,ORD_14158,3255,Nebifast 2.5 Tablet,Warehouse B,74,59,2025-02-18 10:59:00,15
14158,ORD_14159,20887,Deep Cleansing Activated Charcoal Face Wash,Warehouse A,115,99,2025-02-18 10:38:00,16
14159,ORD_14160,20129,"QZ USB 3.1 Ethernet Adapter, USB to LAN Converter, Ethernet to USB, RJ45 USB 3.1",Warehouse B,94,77,2025-02-18 12:49:00,17
14160,ORD_14161,7592,Vega Hot Curl Brush (Medium) (H1 - PRB) 160 gm,Warehouse B,37,30,2025-02-18 22:04:00,7
14161,ORD_14162,4553,Vega Grooming Comb (1264) 37 gm,Warehouse A,95,89,2025-02-18 04:36:00,6
14162,ORD_14163,15203,"Enflamo Soft TPU 3D Relief Flower Printed Phone Case Back Cover for iPhone 11 (White, Mix Lilies)",Warehouse B,77,66,2025-02-18 18:58:00,11
14163,ORD_14164,17695,"CrossBeats Newly launched Revolt Hybrid Active Noise Cancelling Wireless Bluetooth Earbuds, 48hrs Playtime TWS, 10 mm Ti-A...",Warehouse A,48,41,2025-02-18 22:55:00,7
14164,ORD_14165,4716,"Maybelline New York Colossal Kajal + Baby Lips Love Color, Berry Crush, 4 g ((At 20% Off, Pack of 2)",Warehouse B,64,57,2025-02-18 20:52:00,7
14165,ORD_14166,13865,Offer OZ 200mg/500mg Tablet,Warehouse B,81,69,2025-02-18 00:37:00,12
14166,ORD_14167,10723,"Miss Rose Kajal & Kohls, Black, 2.2 g",Warehouse B,74,63,2025-02-18 15:36:00,11
14167,ORD_14168,13686,Lafz Vanilla Bean Lip Balm 4.5 gm,Warehouse A,75,68,2025-02-18 03:22:00,7
14168,ORD_14169,29390,Rhyvog 0.3mg Tablet,Warehouse B,50,42,2025-02-18 10:38:00,8
14169,ORD_14170,9376,Nikther Injection,Warehouse A,93,84,2025-02-18 01:12:00,9
14170,ORD_14171,32890,B Tax 50mg Syrup,Warehouse A,85,68,2025-02-18 07:38:00,17
14171,ORD_14172,36520,Nepa 500mg Injection,Warehouse C,51,40,2025-02-18 18:59:00,11
14172,ORD_14173,14512,Alvinac P Oral Suspension,Warehouse C,16,9,2025-02-18 06:21:00,7
14173,ORD_14174,30788,Methylik Plus Injection,Warehouse B,110,94,2025-02-18 21:48:00,16
14174,ORD_14175,4308,Clear Skin Face Wash,Warehouse C,38,23,2025-02-18 21:20:00,15
14175,ORD_14176,5658,Makeup Revolution Pore Vanish Prime Mist 50 ml,Warehouse C,28,15,2025-02-18 18:58:00,13
14176,ORD_14177,16920,Retop-A 0.05% Gel,Warehouse C,26,13,2025-02-18 17:28:00,13
14177,ORD_14178,6506,"Fashion Colour Kiss Lip Balm, Shade 02 2 gm",Warehouse C,75,58,2025-02-18 14:07:00,17
14178,ORD_14179,7288,"ZEBRONICS Zeb-Juke BAR 9500WS PRO Dolby 5.1 Soundbar with Wireless Satellites, Dolby Audio, 525 Watts Output Power, 16.5cm...",Warehouse A,65,49,2025-02-18 17:01:00,16
14179,ORD_14180,23712,Walimont FX 10mg/120mg Tablet,Warehouse B,44,37,2025-02-18 00:47:00,7
14180,ORD_14181,6625,"Reusable Anti Pollution Face Mask - With Activated Carbon, N99 + PM2.5, Medium",Warehouse B,73,56,2025-02-18 06:02:00,17
14181,ORD_14182,16874,"Gold Medal I-Design 4X1 Power Strip (With 4-Outlet International Sockets, Master Switch, Indicator And 2M Power Cord)",Warehouse B,42,36,2025-02-18 08:37:00,6
14182,ORD_14183,6514,"Cold Processed Reetha Coconut Milk Hair Cleansing Bar - Anti Dandruff, Anti Hairfall",Warehouse A,117,99,2025-02-18 00:01:00,18
14183,ORD_14184,9414,Metozox 25 Tablet ER,Warehouse B,30,19,2025-02-18 06:30:00,11
14184,ORD_14185,23731,"Redmi Watch 2 Lite - 3.94 cm Large HD Edge Display, Multi-System Standalone GPS, Continuous SpO2, Stress & Sleep Monitorin...",Warehouse C,87,79,2025-02-18 15:32:00,8
14185,ORD_14186,33886,Not Out Condoms - Climax Delay & Dotted,Warehouse B,25,7,2025-02-18 13:54:00,18
14186,ORD_14187,27394,Maybelline New York The Colossal Liner Black 1.2 ml,Warehouse A,56,44,2025-02-18 06:47:00,12
14187,ORD_14188,3186,DeBelle Gel Nail Lacquer Chrome Wine Metallic Purple Nail Polish 8 ml,Warehouse A,112,95,2025-02-18 12:45:00,17
14188,ORD_14189,4204,Liv-12 Syrup,Warehouse A,57,41,2025-02-18 20:38:00,16
14189,ORD_14190,15386,"Herbal Acne Repair Face Wash For Clear Skin With Neem, Tulsi, Aloe Vera",Warehouse C,59,44,2025-02-18 03:12:00,15
14190,ORD_14191,16878,"Vero Forza Arctic Pro Mobile Cooler for Gaming, Phone Cooler, for Bgmi, Pubg, Cod, Freefire & Fortnite(iPhone/Android)",Warehouse A,100,91,2025-02-18 00:06:00,9
14191,ORD_14192,36165,"Lotus Herbals Make up Ecosaty Kajal, Black (1.2g) - Pack of 2 Matte Finish",Warehouse A,18,10,2025-02-18 08:16:00,8
14192,ORD_14193,9429,Nortin Forte 400mg/10mg Tablet,Warehouse B,78,63,2025-02-18 21:22:00,15
14193,ORD_14194,4219,Maharishi Ayurveda Ayush Kwath,Warehouse C,26,18,2025-02-18 15:48:00,8
14194,ORD_14195,6604,"ProElite Smart Flip Case Cover for Samsung Galaxy Tab A8 10.5"" SM-X200/ SM-X205/ SM-X207 Translucent Back with Stylus Pen,...",Warehouse A,72,60,2025-02-18 02:12:00,12
14195,ORD_14196,6618,Podoxim DS Syrup,Warehouse C,49,39,2025-02-18 11:41:00,10
14196,ORD_14197,11428,Astin 20 Tablet,Warehouse C,89,73,2025-02-18 15:47:00,16
14197,ORD_14198,6555,Blaupunkt Newly Launched BTW300 BASS Buds Truly Wireless Bluetooth in-Ear Earbuds I Bass Demon Tech I ENC CRISPR TECH I 40...,Warehouse A,64,45,2025-02-18 22:12:00,19
14198,ORD_14199,16810,Tolfree 150 Tablet,Warehouse C,16,2,2025-02-18 22:14:00,14
14199,ORD_14200,27611,"Spigen Polycarbonate, Thermoplastic Polyurethane Rugged Armor Pro Strap and Case Designed for Samsung Galaxy Watch 5 / 4 (...",Warehouse C,90,75,2025-02-18 20:05:00,15
14200,ORD_14201,21142,Zel Force 50mg Tablet,Warehouse A,10,2,2025-02-18 01:46:00,8
14201,ORD_14202,12844,Pinda Taila,Warehouse B,107,91,2025-02-18 12:11:00,16
14202,ORD_14203,710,HIFFIN® Lens Filter Step Up CONVERTION Rings Set 8 Pcs 49 mm-82 As Hood,Warehouse B,78,65,2025-02-18 20:52:00,13
14203,ORD_14204,27018,Zubitrex TM 250mg/31.25mg Injection,Warehouse B,28,15,2025-02-18 19:40:00,13
14204,ORD_14205,11616,"Fashion Colour Lip Crayon, Waterproof, Long Lasting, 14 Hazel Lips 2.8 gm",Warehouse A,47,39,2025-02-18 23:25:00,8
14205,ORD_14206,7241,Rycef T 1000mg/125mg Injection,Warehouse A,25,17,2025-02-18 01:51:00,8
14206,ORD_14207,33880,(Renewed) DELL LATITUDE 7390 (Core i5 8th GEN /8GB RAM/ 256GB SSD/ WEBCAM/ 13.3'' TOUCH/ WIN-10 PRO) 1 Year Warranty,Warehouse A,24,19,2025-02-18 01:30:00,5
14207,ORD_14208,11407,Feveryl Syrup,Warehouse B,62,43,2025-02-18 13:49:00,19
14208,ORD_14209,4280,"Fastrack New Reflex VOX 2.0 Black Smart Watch|BT Calling|1.8"" HD Display|TWS Connect|AI Voice|50+ Sports Modes|100+ Watchf...",Warehouse A,11,3,2025-02-18 15:33:00,8
14209,ORD_14210,9436,Insight Cosmetics Non - Transfer Lip Color - 02 Red Alert 4 ml,Warehouse C,106,90,2025-02-18 17:30:00,16
14210,ORD_14211,32,Iatromox CV 200 mg/28.5 mg Tablet DT,Warehouse A,27,21,2025-02-18 11:37:00,6
14211,ORD_14212,3175,Mefdro M 10mg/250mg Tablet,Warehouse B,76,66,2025-02-18 12:12:00,10
14212,ORD_14213,23770,ABOUTTHEFIT Pu Leather Flip Cover for Samsung Galaxy Tab A7 Lite 8.7 inch 2021,Warehouse A,21,14,2025-02-18 10:16:00,7
14213,ORD_14214,31347,"Wayona USB C to USB C 65W Short Powerbank fast charging cable compatible for Samsung Galaxy S22, S20 FE 2022, S21 Ultra, S...",Warehouse A,32,15,2025-02-18 03:18:00,17
14214,ORD_14215,7436,Lynace P 100mg/325mg Tablet,Warehouse A,48,42,2025-02-18 09:42:00,6
14215,ORD_14216,31311,Urban Balance Pollution Defense Day Cream,Warehouse B,26,12,2025-02-18 01:47:00,14
14216,ORD_14217,20263,Invisible Super Ultra Thin Condoms - For Men,Warehouse B,95,79,2025-02-18 04:34:00,16
14217,ORD_14218,16633,Roxithro 150mg Tablet,Warehouse A,32,18,2025-02-18 02:54:00,14
14218,ORD_14219,29555,"AGARO Ultrasonic Facial Skin Scrubber for Wet Skin, Blackheads Remover and Facial Pores Cleaner with 4 Modes, Facial Scrub...",Warehouse C,65,55,2025-02-18 11:00:00,10
14219,ORD_14220,23803,Cefanz 200mg Tablet,Warehouse B,24,11,2025-02-18 10:54:00,13
14220,ORD_14221,3858,"Lenovo IdeaPad Slim 1 AMD Ryzen 3 3250U 15.6"" (39.62cm) FHD Thin & Light Laptop (8GB/512GB SSD/Windows 11/Office 2021/3mon...",Warehouse B,54,49,2025-02-18 17:50:00,5
14221,ORD_14222,32761,Juarez JRZ12KX Keyboard Stand with Straps,Warehouse C,58,52,2025-02-18 23:46:00,6
14222,ORD_14223,14332,Revclin Gel,Warehouse B,55,49,2025-02-18 14:34:00,6
14223,ORD_14224,25217,"Samsung Galaxy Tab S7 FE 31.5 cm (12.4 inch) Large Display, S-Pen in Box, Slim Metal Body, Dolby Atmos Sound, RAM 4 GB, RO...",Warehouse C,103,87,2025-02-18 12:12:00,16
14224,ORD_14225,30281,Daily Mild Shampoo,Warehouse B,53,45,2025-02-18 06:55:00,8
14225,ORD_14226,16936,"Noise ColorFit Pulse Smartwatch with 3.56 cm (1.4"") Full Touch HD Display, SpO2, Heart Rate, Sleep Monitors & 10-Day Batte...",Warehouse C,17,10,2025-02-18 10:29:00,7
14226,ORD_14227,13611,Myaxyl Oil,Warehouse C,24,15,2025-02-18 15:59:00,9
14227,ORD_14228,31324,Toublin Injection,Warehouse A,10,1,2025-02-18 04:16:00,9
14228,ORD_14229,20943,Ajmal Aurum Concentrated Perfume Oil Fruity Floral And Wisal Deodorant Floral Musky Fragrance 210 ml,Warehouse A,60,55,2025-02-18 18:13:00,5
14229,ORD_14230,15419,Lavender & Vanilla Handmade Luxury Soap,Warehouse A,72,56,2025-02-18 15:03:00,16
14230,ORD_14231,23860,Passion Indulge FACE MUDD PACK-PAPAIN D10 250 gm,Warehouse C,26,12,2025-02-18 04:13:00,14
14231,ORD_14232,13244,VW 60 cm (24 inches) Premium Series HD Ready LED TV VW24A (Black),Warehouse B,79,74,2025-02-18 07:04:00,5
14232,ORD_14233,23871,"Streax Ultralights Hair Color Highlighting Kit for Women & Men, 60ml (Pack of 1) | Gem Collection - Violet Topaz | Contain...",Warehouse C,79,74,2025-02-18 22:08:00,5
14233,ORD_14234,32107,Brechen 4mg Tablet MD,Warehouse C,66,50,2025-02-18 21:50:00,16
14234,ORD_14235,4225,Olsure 20mg Tablet,Warehouse B,65,57,2025-02-18 11:25:00,8
14235,ORD_14236,36113,Tefix-O Tablet DT,Warehouse A,43,31,2025-02-18 07:35:00,12
14236,ORD_14237,12729,Zoook Thunder Storm Bluetooth Party Speaker 80Watt/USB/TF/AUX/FM/Built-in Battery/Wireless Mic/Professional Class D Amplif...,Warehouse C,87,72,2025-02-18 11:31:00,15
14237,ORD_14238,11363,Bathing Soap - Centennial,Warehouse A,56,48,2025-02-18 16:16:00,8
14238,ORD_14239,588,Levokast Syrup,Warehouse C,94,88,2025-02-18 13:33:00,6
14239,ORD_14240,21058,Itramark 200 Capsule,Warehouse C,58,43,2025-02-18 08:16:00,15
14240,ORD_14241,2143,Ultra Nourishing Hair Shampoo + Moroccan Argan Hair Conditioner,Warehouse B,49,30,2025-02-18 19:13:00,19
14241,ORD_14242,24063,Flormar Waterproof Lipliner 246 Rosebush 1.14 gm,Warehouse B,73,54,2025-02-18 13:26:00,19
14242,ORD_14243,21053,Mybro 200mg Tablet,Warehouse A,84,79,2025-02-18 18:49:00,5
14243,ORD_14244,2081,Lectra M 5mg/10mg Tablet,Warehouse C,84,78,2025-02-18 01:08:00,6
14244,ORD_14245,11255,Escident Plus 0.5mg/10mg Tablet,Warehouse C,81,73,2025-02-18 09:27:00,8
14245,ORD_14246,15325,Sepred 80mg Injection,Warehouse C,23,4,2025-02-18 20:01:00,19
14246,ORD_14247,23551,Doxogal 400mg Tablet,Warehouse C,38,22,2025-02-18 12:36:00,16
14247,ORD_14248,29268,Neozox Tablet,Warehouse C,77,60,2025-02-18 21:26:00,17
14248,ORD_14249,27442,Cefitaxe 100mg Syrup,Warehouse A,79,66,2025-02-18 22:25:00,13
14249,ORD_14250,13196,"Redragon K617 Fizz 60% Wired RGB Gaming Keyboard, 61 Keys Compact Mechanical Keyboard w/White and Grey Color Keycaps, Line...",Warehouse B,77,59,2025-02-18 04:56:00,18
14250,ORD_14251,29273,"GadgetBite Soft Silicon Magnetic Strap Cable String for Airpods 1, Airpods 2, Airpods Pro, Classic Black",Warehouse A,44,29,2025-02-18 08:02:00,15
14251,ORD_14252,23876,Glimton MF 1 Tablet,Warehouse B,95,89,2025-02-18 06:23:00,6
14252,ORD_14253,16651,Peropad D 30mg/40mg Capsule SR,Warehouse C,86,79,2025-02-18 12:18:00,7
14253,ORD_14254,31323,KABEER ART 12 x7 inch Size Clear Transparent Acrylic Kidney Shaped Drawing Palette,Warehouse A,58,47,2025-02-18 16:17:00,11
14254,ORD_14255,12210,Ajmal Carbon Wisal Dahab Wisal Deodorant Spray (Pack of 3) 200 ml,Warehouse B,48,43,2025-02-18 04:10:00,5
14255,ORD_14256,12226,Rifadriv Tablet,Warehouse A,48,31,2025-02-18 10:47:00,17
14256,ORD_14257,33833,Repen D 10mg/40mg Tablet,Warehouse B,72,64,2025-02-18 23:21:00,8
14257,ORD_14258,587,SUNISA Black 1 Slim Fan Makeup Highlighter Cosmetic Makeup Brush and 1 Black Mini Foundation Brush for Womens and Girls -...,Warehouse B,48,40,2025-02-18 15:36:00,8
14258,ORD_14259,11491,Ajmal Mukhallat Al Wafa Concentrated Perfume Oil Oriental Musky And Silver Shade Homme Deodorant Citrus Woody Fragrance 212 ml,Warehouse C,12,7,2025-02-18 04:03:00,5
14259,ORD_14260,16666,Torsid 5 Tablet,Warehouse A,25,6,2025-02-18 19:15:00,19
14260,ORD_14261,13595,"Lotus Herbals YouthRx Active Anti Ageing Foaming Gel Face Wash | With Jojoba, Ginseng & Ginger | 50g",Warehouse A,75,56,2025-02-18 04:15:00,19
14261,ORD_14262,7355,Oxyglow Intensive Moisturizing Lotion 100 ml,Warehouse B,45,31,2025-02-18 21:33:00,14
14262,ORD_14263,31847,"Gynoveda Vaginal Discharge Relief | No more Itching, Smell, Milky, Watery, Thick Discharge Before After Periods  | SOMA An...",Warehouse C,47,31,2025-02-18 06:20:00,16
14263,ORD_14264,584,"Pebble Cosmos Endure 1.46"" AMOLED Always-On Display Bluetooth Calling IP68 Waterproof Smartwatch 466 * 466 (Jet Black)",Warehouse C,46,38,2025-02-18 19:30:00,8
14264,ORD_14265,583,Yohit 200 Capsule,Warehouse A,57,44,2025-02-18 00:02:00,13
14265,ORD_14266,30221,"Western Digital WD Green SATA 240GB, Up to 545MB/s, 2.5 Inch/7 mm, 3Y Warranty, Internal Solid State Drive (SSD) (WDS240G3...",Warehouse C,34,28,2025-02-18 21:26:00,6
14266,ORD_14267,11506,Spigen Liquid Crystal Back Cover Case for Samsung Galaxy S23 (TPU | Space Crystal),Warehouse A,110,93,2025-02-18 22:28:00,17
14267,ORD_14268,34764,Bromycodex Syrup,Warehouse C,48,34,2025-02-18 03:27:00,14
14268,ORD_14269,16692,Acelab-TH Tablet,Warehouse B,30,20,2025-02-18 17:40:00,10
14269,ORD_14270,20921,"Lodhi Home Ultra Soft Microfiber Highly Absorbent Face Cleaning Towel for Girls, Ladies, Baby, Face Cloth Makeup Remover, ...",Warehouse A,90,82,2025-02-18 04:22:00,8
14270,ORD_14271,29460,"Noise Combat with Ultra Low Latency 45 Milliseconds Bluetooth Wireless in Ear Earphones with ENC with mic, instacharge and...",Warehouse C,6,1,2025-02-18 08:00:00,5
14271,ORD_14272,29501,Saannerve Plus 750mcg/75mg Capsule,Warehouse C,80,69,2025-02-18 18:38:00,11
14272,ORD_14273,30801,Hazelnut Night Cream,Warehouse B,23,16,2025-02-18 20:45:00,7
14273,ORD_14274,31511,Duralub EG Eye Gel,Warehouse C,65,51,2025-02-18 05:11:00,14
14274,ORD_14275,32117,Cosmic Byte H11 Gaming Headset with Microphone (Black/Blue),Warehouse A,68,59,2025-02-18 22:17:00,9
14275,ORD_14276,1864,"Uniball Air Micro Pen -(Blue Ink,Pack of 5)",Warehouse B,96,86,2025-02-18 14:52:00,10
14276,ORD_14277,34760,Lexicet L 5mg Tablet,Warehouse B,57,50,2025-02-18 07:33:00,7
14277,ORD_14278,29477,"SanDisk Cruzer Force USB Flash Drive, CZ71 32GB, USB2.0, Durable Metal Casing, 5Y",Warehouse A,78,63,2025-02-18 04:13:00,15
14278,ORD_14279,5637,Corsair Vengeance LPX 8GB (1x8GB) DDR4 3200MHZ C16 Desktop RAM (Black),Warehouse B,78,59,2025-02-18 20:27:00,19
14279,ORD_14280,4642,"Emergity Portable Travel Makeup Pouch, Vanity Bag for Makeup, Toiletry Bag, Makeup Box for Women, Makeup Kit Bag, Makeup B...",Warehouse C,44,35,2025-02-18 02:50:00,9
14280,ORD_14281,14596,Makeup Revolution Skin Bright Brightening Make Up Serum 19 ml,Warehouse A,69,61,2025-02-18 09:04:00,8
14281,ORD_14282,77,"boAt Dual QC-PD Port Rapid Car Charger with 18W Qualcomm Quick Charge 3.0 Fast Charge, Smart IC Protection, Universal Comp...",Warehouse A,67,53,2025-02-18 06:15:00,14
14282,ORD_14283,788,Sunfen SP Tablet,Warehouse A,100,95,2025-02-18 00:51:00,5
14283,ORD_14284,35760,Alsone Syrup Sugar Free,Warehouse A,114,99,2025-02-18 15:07:00,15
14284,ORD_14285,7854,Digiway 4 Universal Socket 3 Switch Multiplug Sockets Extension Board/Extension Cord,Warehouse A,77,61,2025-02-18 11:31:00,16
14285,ORD_14286,16105,Exgra 50mg Tablet,Warehouse B,94,88,2025-02-18 09:07:00,6
14286,ORD_14287,27563,Ibolme CT LD 20mg/6.25mg Tablet,Warehouse C,67,62,2025-02-18 03:32:00,5
14287,ORD_14288,35763,Sinarest OD Tablet,Warehouse B,35,16,2025-02-18 05:42:00,19
14288,ORD_14289,24437,Insuman 25/75 Suspension for Injection 40IU/ml,Warehouse A,70,63,2025-02-18 01:43:00,7
14289,ORD_14290,29737,"GoTrippin Universal Travel Adapter with Dual USB Charger Ports, International Worldwide Charger Plug for Phone, Mobile,Lap...",Warehouse C,67,59,2025-02-18 09:46:00,8
14290,ORD_14291,30500,Myynti 2 PCS Face Pack Brush with Face Cleaning Sponge and Facial Headband Combo Set for Men and Women Multicolor,Warehouse B,59,53,2025-02-18 01:50:00,6
14291,ORD_14292,33705,"Zebronics Zeb-FIT3220CH Smart Fitness Watch with Full Touch TFT Round Display, Metal Body, Built-in Games, 7-day Data Stor...",Warehouse C,28,20,2025-02-18 08:34:00,8
14292,ORD_14293,2497,Liforab-DSR Capsule,Warehouse C,69,63,2025-02-18 17:15:00,6
14293,ORD_14294,31880,Revlon Top Speed Hair Color Woman-Natural Black 70 40 Gm,Warehouse A,46,31,2025-02-18 19:24:00,15
14294,ORD_14295,25744,Deco Eye/Ear Drops,Warehouse C,73,62,2025-02-18 06:46:00,11
14295,ORD_14296,18363,"TIMESETL Alpine Loop Bands Compatible with Apple Watch Ultra 49mm 45mm 44mm 42mm Nylon Sport Wristband for Men Women, Tita...",Warehouse C,104,85,2025-02-18 06:37:00,19
14296,ORD_14297,22547,mCaffeine Latte Coffee Sleeping Face Mask with Niacinamide & Hyaluronic Acid for Hydration 100 gm,Warehouse A,67,60,2025-02-18 02:28:00,7
14297,ORD_14298,12740,"Skin Bio Therapy Oil For Stretch Marks, Scars & Skin Toning",Warehouse C,71,57,2025-02-18 13:11:00,14
14298,ORD_14299,10882,Youth Eternity Under Eye Cream,Warehouse B,26,18,2025-02-18 09:58:00,8
14299,ORD_14300,20797,"MINISO Free of Prejudice Eau De Toilette Long Lasting Perfume for Women, 30ml (Aurora)",Warehouse A,13,7,2025-02-18 22:09:00,6
14300,ORD_14301,21373,Coniglu G 2mg/500mg Tablet SR,Warehouse B,65,50,2025-02-18 07:44:00,15
14301,ORD_14302,2727,Ayurvedic Anti-Tan Face Pack,Warehouse B,110,95,2025-02-18 03:22:00,15
14302,ORD_14303,19904,Jojoba Vegetable Oil,Warehouse B,71,59,2025-02-18 00:01:00,12
14303,ORD_14304,16309,Volume Enhance Shampoo,Warehouse B,98,88,2025-02-18 02:15:00,10
14304,ORD_14305,352,Ulpride OD Tablet SR,Warehouse A,14,5,2025-02-18 14:40:00,9
14305,ORD_14306,29713,Axcil LB 500mg Tablet,Warehouse A,63,44,2025-02-18 17:08:00,19
14306,ORD_14307,12367,Canon PG-745s (Small) Ink Cartridge (Black),Warehouse B,56,50,2025-02-18 00:38:00,6
14307,ORD_14308,31758,Piolet 15mg Tablet,Warehouse A,62,43,2025-02-18 07:14:00,19
14308,ORD_14309,16314,Ajmal Khofooq Concentrated Perfume Oil Woody Oudhy And Wisal Dhahab Deodorant Fruity Floral Fragrance 218 ml,Warehouse C,30,25,2025-02-18 06:49:00,5
14309,ORD_14310,7856,Cosmic Byte CB-GK-25 Pandora TKL Mechanical Keyboard Upgraded with Swappable Outemu Blue Switches and Rainbow LED (Black/G...,Warehouse C,66,54,2025-02-18 05:52:00,12
14310,ORD_14311,29740,Vimika 500mg Injection,Warehouse A,94,83,2025-02-18 12:37:00,11
14311,ORD_14312,35125,Steifen Plus 100mg/325mg Tablet,Warehouse B,105,95,2025-02-18 19:45:00,10
14312,ORD_14313,11814,Olmecaid M 25 Tablet ER,Warehouse B,57,39,2025-02-18 04:37:00,18
14313,ORD_14314,15578,Metaflox 100mg/100mg Suspension,Warehouse A,76,66,2025-02-18 21:06:00,10
14314,ORD_14315,899,The Moms Co. Natural Vitamin C Face Cream 50 gm,Warehouse C,57,47,2025-02-18 12:46:00,10
14315,ORD_14316,18155,Xybel 0.1% Nasal Drops,Warehouse B,107,98,2025-02-18 02:27:00,9
14316,ORD_14317,28813,"Fashion Colour Feather Touch Matte Powder, Shade 03 10 gm",Warehouse A,25,14,2025-02-18 13:58:00,11
14317,ORD_14318,22569,"GOVO GOBUDS 902 Super Bass, Waterproof IPX4, Passive Noise Cancellation, 3D Stereo Sound, Type C Fast Charging Bluetooth T...",Warehouse C,88,70,2025-02-18 04:59:00,18
14318,ORD_14319,4595,TNW The Natural Wash Stretch Mark Oil 50 ml,Warehouse B,80,63,2025-02-18 21:49:00,17
14319,ORD_14320,30161,GIZGA Club-laptop Neoprene Reversible for 15.6-inches Laptop Sleeve - Black-Red,Warehouse C,6,1,2025-02-18 00:55:00,5
14320,ORD_14321,19878,Cefico 200 Tablet DT,Warehouse B,38,27,2025-02-18 03:55:00,11
14321,ORD_14322,17775,Miss Rose 2 In 1 Creamy Matte Lipstick Flash OF Pink 7102 - 001M 03 2.1 gm,Warehouse C,57,45,2025-02-18 12:28:00,12
14322,ORD_14323,35777,Gear Triumph 26L Water Resistant School Bag//Backpack/College Bag for Men/Women - Navy Blue,Warehouse A,97,83,2025-02-18 15:34:00,14
14323,ORD_14324,11724,Enalap 5mg Tablet,Warehouse B,106,92,2025-02-18 06:37:00,14
14324,ORD_14325,13823,Lip Bomb Cocoa Butter Balm,Warehouse C,39,25,2025-02-18 06:42:00,14
14325,ORD_14326,26793,Mdpod 100mg Tablet DT,Warehouse A,89,81,2025-02-18 06:22:00,8
14326,ORD_14327,6305,Antibacteria Overnight Pads - XXL,Warehouse B,107,98,2025-02-18 11:27:00,9
14327,ORD_14328,24289,House Of Makeup Nail Lacquer - Nitro Coffee 12 ml,Warehouse B,41,32,2025-02-18 12:16:00,9
14328,ORD_14329,36642,Rabido 20 Tablet,Warehouse C,101,85,2025-02-18 00:31:00,16
14329,ORD_14330,34105,Canon PIXMA TS3370s All-in-One Wireless Inkjet Color Printer (Black),Warehouse A,112,99,2025-02-18 20:10:00,13
14330,ORD_14331,20468,"LG Qhd 2K - 27Qn600, 2560 X 1440 Pixels 27 Inch (68.58 Cm) IPS Display 3 Side Borderless - HDR 10, Srgb 99%, AMD Free Sync...",Warehouse C,110,92,2025-02-18 18:03:00,18
14331,ORD_14332,7841,Lonafest P 0.25mg/10mg Tablet,Warehouse A,109,93,2025-02-18 03:36:00,16
14332,ORD_14333,30391,"Hola ! TF-500 Basic Corded Landline Phone for intercom and EPABX Desk & Wall Mountable, Mute/Pause/Flash/Redial Function (...",Warehouse C,110,99,2025-02-18 18:56:00,11
14333,ORD_14334,28858,Shermox-CV Dry Syrup,Warehouse B,79,66,2025-02-18 23:08:00,13
14334,ORD_14335,36889,"Odeon Turmeric & Yogurt Face And Body Scrub, Tube 100 ml",Warehouse C,101,96,2025-02-18 03:22:00,5
14335,ORD_14336,1679,Sery Colorflirt Nail Paint Coral Crush 10 ml,Warehouse C,67,59,2025-02-18 19:01:00,8
14336,ORD_14337,4604,Organic Harvest Coffee Conditioner 500 ml,Warehouse B,69,55,2025-02-18 17:00:00,14
14337,ORD_14338,21358,"Ant Esports GP300 Pro V2 Wireless Gaming Controller, Compatible for PC & Laptop (Windows 10/8 /7 XP, Steam) / PS3",Warehouse A,58,40,2025-02-18 20:35:00,18
14338,ORD_14339,1671,Omeday D 30mg/20mg Capsule,Warehouse C,103,88,2025-02-18 20:46:00,15
14339,ORD_14340,12741,Amazon Basics USB Adaptor with 1 Universal AC Socket and 2 USB Ports (White),Warehouse B,47,36,2025-02-18 07:51:00,11
14340,ORD_14341,6736,TWC Compassionate Sanitary Pad 180 gm,Warehouse B,44,32,2025-02-18 10:53:00,12
14341,ORD_14342,11743,Daughter Earth Kissing Glass Wet Lip Coat,Warehouse B,30,23,2025-02-18 17:50:00,7
14342,ORD_14343,17844,Ultracort 100mg Injection,Warehouse A,78,68,2025-02-18 20:05:00,10
14343,ORD_14344,12867,Faces Canada Weightless Creme Finish Lipstick Love Nude 09 4 Gm,Warehouse A,30,12,2025-02-18 00:39:00,18
14344,ORD_14345,10792,Vemax Base 3-Band (FM/AM/MW) Portable Radio (Black),Warehouse A,100,93,2025-02-18 07:35:00,7
14345,ORD_14346,12388,Dopamine 10mg/500mg Tablet,Warehouse A,38,31,2025-02-18 02:15:00,7
14346,ORD_14347,26737,Nature's Essence Detan Therpay Wipe-Off Mask 500 gm,Warehouse B,104,90,2025-02-18 17:58:00,14
14347,ORD_14348,10795,Dexagee Injection 2ml,Warehouse B,78,65,2025-02-18 19:33:00,13
14348,ORD_14349,22605,"Cable Management Box With Mobile Stand - Cord Organizer Hides Extention Board, Power Strips, Surge Protector, Cords, Wire,...",Warehouse C,51,35,2025-02-18 04:42:00,16
14349,ORD_14350,32017,Offnil 200mg Tablet,Warehouse B,7,1,2025-02-18 07:52:00,6
14350,ORD_14351,18292,Dlt 18mg Tablet,Warehouse B,64,45,2025-02-18 15:31:00,19
14351,ORD_14352,22604,"Vichaxan Compact Binoculars, Small Folding Binoculars, Large Eyepiece Easy Focus for Kids Adults Bird Watching Travel Hunt...",Warehouse A,91,85,2025-02-18 22:56:00,6
14352,ORD_14353,10794,"Beetel X70 Cordless Phone, 2.4GHz Frequency, 2 Way Speaker Phone, Ringer Volume, LED Notification for Ringer and Charging...",Warehouse B,37,18,2025-02-18 09:42:00,19
14353,ORD_14354,6285,Plum Candy Melts Vegan Lip Balm Red Velvet Love 12 Gm,Warehouse C,73,59,2025-02-18 10:42:00,14
14354,ORD_14355,17725,Europan 40mg Injection,Warehouse C,67,58,2025-02-18 15:57:00,9
14355,ORD_14356,16114,Dafli 6mg Oral Suspension,Warehouse C,73,66,2025-02-18 13:58:00,7
14356,ORD_14357,15017,Redux 650mg Tablet,Warehouse B,108,99,2025-02-18 01:50:00,9
14357,ORD_14358,33173,CEDO Samsung Tab A8 10.5 Inch Tempered Glass | Screen Protector Tempered Glass for Samsung Galaxy Tab A8 10.5 Inch (SM-X20...,Warehouse A,24,17,2025-02-18 09:52:00,7
14358,ORD_14359,15013,Etorex BR Syrup,Warehouse C,107,89,2025-02-18 06:24:00,18
14359,ORD_14360,10789,TEEN TEEN Waterproof Herbal Liquid Sindoor With Glitter Red No:1,Warehouse A,36,28,2025-02-18 13:45:00,8
14360,ORD_14361,1148,Furniture Cafe Set top Box Stand | WiFi Router Holder Wooden Wall Shelves | Setup Box Stand for Home | Wall Mount Stylish ...,Warehouse A,46,40,2025-02-18 14:17:00,6
14361,ORD_14362,17825,Eyetex pallavi Bindi P5 RED (Pack of 10 flaps)+Fancy designer bindi 1 card,Warehouse A,112,98,2025-02-18 12:17:00,14
14362,ORD_14363,20406,Fluvell 300mg Tablet,Warehouse A,26,11,2025-02-18 00:17:00,15
14363,ORD_14364,37116,"Park Avenue Sportz Power Deodorant for Men, 150ml",Warehouse A,78,63,2025-02-18 18:50:00,15
14364,ORD_14365,1949,Conafung 100 Capsule,Warehouse C,62,52,2025-02-18 03:51:00,10
14365,ORD_14366,1515,"Mouthwash Liquid - Cavity Fighter, Removes 99.9% Germs",Warehouse A,94,75,2025-02-18 11:27:00,19
14366,ORD_14367,30747,Temax H 40mg Tablet,Warehouse A,53,34,2025-02-18 03:49:00,19
14367,ORD_14368,9614,Infura 100mg Tablet,Warehouse A,109,99,2025-02-18 21:27:00,10
14368,ORD_14369,33702,Itranase 200mg Capsule,Warehouse A,22,14,2025-02-18 08:37:00,8
14369,ORD_14370,10517,Mint Lip Balm,Warehouse B,41,33,2025-02-18 18:47:00,8
14370,ORD_14371,3346,Cuzor UPS for JioFiber & Airtel Xtreme Routers | UPS for WiFi routers 12V Upto 2.5A | Replaceable Battery | Power Back up ...,Warehouse B,110,92,2025-02-18 17:21:00,18
14371,ORD_14372,7818,"EGate i9 Pro-Max 1080p Native Full HD Projector 4k Support | 4500 L (420 ANSI) | 210"" (533 cm) Large Screen | VGA, AV, HDM...",Warehouse C,41,34,2025-02-18 22:21:00,7
14372,ORD_14373,34684,Refreshing Tea Tree Body Lotion,Warehouse A,96,85,2025-02-18 17:02:00,11
14373,ORD_14374,25022,"Pinnaclz Original Combo of 2 Micro USB Fast Charging Cable, USB Charging Cable for Data Transfer Perfect for Android Smart...",Warehouse A,35,18,2025-02-18 16:52:00,17
14374,ORD_14375,27215,Zidmin 5 mg/500 mg Tablet,Warehouse C,40,33,2025-02-18 11:36:00,7
14375,ORD_14376,32404,"Tattoo Gizmo Bandage for Tattoo Grip Tubes,Black-Pack of 2",Warehouse C,72,58,2025-02-18 08:50:00,14
14376,ORD_14377,8864,DeBelle Gel Nail Lacquer Princess Belle Coral Orange Nail Polish 8 ml,Warehouse B,106,98,2025-02-18 20:07:00,8
14377,ORD_14378,34251,I AM EYECONIC FINE GLITTER MIRROR 4 gm,Warehouse C,70,61,2025-02-18 14:02:00,9
14378,ORD_14379,17731,Zutex-T 250mg/31.25mg Injection,Warehouse B,77,70,2025-02-18 05:30:00,7
14379,ORD_14380,922,"L'Oréal Paris Infallible Pro Last 2 Step Lipstick, Cherry Noir, 1 fl. oz.",Warehouse C,22,4,2025-02-18 00:32:00,18
14380,ORD_14381,3583,"Color Diva Capsule Eyeshadow, Multi Color Shade-104, 1.5g Each (Pack of 12)",Warehouse A,38,27,2025-02-18 15:49:00,11
14381,ORD_14382,11825,Shila X-Oil,Warehouse C,50,35,2025-02-18 19:20:00,15
14382,ORD_14383,24266,Crucial BX500 500GB 2.5-inch SATA 3D NAND Internal SSD Upto 550 MB/s,Warehouse C,52,44,2025-02-18 04:49:00,8
14383,ORD_14384,2970,Tocid 75mg Tablet,Warehouse C,21,2,2025-02-18 08:18:00,19
14384,ORD_14385,3389,Topomed 100mg Tablet,Warehouse B,38,22,2025-02-18 07:19:00,16
14385,ORD_14386,18354,Arilev 500mg Tablet,Warehouse B,90,78,2025-02-18 09:47:00,12
14386,ORD_14387,21224,"Fashion Colour 2 - In - 1 Face Powder, Shade 02 20 gm",Warehouse C,87,79,2025-02-18 06:26:00,8
14387,ORD_14388,28569,Qtripril 200mg Tablet,Warehouse A,71,53,2025-02-18 11:05:00,18
14388,ORD_14389,10810,"Turron One Side Ruled Index Flash Cards Tray - 200 GSM, 150 Cards, 3x5 inch, White - with Free Binder Rings for Short Note...",Warehouse B,75,65,2025-02-18 03:58:00,10
14389,ORD_14390,16254,Natural Shaving Gel - Bergamot & Vitamin E,Warehouse A,95,90,2025-02-18 22:30:00,5
14390,ORD_14391,19858,"SIDRUM D2 DSLR/SLR Camera Shoulder Bag Case with Adjustable Shoulder Strap, Compatible for Nikon, Canon, Sony Mirrorless C...",Warehouse A,67,50,2025-02-18 17:07:00,17
14391,ORD_14392,17857,Zeo CV DS Dry Syrup,Warehouse A,30,18,2025-02-18 11:12:00,12
14392,ORD_14393,19856,"Ajjas - Waterproof GPS Tracker for Bike, Scooty, Car, Bus, Device + 3 Month Sim Data & Free Mobile App (Features with Acci...",Warehouse B,33,14,2025-02-18 21:54:00,19
14393,ORD_14394,16181,Gabafem 300mg/500mcg Tablet,Warehouse C,50,39,2025-02-18 20:23:00,11
14394,ORD_14395,27637,Carnosin Injection,Warehouse B,18,12,2025-02-18 06:29:00,6
14395,ORD_14396,19776,"uni-Ball Eye UB 157 Roller Pen | Tip Size 0.7 mm | Comfortable Grip| Ideal for Students and Professionals | for School, Of...",Warehouse C,20,14,2025-02-18 12:59:00,6
14396,ORD_14397,22814,Clfate 1000mg Suspension,Warehouse C,61,46,2025-02-18 04:46:00,15
14397,ORD_14398,9675,Cefmay O 100mg Tablet,Warehouse A,90,78,2025-02-18 15:07:00,12
14398,ORD_14399,7084,"Amrutadi Vati - Anti Bacterial, 500 mg",Warehouse C,92,79,2025-02-18 00:08:00,13
14399,ORD_14400,18246,Cephalkem 125mg Tablet,Warehouse B,65,58,2025-02-18 02:45:00,7
14400,ORD_14401,895,"ESR Metal Kickstand Back Cover Case for Samsung Galaxy S22 Ultra Case,PC, Versatile Patented Kickstand, Crystal Clear Scra...",Warehouse C,90,81,2025-02-18 06:32:00,9
14401,ORD_14402,1724,Tiox 0.5mg Tablet,Warehouse A,47,37,2025-02-18 23:41:00,10
14402,ORD_14403,24329,"ZIZLY 3 LED Light 3X & 45x Handheld Magnifier, Reading Magnifying Glass Lens Jewelry Loupe, Book and Newspaper Reading, In...",Warehouse C,102,97,2025-02-18 16:41:00,5
14403,ORD_14404,11807,Ajmal Dahnul Oudh Khalifa Concentrated Perfume Free From Alcohol 3ml for Unisex,Warehouse C,71,61,2025-02-18 07:24:00,10
14404,ORD_14405,36978,Original Germ Protection Bathing Soap,Warehouse C,28,10,2025-02-18 08:14:00,18
14405,ORD_14406,35621,"Nokia 105 Plus Single SIM, Keypad Mobile Phone with Wireless FM Radio, Memory Card Slot and MP3 Player | Charcoal",Warehouse B,58,43,2025-02-18 12:57:00,15
14406,ORD_14407,29758,"Transcend TS-RDF8K2 USB 3.1 Gen 1 SDXC/SDHC UHS-I, microSDXC/SDHC UHS-I and CompactFlash Memory Cards Multi Card Reader US...",Warehouse A,101,87,2025-02-18 17:14:00,14
14407,ORD_14408,9686,"Camel Fabrica Acrylic Ultra Color - 15ml Each, 10 Shades",Warehouse B,91,82,2025-02-18 02:41:00,9
14408,ORD_14409,30734,"DIGITEK® (DRL 018) Professional 46 CM (18 inch) Big LED Ring Light with 2 Color Modes Dimmable Lighting, Photo-shoot, Vide...",Warehouse B,59,46,2025-02-18 11:22:00,13
14409,ORD_14410,32373,Deborah Milano Divine Volume & Curves - Black 10 ml,Warehouse A,50,45,2025-02-18 05:35:00,5
14410,ORD_14411,13893,Neem Aloevera Face Wash,Warehouse C,75,69,2025-02-18 08:44:00,6
14411,ORD_14412,22722,"Ant Value H61MAD3-N Gaming mATX Motherboard LGA1155 Intel 2nd and 3rd Generation i3/i5/i7 DDR3, M.2 NVMe, USB 2.0 Ports",Warehouse B,51,42,2025-02-18 17:30:00,9
14412,ORD_14413,12889,Tromadac P 50mg/500mg Tablet,Warehouse C,66,49,2025-02-18 09:22:00,17
14413,ORD_14414,18119,Extadil 20 Disintegrating Strip,Warehouse C,13,2,2025-02-18 15:15:00,11
14414,ORD_14415,16164,"ELEPHANTBOAT Travel Case for Apple Watch Charger,Waterproof Portable Carrying EVA Charging Dock Holder for 38mm/42mm/40mm/...",Warehouse B,63,58,2025-02-18 03:00:00,5
14415,ORD_14416,32001,HP 46 Tri-Color Original Ink Advantage Cartridge,Warehouse B,46,39,2025-02-18 07:59:00,7
14416,ORD_14417,28656,Ajmal Selfie Concentrated Perfume Oil Woody Aromatic And Maryaj Grey Stone EDP Aromatic Woody Perfume 110 ml,Warehouse A,90,84,2025-02-18 05:40:00,6
14417,ORD_14418,31160,Cortent NM Cream,Warehouse B,91,81,2025-02-18 01:11:00,10
14418,ORD_14419,25964,Pilol 10mg Tablet,Warehouse C,79,69,2025-02-18 18:23:00,10
14419,ORD_14420,2223,Rptel 40mg Tablet,Warehouse C,9,4,2025-02-18 04:11:00,5
14420,ORD_14421,6196,House of Aroma Lavender Fragrance Oil 10 ml,Warehouse C,43,38,2025-02-18 02:24:00,5
14421,ORD_14422,26759,Western Digital WD Purple 32GB Surveillance and Security Camera Memory Card for CCTV & WiFi Cameras (WDD032G1P0C),Warehouse A,77,69,2025-02-18 22:51:00,8
14422,ORD_14423,18102,"Toothpaste - 2 In 1, Cavity Protection",Warehouse B,50,35,2025-02-18 09:44:00,15
14423,ORD_14424,28792,Vega Round Brush (E2 - PR) 64 gm,Warehouse C,27,10,2025-02-18 00:13:00,17
14424,ORD_14425,18243,"Seagate One Touch 2TB External HDD with Password Protection – Rose Gold, for Windows and Mac, with 3 yr Data Recovery Serv...",Warehouse B,11,6,2025-02-18 05:31:00,5
14425,ORD_14426,20417,"(Renewed) DELL OPTIPLEX 7010 Business Class Performance Desktop SFF (Intel Core i5 3470 3.2 Ghz, 8GB RAM, 250 GB SSD Windo...",Warehouse A,95,84,2025-02-18 23:38:00,11
14426,ORD_14427,26775,Insulatard NOVOLET 100IU Suspension for Injection,Warehouse A,33,16,2025-02-18 00:23:00,17
14427,ORD_14428,19716,Ankeer Eyebrow Pencil Beard Filler Pen for Drawing Eyebrow Beard Shape Long-Lasting Waterproof Sweatproof Eyebrow Color Pe...,Warehouse A,43,29,2025-02-18 02:43:00,14
14428,ORD_14429,4630,Sivanna Colors In The Peach Pro Cheek - HF6038 06 10 gm,Warehouse C,17,10,2025-02-18 20:55:00,7
14429,ORD_14430,32693,HP Blue Pin Original Laptop Charger 19.5V 3.33A 65W Adapter (Power Cable Included),Warehouse B,86,67,2025-02-18 02:48:00,19
14430,ORD_14431,22920,JAGUAR Classic Black Eau de Toilette - 100 ml (For Men),Warehouse B,51,34,2025-02-18 02:44:00,17
14431,ORD_14432,20729,Mercedes-Benz Select Shower Gel 75 ml,Warehouse B,79,71,2025-02-18 01:00:00,8
14432,ORD_14433,22921,Pain Relief Balm - White,Warehouse C,109,92,2025-02-18 17:30:00,17
14433,ORD_14434,33245,"CHAMBOR Silver Shadow, Sable Rr3 - 16 + 16 gm",Warehouse B,33,21,2025-02-18 12:04:00,12
14434,ORD_14435,6271,Natazolcin Tablet,Warehouse B,98,88,2025-02-18 23:26:00,10
14435,ORD_14436,17894,"Digitek DTR 550 LW (67 Inch) Tripod For DSLR, Camera |Operating Height: 5.57 Feet | Maximum Load Capacity up to 4.5kg | Po...",Warehouse A,49,37,2025-02-18 02:05:00,12
14436,ORD_14437,21249,Onclav 500mg/125mg Tablet,Warehouse B,39,27,2025-02-18 09:31:00,12
14437,ORD_14438,36878,Rholic Square Empty Luxurious Portable Air Cushion Puff Box BB Cream Container Case White,Warehouse C,78,70,2025-02-18 06:25:00,8
14438,ORD_14439,28601,Olmy 40 Tablet,Warehouse A,62,53,2025-02-18 04:22:00,9
14439,ORD_14440,5482,Revlon Matte Balm - Sultry 2.7 Gm,Warehouse A,77,71,2025-02-18 17:22:00,6
14440,ORD_14441,32321,Bella Vita Organic Choco 3 In 1 Tinty For Lips 8 gm,Warehouse B,34,23,2025-02-18 19:56:00,11
14441,ORD_14442,15111,Vomirid Drop,Warehouse A,107,91,2025-02-18 00:24:00,16
14442,ORD_14443,17885,Cello Signature Moonlit Ball Pen | Blue Ball Pen | Pack of 1 | Best Ball Pens for Smooth Writing | Gifting Pens | Premium ...,Warehouse B,43,36,2025-02-18 07:36:00,7
14443,ORD_14444,11756,Sial 200mg Tablet,Warehouse C,7,2,2025-02-18 03:04:00,5
14444,ORD_14445,2503,CEDO iPhone 11 Case Back Cover Shockproof Bumper Crystal Clear | 360 Degree Protection TPU+PC | Camera Protection | Acryli...,Warehouse A,90,72,2025-02-18 03:13:00,18
14445,ORD_14446,8085,Tyclo P Oral Suspension Mango,Warehouse C,53,48,2025-02-18 03:20:00,5
14446,ORD_14447,4649,Nail Filer - No 20,Warehouse B,53,34,2025-02-18 04:33:00,19
14447,ORD_14448,27589,Halexin 125mg Dry Syrup,Warehouse B,88,70,2025-02-18 11:32:00,18
14448,ORD_14449,20770,Psyril 50mg Tablet,Warehouse A,98,88,2025-02-18 19:15:00,10
14449,ORD_14450,32388,"(Renewed) boAt Rockerz 255 Pro+ Bluetooth in Ear Earphones with Upto 40 Hours Playback, ASAP Charge, IPX7, Dual Pairing an...",Warehouse A,46,38,2025-02-18 10:06:00,8
14450,ORD_14451,22641,"ENTWINO USB Wired Gaming Mouse D1 Black, LED Backlight up to 3200 DPI, Ergonomic Design for Laptop & PC",Warehouse A,99,86,2025-02-18 11:58:00,13
14451,ORD_14452,894,Nuroapt-D3 Tablet,Warehouse A,46,39,2025-02-18 10:13:00,7
14452,ORD_14453,2893,Pikkme Oneplus Nord Ce 2 Lite 5G Flip Case Leather Finish | Inside TPU with Card Pockets | Wallet Stand | Magnetic Closing...,Warehouse A,68,59,2025-02-18 17:58:00,9
14453,ORD_14454,14624,Aester-P Oral Suspension,Warehouse C,46,31,2025-02-18 16:00:00,15
14454,ORD_14455,9662,"FORFOR® Forever Matte Long Lasting | Waterproof | Liquid Matte Lip Color Combo of 3 (upto 12 hours Stay)(Bury Brown ,Moon ...",Warehouse B,96,78,2025-02-18 07:39:00,18
14455,ORD_14456,9110,"Sounce Car Mobile Holder with One Click Technology, 360° Rotational, Strong Suction Cup, Compatible with 4 to 7 Inch Devic...",Warehouse A,32,23,2025-02-18 13:56:00,9
14456,ORD_14457,27230,Moxipace-CV 625 Tablet,Warehouse B,107,97,2025-02-18 08:17:00,10
14457,ORD_14458,15570,Lupigra Tablet,Warehouse A,23,9,2025-02-18 04:01:00,14
14458,ORD_14459,34173,Gynasafe 150mg Capsule,Warehouse C,28,14,2025-02-18 04:01:00,14
14459,ORD_14460,24980,Xylorin-P Nasal Drops,Warehouse B,23,13,2025-02-18 12:06:00,10
14460,ORD_14461,27249,ADISA 32L Large Laptop Backpack Office Bag College Travel Back Pack with rain Cover (Navy),Warehouse A,59,52,2025-02-18 00:04:00,7
14461,ORD_14462,4651,Urgiso Tablet,Warehouse A,108,89,2025-02-18 00:48:00,19
14462,ORD_14463,26771,"HyperX Cloud Core  On-Ear Wired Gaming Headset with Mic for PC, DTS Headpone:X (Black)",Warehouse A,111,97,2025-02-18 22:25:00,14
14463,ORD_14464,28924,"Just Herbs Youth Anti Wrinkle Cream, 50g",Warehouse B,76,61,2025-02-18 06:36:00,15
14464,ORD_14465,19791,Arata Natural Nourishing Hempocado Hair Oil With Hempseed & Avocado Oil 100 ml,Warehouse A,104,88,2025-02-18 06:22:00,16
14465,ORD_14466,2883,Blaupunkt EM10 in-Ear Wired Earphone with Mic and Deep Bass HD Sound Mobile Headset with Noise Isolation and with customis...,Warehouse A,75,56,2025-02-18 04:34:00,19
14466,ORD_14467,2683,Aceprime-SP Tablet,Warehouse C,68,51,2025-02-18 12:50:00,17
14467,ORD_14468,34213,Jetmol Suspension,Warehouse A,110,96,2025-02-18 00:55:00,14
14468,ORD_14469,30973,Sun expert Lotion,Warehouse B,47,42,2025-02-18 17:35:00,5
14469,ORD_14470,19732,Seafax 500mg Capsule,Warehouse A,24,8,2025-02-18 09:22:00,16
14470,ORD_14471,28645,"M.G.R.J® Tempered Glass Screen Protector for Samsung Galaxy Watch 4 Classic (42mm) (1.2"" inch) (Pack of 2)",Warehouse C,78,70,2025-02-18 12:50:00,8
14471,ORD_14472,24954,OpenTech® Tempered Glass Screen Protector Compatible for Samsung Galaxy M32 / F22 / A32 / A31 (Transparent) Full Screen Co...,Warehouse C,94,76,2025-02-18 06:30:00,18
14472,ORD_14473,27646,"Maybelline New York Baby Lips Alia Loves New York Lip Balm, Manhattan Mauve 4 Gm",Warehouse C,114,99,2025-02-18 20:11:00,15
14473,ORD_14474,9123,S Gary OZ 200 mg/500 mg Tablet,Warehouse C,24,11,2025-02-18 16:19:00,13
14474,ORD_14475,28709,"Tecno Spark 8T (Atlantic Blue, 4GB RAM,64GB Storage)| 50MP AI Camera | 7GB Expandable RAM",Warehouse B,18,10,2025-02-18 06:14:00,8
14475,ORD_14476,13077,Q Vid TZ 200 mg/600 mg Tablet,Warehouse C,79,72,2025-02-18 16:22:00,7
14476,ORD_14477,20431,"Amkette Nylon Braided Aux Audio Cable - 3.5 mm Gold Plated Jack Male to Male Tangle Free for Car Stereo, Speakers, Headpho...",Warehouse A,32,21,2025-02-18 04:23:00,11
14477,ORD_14478,29784,Ajmal Jannatul Firdaus Concentrated Perfume Oil Oriental Attar And Colaba Mukhallat Concentrated Perfume Oil Floral Oriental Attar 24 ml,Warehouse C,103,92,2025-02-18 06:43:00,11
14478,ORD_14479,35693,Nature's Essence Lacto Bleach Natural Milk Bleach Without Activator 478 gm,Warehouse C,47,35,2025-02-18 16:46:00,12
14479,ORD_14480,4657,Dot & Key Pore Decongesting + Detoxifying Charcoal Mousse Mask 85 gm,Warehouse C,41,34,2025-02-18 22:18:00,7
14480,ORD_14481,870,Bonjour Paris Premium Creme Matte 9-5 Hydrating Lipstick - Light Burgundy 4.2 gm,Warehouse C,27,8,2025-02-18 21:20:00,19
14481,ORD_14482,5755,Nomarks - Antimarks Soap For Normal Skin,Warehouse B,104,91,2025-02-18 01:55:00,13
14482,ORD_14483,18129,Glimmer Premium Nail Enamel Soft Maroon 10 ml,Warehouse A,30,19,2025-02-18 22:23:00,11
14483,ORD_14484,21316,Joykem 100mg Tablet,Warehouse C,31,14,2025-02-18 20:43:00,17
14484,ORD_14485,34203,UGREEN USB Switch Selector,Warehouse B,41,35,2025-02-18 05:31:00,6
14485,ORD_14486,1693,Meslone 4mg Tablet,Warehouse A,75,67,2025-02-18 18:24:00,8
14486,ORD_14487,8031,Duphapro 1mg Tablet,Warehouse B,36,30,2025-02-18 16:20:00,6
14487,ORD_14488,10622,Acrea T 100mg/4mg Tablet,Warehouse B,32,16,2025-02-18 08:48:00,16
14488,ORD_14489,18146,Mdther 75mg Injection,Warehouse C,31,12,2025-02-18 06:24:00,19
14489,ORD_14490,3914,VEGA Go Lite 1400w Powerful & Foldable Hair Dryer (VHDH-19) Pink 1 gm,Warehouse C,100,91,2025-02-18 00:19:00,9
14490,ORD_14491,24395,Dosulex 25 Tablet,Warehouse A,57,46,2025-02-18 01:04:00,11
14491,ORD_14492,10650,Renator 20mg Tablet,Warehouse B,86,76,2025-02-18 18:10:00,10
14492,ORD_14493,16148,Egsure 1mg Tablet,Warehouse C,97,85,2025-02-18 10:51:00,12
14493,ORD_14494,34200,Amvus DX Syrup,Warehouse B,51,35,2025-02-18 16:49:00,16
14494,ORD_14495,13066,Panviz D 30mg/40mg Capsule SR,Warehouse B,85,80,2025-02-18 08:32:00,5
14495,ORD_14496,22711,Odeon Charcoal Tea Tree Deep Cleansing Exfoliating Body Scrub 300ml,Warehouse A,38,23,2025-02-18 19:04:00,15
14496,ORD_14497,12445,"Maybelline New York Color Sensational Creamy Matte Lipstick, 696 Burgundy Blush 3.9 gm",Warehouse B,36,17,2025-02-18 03:01:00,19
14497,ORD_14498,3751,Ajmal Blu Wisal Dahab Wisal Dahab Deodorant Spray (Pack of 3) 200 ml,Warehouse C,27,18,2025-02-18 05:49:00,9
14498,ORD_14499,4683,"Amazon Basics Universal Car Mobile Holder with One Touch Mechanism - Expandable, Rotatable & Double Shift Locking (Black)",Warehouse B,100,90,2025-02-18 02:48:00,10
14499,ORD_14500,36623,"rts [2 Pack] Mini USB C Type C Adapter Plug, Type C Female to USB A Male Charger Charging Cable Adapter Converter compatib...",Warehouse B,53,36,2025-02-18 07:03:00,17
14500,ORD_14501,21314,Reform 500mg Tablet,Warehouse B,71,55,2025-02-18 13:11:00,16
14501,ORD_14502,13319,Visnac SP 100mg/325mg/15mg Tablet,Warehouse A,113,94,2025-02-18 14:52:00,19
14502,ORD_14503,3223,Nataraj GCM Ball Pen Jar,Warehouse C,23,9,2025-02-18 20:00:00,14
14503,ORD_14504,8004,Vega Mini Round Brush (R7 - RB) 70 gm,Warehouse C,77,66,2025-02-18 05:53:00,11
14504,ORD_14505,16184,"Ajmal Blu EDP Citrus Perfume for Men, 90 ml & Ajmal Blu Deodorant for Man, 200 ml & Ajmal Blu Femme EDP Floral Perfume for...",Warehouse C,72,55,2025-02-18 14:13:00,17
14505,ORD_14506,2872,"Wayona Nylon Braided 2M / 6Ft Fast Charge Usb To Lightning Data Sync And Charging Cable For Iphone, Ipad Tablet (6 Ft Pack...",Warehouse B,77,70,2025-02-18 16:20:00,7
14506,ORD_14507,21148,"Honeybee Aloe Vera Vegan Facial Wax Strips | Waxing Strips for Women | Upper Lips, Chin, Fingers & Toes Hair Removal | For...",Warehouse B,110,97,2025-02-18 12:55:00,13
14507,ORD_14508,29022,Serwal 50mg Tablet,Warehouse C,105,91,2025-02-18 15:01:00,14
14508,ORD_14509,20651,Itoclav-CV 625 Tablet,Warehouse B,105,96,2025-02-18 03:26:00,9
14509,ORD_14510,5936,RAEGR Arc One 15W Type-C PD |Made in India |Qi-Certified Wireless Charger with Fireproof ABS for iPhone 14/13/12/11/X/8 Se...,Warehouse B,106,93,2025-02-18 11:20:00,13
14510,ORD_14511,36355,"One Plus Type c to 3.5mm Audio Jack, 1-Plus Audio Jack Adapter, car Audio Connector USB Type c, Headphone Converter Cable ...",Warehouse B,81,63,2025-02-18 22:27:00,18
14511,ORD_14512,27797,Orange & Multani Mitti Ubtan - Tan Removal & Brightness,Warehouse A,77,67,2025-02-18 14:59:00,10
14512,ORD_14513,26416,Shaving Foam Mint Marine,Warehouse C,102,83,2025-02-18 02:18:00,19
14513,ORD_14514,24691,"Amazon Basics Permanent Markers, Assorted Colours, Pack of 24",Warehouse C,112,94,2025-02-18 15:29:00,18
14514,ORD_14515,27875,Endosure 25mg Disintegrating Strip,Warehouse C,60,42,2025-02-18 12:54:00,18
14515,ORD_14516,15790,Digirest Plus Oral Suspension Mint Sugar Free,Warehouse B,22,11,2025-02-18 01:43:00,11
14516,ORD_14517,10307,Freecan 150mg Tablet,Warehouse C,117,98,2025-02-18 14:29:00,19
14517,ORD_14518,26413,Biladoz M 20mg/10mg Tablet,Warehouse C,30,20,2025-02-18 07:16:00,10
14518,ORD_14519,18611,Cetrezol 10 Tablet,Warehouse B,95,80,2025-02-18 16:26:00,15
14519,ORD_14520,34454,HELLO ZONE Rubber Exclusive Matte Finish Soft Back Cover for Nokia C01 Plus - Black,Warehouse A,33,16,2025-02-18 16:51:00,17
14520,ORD_14521,22306,Oxeltra OD 450mg Tablet,Warehouse C,73,65,2025-02-18 04:40:00,8
14521,ORD_14522,24693,Tolnacomb RF Cream,Warehouse B,62,43,2025-02-18 01:44:00,19
14522,ORD_14523,24817,Clinziv Vaginal Soft Gelatin Capsule,Warehouse B,93,77,2025-02-18 04:09:00,16
14523,ORD_14524,24688,Xop CV 200mg/125mg Tablet,Warehouse C,49,44,2025-02-18 06:08:00,5
14524,ORD_14525,6900,GLUN HOT MELT Transparent Glue Sticks for Glue Gun (7MM - 25 Sticks),Warehouse B,59,48,2025-02-18 21:20:00,11
14525,ORD_14526,5548,Gel Bathing Bar - Patchouli & Macadamia La Fantasia,Warehouse A,30,11,2025-02-18 14:51:00,19
14526,ORD_14527,19113,"ProElite Smart Flip Case Cover for Apple iPad 10.2"" 9th Gen (2021) 8th Gen/7th Gen, with Stylus Pen, Translucent & Hard Ba...",Warehouse B,110,98,2025-02-18 11:37:00,12
14527,ORD_14528,5835,Clear Complexion Brightening Body Lotion,Warehouse B,53,42,2025-02-18 10:15:00,11
14528,ORD_14529,11910,Gertum 250mg Tablet,Warehouse C,37,19,2025-02-18 17:58:00,18
14529,ORD_14530,31104,"Pmw Loose Packed Kamakhya Sindoor (5G, Maroon)",Warehouse C,108,92,2025-02-18 02:59:00,16
14530,ORD_14531,10242,Floace SP 100mg/325mg/15mg Tablet,Warehouse B,74,56,2025-02-18 14:24:00,18
14531,ORD_14532,6846,Zebronics Zeb Wonderbar 10 USB Powered 2.0 Computer Speaker with RGB Lights,Warehouse C,38,26,2025-02-18 16:48:00,12
14532,ORD_14533,19421,"Parandiv Branded Short Length 2.4A Faster Charging 0.25M with Data Sync Power Bank Lightning Cable For iPhones,iPad Air,iP...",Warehouse C,40,31,2025-02-18 06:51:00,9
14533,ORD_14534,3679,"YOGINE 5w Fast Charger for iPhone 5/6, 7, 8, X, 11 Series | 5 Watt Charging Adapter with USB Cable Compatible for iPhone ...",Warehouse B,29,15,2025-02-18 07:20:00,14
14534,ORD_14535,15945,Sulfaquin 300mg Tablet,Warehouse C,96,88,2025-02-18 12:11:00,8
14535,ORD_14536,15946,Rabecool LS 75 mg/20 mg Tablet,Warehouse A,102,86,2025-02-18 01:26:00,16
14536,ORD_14537,1498,"Lakme Eyeconic Lash Curling Mascara, Black, 9ml and Lakme Absolute Shine Liquid Eye Liner, Black, 4.5ml",Warehouse A,10,5,2025-02-18 13:57:00,5
14537,ORD_14538,14185,J-Coff Plus Syrup,Warehouse A,91,83,2025-02-18 01:46:00,8
14538,ORD_14539,19116,Pepgerd 20mg Tablet,Warehouse B,76,61,2025-02-18 01:31:00,15
14539,ORD_14540,4866,"POSH VGA to HDMI, Mini HD 1080P 3.5mm Audio VGA to HDMI HD HDTV Video Converter Box Adapter VGA2HDMI for PC Laptop Dispaly...",Warehouse B,57,50,2025-02-18 20:00:00,7
14540,ORD_14541,11889,"SupCares Edge to Edge Tempered Glass for OnePlus 10R 5G, OnePlus 10R 5G - Prime Edition, and OnePlus 10T 5G with Easy Self...",Warehouse A,82,76,2025-02-18 08:40:00,6
14541,ORD_14542,28354,"PiBOX India, Video Capture Card, 4K HDMI to USB 3.0 Game Capture Device Aluminium Windows Android Mac,HD 1080P Audio Video...",Warehouse B,27,8,2025-02-18 18:39:00,19
14542,ORD_14543,9931,"Grooming Comb - GRC1004, Colour May Vary",Warehouse A,90,83,2025-02-18 22:39:00,7
14543,ORD_14544,32556,HG Mide 2mg Capsule,Warehouse B,38,31,2025-02-18 18:01:00,7
14544,ORD_14545,2014,Ant Esports 690 NEO VS 8GB (1*8GB) DDR3 1600 MHz CL 11-11-11-28 U-DIMM Desktop Memory - AE8GD3U16M16C,Warehouse A,48,30,2025-02-18 09:55:00,18
14545,ORD_14546,36750,TheGiftKart Shockproof Crystal Clear Back Cover Case for Back Cover Case for Poco F1 | 360 Degree Protection | Protective ...,Warehouse C,12,5,2025-02-18 09:57:00,7
14546,ORD_14547,5186,"Ambrane Tabletop Mobile Holding Stand, 180 Degree View, Premium Metal Body, Wide Compatibility, Multipurpose, Anti-Skid De...",Warehouse A,44,39,2025-02-18 21:16:00,5
14547,ORD_14548,6030,"M.G.R.J® Tempered Glass Screen Protector for Realme Pad Mini (8.7"" inch)",Warehouse C,91,72,2025-02-18 04:53:00,19
14548,ORD_14549,19624,MADES Recipes Juicy Delight Body Lotion 350 ml,Warehouse A,114,95,2025-02-18 22:31:00,19
14549,ORD_14550,374,"Amkette Hush Pro Spectra 2.4 GHz Silent Switch Wireless Mouse with Ergonomic Design, Rechargeable Battery, High Precision,...",Warehouse C,109,91,2025-02-18 19:10:00,18
14550,ORD_14551,30553,Kanzole 1% Cream,Warehouse B,36,22,2025-02-18 12:44:00,14
14551,ORD_14552,9929,Aenafen 75mg Injection,Warehouse B,114,95,2025-02-18 07:55:00,19
14552,ORD_14553,24592,"Oral B Criss Cross Manual Toothbrush for Adults (Medium, Multicolor) (BUY 2 GET 2 Free)",Warehouse C,62,53,2025-02-18 05:32:00,9
14553,ORD_14554,18468,Jazmet G 1mg/1000mg Tablet,Warehouse B,56,37,2025-02-18 16:28:00,19
14554,ORD_14555,19269,"L.A. Colors Matte Liquid Lip Color, Moonlight Brown, 3.9g",Warehouse B,74,63,2025-02-18 12:34:00,11
14555,ORD_14556,30513,TheGiftKart Tough Armor Bumper Back Cover Case for OnePlus 6T / OnePlus 7 Bumper | Ring Holder & Kickstand in-Built | 360 ...,Warehouse B,21,7,2025-02-18 04:37:00,14
14556,ORD_14557,30520,Medrab L 75mg/20mg Capsule SR,Warehouse C,45,32,2025-02-18 19:23:00,13
14557,ORD_14558,12108,CP PLUS 1MP Full HD IR Bullet Camera | 1/4.5'' 1MP PS CMOS Image Sensor| Max 30fps@720P | 3.6 mm Fixed Lens | IR Range of ...,Warehouse A,62,53,2025-02-18 16:58:00,9
14558,ORD_14559,5205,Manfex 200mg Tablet DT,Warehouse C,90,75,2025-02-18 17:50:00,15
14559,ORD_14560,235,Duzela 30 Capsule DR,Warehouse C,32,17,2025-02-18 18:32:00,15
14560,ORD_14561,5833,Alzero Tablet,Warehouse A,74,65,2025-02-18 02:57:00,9
14561,ORD_14562,2627,Rebnar L 75mg/20mg Capsule SR,Warehouse A,82,77,2025-02-18 18:57:00,5
14562,ORD_14563,33116,HP Wireless Mouse 250/2.4 GHz Wireless USB connectivity/12 Months Battery Life/LED Optical Sensor/ 1600 DPI/3 Years Warran...,Warehouse C,64,45,2025-02-18 00:43:00,19
14563,ORD_14564,28086,Hand Cream,Warehouse A,89,74,2025-02-18 14:51:00,15
14564,ORD_14565,19094,DUDAO Quick Car Charger 3A Super-fast car charger with 3 in 1 stretchable coil Cable 1.2m DUAL USB Port Qualcomm 3.0 Car C...,Warehouse C,50,41,2025-02-18 20:54:00,9
14565,ORD_14566,32633,Wet N Wild Makeup Sponge Applicator 1's,Warehouse B,104,87,2025-02-18 16:29:00,17
14566,ORD_14567,22206,Nutri Active Advanced Skin Firming Cream,Warehouse B,53,47,2025-02-18 13:01:00,6
14567,ORD_14568,6059,"mobimint 7 Feet Big Tripod Stand for Phone and Camera Adjustable Aluminium Alloy Big Tripod Stand Holder, Photo/Video Shoo...",Warehouse A,83,68,2025-02-18 01:01:00,15
14568,ORD_14569,33117,"Samsung Galaxy A14 5G (Black, 4GB, 64GB Storage) | Triple Rear Camera (50 MP Main) | Upto 8 GB RAM with RAM Plus | Travel ...",Warehouse B,44,27,2025-02-18 12:31:00,17
14569,ORD_14570,24524,Allure Eyeshadow Brush - (232) 1's,Warehouse A,14,7,2025-02-18 11:06:00,7
14570,ORD_14571,2344,Fragrance Body Spray - Delicious,Warehouse B,72,61,2025-02-18 11:23:00,11
14571,ORD_14572,26361,Chitrak Root Powder - Supports Healthy Digestion & Appetite,Warehouse A,72,59,2025-02-18 09:36:00,13
14572,ORD_14573,28128,Akai PartyMate Bluetooth Party Speaker PM-80T 80W Karaoke System Portable Trolley Outdoor Speaker/Inbuilt Battery Upto 6 H...,Warehouse A,62,57,2025-02-18 20:14:00,5
14573,ORD_14574,21494,Olmetru H 12.5mg/40mg Tablet,Warehouse C,61,45,2025-02-18 18:30:00,16
14574,ORD_14575,21495,"DYAZO Water Resistant Camera Bag/Case Shoulder Strap Space for Photography Lens and Accessories Compatible for Nikon, Cano...",Warehouse C,98,83,2025-02-18 09:16:00,15
14575,ORD_14576,5008,Zoop Spiderman Analog Black Dial Unisex's Watch-NNC4048PP15,Warehouse B,18,9,2025-02-18 12:23:00,9
14576,ORD_14577,26211,Mono CC Syrup,Warehouse A,108,93,2025-02-18 09:06:00,15
14577,ORD_14578,15970,"Acer EK220Q 21.5 Inch (54.61 Cm) Full HD (1920x1080 Pixels) VA Panel LCD Monitor with LED Back Light I 250 Nits I HDMI, VG...",Warehouse C,39,24,2025-02-18 18:56:00,15
14578,ORD_14579,19038,Oftor 200mg Tablet,Warehouse A,79,62,2025-02-18 14:11:00,17
14579,ORD_14580,35495,Odace 2.5mg Tablet,Warehouse A,96,80,2025-02-18 19:02:00,16
14580,ORD_14581,26212,Pierre Cardin Paris - Pearly Velvet Eyeshadow 575-Silver Grey,Warehouse A,22,13,2025-02-18 16:40:00,9
14581,ORD_14582,21922,Spigen Tough Armor Back Cover Case for Samsung Galaxy S23 Ultra (Poly Carbonate + TPU | Abyss Green),Warehouse A,74,64,2025-02-18 20:22:00,10
14582,ORD_14583,15972,Hello Zone Exclusive Dotted Matte Finish Soft Rubberised Back Case Cover for OnePlus 5 - Black,Warehouse B,50,40,2025-02-18 00:30:00,10
14583,ORD_14584,26595,Anti-Oxidant 24 Active Oils - Professional Face Oil,Warehouse B,43,37,2025-02-18 18:31:00,6
14584,ORD_14585,19527,"Amazon Basics Adjustable Portable Laptop Table, Bed Table, Notebook Stand, Laptop Standing Desk, Portable Standing Table w...",Warehouse C,66,56,2025-02-18 14:39:00,10
14585,ORD_14586,8477,Voglow 0.3 GM2 Tablet,Warehouse C,50,40,2025-02-18 00:13:00,10
14586,ORD_14587,19074,Cosmic Byte CB-GK-26 Pandora TKL Mechanical Keyboard Upgraded with Swappable Outemu Red Switches & Rainbow LED (Black/Grey),Warehouse B,106,90,2025-02-18 05:47:00,16
14587,ORD_14588,10252,Whitening Rock Natural Ayurvedic Salt Toothpaste,Warehouse B,104,90,2025-02-18 19:00:00,14
14588,ORD_14589,30084,"Lenovo L-Series 60.45 cm (24 inch) FHD IPS Ultraslim Monitor | 16.7 Million Colors, 75Hz, AMD FreeSync, HDMI, Tilt, VESA M...",Warehouse C,19,1,2025-02-18 20:48:00,18
14589,ORD_14590,2582,Pain Balm - Strong,Warehouse B,100,87,2025-02-18 15:41:00,13
14590,ORD_14591,32564,Ajmal 3 Blu Deo & Yearn EDP Pack of 4 20 ml,Warehouse A,87,68,2025-02-18 23:51:00,19
14591,ORD_14592,24534,"Fashion Colour Non - Transfer Matt Waterproof Lipstick, 71 Ladies Night 2.6 gm",Warehouse C,105,92,2025-02-18 08:17:00,13
14592,ORD_14593,28362,Lemongrass Hexagon Bath Personal Care Gift Set,Warehouse C,63,46,2025-02-18 01:06:00,17
14593,ORD_14594,26383,Mother Sparsh Natural Insect Repellent Spray 100 ml,Warehouse B,64,58,2025-02-18 02:44:00,6
14594,ORD_14595,8210,Orbis 150mg Tablet,Warehouse A,46,31,2025-02-18 02:27:00,15
14595,ORD_14596,8216,"Upix® AC Remote No. 68 with Backlight & Timer, Compatible for Hitachi AC Remote Control (Exactly Same Remote Will Only Work)",Warehouse A,107,93,2025-02-18 07:10:00,14
14596,ORD_14597,26331,Multivitamin Gummies - For Kids & Adults,Warehouse C,96,88,2025-02-18 17:57:00,8
14597,ORD_14598,3426,Omento 20mg Capsule,Warehouse B,107,94,2025-02-18 23:46:00,13
14598,ORD_14599,8332,Rapizer D 30mg/20mg Capsule SR,Warehouse A,27,12,2025-02-18 22:33:00,15
14599,ORD_14600,8213,CEDO Tempered Glass for iPad 5 Gen / 6 Gen - 9.7 inch | Screen Protector Tempered Glass for iPad Tab 9.7 inch - 5th / 6th ...,Warehouse B,29,15,2025-02-18 05:45:00,14
14600,ORD_14601,13978,Tryden D 50mg Tablet,Warehouse C,96,91,2025-02-18 03:07:00,5
14601,ORD_14602,10108,Irokia S 20mg Injection,Warehouse C,94,80,2025-02-18 21:56:00,14
14602,ORD_14603,19417,Droamp Oral Drops,Warehouse A,67,53,2025-02-18 04:53:00,14
14603,ORD_14604,21826,Meclomide Suspension,Warehouse C,98,86,2025-02-18 16:23:00,12
14604,ORD_14605,36390,Face Wash - Activated Charcoal & Quinoa,Warehouse A,107,96,2025-02-18 02:48:00,11
14605,ORD_14606,21824,Tea Tree Skin Clearing Day Gel - SPF 30,Warehouse C,43,33,2025-02-18 13:37:00,10
14606,ORD_14607,21447,Cold Pressed Virgin Coconut Oil For Hair & Skin Moisturisation,Warehouse A,65,54,2025-02-18 12:55:00,11
14607,ORD_14608,13977,Ibudolo Tablet,Warehouse C,61,42,2025-02-18 07:17:00,19
14608,ORD_14609,9190,Original 25W Charger Super Fast Charging Charger Adapter Smartphone Charger Compatible for Samsung Galaxy S21/S21+/S21 Ult...,Warehouse B,68,54,2025-02-18 19:29:00,14
14609,ORD_14610,1034,"CeraVe Renewing System, Skin Renewing Night Cream, 1.7 Ounce, 48 g (Pack of 1) (B00SNPCSUY)",Warehouse C,93,75,2025-02-18 06:14:00,18
14610,ORD_14611,14060,Vega Grooming Wooden Comb (HMWC - 04) 38 gm,Warehouse C,24,13,2025-02-18 04:48:00,11
14611,ORD_14612,18706,Telpod-H Tablet,Warehouse A,73,64,2025-02-18 09:07:00,9
14612,ORD_14613,13413,"ONEPLUS USB 3.0 to Type-C OTG Cable Adapter Compatible with USB to c Type Converter Supporting All laptops, Mobile Smartph...",Warehouse A,73,67,2025-02-18 10:40:00,6
14613,ORD_14614,35371,Ajmal Desert Rose EDP Floral Oriental Perfume And Sacred Love Deodorant Floral Musky Fragrance 300 ml,Warehouse A,27,15,2025-02-18 07:42:00,12
14614,ORD_14615,24553,Anti-Hair Fall Shampoo,Warehouse C,102,94,2025-02-18 06:53:00,8
14615,ORD_14616,22232,Edoclof-SP Tablet,Warehouse C,31,17,2025-02-18 11:41:00,14
14616,ORD_14617,19052,Cutifen 180mg Tablet,Warehouse C,14,2,2025-02-18 20:06:00,12
14617,ORD_14618,12529,Spigen Ultra Hybrid Back Cover Case Compatible with iPhone 14 Plus (TPU + Poly Carbonate | Matte Black),Warehouse A,77,58,2025-02-18 16:46:00,19
14618,ORD_14619,2551,Telmisan 40mg Tablet,Warehouse C,85,70,2025-02-18 11:45:00,15
14619,ORD_14620,26387,Famocid 40 Tablet,Warehouse A,33,22,2025-02-18 04:06:00,11
14620,ORD_14621,28313,Omit-MD Tablet,Warehouse B,87,75,2025-02-18 11:26:00,12
14621,ORD_14622,8299,Closed 0.25mg Tablet,Warehouse C,104,97,2025-02-18 00:23:00,7
14622,ORD_14623,10065,Tadovas 10mg Tablet,Warehouse B,22,9,2025-02-18 14:35:00,13
14623,ORD_14624,8457,Insight Cosmetics Non Transfer Matte Lipstick - Checkmate 4.2 gm,Warehouse C,97,91,2025-02-18 02:31:00,6
14624,ORD_14625,6038,Anti-Hair Fall Pack,Warehouse C,58,41,2025-02-18 03:49:00,17
14625,ORD_14626,975,Eyetex Dazller Nail Glitter- DR11 (Red Dear) 12 ml,Warehouse A,58,48,2025-02-18 00:51:00,10
14626,ORD_14627,2592,Sadhev Anti-Dandruff Hair Oil 150 ml,Warehouse C,57,44,2025-02-18 04:30:00,13
14627,ORD_14628,27194,Tuscof-D Syrup Honey Sugar Free,Warehouse B,25,13,2025-02-18 07:33:00,12
14628,ORD_14629,2917,Zyrtec OD 10mg Tablet,Warehouse A,59,53,2025-02-18 18:55:00,6
14629,ORD_14630,4890,Agtin 500mg/125mg Tablet,Warehouse A,92,82,2025-02-18 13:59:00,10
14630,ORD_14631,33058,MYVN TPU Carbon Protective Galaxy Buds 2 Pro Case Cover 2022 with Carabiner for Samsung Galaxy Buds Live Case (2020) | Gal...,Warehouse C,103,84,2025-02-18 19:52:00,19
14631,ORD_14632,21500,Zolpidox 1 Tablet MD,Warehouse A,55,43,2025-02-18 05:48:00,12
14632,ORD_14633,30692,Uvasaggaharam Digital Camera + Video Recorder for Kids Boys & Girls with Expandable Memory with Variety of Filters (Withou...,Warehouse C,76,65,2025-02-18 01:35:00,11
14633,ORD_14634,21502,DeBelle Gel Nail Lacquer Pegasus Lime Yellow With Gold Glitter Nail Polish 8 ml,Warehouse A,34,18,2025-02-18 01:08:00,16
14634,ORD_14635,36816,Dukes Crème 4 Fun strawberry/Orange and Chocolate Flavoured Sandwich Biscuits (Buy 2 get 1 free - 450g)/ Flavour's may vary,Warehouse A,58,42,2025-02-18 11:52:00,16
14635,ORD_14636,5013,Streetwear Nail Enamel - Silver Sizzle 8 Ml,Warehouse C,83,70,2025-02-18 15:20:00,13
14636,ORD_14637,19574,ANNA CREATIONS latest Korean fashion Style Flower Lock Hair Clip Pin Hair Accessories set For Women And Girls (4 Pcs),Warehouse B,106,98,2025-02-18 03:37:00,8
14637,ORD_14638,19083,Khaas Shampoo Bar - Heena Amla,Warehouse B,32,24,2025-02-18 15:32:00,8
14638,ORD_14639,15810,Samsung Original IC050 Type-C Wired in Ear Earphone with mic (White),Warehouse C,36,25,2025-02-18 21:01:00,11
14639,ORD_14640,30109,Bleach Laser - White,Warehouse B,65,59,2025-02-18 21:06:00,6
14640,ORD_14641,8614,Berina A39 Matt Blonde Hair Color Cream 60 gm,Warehouse B,83,76,2025-02-18 01:28:00,7
14641,ORD_14642,24770,mCaffeine Coffee Prep Gift Kit 70 ml,Warehouse B,97,85,2025-02-18 01:50:00,12
14642,ORD_14643,10208,Khadi Essentials Luxurious Hair Care Conditioner - Almond Milk & Arnica 200 ml,Warehouse C,95,81,2025-02-18 19:14:00,14
14643,ORD_14644,26309,LzHH Cream,Warehouse C,102,86,2025-02-18 14:42:00,16
14644,ORD_14645,953,Flustan 150mg Tablet,Warehouse C,72,60,2025-02-18 14:13:00,12
14645,ORD_14646,30063,"Xiaomi 13 Pro (Ceramic White, 12GB RAM 256GB Storage) | Leica Professional 50MP Triple Camera | Biggest Camera Sensor 1"" I...",Warehouse C,51,44,2025-02-18 19:10:00,7
14646,ORD_14647,12962,Lenovo GX20K11840 45W Round Pin Laptop Adapter/Charger with Power Cord for Select Models of Lenovo (Black),Warehouse A,66,51,2025-02-18 17:21:00,15
14647,ORD_14648,21774,I AM EYECONIC 3D GLITTER ROSE GOLD 4 gm,Warehouse A,15,9,2025-02-18 20:36:00,6
14648,ORD_14649,9144,"Parker Frontier Gold Trim Roller Ball Pen with Free Card Holder (Matte Black), 2 Piece Set",Warehouse A,76,71,2025-02-18 11:35:00,5
14649,ORD_14650,22079,Clobidex-S Dermal,Warehouse A,99,83,2025-02-18 22:43:00,16
14650,ORD_14651,6006,Onsitego 1 Year Extended Warranty for Small Electric Appliances from Rs. 6001-7000 (Email Delivery - No Physical Kit),Warehouse C,31,25,2025-02-18 10:42:00,6
14651,ORD_14652,34558,Vasryl 1mg Tablet,Warehouse C,76,63,2025-02-18 17:55:00,13
14652,ORD_14653,31037,"INCOLOR Shine Shine Shine Matte Smooth Liquid Lipgloss, Long Lasting, Smudge Proof, Soft Creamy Natural Lipstick For Girl ...",Warehouse C,80,73,2025-02-18 18:57:00,7
14653,ORD_14654,26695,Sony WH-CH510 Wireless Bluetooth On Ear Headphone with Mic (Blue),Warehouse C,32,15,2025-02-18 08:41:00,17
14654,ORD_14655,35305,Aloe Vera Carrier Gel,Warehouse C,110,95,2025-02-18 23:42:00,15
14655,ORD_14656,27842,"Portronics Konnect A Trio 3-In-1 Multifunctional Cable For Micro Usb For Ios And Type C Mobile Phones, Smartphone, Tablet,...",Warehouse C,46,35,2025-02-18 02:15:00,11
14656,ORD_14657,4815,Dividom-O Capsule,Warehouse A,55,45,2025-02-18 22:45:00,10
14657,ORD_14658,28178,Prepulsid 10mg Tablet,Warehouse A,74,60,2025-02-18 05:23:00,14
14658,ORD_14659,7,Ajmal Neea EDP & Magnetize Deodorant Pack of 2 300 ml,Warehouse C,79,66,2025-02-18 09:39:00,13
14659,ORD_14660,32521,Odoxy 200mg Tablet,Warehouse A,103,88,2025-02-18 18:23:00,15
14660,ORD_14661,19236,Stretchmarks & Scar Treatment Biotoning Oil,Warehouse B,63,53,2025-02-18 15:15:00,10
14661,ORD_14662,16068,Vega Iris Grooming Comb (DC - 1264) 38 gm,Warehouse B,40,35,2025-02-18 01:03:00,5
14662,ORD_14663,34290,Total Repair 5 Shampoo,Warehouse B,78,67,2025-02-18 16:55:00,11
14663,ORD_14664,19364,Colipam Plus Tablet,Warehouse C,105,89,2025-02-18 09:48:00,16
14664,ORD_14665,21706,"Zayn & Myza Breathable Nail Enamel With Raspberry & Almond Oil, Red Velvet 6 ml",Warehouse A,97,83,2025-02-18 08:40:00,14
14665,ORD_14666,27969,Spigen AquaShield Waterproof Cover case A600 (Mobile Device Upto 6.2 inch) - White,Warehouse B,71,61,2025-02-18 10:42:00,10
14666,ORD_14667,31902,Bio Bhringraj Oil 100 Ml,Warehouse A,83,64,2025-02-18 00:29:00,19
14667,ORD_14668,18811,"Sounce Type C to RJ45 Ethernet LAN Adapter, Up to 1000 Mbps, for Windows/Mac/Linux (Black)",Warehouse A,100,81,2025-02-18 23:50:00,19
14668,ORD_14669,12063,"ZSIGNS Hydra Under Eye Vitamin C Serum Patches. Under Eye Masks to Reduce Dark Circles, Puffiness Fine Lines & Wrinkles. P...",Warehouse B,114,99,2025-02-18 20:14:00,15
14669,ORD_14670,29845,SKYVIK TRUHOLD AC Airvent Magnetic Car Mobile Phone Holder-Black,Warehouse C,84,75,2025-02-18 14:41:00,9
14670,ORD_14671,15740,David Beckham Intimately Man Deodorant Spray 150 ml,Warehouse A,20,9,2025-02-18 09:53:00,11
14671,ORD_14672,15862,Complete Starter Pack - Red,Warehouse C,40,31,2025-02-18 23:56:00,9
14672,ORD_14673,35551,"Nua Oil-Free Gel Moisturizer with 5% Niacinamide, Ceramides, Vitamin B5 and Vitamin E, Controls Acne & Strengthens Skin Ba...",Warehouse A,20,6,2025-02-18 11:11:00,14
14673,ORD_14674,12905,"Wayona Type C to Lightning MFI Certified 20W Fast charging Nylon Braided USB C Cable for iPhone 14,14 Pro,14 Pro Max,14 Pl...",Warehouse B,82,67,2025-02-18 00:45:00,15
14674,ORD_14675,22138,Cfpod 50mg Syrup,Warehouse B,109,92,2025-02-18 21:56:00,17
14675,ORD_14676,26109,"truke Fit 1+ Bluetooth 5.1 Truly Wireless in Ear Earbuds with mic, Dedicated Gaming Mode | 48hrs of Playtime | IPX4 | Touc...",Warehouse A,45,31,2025-02-18 08:22:00,14
14676,ORD_14677,14957,"ClubBeauty Hard Wax Beans for Painless Hair Removal, Brazilian Waxing for Face, Eyebrow, Back, Chest, Bikini Areas, Legs A...",Warehouse B,19,4,2025-02-18 17:56:00,15
14677,ORD_14678,22497,Opiz D 10mg/20mg Capsule,Warehouse C,78,68,2025-02-18 21:56:00,10
14678,ORD_14679,14865,"Ant Esports GP310 Wireless Gamepad, Compatible for PC & Laptop (Windows 10/8 /7, Steam) / PS3 / Android",Warehouse B,32,17,2025-02-18 13:17:00,15
14679,ORD_14680,34909,Robustrion [Anti-Scratch] & [Smudge Proof] [Bubble Free] Premium Tempered Glass Screen Protector Guard for Samsung Galaxy ...,Warehouse B,66,51,2025-02-18 09:47:00,15
14680,ORD_14681,36429,"Sery Color Flirt Nail Paint, Pastel Shimmer Nail Polish, Lilac Love 10 ml",Warehouse A,12,7,2025-02-18 20:23:00,5
14681,ORD_14682,21430,"HAKUHO Telephone Line Cord Telephone Extension Cord Rj11 Male To Male Cable Or Landline, Phone, Modem Or Fax Machine (Blac...",Warehouse A,74,66,2025-02-18 22:40:00,8
14682,ORD_14683,9791,"Falcon Wireless Pen Tattoo Machine, Single Button, Professional, Six Month Warranty(Coffee Round Grip)",Warehouse A,77,67,2025-02-18 15:43:00,10
14683,ORD_14684,22095,"FASHION COLOUR WATERPROOF GEL KAJAL Waterproof Kajal Liner, Pro intense Gel Kajal",Warehouse B,22,5,2025-02-18 05:12:00,17
14684,ORD_14685,27928,"SanDisk Ultra Dual Drive Go 256GB USB 3.0 Type C Pen Drive for Mobile (Mint Green, 5Y)",Warehouse A,25,13,2025-02-18 03:09:00,12
14685,ORD_14686,16038,Respira Tablet,Warehouse C,54,41,2025-02-18 15:48:00,13
14686,ORD_14687,12929,Zeebee Tablet,Warehouse B,67,60,2025-02-18 05:34:00,7
14687,ORD_14688,26104,Evitam 800mg Tablet,Warehouse B,26,21,2025-02-18 21:20:00,5
14688,ORD_14689,26067,Vega D'zyner Tweezer - Slant Tip (TW - 08) 19 gm,Warehouse C,38,28,2025-02-18 13:09:00,10
14689,ORD_14690,36743,"KAVANA Shyne 6 amp to 16 amp Converter/Conversion Plug (5-16A) Converts 6A Socket to 16 A Socket for Geysers, A/C,Refrigra...",Warehouse B,95,86,2025-02-18 14:42:00,9
14690,ORD_14691,3059,Charcoal Face Pack,Warehouse C,105,86,2025-02-18 17:41:00,19
14691,ORD_14692,26819,"SanDisk Ultra microSD UHS-I Card 128GB, 120MB/s R",Warehouse B,39,31,2025-02-18 08:16:00,8
14692,ORD_14693,3146,The Skin Story Facewash - Moringa & Shea Butter 100 ml,Warehouse C,106,91,2025-02-18 04:18:00,15
14693,ORD_14694,28213,Respicure Syrup,Warehouse C,110,98,2025-02-18 09:15:00,12
14694,ORD_14695,6129,Maryaj Wild Stripes EDP Aromatic Oriental Perfume And Ajmal Avid Homme Deodorant Aquatic Woody Fragrance 300 ml,Warehouse C,83,78,2025-02-18 01:19:00,5
14695,ORD_14696,33081,Pure Shilajeet Ras,Warehouse A,84,65,2025-02-18 17:43:00,19
14696,ORD_14697,3994,realme narzo 50i Prime (Mint Green 3GB RAM+32GB Storage) Octa-core Processor | 5000 mAh Battery,Warehouse C,92,75,2025-02-18 08:43:00,17
14697,ORD_14698,15705,"Wayona Nylon Braided Lightning To Usb A Data Sync & Fast Charging Cable 3A Charger Lead Compatible For Iphone, Ipad Pro Ta...",Warehouse B,52,41,2025-02-18 02:43:00,11
14698,ORD_14699,32647,Navneet Youva | Primed Canvas Board for Acrylic and Oil Colour Painting | 16x20 inch | for Students and Budding Artists,Warehouse A,62,48,2025-02-18 04:21:00,14
14699,ORD_14700,10185,AmazonBasics Professional 5.1 X 3.5 inches Graphics Drawing Tablet 8192 Levels Digital Drawing Tablet with Pen Multifuncti...,Warehouse A,72,62,2025-02-18 08:51:00,10
14700,ORD_14701,19522,"Anti-Ageing Cream - With Extracts Of Almonds, Wheatgerm & Rose",Warehouse C,26,12,2025-02-18 03:45:00,14
14701,ORD_14702,14744,First Beauty Complete Makeup Mini Brush Kit Eye/Lips/Face Makeup Brush With A Storage Box - Black (Pack of 7),Warehouse A,73,64,2025-02-18 03:51:00,9
14702,ORD_14703,6005,"(Renewed) Redmi Note 9 (Pebble Grey, 4GB RAM 64GB Storage) - 48MP Quad Camera & Full HD+ Display - 3 Months No Cost EMI on...",Warehouse A,34,27,2025-02-18 03:31:00,7
14703,ORD_14704,34565,Lixime 100mg Tablet,Warehouse B,78,60,2025-02-18 11:18:00,18
14704,ORD_14705,26308,Diepin 25 Tablet,Warehouse B,47,37,2025-02-18 06:01:00,10
14705,ORD_14706,22433,Fungiton B Cream,Warehouse C,57,39,2025-02-18 15:55:00,18
14706,ORD_14707,18877,"Fashion Colour Lip Crayon, Waterproof, Long Lasting, 22 Sunset Dunes 2.8 gm",Warehouse B,59,48,2025-02-18 07:36:00,11
14707,ORD_14708,9210,Uticod-MS Oral Suspension,Warehouse C,29,18,2025-02-18 03:20:00,11
14708,ORD_14709,10455,Agaba-N 300mg/500mcg Tablet,Warehouse C,50,37,2025-02-18 00:01:00,13
14709,ORD_14710,16060,Tigus M 500mg/20mg Tablet PR,Warehouse B,106,98,2025-02-18 04:55:00,8
14710,ORD_14711,16070,"IFB 25 L Convection Microwave Oven (25BC3, Black, Oil Free Cooking, With Starter Kit)",Warehouse B,74,59,2025-02-18 23:56:00,15
14711,ORD_14712,12061,"Gizga Essentials Laptop Bag Sleeve Case Cover Pouch with Handle for 15.6 Inch Laptop for Men & Women, Padded Laptop Compar...",Warehouse A,90,77,2025-02-18 17:45:00,13
14712,ORD_14713,3924,Logic H 50mg/12.5mg Tablet,Warehouse A,78,70,2025-02-18 00:20:00,8
14713,ORD_14714,22441,"HAMMER Airflow Truly Wireless Earbuds (TWS), Bluetooth 5.0, 3-4 Hours Playtime, 10M Range, Wireless Headphone with Magneti...",Warehouse B,41,26,2025-02-18 16:19:00,15
14714,ORD_14715,6997,Sefixim-L Tablet,Warehouse A,84,75,2025-02-18 01:14:00,9
14715,ORD_14716,31038,Elitox 50mg Tablet,Warehouse C,31,24,2025-02-18 02:50:00,7
14716,ORD_14717,31009,Spantra Apple Cider Vinegar Conditioner 300 ml,Warehouse A,102,85,2025-02-18 00:49:00,17
14717,ORD_14718,5162,Bio Palmyra Expert Shave Gel,Warehouse B,57,40,2025-02-18 03:01:00,17
14718,ORD_14719,12605,Ajmal Bastion EDP Woody Aromatic Perfume And Mukhallat Al Wafa Concentrated Perfume Oil Oriental Musky 112 ml,Warehouse A,81,63,2025-02-18 05:46:00,18
14719,ORD_14720,33518,"Avimee Herbal Amla Hair Oil | For Strong, Long & Thick Hair | Contains Both Amla Fruit & Seed Oil | 100 ml",Warehouse A,32,17,2025-02-18 04:59:00,15
14720,ORD_14721,21426,Telmican 40 Tablet,Warehouse B,39,28,2025-02-18 13:43:00,11
14721,ORD_14722,12758,SD CASS® Overhead Video Stand Phone Holder Articulating Arm Phone Mount Table Top Scissor Boom Arm Articulating Phone Stan...,Warehouse C,93,83,2025-02-18 13:40:00,10
14722,ORD_14723,5081,"Oppo A78 5G (Glowing Black, 8GB RAM, 128 Storage) | 5000 mAh Battery with 33W SUPERVOOC Charger| 50MP AI Camera | 90Hz Ref...",Warehouse C,118,99,2025-02-18 12:45:00,19
14723,ORD_14724,19646,Biosoft Lavender Pre Wax Gel 500 ml,Warehouse A,100,81,2025-02-18 01:09:00,19
14724,ORD_14725,18919,"ZEBRONICS Zeb-Fun 3 W Karaoke Mic Comes with Bluetooth Supporting Speaker, mSD Card, AUX and Media Control(Blue)",Warehouse A,62,47,2025-02-18 05:41:00,15
14725,ORD_14726,15911,Rifanim 400mg Tablet,Warehouse C,99,88,2025-02-18 05:28:00,11
14726,ORD_14727,31125,Turmeric Herbal Bleach,Warehouse C,68,53,2025-02-18 11:14:00,15
14727,ORD_14728,21392,The Derma Co 5% Vitamin C Oil-Free Daily Face Moisturizer for Skin Radiance - 100g,Warehouse A,71,60,2025-02-18 18:25:00,11
14728,ORD_14729,2334,Tether 80mg/480mg Tablet,Warehouse C,76,65,2025-02-18 19:37:00,11
14729,ORD_14730,3613,"KHR® Silicone Protective Case Cover Compatible for Oppo Enco Buds 2 Full Protection Soft Silicone Case Cover with Hook, Black",Warehouse C,28,10,2025-02-18 15:58:00,18
14730,ORD_14731,18855,"Fashion Colour Non - Transfer Matt Waterproof Lipstick, 65 Terra Copper 2.6 gm",Warehouse A,27,8,2025-02-18 17:10:00,19
14731,ORD_14732,8585,"Fashion Colour Kiss Lip No Transfer Lipstick, 48 Brown Purple 2.6 gm",Warehouse A,22,17,2025-02-18 11:23:00,5
14732,ORD_14733,36432,"Tiny Deal One-Time Hair dye Instant Gray Root Coverage Hair Color Modify Cream Stick Temporary Cover Up Hair Color Dye, 10...",Warehouse B,102,87,2025-02-18 19:29:00,15
14733,ORD_14734,8756,Saregama Carvaan Mini Hindi 2.0- Music Player with Bluetooth/FM/AM/AUX (Moonlight Black),Warehouse C,97,82,2025-02-18 12:26:00,15
14734,ORD_14735,30072,Qzine 25mg Tablet,Warehouse B,16,5,2025-02-18 04:22:00,11
14735,ORD_14736,26556,"Fashion Colour Non - Transfer Matt Waterproof Lipstick, 48 Deep Juice 2.6 gm",Warehouse C,85,67,2025-02-18 13:34:00,18
14736,ORD_14737,36655,Bio Dandelion Serum 190 Ml,Warehouse C,86,79,2025-02-18 20:17:00,7
14737,ORD_14738,9706,Bath & Body Works Black Chamomile Luxe Bath 445 ml,Warehouse B,68,58,2025-02-18 16:28:00,10
14738,ORD_14739,938,Kufmon X Syrup,Warehouse B,86,78,2025-02-18 04:14:00,8
14739,ORD_14740,33088,Dry Fruit Single Time Use Facial Kit,Warehouse A,44,38,2025-02-18 03:09:00,6
14740,ORD_14741,7003,"FOLX FMC76 22MM Watch Band Strap with Rust Free Button Compatible with ColorFit Ultra/Ultra 2, Amazfit GTR (47mm)/ GTR 2E,...",Warehouse A,90,75,2025-02-18 13:52:00,15
14741,ORD_14742,14137,"Makeup Revolution I Heart Revolution Highlighter Wardrobe, 18.96g",Warehouse A,28,13,2025-02-18 09:24:00,15
14742,ORD_14743,14855,"SupCares Edge to Edge Tempered Glass for Redmi 10 Power, Redmi 10 and Redmi 10C (6.7 inch) with Easy Self Installation Kit...",Warehouse C,65,46,2025-02-18 12:28:00,19
14743,ORD_14744,1595,Voglisug 0.2mg Tablet MD,Warehouse A,43,30,2025-02-18 16:23:00,13
14744,ORD_14745,32418,Fast Charger for Mi Xiaomi Redmi Mi 9/9A/9i/4/4A/5/5A/6A/6 Pro/7/7A/Y1 /Y1 Lite/Y2/Y3/Xiaomi Mi Poco C3 | Mobile | Wall | ...,Warehouse B,37,29,2025-02-18 14:24:00,8
14745,ORD_14746,14200,Myodol SP Tablet,Warehouse C,14,4,2025-02-18 04:09:00,10
14746,ORD_14747,15902,Teldiac-H Tablet,Warehouse A,86,70,2025-02-18 14:29:00,16
14747,ORD_14748,22461,Glourea 500mg Capsule,Warehouse A,34,17,2025-02-18 09:40:00,17
14748,ORD_14749,26084,Ajmal Aurum & Wisal & Silver Shade & Evoke silver Edition Homme Deo & Aretha EDP Pack of 5 820 ml,Warehouse B,84,68,2025-02-18 03:22:00,16
14749,ORD_14750,14422,"Dermalogica Daily Microfoliant Exfoliant, Gentle Daily-Use Face Scrub For Glowing Skin, With Salicylic Acid, Papaya Enzym...",Warehouse A,57,42,2025-02-18 00:08:00,15
14750,ORD_14751,9921,HP8100/46 Hair Dryer - Purple,Warehouse B,62,48,2025-02-18 17:35:00,14
14751,ORD_14752,14444,Parker Frontier Matte Black CT Roller Ball Pen,Warehouse B,45,39,2025-02-18 14:07:00,6
14752,ORD_14753,33156,Metsmall 500 Tablet SR,Warehouse A,35,26,2025-02-18 21:55:00,9
14753,ORD_14754,8172,Anomed L Cream,Warehouse B,88,71,2025-02-18 21:57:00,17
14754,ORD_14755,28190,ZO Plus 200 mg/200 mg Tablet,Warehouse C,54,36,2025-02-18 07:04:00,18
14755,ORD_14756,32584,Defzacort 6mg Tablet,Warehouse A,25,18,2025-02-18 15:53:00,7
14756,ORD_14757,28193,HP 100 Lightweight Backpack for 15.6-inch Laptop with Elastic and Padded Shoulder Straps (Black),Warehouse A,70,53,2025-02-18 13:57:00,17
14757,ORD_14758,34392,Avopan-D 10mg/40mg Tablet,Warehouse B,66,60,2025-02-18 15:33:00,6
14758,ORD_14759,28228,"QUANTUM OTG Card Reader and Hub with Type-C, USB & Micro USB Ports | Portable Memory Card Reader Supports USB Drives, TF, ...",Warehouse B,65,53,2025-02-18 04:19:00,12
14759,ORD_14760,12479,Symtel 40mg Tablet,Warehouse B,36,22,2025-02-18 00:10:00,14
14760,ORD_14761,4945,BISMAADH 35 in 1 Gayatri Mantra Chanting Box Mini Plug Device (White),Warehouse B,84,70,2025-02-18 01:52:00,14
14761,ORD_14762,14734,Pro 6 Advance Razor Value Kit For Men,Warehouse B,33,20,2025-02-18 03:15:00,13
14762,ORD_14763,5883,Backstroke Massager - Colour May Vary,Warehouse A,51,40,2025-02-18 20:01:00,11
14763,ORD_14764,24599,Amazon Basics Portable Multimedia Speaker| Suitable for Laptop & Desktop (Black) | USB 2.0 | Deep Bass,Warehouse A,61,49,2025-02-18 18:52:00,12
14764,ORD_14765,30698,Azivest 500mg Tablet,Warehouse B,93,74,2025-02-18 09:39:00,19
14765,ORD_14766,21405,Cezipod 50 Dry Syrup,Warehouse A,83,69,2025-02-18 23:14:00,14
14766,ORD_14767,19309,Paco Rabanne Lady Million Eau de Parfum 80ml with Body Lotion 100ml,Warehouse B,56,48,2025-02-18 19:59:00,8
14767,ORD_14768,27972,mCaffeine Naked & Raw Coffee Scalp Scrub for Dandruff Control & Scalp Exfoliation 250 gm,Warehouse A,59,44,2025-02-18 10:19:00,15
14768,ORD_14769,12048,Ajmal Aurum & Wisal & Silver Shade & Evoke silver Edition Homme Deo & Yearn EDP Pack of 5 820 ml,Warehouse C,57,50,2025-02-18 08:19:00,7
14769,ORD_14770,21723,Ice Cool Gas Free Deodorant - Daylong Odour Control,Warehouse A,44,31,2025-02-18 19:17:00,13
14770,ORD_14771,24937,"Miss Claire Soft Matte Lip Cream, 20 Pink, 6 g",Warehouse B,50,33,2025-02-18 06:01:00,17
14771,ORD_14772,5866,Fujifilm Instax Square Wall Pocket 3 (Black),Warehouse A,71,61,2025-02-18 15:50:00,10
14772,ORD_14773,21402,20pcs One Piece Anime Merch Sticker Pack from animo India Perfect for Laptop Computer Car Water Bottle Travel Case Guitar ...,Warehouse B,46,41,2025-02-18 00:38:00,5
14773,ORD_14774,24765,"Boltove® 8FTX9FT Green Screen Backdrop Background Rod Pocket for Photography Backdrop,Photoshoot Background,Video producti...",Warehouse A,55,50,2025-02-18 20:17:00,5
14774,ORD_14775,33061,Spigen Liquid Air Back Cover Case for Samsung Galaxy S23 (TPU | Abyss Green),Warehouse A,20,10,2025-02-18 14:59:00,10
14775,ORD_14776,2277,Facial Oil - for Cleansing,Warehouse A,36,20,2025-02-18 13:39:00,16
14776,ORD_14777,716,HARISSONS Bags Delta 39 L Polyester Black 15.6 inch Laptop Backpack with Built-in Rain Cover & Anti-Sweat Air Mesh | Offic...,Warehouse A,78,65,2025-02-18 22:58:00,13
14777,ORD_14778,2389,Papilon SP Tablet,Warehouse A,23,13,2025-02-18 11:19:00,10
14778,ORD_14779,35942,"Seagate Expansion 2TB External HDD - USB 3.0 for Windows and Mac with 3 yr Data Recovery Services, Portable Hard Drive (ST...",Warehouse C,90,81,2025-02-18 12:10:00,9
14779,ORD_14780,15285,"Fashion Colour Non - Transfer Matt Waterproof Lipstick, 62 Spicy Ruby 2.6 gm",Warehouse A,74,59,2025-02-18 10:51:00,15
14780,ORD_14781,6407,Glyciray M 1mg/500mg Tablet,Warehouse A,70,53,2025-02-18 06:55:00,17
14781,ORD_14782,32057,"7 in 1 Electronic Cleaner kit, Cleaning Kit for Monitor Keyboard Airpods MacBook iPad iPhone iPod, Screen Dust Brush Inclu...",Warehouse C,67,52,2025-02-18 11:03:00,15
14782,ORD_14783,17271,Aegte Growlong Rice Shampoo 250 ml,Warehouse A,45,40,2025-02-18 03:37:00,5
14783,ORD_14784,27007,Canogen 20mg Tablet,Warehouse C,58,45,2025-02-18 00:19:00,13
14784,ORD_14785,12309,C2Win 2mg Tablet,Warehouse C,96,91,2025-02-18 04:41:00,5
14785,ORD_14786,4413,"Duracell Rechargeable AAA 900mAh Batteries, 4 Pcs",Warehouse C,29,10,2025-02-18 00:50:00,19
14786,ORD_14787,23458,Uniball Air UB188M Roller Ball Pen Set - Pack of 6 (Blue),Warehouse A,8,2,2025-02-18 04:19:00,6
14787,ORD_14788,2482,Faces Canada Hi Shine Nail Enamel Citrus Lemon 227 9 Ml,Warehouse B,27,13,2025-02-18 20:26:00,14
14788,ORD_14789,743,Uncle Tony Face Scrub 200 ml,Warehouse C,75,61,2025-02-18 20:41:00,14
14789,ORD_14790,23318,Flormar Compact Powder 089 Medium Cream 11 gm,Warehouse A,109,98,2025-02-18 11:07:00,11
14790,ORD_14791,1178,"(Renewed) Infinity (JBL) Glide 120, In Ear Wireless Earphones with Mic, Deep Bass, Dual Equalizer, 12mm Drivers, Premium M...",Warehouse B,95,81,2025-02-18 13:06:00,14
14791,ORD_14792,25665,Cefil 200mg Tablet,Warehouse A,71,58,2025-02-18 22:53:00,13
14792,ORD_14793,35830,"Dell Power Cable & Laptop Adapter Charger for 65W 19.5V 3.34A Inspiron 15 3452, 3520, 3521, 3540, 3541, 3543 - Black",Warehouse A,48,34,2025-02-18 11:48:00,14
14793,ORD_14794,32260,Glimiprime M1 Forte Tablet,Warehouse B,93,81,2025-02-18 03:52:00,12
14794,ORD_14795,21162,Bonjour Paris Just Matte Lip Crayon - Bubble Gum Pink 3.2 gm,Warehouse C,49,39,2025-02-18 06:49:00,10
14795,ORD_14796,28982,Tibizim SF Tablet,Warehouse C,78,70,2025-02-18 22:22:00,8
14796,ORD_14797,5342,Bonjour Paris Photo Match Mousse Foundation - Nude Ochre 30 ml,Warehouse C,29,10,2025-02-18 14:57:00,19
14797,ORD_14798,10933,Ramihart-H 2.5 Tablet,Warehouse A,55,43,2025-02-18 16:11:00,12
14798,ORD_14799,3333,POPIO Screen Guard for Samsung Galaxy S22 Ultra 5G / Samsung Galaxy S23 Ultra 5G (Transparent) Edge to Edge Full Screen Co...,Warehouse C,84,71,2025-02-18 10:24:00,13
14799,ORD_14800,13789,LAKMÉ Lipstick Dusty Pink (Matte),Warehouse C,42,35,2025-02-18 10:53:00,7
14800,ORD_14801,9573,HOUSE HATCH 8 Slots ACRYLIC Compact Holder Powder Eye Shadow Blush Highlighters Makeup Organizer,Warehouse B,86,76,2025-02-18 22:07:00,10
14801,ORD_14802,17612,Hair Styling Gel - Rugged Hold,Warehouse A,96,78,2025-02-18 10:01:00,18
14802,ORD_14803,27527,Tujoy 100mg Dry Syrup,Warehouse B,41,26,2025-02-18 09:01:00,15
14803,ORD_14804,19927,Mun L 5mg/10mg Tablet,Warehouse C,66,61,2025-02-18 13:30:00,5
14804,ORD_14805,34806,"Deborah Milano 24 Oreperfectfoundation, 3",Warehouse A,93,81,2025-02-18 08:59:00,12
14805,ORD_14806,25524,Dynotrek Root 11.6-12.9 Inch Laptop Sleeve/Case/Cover with Handle for Men Women Compatible Chromebook/Tablet/iPad Waterpro...,Warehouse C,84,66,2025-02-18 08:29:00,18
14806,ORD_14807,11626,Shiseido Syncro Skin Self- Refershing Concealer,Warehouse C,100,92,2025-02-18 08:08:00,8
14807,ORD_14808,32193,Medimade Shea Butter And Mango Butter Moisturising Body Lotion 300 ml,Warehouse B,45,38,2025-02-18 00:31:00,7
14808,ORD_14809,23471,Armaf Vanity Femme Essence Perfume Body Spray For Woman 200Ml,Warehouse B,95,88,2025-02-18 05:45:00,7
14809,ORD_14810,21074,Bio Fruit Flawless Whitening & Depigmentation Face Pack,Warehouse B,47,33,2025-02-18 08:59:00,14
14810,ORD_14811,25504,Venmol 650mg Tablet DT,Warehouse C,36,27,2025-02-18 13:44:00,9
14811,ORD_14812,3834,"Portronics Power Brick II 10000 mAh Power Bank with LED Indicators, Fast Charging for Mobile & Other Devices(White)",Warehouse C,89,74,2025-02-18 12:24:00,15
14812,ORD_14813,33972,Sigdoth 75mg Tablet,Warehouse B,33,25,2025-02-18 12:23:00,8
14813,ORD_14814,6414,Grisactin Forte 250mg Tablet,Warehouse B,37,24,2025-02-18 23:20:00,13
14814,ORD_14815,11176,Laxitol Syrup,Warehouse B,41,35,2025-02-18 19:04:00,6
14815,ORD_14816,23425,Epitic 50mg Tablet,Warehouse B,27,10,2025-02-18 09:45:00,17
14816,ORD_14817,27472,Skin Fruits Blemish Clarifying Tomato Face Wash - Normal to Dry Skin,Warehouse A,111,99,2025-02-18 09:47:00,12
14817,ORD_14818,11661,Natural Hydrating & Non-Drying Body Wash,Warehouse B,36,26,2025-02-18 20:03:00,10
14818,ORD_14819,25570,Vega General Cutting Scissor (LCS - 01) 101 gm,Warehouse C,100,83,2025-02-18 01:17:00,17
14819,ORD_14820,1174,Allure Eyeshadow Brush (c-13) 1's,Warehouse B,83,67,2025-02-18 08:38:00,16
14820,ORD_14821,21076,"Spigen TPU Rugged Armor Cover Case for Apple Watch 8 (41mm), SE2 / 7/6 / SE / 5/4 (40mm) - Black (Watch not Included)",Warehouse A,48,29,2025-02-18 18:13:00,19
14821,ORD_14822,11197,Clavicure Dry Syrup,Warehouse B,36,20,2025-02-18 02:29:00,16
14822,ORD_14823,33328,Bella Voste Eyeshadow Edgy Green 04 2.6 gm,Warehouse B,103,85,2025-02-18 23:16:00,18
14823,ORD_14824,25497,Agaro Blaze USBA to TypeC Nylon Braided 1.2M Cable,Warehouse C,58,52,2025-02-18 20:24:00,6
14824,ORD_14825,11628,Pira  400mg Tablet,Warehouse A,95,77,2025-02-18 06:11:00,18
14825,ORD_14826,12183,XX2 Cologne Spray,Warehouse A,17,9,2025-02-18 08:50:00,8
14826,ORD_14827,31383,"Samsung Galaxy M13 5G (Midnight Blue, 6GB, 128GB Storage) | 5000mAh Battery | Upto 12GB RAM with RAM Plus",Warehouse C,97,92,2025-02-18 14:02:00,5
14827,ORD_14828,20050,Amlant Ayurvedic Medicine For Acidity,Warehouse B,83,78,2025-02-18 15:07:00,5
14828,ORD_14829,20052,Just Herbs Ayurvedic Bb Cream Skin Tint Foundation For Light Coverage - 10_Cocoa 40 Ml,Warehouse B,72,61,2025-02-18 07:28:00,11
14829,ORD_14830,34787,Odiglim 1mg Tablet,Warehouse C,82,76,2025-02-18 19:25:00,6
14830,ORD_14831,14299,L.A Girl Pro Conceal - Suede 8 gm,Warehouse C,51,44,2025-02-18 09:16:00,7
14831,ORD_14832,11202,rts [2 Pack] USB Type C to USB Male Adapter Mini Hi-speed USB Female (Type-C) to USB 2.0 Male Fast Charging & Data Sync OT...,Warehouse B,88,79,2025-02-18 00:10:00,9
14832,ORD_14833,4401,Blaupunkt Newly Launched SBA15 Gaming 15W Bluetooth Soundbar with 2000 mAh Battery I Gaming RGB Lights I TurboVolt Chargin...,Warehouse B,111,99,2025-02-18 19:41:00,12
14833,ORD_14834,12295,Liofen XL 10 Capsule,Warehouse A,103,88,2025-02-18 19:50:00,15
14834,ORD_14835,3838,Lavender Water -100% Natural & Pure Skin Toner,Warehouse C,40,35,2025-02-18 12:37:00,5
14835,ORD_14836,31799,Nismol-S Tablet,Warehouse B,67,62,2025-02-18 03:51:00,5
14836,ORD_14837,29686,"Boult Audio Bassbuds Loop 2 Wired in Ear Earphones with Mic, 10mm Powerful Driver for Extra Bass with Customizable Ear Loo...",Warehouse C,70,60,2025-02-18 12:27:00,10
14837,ORD_14838,13748,Aine® Samsung 25W Super Fast Charger with C To C Cable Compatible for Samsung Galaxy S10 5G|S20| S20 5G|S20 5G UW|S20 FE|S...,Warehouse A,64,45,2025-02-18 16:17:00,19
14838,ORD_14839,35878,superdrug teatree moisturising face cream 50ml,Warehouse A,36,25,2025-02-18 20:11:00,11
14839,ORD_14840,16407,Vega Tail Comb (AC - 06) 37 gm,Warehouse C,79,67,2025-02-18 23:53:00,12
14840,ORD_14841,29080,Daily Life Forever52 Duo Fiber Brush Nx007 1's,Warehouse A,54,41,2025-02-18 17:36:00,13
14841,ORD_14842,747,Albins 400mg Tablet,Warehouse B,82,72,2025-02-18 07:12:00,10
14842,ORD_14843,3326,Conazol 150mg Capsule,Warehouse B,58,53,2025-02-18 16:18:00,5
14843,ORD_14844,34015,Ceftiway 1000 Injection,Warehouse A,76,63,2025-02-18 18:51:00,13
14844,ORD_14845,24164,Janma Ghunti - Indigestion in children,Warehouse B,102,97,2025-02-18 15:03:00,5
14845,ORD_14846,19987,Avtram 50mg Injection,Warehouse A,90,79,2025-02-18 21:44:00,11
14846,ORD_14847,32041,Budate Transpules,Warehouse B,21,9,2025-02-18 03:30:00,12
14847,ORD_14848,2771,Acer Nitro Vg270 S 27 Inch (68.58 Cm) LCD 1920 x 1080 Pixels Monitor with LED Backlight Full Hd IPS Gaming I 0.5 Ms Respon...,Warehouse A,39,34,2025-02-18 11:35:00,5
14848,ORD_14849,29066,Hemp Seed Oil Body Wash With Neem,Warehouse C,64,52,2025-02-18 13:49:00,12
14849,ORD_14850,12837,TheGiftKart Back Cover Case for Samsung Galaxy M31s (Shockproof | Crystal Clear | Hybrid TPU & PC | Transparent Back | Bla...,Warehouse C,85,77,2025-02-18 04:21:00,8
14850,ORD_14851,514,Clinmide Gel,Warehouse B,74,55,2025-02-18 07:10:00,19
14851,ORD_14852,31532,Silpan 40mg Tablet,Warehouse A,63,50,2025-02-18 17:18:00,13
14852,ORD_14853,31806,Ads Color Series 15 Eyeshadow 2 Blusher 3 Powder Cake 4 Lipcolour A3900-2,Warehouse C,90,74,2025-02-18 13:09:00,16
14853,ORD_14854,2487,"iPhone Original 20W PD QC Charger Compatible with iPhone 14,14 Pro 13,13 Pro Max,12,11,X Series|Pd Superfast Charger Adapt...",Warehouse B,91,80,2025-02-18 19:27:00,11
14854,ORD_14855,19969,"Tuarso 43W Car Charger Fast Charging , Car Mobile Charger With Dual-Port Fast Charging At The Same Time ( PD 25W & QC3.0 1...",Warehouse A,79,65,2025-02-18 22:46:00,14
14855,ORD_14856,11021,TheGiftKart ShockProof Crystal Clear Back Cover Case for Poco X5 5G / Mi Redmi Note 12 5G | 360 Degree Protection | Protec...,Warehouse A,104,92,2025-02-18 02:50:00,12
14856,ORD_14857,32251,"Oppo F21s Pro (Dawnlight Gold, 8GB RAM, 128 Storage) with No Cost EMI/Additional Exchange Offers",Warehouse A,63,49,2025-02-18 08:34:00,14
14857,ORD_14858,11669,"RPM Euro Games Finger Sleeves Pack of 3 Boxes/ 6 Pieces for Mobile Gaming with Super Conductive Fiber Fabric, Anti-Sweat a...",Warehouse B,29,12,2025-02-18 04:58:00,17
14858,ORD_14859,17526,"mobistyle Compatible with iPhone 11 Cover, Luxury Electroplating Case, Individual Protection for Each Lens, Back Cover for...",Warehouse A,115,96,2025-02-18 18:44:00,19
14859,ORD_14860,10988,Scotil 750mg Injection,Warehouse B,54,49,2025-02-18 06:58:00,5
14860,ORD_14861,17535,Citograph 10mg Tablet,Warehouse C,90,84,2025-02-18 22:07:00,6
14861,ORD_14862,3580,"Redmi Note 9 (Pebble Grey, 4GB RAM 64GB Storage) - 48MP Quad Camera & Full HD+ Display",Warehouse B,35,27,2025-02-18 16:06:00,8
14862,ORD_14863,32714,Nimdad Forte MR Tablet,Warehouse A,47,30,2025-02-18 05:50:00,17
14863,ORD_14864,20625,Evident Dental Gel,Warehouse B,50,45,2025-02-18 22:02:00,5
14864,ORD_14865,6346,Rebez 20mg Tablet,Warehouse B,67,52,2025-02-18 18:38:00,15
14865,ORD_14866,13137,Alenzer-T Tablet,Warehouse C,30,12,2025-02-18 13:15:00,18
14866,ORD_14867,6345,Volimed 03 Tablet,Warehouse B,87,73,2025-02-18 21:35:00,14
14867,ORD_14868,35839,Petals - Dharwad Foldable Cloth Pads,Warehouse C,9,3,2025-02-18 03:01:00,6
14868,ORD_14869,16374,Neutram 100mg Tablet SR,Warehouse C,26,12,2025-02-18 10:36:00,14
14869,ORD_14870,20829,Sleacof Tablet,Warehouse B,27,16,2025-02-18 22:37:00,11
14870,ORD_14871,23284,Alifiya Polyester Gadget Charger Pouch / Travel Organizer Pouch for Cables / Hard Disk / Charger (Grey - Pack of 2),Warehouse C,34,18,2025-02-18 22:20:00,16
14871,ORD_14872,12352,Prolet Designed for AirPods Pro Case Cute 3D Bulldog Fashion Character Silicone Case Cover for Airpods Pro Protective Skin...,Warehouse A,30,20,2025-02-18 12:33:00,10
14872,ORD_14873,1243,Metcy 50 Tablet SR,Warehouse B,100,83,2025-02-18 07:40:00,17
14873,ORD_14874,23137,Ajmal Asher Concentrated Perfume Oil Oriental And Shadow Homme Deodorant Citrus Woody Fragrance 212 ml,Warehouse B,84,76,2025-02-18 17:26:00,8
14874,ORD_14875,2732,"ZEBRONICS Zeb-Thunder Bluetooth Wireless Over The Ear Headphone FM, mSD, 9 hrs Playback with Mic (Blue with Red)",Warehouse B,32,24,2025-02-18 22:39:00,8
14875,ORD_14876,14583,Kit Kat Suspension,Warehouse B,40,31,2025-02-18 22:43:00,9
14876,ORD_14877,11699,Kestil 20mg Tablet,Warehouse A,33,24,2025-02-18 10:17:00,9
14877,ORD_14878,19913,Mahatax 200mg Tablet,Warehouse B,81,62,2025-02-18 17:04:00,19
14878,ORD_14879,1757,"Redmi 11 Prime 5G (Thunder Black, 6GB RAM, 128GB Storage) | Prime Design | MTK Dimensity 700 | 50 MP Dual Cam | 5000mAh | ...",Warehouse C,9,3,2025-02-18 11:53:00,6
14879,ORD_14880,33726,CROSSVOLT Compatible for supervooc Dash Warp / 6Amp / 65W / 30W / 20W / Type C Charger Cable | Fast Data Sync Charging Cab...,Warehouse C,41,28,2025-02-18 04:48:00,13
14880,ORD_14881,4550,Tercan Cream,Warehouse B,105,90,2025-02-18 10:00:00,15
14881,ORD_14882,36243,Gesicare SP 100mg/325mg/15mg Tablet,Warehouse C,95,82,2025-02-18 10:15:00,13
14882,ORD_14883,17630,"realme narzo 50 5G (Hyper Blue, 4GB RAM+64GB Storage) Dimensity 810 5G Processor | 48MP Ultra HD Camera",Warehouse B,36,18,2025-02-18 08:21:00,18
14883,ORD_14884,27276,EKRON Push Pull Metal Sign Stickers Self Adhesive Stainless Steel Push & Pull Signage Board for Glass Wooden Doors/Office ...,Warehouse C,60,43,2025-02-18 15:34:00,17
14884,ORD_14885,31404,Cnzep 0.5mg Tablet,Warehouse C,38,26,2025-02-18 05:14:00,12
14885,ORD_14886,30943,L.A Girl HD PRO Conceal Light Ivory 8 gm,Warehouse A,46,31,2025-02-18 08:01:00,15
14886,ORD_14887,32255,Uroconkit 200 mg/200 mg Tablet,Warehouse A,107,92,2025-02-18 02:06:00,15
14887,ORD_14888,15523,"Scotch 3M BOPP Packaging Brown Tape (Tan) | 48mm x 50 Meter | Pack of 2 | for Packaging, Decorating and DIY",Warehouse C,101,86,2025-02-18 14:14:00,15
14888,ORD_14889,7148,Tizum High Speed HDMI Cable with Ethernet | Supports 3D 4K | for All HDMI Devices Laptop Computer Gaming Console TV Set To...,Warehouse A,65,51,2025-02-18 10:39:00,14
14889,ORD_14890,23282,Montilife 5mg/10mg Tablet,Warehouse A,36,28,2025-02-18 06:56:00,8
14890,ORD_14891,28945,HOUSE OF QUIRK Black Board Vinyl Wall Sticker Removable Decal Chalkboard (45 X 200 Cm),Warehouse B,80,68,2025-02-18 04:59:00,12
14891,ORD_14892,29056,Isibrex Plus 1% Eye Drop,Warehouse B,91,82,2025-02-18 10:18:00,9
14892,ORD_14893,15221,Nutrazol LS 75mg/20mg Capsule SR,Warehouse B,24,17,2025-02-18 17:25:00,7
14893,ORD_14894,20356,Zayn & Myza Cherry Lip Balm 4.5 gm,Warehouse B,24,7,2025-02-18 13:59:00,17
14894,ORD_14895,29684,Dcec MR 100mg/325mg/250mg Tablet,Warehouse C,41,36,2025-02-18 20:22:00,5
14895,ORD_14896,1343,Ajmal 2 Aurum & 2 Wisal Dhahab Deo & Prose EDP Pack of 5 20 ml,Warehouse A,31,20,2025-02-18 12:54:00,11
14896,ORD_14897,4546,"Tribit [Upgraded Version] XSound Go Wireless Bluetooth 5.0 Speakers with Loud Stereo Sound & Rich Bass 16W,24H Playtime,10...",Warehouse B,80,67,2025-02-18 13:18:00,13
14897,ORD_14898,34074,Miss Claire Lip Balm Conditioner - Strawberry 3.5 Gm,Warehouse A,80,70,2025-02-18 01:29:00,10
14898,ORD_14899,25683,Elcapon 50 mg/12.5 mg/200 mg Tablet,Warehouse A,34,28,2025-02-18 21:42:00,6
14899,ORD_14900,23152,bArrett Fast USB Charger 2.4Amp for Samsung Galaxy J1/J2/J3/J4/J5/J6/J7/A3/A4/A5/A6+/A7/A8/A9/On 5/On 6/On 7/ On 8 Prime P...,Warehouse A,109,94,2025-02-18 10:16:00,15
14900,ORD_14901,23151,"Artis AR0506 65Watt Laptop Charger/Adapter with Power Cord Compatible with Lenovo Laptops (20V/3.25A, 65Watt) (USB Pin) (B...",Warehouse B,20,11,2025-02-18 17:25:00,9
14901,ORD_14902,16335,Ximrite O 200mg/200mg Tablet,Warehouse C,71,56,2025-02-18 02:12:00,15
14902,ORD_14903,16433,Remove Wax Strips 24 Pcs Body Strips - Sensitive (20 Body Strips & 2 Pain-Less + 4 Post Depilation Cleaning Wipes) 1's,Warehouse B,86,75,2025-02-18 09:03:00,11
14903,ORD_14904,29680,Itragen 200 Capsule,Warehouse A,89,80,2025-02-18 20:51:00,9
14904,ORD_14905,17391,Cough LS Junior Syrup,Warehouse A,85,72,2025-02-18 10:27:00,13
14905,ORD_14906,8663,"NEXDIGITRON A3 Car Dash Camera, Only Made in India Super-Capacitor Dashcam, Full HD 1080p, H.265, F2.0 6G Lens, 140° Wide ...",Warehouse C,56,40,2025-02-18 10:33:00,16
14906,ORD_14907,9737,Whisky Red Eau De Toilette,Warehouse A,28,9,2025-02-18 15:12:00,19
14907,ORD_14908,10223,Vomifresh O 2mg Syrup,Warehouse A,56,48,2025-02-18 01:13:00,8
14908,ORD_14909,22325,"Arctic Hunter Laptop Backpack, Premium Business Backpack Office Travel Laptop Bag with 15.6-inch Laptop Pocket Water/Scrat...",Warehouse C,73,56,2025-02-18 14:53:00,17
14909,ORD_14910,27152,Aritha Hair Care Powder - Pure Herb,Warehouse A,99,81,2025-02-18 17:16:00,18
14910,ORD_14911,32536,Sazolol 50mg Tablet XL,Warehouse C,111,95,2025-02-18 13:03:00,16
14911,ORD_14912,24640,Molox Lbs Tablet,Warehouse A,34,29,2025-02-18 08:35:00,5
14912,ORD_14913,19142,"Mi Step Out 12 L Mini Backpack (Small Size, Dark Blue, Water Repellant)",Warehouse C,87,69,2025-02-18 06:01:00,18
14913,ORD_14914,119,Telpha CH 40mg/12.5mg Tablet,Warehouse C,45,31,2025-02-18 19:53:00,14
14914,ORD_14915,18584,"Samsung Galaxy M32 Prime Edition (Black, 4GB RAM, 64GB)",Warehouse B,46,30,2025-02-18 11:37:00,16
14915,ORD_14916,8330,Turgoderm Cream,Warehouse A,89,82,2025-02-18 22:09:00,7
14916,ORD_14917,21843,Cadoxy 100mg Capsule,Warehouse B,78,68,2025-02-18 06:03:00,10
14917,ORD_14918,26165,Shampoo - Aloe Tearless,Warehouse B,33,15,2025-02-18 07:34:00,18
14918,ORD_14919,34317,S.A.V.I 3D Temporary Tattoo Waterproof Sticker Beautiful Black Big Flower Text Moon Popular New Designs Size - 21x15cm (79...,Warehouse B,44,26,2025-02-18 13:08:00,18
14919,ORD_14920,12582,Panmol 40mg Tablet,Warehouse B,50,31,2025-02-18 19:05:00,19
14920,ORD_14921,26243,Woman - Original Body Mist,Warehouse B,86,67,2025-02-18 10:36:00,19
14921,ORD_14922,35457,"Papergrid Notebook - A4 (29.7 cm x 21 cm), Single Line, 216 Pages, Soft Cover - Pack of 6",Warehouse B,99,92,2025-02-18 08:04:00,7
14922,ORD_14923,5831,"TheGiftKart Back Cover for Samsung Galaxy M21 2021 Edition / M21 / M30s (TPU, PC | Transparent | Black Bumper)",Warehouse B,67,54,2025-02-18 17:09:00,13
14923,ORD_14924,11880,Meroxime 500mg Tablet,Warehouse B,58,45,2025-02-18 13:03:00,13
14924,ORD_14925,21510,mCaffeine Naked & Raw Coffee Body Polishing Oil 100 ml,Warehouse C,77,61,2025-02-18 14:01:00,16
14925,ORD_14926,3678,NutriGlow Diamond Radiance Face Wash With Diamond Dust & Vitamin E For Glowing Skin Skin Purifying Hydrated Skin (65ml),Warehouse A,70,53,2025-02-18 01:23:00,17
14926,ORD_14927,26434,"Daily Life Forever52 Long Wear Gel Eyeliner & Tattoo, Waterproof Smudgeproof Long Lasting Cream Eyeliner Gel with 2PCS Bru...",Warehouse B,107,96,2025-02-18 04:27:00,11
14927,ORD_14928,12535,Handwash - Fresh,Warehouse B,42,29,2025-02-18 09:33:00,13
14928,ORD_14929,29922,"SPYKART 360°Rotatable and Retractable Car Phone Holder, Multifunctional Adjustable Mount, Universal Rearview Mirror Phone ...",Warehouse B,86,77,2025-02-18 20:39:00,9
14929,ORD_14930,15999,Magnexim LB 200mg Tablet,Warehouse C,29,21,2025-02-18 22:33:00,8
14930,ORD_14931,24872,Vega Classic Wooden Comb (HMWC - 02) 35 gm,Warehouse C,30,19,2025-02-18 12:20:00,11
14931,ORD_14932,27128,Revolution Pro Supreme Matte Lip Pigment-Psychedelic 2.5 ml,Warehouse A,80,68,2025-02-18 13:32:00,12
14932,ORD_14933,14397,Mapdox CV Dry Syrup,Warehouse A,35,26,2025-02-18 16:59:00,9
14933,ORD_14934,28055,Sadbindu Oil - Ayurvedic Nasal Drop,Warehouse C,99,80,2025-02-18 04:51:00,19
14934,ORD_14935,31927,Pikkme iPhone 12 Pro Max Back Cover | Flexible Pu Leather | Full Camera Protection | Raised Edges | Super Soft-Touch | Bum...,Warehouse A,36,20,2025-02-18 02:36:00,16
14935,ORD_14936,10198,Stunning Black Shine Shampoo,Warehouse A,42,30,2025-02-18 19:40:00,12
14936,ORD_14937,19194,Compatible for HAIER AC Remote,Warehouse B,29,20,2025-02-18 12:08:00,9
14937,ORD_14938,21457,Body Deodorant - Night Rider,Warehouse C,98,88,2025-02-18 23:25:00,10
14938,ORD_14939,27863,Toflox 200mg Syrup,Warehouse A,21,7,2025-02-18 02:13:00,14
14939,ORD_14940,19623,Daily Life Forever52 Glitz Waterproof Eyeliner Eyeshadow Glt007 0.6 gm,Warehouse A,71,64,2025-02-18 03:34:00,7
14940,ORD_14941,4830,Ricosprin 2.5 Tablet,Warehouse A,65,46,2025-02-18 11:08:00,19
14941,ORD_14942,387,L'Oreal Paris Color Protect Shampoo 82.5 Ml,Warehouse A,92,80,2025-02-18 05:19:00,12
14942,ORD_14943,20699,GLAMLER Professional Makeup Combo Waterproof Long Lasting Dark Blue And Green Glitter Eyeliner (Set Of 2).,Warehouse A,37,18,2025-02-18 08:08:00,19
14943,ORD_14944,18961,Busulmax 2mg Tablet,Warehouse B,96,79,2025-02-18 01:22:00,17
14944,ORD_14945,35527,Flormar Compact Powder 091 Medium Cream Rose 11 gm,Warehouse C,36,29,2025-02-18 05:36:00,7
14945,ORD_14946,9810,"Tecno Spark 9 (Sky Mirror, 6GB RAM,128GB Storage) | 11GB Expandable RAM | Helio G37 Gaming Processor",Warehouse B,79,60,2025-02-18 08:50:00,19
14946,ORD_14947,5038,Vega Graduated Dressing Comb (HMC - 09D) 29 gm,Warehouse B,32,16,2025-02-18 06:32:00,16
14947,ORD_14948,21630,Wella Professionals Wella Professionals Invigo Nutri Enrich Deep Nourishing Regime For Dry and Damaged Hair - Shampoo 250m...,Warehouse A,85,73,2025-02-18 17:04:00,12
14948,ORD_14949,33102,Dermexa Emollient Cream,Warehouse C,63,52,2025-02-18 06:14:00,11
14949,ORD_14950,28036,Rich Cocoa Butter Body Cream,Warehouse B,59,45,2025-02-18 16:29:00,14
14950,ORD_14951,8218,Onbit 4mg Tablet,Warehouse C,64,53,2025-02-18 21:46:00,11
14951,ORD_14952,1385,"Perfume Body Spray - Good Morning, Intense",Warehouse A,53,43,2025-02-18 05:53:00,10
14952,ORD_14953,6992,LOHAYA Remote Control Compatible for Amazon Fire Tv Stick Remote Control [ 2nd Gen ] with Voice (Pairing Manual Will be Ba...,Warehouse A,38,21,2025-02-18 03:12:00,17
14953,ORD_14954,6090,Cisacone 125mg/10mg Tablet,Warehouse A,15,1,2025-02-18 23:05:00,14
14954,ORD_14955,8336,AEIDESS Screen Guard Compatible for Ola S1 / S1 Pro EV Scooter (Transparent),Warehouse B,52,44,2025-02-18 00:16:00,8
14955,ORD_14956,15856,Etowish 90 Tablet,Warehouse B,18,6,2025-02-18 11:38:00,12
14956,ORD_14957,5537,Livatira 1000mg Tablet,Warehouse A,61,52,2025-02-18 05:44:00,9
14957,ORD_14958,4838,"Amazon Basics Wired Mouse, 1000 DPI Optical Sensor Tracking, Standard Control 3-Button & 1 Scroller | USB 2.0 Mice Compati...",Warehouse C,42,34,2025-02-18 10:27:00,8
14958,ORD_14959,20622,Oakter Mini UPS for 12V WiFi Router Broadband Modem | Backup Upto 4 Hours | WiFi Router UPS Power Backup During Power Cuts...,Warehouse C,92,86,2025-02-18 04:24:00,6
14959,ORD_14960,22157,Blazex 40mg Injection,Warehouse C,88,69,2025-02-18 10:09:00,19
14960,ORD_14961,22386,Meftafil-P Tablet,Warehouse A,60,46,2025-02-18 06:00:00,14
14961,ORD_14962,14668,Magic Freshness Talc,Warehouse B,58,51,2025-02-18 03:16:00,7
14962,ORD_14963,13407,Glycerin Soap,Warehouse B,72,65,2025-02-18 19:36:00,7
14963,ORD_14964,19391,Nimley 100mg Tablet MD,Warehouse B,102,97,2025-02-18 10:40:00,5
14964,ORD_14965,11861,The Beauty Co. Dwine Body Wash Gel 250 ml,Warehouse B,33,24,2025-02-18 11:35:00,9
14965,ORD_14966,19471,Lakme Absolute 3D Lipstick Red Carnival 3.6 Gm,Warehouse A,63,54,2025-02-18 23:44:00,9
14966,ORD_14967,960,"Zebra NC5 Highlighter Mildliner, 5 Color Set (WKT7-5C-NC)",Warehouse B,62,47,2025-02-18 13:24:00,15
14967,ORD_14968,26144,"Pond's White Beauty BB+ Fairness Cream 01 Original, 18 g And Lakme Nail Color Remover, 27ml",Warehouse B,64,50,2025-02-18 16:17:00,14
14968,ORD_14969,9282,"SoloTravel EVA Shockproof Case for External Hard Drive Compatible with 2.5 Inch (6.35 cm) External Hard Disk, Grey",Warehouse C,79,74,2025-02-18 18:42:00,5
14969,ORD_14970,1348,Maybelline Liquid Lipstick 11 Made Easy (Matte),Warehouse A,51,41,2025-02-18 09:55:00,10
14970,ORD_14971,36484,PackingKaro Courier Bags/Envelopes/Pouches/Cover 60 Micron 8X10 Pack of 100 Tamper Proof Plastic Polybags for Shipping/Pac...,Warehouse C,90,74,2025-02-18 20:46:00,16
14971,ORD_14972,9066,TheGiftKart Transparent Crystal Clear Back Cover Case for OnePlus 8 | Shockproof Soft TPU Case | Cushioned Edges for Ultim...,Warehouse A,87,77,2025-02-18 06:49:00,10
14972,ORD_14973,33983,"Amazon Brand - Solimo Mobile Soft & Flexible Shockproof Back Cover with Cushioned Edges for Samsung Galaxy S20 FE, Transpa...",Warehouse B,38,21,2025-02-18 19:27:00,17
14973,ORD_14974,11635,Itorgo 1% Cream,Warehouse B,65,49,2025-02-18 15:05:00,16
14974,ORD_14975,16464,Cefquad O Tablet,Warehouse B,75,61,2025-02-18 08:15:00,14
14975,ORD_14976,1351,Benetus Syrup,Warehouse C,67,53,2025-02-18 04:25:00,14
14976,ORD_14977,32210,Herbal Face Pack With Chandan Extracts Natural Skin Care For Glowing Skin,Warehouse A,84,70,2025-02-18 19:10:00,14
14977,ORD_14978,20024,Elamin 25mg Tablet,Warehouse C,16,6,2025-02-18 13:26:00,10
14978,ORD_14979,17327,Asar 40 Tablet,Warehouse B,103,89,2025-02-18 05:31:00,14
14979,ORD_14980,30891,"Kadence Mic Stand Heavy Duty Adjustable Dual Microphone Stand, Studio Microphone Stand (M30 Black)",Warehouse A,66,47,2025-02-18 20:12:00,19
14980,ORD_14981,27298,Myglamm Pose Hd Bronzer Duo - Cinnamon Teracotta 9 Gm,Warehouse C,30,23,2025-02-18 06:34:00,7
14981,ORD_14982,9515,"Apple Watch SE (GPS + Cellular, 44mm) - Space Grey Aluminium Case with Midnight Sport Band - Regular",Warehouse A,44,32,2025-02-18 18:27:00,12
14982,ORD_14983,15258,Dicloin-AQ Injection,Warehouse B,102,88,2025-02-18 07:29:00,14
14983,ORD_14984,32783,"Airtel DigitalTV DTH Television, Setup Box Remote Compatible for SD and HD Recording (Black)",Warehouse B,71,64,2025-02-18 00:38:00,7
14984,ORD_14985,11058,"Hair Color 87.5 g + 72 ml, Chocolate 535 + Color Protect Shampoo 175 ml",Warehouse B,67,55,2025-02-18 09:06:00,12
14985,ORD_14986,3811,Gabacure NT 75mg/10mg Tablet,Warehouse B,104,96,2025-02-18 14:14:00,8
14986,ORD_14987,2386,"Acko 1 Year Extended Warranty for ACs from Rs-30,000 to Rs-40,000 (Email Delivery)",Warehouse A,80,62,2025-02-18 23:49:00,18
14987,ORD_14988,29086,OnePlus 163.8 cm (65 inches) U Series 4K LED Smart Android TV 65U1S (Black),Warehouse A,36,22,2025-02-18 21:06:00,14
14988,ORD_14989,29087,WOW IMAGINE Redmi A1 Slim Ultra Soft Rubberised Back Cover | Inner Velvet Fabric Lining | Matte Silicone Flexible Camera P...,Warehouse A,14,8,2025-02-18 10:01:00,6
14989,ORD_14990,6367,Ezo 200 Tablet,Warehouse A,78,71,2025-02-18 03:48:00,7
14990,ORD_14991,12326,Natural & Herbal Henna,Warehouse A,113,95,2025-02-18 21:40:00,18
14991,ORD_14992,37035,ARCTIC MX-4 - Thermal Compound Paste - Carbon Based High Performance - Heatsink Paste - Thermal Compound CPU for All Coole...,Warehouse A,42,29,2025-02-18 09:27:00,13
14992,ORD_14993,6368,"FAMEZA 100 Pcs Clear Coffin Nails, Fake Nails, Full Cover Acrylic Nails False Nail Tips(10 Sizes)",Warehouse A,97,83,2025-02-18 19:00:00,14
14993,ORD_14994,23370,Cefistar-O Tablet,Warehouse C,64,51,2025-02-18 21:10:00,13
14994,ORD_14995,7194,"Apple Cider Vinegar Shampoo With Rosemary, Sage & Lavender",Warehouse A,49,43,2025-02-18 01:08:00,6
14995,ORD_14996,4461,"Redmi 11 Prime (Peppy Purple, 4GB RAM 64GB ROM) | Prime Design | High Performance Helio G99 | 50 MP AI Triple Cam | 5000 m...",Warehouse B,73,54,2025-02-18 10:53:00,19
14996,ORD_14997,34001,Effect Plus Tablet,Warehouse A,35,29,2025-02-18 06:32:00,6
14997,ORD_14998,14876,Zincopan-D SR 30mg/40mg Capsule,Warehouse C,25,13,2025-02-18 16:19:00,12
14998,ORD_14999,24146,"Duracell Specialty CR2025 Lithium Coin Battery 3V, Pack of 5 Suitable for use in keyfobs, Scales, wearables and Medical De...",Warehouse B,64,46,2025-02-18 14:47:00,18
14999,ORD_15000,35915,Spigen DuraPro Flex Strap band for Apple Watch Ultra (49mm) / Apple Watch Series 8/7 (45mm) / Series SE2/6/SE/5/4 (44mm) /...,Warehouse A,76,60,2025-02-18 09:11:00,16
15000,ORD_15001,25571,Flormar Waterproof Eyeliner 105 Warm Brown 1.14 gm,Warehouse A,101,89,2025-02-18 16:15:00,12
15001,ORD_15002,11121,"AEC Ultra Premium Microfiber Cleaning Cloth for Mobile Screen, Camera Lenses, Tablets, Monitors etc Pack of 3",Warehouse B,93,85,2025-02-18 10:42:00,8
15002,ORD_15003,14188,"INDRICO 16A Electric Multi Outlet Extension Board Box with MCB for Heavy Duty PVC White Pack of 1 (2.5 MM 3000 Watts, 3 Me...",Warehouse A,82,65,2025-02-18 01:31:00,17
15003,ORD_15004,27150,Sivanna Colors Long Wear Gel Eyeliner Pen - HF777 0.5 gm,Warehouse A,83,70,2025-02-18 10:12:00,13
15004,ORD_15005,15624,Cetriax S 250 mg/125 mg Injection,Warehouse C,88,83,2025-02-18 17:49:00,5
15005,ORD_15006,22335,Esciram 20mg Tablet,Warehouse A,34,25,2025-02-18 02:00:00,9
15006,ORD_15007,12565,Doedox 200mg Tablet,Warehouse A,53,43,2025-02-18 04:40:00,10
15007,ORD_15008,24707,Ant Esports 7.1 USB Gaming Sound Card,Warehouse A,72,59,2025-02-18 18:42:00,13
15008,ORD_15009,14409,TheGiftKart Crystal Clear Back Cover Case for iQOO Z6 Pro/Vivo T1 Pro 5G | 360 Degree Protection | Shock Proof Design | Tr...,Warehouse C,57,44,2025-02-18 07:40:00,13
15009,ORD_15010,32962,Geecort 6mg Syrup,Warehouse C,93,83,2025-02-18 19:34:00,10
15010,ORD_15011,28269,Amozo Back Cover Case for iPhone 12 Mini (Polycarbonate | Black),Warehouse C,76,69,2025-02-18 06:14:00,7
15011,ORD_15012,30649,Verdrot 40mg Tablet,Warehouse C,49,34,2025-02-18 04:30:00,15
15012,ORD_15013,10103,Apsara Platinum Extra Dark Pencils - Pack of 10,Warehouse A,57,44,2025-02-18 23:02:00,13
15013,ORD_15014,6957,Vega Shampoo Comb (HMC - 30) 57 gm,Warehouse A,27,15,2025-02-18 16:00:00,12
15014,ORD_15015,34465,"Dynotrek Grade 13-13.3 Inch Laptop Sleeve Case Cover with Charger Pouch Compatible for Inspiron 13 XPS, MacBook Pro M1 A24...",Warehouse B,107,96,2025-02-18 08:26:00,11
15015,ORD_15016,23398,Zolsan 10 Tablet,Warehouse B,51,39,2025-02-18 10:11:00,12
15016,ORD_15017,20631,Cello Aspro Mavro Ball Pens | Pack of 25 | BlueBall Pens| Smooth Ball Pens | Long-lasting ball pens | Classy and stylish b...,Warehouse C,82,75,2025-02-18 03:17:00,7
15017,ORD_15018,1635,The Natural Wash Pore Minimizing Face Serum 15 ml,Warehouse B,72,54,2025-02-18 12:55:00,18
15018,ORD_15019,14817,Itro-Dalcare 200 Capsule,Warehouse A,42,24,2025-02-18 07:02:00,18
15019,ORD_15020,4230,Zen Plus 100mg/500mg Tablet,Warehouse B,72,64,2025-02-18 11:01:00,8
15020,ORD_15021,6379,"TP-LINK TG-3468 Gigabit PCI Express Network Adapter - Green, 32-bit 10/100/1000 Mbps RJ45 Port, IEEE 802.3X Flow Control, ...",Warehouse B,92,73,2025-02-18 22:49:00,19
15021,ORD_15022,6781,"JD9 Paper Cutter A4 Heavy Duty Professional Paper Trimmer, Guillotine Craft Machine for Office, Home, Craft, Photo Studio...",Warehouse B,15,7,2025-02-18 07:06:00,8
15022,ORD_15023,33995,Nimnic P 100mg/325mg Tablet,Warehouse C,98,86,2025-02-18 12:45:00,12
15023,ORD_15024,29125,Apecyp Syrup,Warehouse A,40,22,2025-02-18 06:15:00,18
15024,ORD_15025,730,Bhringaraj Hair Care Powder - Pure Herb,Warehouse A,24,11,2025-02-18 23:15:00,13
15025,ORD_15026,11829,Original Eau De Cologne,Warehouse B,17,6,2025-02-18 01:16:00,11
15026,ORD_15027,32450,Laptop Cover 13.3 inch for MacBook Air M1 Case Cover Laptop Case Compatible with 2020/2019/2018 MacBook Air M1 A2337 A2179...,Warehouse B,68,59,2025-02-18 18:42:00,9
15027,ORD_15028,28052,"Callmate 50000mAh Ultra High Capacity Power Bank, 15W Fast Charging |Digital Display |3 USB Output Ports and 3 Input |LED ...",Warehouse A,107,99,2025-02-18 03:37:00,8
15028,ORD_15029,30586,"Leeonz Mirror, Dressing Table Makeup Mirror,360° Swivel Mirror, Bathroom Mirror, Shaving Mirror for Men, Round, Tabletop M...",Warehouse C,97,87,2025-02-18 12:05:00,10
15029,ORD_15030,27124,"‎GIZGA essentials â Portable 360 Rotating Tabletop Mobile Holder, Dock for Ipad, Smartphone, Kindle, E-Reader, Fully Folda...",Warehouse C,64,57,2025-02-18 08:57:00,7
15030,ORD_15031,30646,Flusun 200mg Tablet,Warehouse A,53,41,2025-02-18 08:50:00,12
15031,ORD_15032,34911,"Lotus Professional Phytorx Daily Deep Cleansing Face Wash, 80g, Transparent (SG_B01AJBVX1E_IN)",Warehouse C,72,61,2025-02-18 02:07:00,11
15032,ORD_15033,4995,Amazon Brand - Solimo Makeup Blender with a Teardrop and Olive Slanted Shape Sponge Set (Pack of 2),Warehouse C,48,39,2025-02-18 08:32:00,9
15033,ORD_15034,35181,VITRO I AM NATURAL Aloe Jojoba shampoo (Pack Of 2) 500 ml,Warehouse B,52,35,2025-02-17 18:52:00,17
15034,ORD_15035,24432,Toothpaste - Ayurvedic Gel,Warehouse C,39,32,2025-02-17 19:51:00,7
15035,ORD_15036,34287,"ETUZI Silicone Remote Cover Compatible for Fire TV Stick (3rd Gen, 2021) with All-New Alexa Voice Remote Case (Remote Not ...",Warehouse B,97,88,2025-02-17 05:57:00,9
15036,ORD_15037,22606,Ajmal Raindropss & Blu & Aurum & Wisal Deo & Aretha EDP Pack of 5 20 ml,Warehouse C,52,44,2025-02-17 21:10:00,8
15037,ORD_15038,31137,"Sounce Earphone Case Cover for Realme TechLife Buds T100, Soft Silicone Skin Case Cover Shock-Absorbing Protective Case wi...",Warehouse B,99,82,2025-02-17 04:28:00,17
15038,ORD_15039,21340,"AINE USB C Fast Charging Cable For Lightning To C Type, USB-C Power Delivery Charging Cord for iPhone 14/13/12/12 PRO Max/...",Warehouse C,19,9,2025-02-17 00:49:00,10
15039,ORD_15040,6762,SYGA Professional Sketch and Drawing Pencils ，Art Pencil Box Contains 12 Pieces Set B 2B 3B 4B 5B 6B 7B 8B HB H 2H F,Warehouse C,105,86,2025-02-17 19:19:00,19
15040,ORD_15041,1686,"IT2M Designer Mouse Pad for Laptop/Computer (9.2 X 7.6 Inches, 12788)",Warehouse C,88,82,2025-02-17 05:55:00,6
15041,ORD_15042,28596,Electvision Remote Control for led Smart tv Compatible with VU Smart Led (Without Voice),Warehouse A,49,31,2025-02-17 15:57:00,18
15042,ORD_15043,32943,CEDO Samsung M53 (5G) Case Back Cover Shockproof Bumper Crystal Clear | 360 Degree Protection TPU+PC | Camera Protection |...,Warehouse C,35,25,2025-02-17 07:46:00,10
15043,ORD_15044,18268,Gulabari Premium Rose Water - Paraben Free Skin Toner,Warehouse C,55,38,2025-02-17 05:04:00,17
15044,ORD_15045,6162,Deo Body Spray - Dynamic Pulse,Warehouse A,34,17,2025-02-17 00:15:00,17
15045,ORD_15046,6119,"Stewit Plug in LED Night Light Mini USB LED Light Flexible USB LED Ambient Light Mini USB LED Light, LED Portable car Bul...",Warehouse C,61,52,2025-02-17 21:33:00,9
15046,ORD_15047,9130,Zydiclo Injection 3ml,Warehouse C,38,33,2025-02-17 02:01:00,5
15047,ORD_15048,31764,Amazon Brand - Solimo 360 Degree Protection Bumper Protective Design Shockproof Crystal Clear Transparent Back Cover Case ...,Warehouse B,27,21,2025-02-17 14:04:00,6
15048,ORD_15049,34235,Glimtin 3mg Tablet,Warehouse C,48,30,2025-02-17 11:11:00,18
15049,ORD_15050,4735,Ofvoiz M Oral Suspension,Warehouse B,43,27,2025-02-17 21:49:00,16
15050,ORD_15051,22603,Bhurab D 30mg/20mg Capsule SR,Warehouse B,46,32,2025-02-17 13:45:00,14
15051,ORD_15052,5494,iTronix Replacement USB Charging Cable for Noise ColorFit Pro 4 / Pro 4 Max / Pro 3 / ColorFit Pulse / Pulse Grand / Pulse...,Warehouse B,46,36,2025-02-17 11:48:00,10
15052,ORD_15053,4747,Enapra 100mg/500mg Tablet,Warehouse C,82,65,2025-02-17 01:44:00,17
15053,ORD_15054,16097,Faces Canada Ultime Pro Matte Lip Crayon Midnight Rose 12 2.8 Gm,Warehouse B,96,80,2025-02-17 05:51:00,16
15054,ORD_15055,34244,Aurnac TP 37.5mg/325mg Tablet,Warehouse A,93,76,2025-02-17 05:06:00,17
15055,ORD_15056,18359,"boAt Wave Electra with 1.81"" HD Display, Smart Calling Ultra-Seamless BT Calling Chip, 20 Built-in Watch Faces, 100 + Spor...",Warehouse A,111,99,2025-02-17 22:25:00,12
15056,ORD_15057,8121,Alkof Cough Lozenges Orange,Warehouse A,20,6,2025-02-17 12:13:00,14
15057,ORD_15058,8773,Morser D Tablet,Warehouse A,73,63,2025-02-17 09:15:00,10
15058,ORD_15059,22545,Panasonic Single Line 2.4GHz KX-TG3712SXB Digital Cordless Telephone (Black),Warehouse A,63,51,2025-02-17 20:58:00,12
15059,ORD_15060,10502,Tramacon 50mg Tablet,Warehouse A,81,71,2025-02-17 07:49:00,10
15060,ORD_15061,11827,"HomeMate® Wi-Fi Smart IR Control Hub (Pack of 1) | Smart Air Conditioner Remote | Compatible with Alexa, Google Home | All...",Warehouse B,22,11,2025-02-17 04:10:00,11
15061,ORD_15062,3740,Pro 3 Razor Value Kit For Men,Warehouse A,100,84,2025-02-17 02:33:00,16
15062,ORD_15063,9702,Face Wash - Saundarya,Warehouse A,101,95,2025-02-17 14:11:00,6
15063,ORD_15064,15,"PHILIPS Audio TAE1136 Wired in Ear Earphones with Built in Mic, 10 mm Driver, Powerful bass and Clear Sound",Warehouse C,65,56,2025-02-17 20:14:00,9
15064,ORD_15065,10445,Atulya Hibiscus Organic Powder 100 gm,Warehouse A,38,20,2025-02-17 23:50:00,18
15065,ORD_15066,10540,Nivia Country Colour Rubber Moulded Football,Warehouse C,52,39,2025-02-17 01:14:00,13
15066,ORD_15067,28565,"FEDUS Cat6 Ethernet Cable, 50 Meter High Speed 550MHZ / 10 Gigabit Speed UTP LAN Cable, Network Cable Internet Cable RJ45 ...",Warehouse C,58,48,2025-02-17 04:25:00,10
15067,ORD_15068,30936,Foundation Makeup Brush Flat Top Face Blush Liquid Powder Brush Petal-Shaped High Density Seamless Foundation Brush for Mi...,Warehouse B,61,43,2025-02-17 02:03:00,18
15068,ORD_15069,7924,"realme Buds Wireless Pro Bluetooth in Ear Earphones with Mic, Active Noise Cancellation (ANC), LDAC Hi-Res Audio, Fast Cha...",Warehouse C,57,46,2025-02-17 03:33:00,11
15069,ORD_15070,25845,Beauty People Velvet Matte Nail Polish Matte - Me - Navy - 372 9.9 ml,Warehouse B,41,32,2025-02-17 02:55:00,9
15070,ORD_15071,1441,Berina A43 Light Golden Brown Hair Color Cream 60 gm,Warehouse C,90,76,2025-02-17 02:42:00,14
15071,ORD_15072,2512,Jeevcold-LM 5mg/10mg Tablet,Warehouse C,84,66,2025-02-17 07:38:00,18
15072,ORD_15073,21263,"Wings Phantom Pro Wireless Earphones Earbuds with LED Battery Indicator, 50msLow Latency, Bluetooth 5.3, 40 Hours Playtim...",Warehouse A,74,63,2025-02-17 04:51:00,11
15073,ORD_15074,34150,Enlacard 5mg Tablet,Warehouse C,33,18,2025-02-17 00:50:00,15
15074,ORD_15075,10731,Fedoxime 200mg Tablet,Warehouse C,67,55,2025-02-17 22:03:00,12
15075,ORD_15076,17954,Repadevak 2mg Tablet,Warehouse C,108,99,2025-02-17 19:21:00,9
15076,ORD_15077,21266,"Belkin USB-C to HDMI Adapter + Charge (Supports 4K UHD Video, Pass-Through Power up to 60W for Connected Devices) HDMI Ada...",Warehouse A,113,96,2025-02-17 08:43:00,17
15077,ORD_15078,463,Detan Scrub,Warehouse A,103,93,2025-02-17 23:58:00,10
15078,ORD_15079,9658,"Amazon Basics 38W Mini Car Charger with Dual Output, Fast Charging (Type C 20W + Type A 18W) Compatible with All Smartphon...",Warehouse B,60,43,2025-02-17 23:46:00,17
15079,ORD_15080,9270,"Fashion Colour Professional Makeup Kit, Bke01 - 3 36 gm",Warehouse C,28,11,2025-02-17 12:56:00,17
15080,ORD_15081,24440,Fexiloc-M Tablet,Warehouse B,47,30,2025-02-17 17:59:00,17
15081,ORD_15082,4798,Drester M Cream,Warehouse B,8,1,2025-02-17 06:27:00,7
15082,ORD_15083,36459,Apofec Tablet,Warehouse A,93,75,2025-02-17 16:06:00,18
15083,ORD_15084,13940,Ajmal Aurum Aurum Carbon Deodorant Spray (Pack of 3) 200 ml,Warehouse B,23,16,2025-02-17 10:06:00,7
15084,ORD_15085,3039,P-Joint Tablet,Warehouse C,67,57,2025-02-17 20:29:00,10
15085,ORD_15086,26730,Amzol 0.25mg Tablet,Warehouse A,108,97,2025-02-17 11:13:00,11
15086,ORD_15087,4070,Colrab 20mg Injection,Warehouse C,98,90,2025-02-17 19:12:00,8
15087,ORD_15088,22582,Amazon Brand - Solimo Back Cover Case for Motorola One Power | Compatible for Motorola One Power Back Cover Case | 360 Deg...,Warehouse B,110,93,2025-02-17 08:42:00,17
15088,ORD_15089,444,Herbal Rose & Honey Moisturiser,Warehouse A,71,54,2025-02-17 04:34:00,17
15089,ORD_15090,15005,Regiox 200 LB Tablet,Warehouse C,80,72,2025-02-17 21:43:00,8
15090,ORD_15091,13331,Luxury Bathing Bar - Cinnamon & Patchouili,Warehouse A,77,58,2025-02-17 13:30:00,19
15091,ORD_15092,35569,NISHTECH for Redmi A1 (2022) Premium Transparent Crystal Clear Soft & Slim Back case Cover [Transparent],Warehouse B,22,13,2025-02-17 12:35:00,9
15092,ORD_15093,19691,Nourishing Coconut Butter Body Lotion,Warehouse C,39,24,2025-02-17 17:22:00,15
15093,ORD_15094,12471,Perfumed Deodoramt - Impact Icon,Warehouse C,63,51,2025-02-17 11:03:00,12
15094,ORD_15095,31885,Vermox 500mg Capsule,Warehouse C,36,22,2025-02-17 13:36:00,14
15095,ORD_15096,26690,"Duracell Type C To Type C 5A (100W) Braided Sync & Fast Charging Cable, 3.9 Feet (1.2M). USB C to C Cable, Supports PD & Q...",Warehouse B,110,95,2025-02-17 06:53:00,15
15096,ORD_15097,22514,Zor 25mg Injection,Warehouse A,29,13,2025-02-17 04:16:00,16
15097,ORD_15098,930,KAPAVER® Tempered Glass Screen Guard for Nothing Phone 1 [Edge-to-Edge] [Full Glue] [Anti-Scratch] Tempered Glass for Noth...,Warehouse C,117,99,2025-02-17 10:27:00,18
15098,ORD_15099,6182,"Tizum Extended Mouse Pad Blotter for Work from Home/Office/Gaming | Vegan PU Leather | Anti-Skid, Anti-Slip Extended Desk ...",Warehouse C,20,10,2025-02-17 17:29:00,10
15099,ORD_15100,22694,Kofcalm Syrup,Warehouse A,32,20,2025-02-17 18:43:00,12
15100,ORD_15101,8192,"Syvo S-11 Camera Tripod, Mini Flexible Tripod Stand with Hidden Phone Holder w Cold Shoe Mount, 1/4'' Screw for Magic Arm,...",Warehouse C,72,63,2025-02-17 16:02:00,9
15101,ORD_15102,8191,Olmetake 20 Tablet,Warehouse B,106,89,2025-02-17 20:13:00,17
15102,ORD_15103,28442,Vega Safety Scissor (NS - 01) 17 gm,Warehouse A,39,26,2025-02-17 18:50:00,13
15103,ORD_15104,2957,Faber-Castell 379012 Student Acrylic Colour Set - Pack of 12 (12 x 9 ml),Warehouse B,17,11,2025-02-17 16:14:00,6
15104,ORD_15105,18496,Rosvent 100mg Capsule,Warehouse C,86,79,2025-02-17 03:43:00,7
15105,ORD_15106,35645,Mozikast F 10mg/120mg Tablet,Warehouse C,13,4,2025-02-17 16:35:00,9
15106,ORD_15107,18178,"SanDisk Ultra Dual Drive Go usb3.0 Type C Pendrive for Mobile (Black, 64 GB, 5Y - SDDDC3-064G-I35)",Warehouse C,29,15,2025-02-17 14:26:00,14
15107,ORD_15108,18181,M Pride 5mg Tablet,Warehouse B,35,29,2025-02-17 17:39:00,6
15108,ORD_15109,36451,Medimade Dead Sea Mineral Premium Soap (Pack of 3) 1's,Warehouse C,79,61,2025-02-17 03:32:00,18
15109,ORD_15110,28649,myaddiction Empty Magnetic Palette Box for Eyeshadow Powder Makeup Case,Warehouse A,115,99,2025-02-17 03:42:00,16
15110,ORD_15111,9205,Axcil CV 500mg/125mg Tablet,Warehouse B,50,33,2025-02-17 03:46:00,17
15111,ORD_15112,35655,Olyzer Syrup,Warehouse C,38,22,2025-02-17 16:25:00,16
15112,ORD_15113,26753,Comet Busters Basic Round Black Velvet Bindis (5mm) (BIN1725),Warehouse C,26,18,2025-02-17 07:11:00,8
15113,ORD_15114,18133,Nitra Gel Dental Gel,Warehouse B,35,26,2025-02-17 14:52:00,9
15114,ORD_15115,19753,CEDO Xiaomi Redmi Pad (10.6 Inch) Flip Cover | Leather Finish | 360 Degree Rotate Flip Cover | Shockproof Style Back Cover...,Warehouse B,68,53,2025-02-17 06:17:00,15
15115,ORD_15116,26686,X-Para 100mg/500mg Tablet,Warehouse C,12,1,2025-02-17 04:20:00,11
15116,ORD_15117,18526,"Biotique Natural Makeup Diva Shine Lip Gloss, Paprika Madness Red",Warehouse A,101,92,2025-02-17 11:22:00,9
15117,ORD_15118,16031,Spunky & Funky Avatar Perfume,Warehouse B,26,17,2025-02-17 03:00:00,9
15118,ORD_15119,18130,Fechem-SP Tablet,Warehouse B,54,39,2025-02-17 07:19:00,15
15119,ORD_15120,12110,Utzy 10mg Tablet,Warehouse C,37,31,2025-02-17 02:52:00,6
15120,ORD_15121,22712,"IONIX Big Size LCD Writing Tablet 12 Inch Screen, LCD Writing pad, Tablet, Kids Toys for Boys, Toys for Boys 4 Years, Toys...",Warehouse A,95,83,2025-02-17 16:41:00,12
15121,ORD_15122,35537,Nitrac 10mg Tablet,Warehouse B,20,1,2025-02-17 15:05:00,19
15122,ORD_15123,33680,Tyrit Oral Suspension,Warehouse B,42,24,2025-02-17 10:44:00,18
15123,ORD_15124,35143,Apple iPhone 13 (128GB) - Midnight,Warehouse A,91,74,2025-02-17 10:07:00,17
15124,ORD_15125,12907,realme Narzo 50 Pro 5G (Hyper Blue 6GB RAM+128GB Storage) Super AMOLED | Advanced Dimensity 920 5G Gaming Processor | 50% ...,Warehouse C,42,25,2025-02-17 12:14:00,17
15125,ORD_15126,6749,UNI-BALL UNJSP101BK6 Jetstream Roller Ball Pen Set - Pack of 6 (Black),Warehouse B,44,26,2025-02-17 17:15:00,18
15126,ORD_15127,4691,Stozen 100mg Tablet,Warehouse C,91,74,2025-02-17 08:54:00,17
15127,ORD_15128,33196,YAMAHA PSR-F52 PORTABLE KEYBOARD WITH 61 KEYS,Warehouse B,66,58,2025-02-17 18:27:00,8
15128,ORD_15129,18159,Sef Oxi 50mg Syrup,Warehouse A,44,25,2025-02-17 18:23:00,19
15129,ORD_15130,4758,Sertamid 2% Cream,Warehouse A,86,81,2025-02-17 14:34:00,5
15130,ORD_15131,31882,Bowlrlf 5mg Syrup,Warehouse A,69,53,2025-02-17 16:22:00,16
15131,ORD_15132,26052,"realme C30s (Stripe Blue, 4GB RAM, 64GB Storage)",Warehouse A,41,31,2025-02-17 04:31:00,10
15132,ORD_15133,28511,Ibotris 200mg Capsule SR,Warehouse C,74,60,2025-02-17 04:47:00,14
15133,ORD_15134,4781,Bludrox LB 250 mg/60 mg Tablet,Warehouse A,35,18,2025-02-17 07:53:00,17
15134,ORD_15135,34618,"AMD Ryzen™ 5 5600G Desktop Processor (6-core/12-thread, 19MB Cache, up to 4.4 GHz max Boost) with Radeon™ Graphics",Warehouse A,69,60,2025-02-17 09:58:00,9
15135,ORD_15136,19682,Kratol Infusion,Warehouse A,91,84,2025-02-17 09:24:00,7
15136,ORD_15137,26031,"Himalaya Herbals Refreshing Cleansing Milk, 100ml",Warehouse A,72,66,2025-02-17 13:34:00,6
15137,ORD_15138,28493,House Of Makeup Nail Lacquer - Saucy Blackcurrant 12 ml,Warehouse A,39,28,2025-02-17 21:43:00,11
15138,ORD_15139,12754,Mygirl Womens And Girls Tya Fashion Mini 5024 Multicolour Makeup Kit And 5 Light Weight Pink Makeup Brushes Set - (Pack Of 6),Warehouse A,105,87,2025-02-17 19:33:00,18
15139,ORD_15140,26024,Flormar Style Matic Eyeliner S08 Serious Green 0.35 gm,Warehouse C,70,53,2025-02-17 04:27:00,17
15140,ORD_15141,18406,Mokzin-L Tablet,Warehouse B,75,60,2025-02-17 04:10:00,15
15141,ORD_15142,12897,Cipril 2.5mg Tablet,Warehouse B,62,45,2025-02-17 20:30:00,17
15142,ORD_15143,8802,Ringke Fusion-X Compatible with Samsung Galaxy S23 Ultra 5G Case Cover Military Camo Hard Back Soft TPU Bumper Scratch Res...,Warehouse A,97,83,2025-02-17 12:58:00,14
15143,ORD_15144,4759,F&D A110 70 W 2.1 Channel Wired Multimedia Speakers with Subwoofer Satellite Speaker,Warehouse C,85,71,2025-02-17 04:51:00,14
15144,ORD_15145,6140,Doxmono Tablet,Warehouse C,101,90,2025-02-17 09:20:00,11
15145,ORD_15146,18352,"Max Fresh Anticavity Toothpaste Gel - Peppermint Ice, Saver Pack",Warehouse B,91,77,2025-02-17 15:47:00,14
15146,ORD_15147,28549,TheGiftKart Back Cover Case for OnePlus Nord 2 5G / OnePlus Nord 2 5G Pac-Man Edition (Crystal Clear | Shockproof | Hybrid...,Warehouse C,39,26,2025-02-17 22:13:00,13
15147,ORD_15148,2664,Tower Mouth Organ/Harmonica Key-C 24 Holes 48 Tones With Scale Changer,Warehouse C,41,27,2025-02-17 00:51:00,14
15148,ORD_15149,4763,Falmet Dry Syrup,Warehouse A,88,78,2025-02-17 05:29:00,10
15149,ORD_15150,36455,Naso 2D Tablet,Warehouse C,32,14,2025-02-17 05:21:00,18
15150,ORD_15151,19669,Maryaj Wild Speed EDP Citrus Spicy Perfume And Ajmal Evoke Silver Edition Him Deodorant Spicy Floral Fragrance 300 ml,Warehouse A,97,87,2025-02-17 18:30:00,10
15151,ORD_15152,3729,Eyetex Divya Kumkum 11 In 1 (skin friendly) 1's,Warehouse B,15,1,2025-02-17 05:14:00,14
15152,ORD_15153,27694,Vermikos 400mg Tablet,Warehouse A,39,34,2025-02-17 16:38:00,5
15153,ORD_15154,28471,Multipram CZ 0.5mg/10mg Tablet,Warehouse A,93,78,2025-02-17 00:05:00,15
15154,ORD_15155,13932,"Swiss Beauty Professional Blusher with highly blendable shades | Pigmented Blusher for a Natural Flush | Shade-06, 6gm|",Warehouse A,24,13,2025-02-17 00:32:00,11
15155,ORD_15156,6083,Faces Canada Perfecting Blush Apricot 06 5 Gm,Warehouse C,74,69,2025-02-17 07:33:00,5
15156,ORD_15157,26671,Derma Care Advanced Repair Body Lotion,Warehouse B,78,69,2025-02-17 20:55:00,9
15157,ORD_15158,17987,(Renewed) Mi Wired In Ear Earphones Basic with Mic (Black),Warehouse C,65,51,2025-02-17 17:54:00,14
15158,ORD_15159,7915,EVM EnSave 1TB Smallest Portable External SSD with 3D NAND Flash Technology Speed of 550/R 500/W MB/s IP55 Rated- Compatib...,Warehouse A,84,70,2025-02-17 09:32:00,14
15159,ORD_15160,7890,Amazon Brand - Solimo Back Cover Case for Samsung Galaxy M20 | Compatible for Samsung Galaxy M20 Back Cover Case | 360 Deg...,Warehouse A,62,52,2025-02-17 02:12:00,10
15160,ORD_15161,8011,Aziza 500mg Tablet,Warehouse C,54,39,2025-02-17 12:15:00,15
15161,ORD_15162,22736,"WELLA Color Save Conditioner For Coloured Hair, 200ml",Warehouse C,96,79,2025-02-17 05:16:00,17
15162,ORD_15163,22380,Energizer Max Alkaline AA Batteries - Pack of 6,Warehouse C,32,21,2025-02-17 14:28:00,11
15163,ORD_15164,16169,MENORAH - A4 Sketch Artist Book- Drawing Notebook- 50 Sheets / 100 Pages- (21.0 cm x 29.7 cm)-140 GSM- (Poppy Field) Design,Warehouse A,50,44,2025-02-17 20:23:00,6
15164,ORD_15165,10643,Tegma-M Forte 1000mg/20mg Tablet,Warehouse B,26,20,2025-02-17 15:55:00,6
15165,ORD_15166,11779,"SPIN CART 3.5mm to RCA Cable, 2RCA Male to 3.5mm Male Stereo Y Splitter Audio cable Compatible with Phones, Laptop, HDTV, ...",Warehouse C,50,45,2025-02-17 19:00:00,5
15166,ORD_15167,3091,Miss Rose Matte Finish Bullet Lipstick Shade 34 Marjorie 7301 - 026B 34 3.4 gm,Warehouse C,38,31,2025-02-17 00:31:00,7
15167,ORD_15168,15573,Uriwell 0.4 Tablet PR,Warehouse A,25,6,2025-02-17 08:03:00,19
15168,ORD_15169,22758,Tinazen 250mg Tablet,Warehouse A,42,31,2025-02-17 14:34:00,11
15169,ORD_15170,27755,Nimuttle-P Tablet,Warehouse B,11,5,2025-02-17 10:37:00,6
15170,ORD_15171,24376,Pantras DSR 30mg/40mg Capsule,Warehouse C,58,40,2025-02-17 15:00:00,18
15171,ORD_15172,29884,"SNOOZEHUB Smart Watch ID116 Plus Bluetooth Smart Fitness Band Watch with Heart Rate Activity Tracker Waterproof Body, Step...",Warehouse B,51,43,2025-02-17 18:27:00,8
15172,ORD_15173,6780,Qualixime 200mg Tablet,Warehouse A,33,19,2025-02-17 22:30:00,14
15173,ORD_15174,32802,Cephin 500mg Capsule,Warehouse A,67,55,2025-02-17 07:11:00,12
15174,ORD_15175,13083,Pantoz 40mg Tablet,Warehouse C,12,7,2025-02-17 18:11:00,5
15175,ORD_15176,15571,Gerab IT 20mg/150mg Capsule,Warehouse B,25,12,2025-02-17 15:45:00,13
15176,ORD_15177,1134,Amoxprl CV Dry Syrup,Warehouse B,113,95,2025-02-17 18:07:00,18
15177,ORD_15178,3602,Body Deodorant - Forest Spice,Warehouse C,54,41,2025-02-17 12:13:00,13
15178,ORD_15179,35162,F-Nar 10 Tablet,Warehouse C,40,28,2025-02-17 10:48:00,12
15179,ORD_15180,6984,Faces Canada Hi Shine Nail Enamel Simple Taupe 228 9 Ml,Warehouse B,45,26,2025-02-17 02:44:00,19
15180,ORD_15181,16020,"HP Deskjet Ink Advantage 2778 AIO Printer, Copy, Scan, WiFi, Bluetooth, USB, Simple Setup Smart App, Ideal for Home.",Warehouse C,75,58,2025-02-17 23:26:00,17
15181,ORD_15182,7053,Jpcef 200mg Tablet,Warehouse C,46,39,2025-02-17 21:14:00,7
15182,ORD_15183,22766,Peppermint Essential Oil - 100% Pure & Natural,Warehouse B,9,3,2025-02-17 17:13:00,6
15183,ORD_15184,20689,Montasma 4mg Tablet DT,Warehouse B,97,86,2025-02-17 21:29:00,11
15184,ORD_15185,13025,Opimox 500 Capsule,Warehouse C,64,48,2025-02-17 02:10:00,16
15185,ORD_15186,5295,"Wayona Usb Type C 10Ft Nylon Braided 2.8A Fast Charger Cord ( Black,Wc10Cb1)",Warehouse C,82,66,2025-02-17 18:48:00,16
15186,ORD_15187,35666,"LifeKrafts Magnetic Adhesive Sheets | 12"" x 12"" | Pack of 1| Make Anything a Magnet! | Flexible Peel and Stick Self Adhesi...",Warehouse C,15,6,2025-02-17 16:22:00,9
15187,ORD_15188,33238,ARDELL Magnetic Lashes Double Wispies - 67952 + Duo Clear Glue 1g,Warehouse A,42,27,2025-02-17 04:57:00,15
15188,ORD_15189,15066,Himalaya Anti Wrinkle Cream 50 Gm,Warehouse B,34,29,2025-02-17 05:15:00,5
15189,ORD_15190,82,Bonjour Paris Premium Mettalic Shine Lipstick for Women - Nude Pink 4.2 gm,Warehouse B,110,98,2025-02-17 02:16:00,12
15190,ORD_15191,18010,"Portronics Adapto 65X Adapter/Charger 65W for Laptop/Mobile with Triple Output (USB +PD) Compatible with Mac Book Pro, 100...",Warehouse A,16,7,2025-02-17 06:03:00,9
15191,ORD_15192,19746,Glicra M 40mg/500mg Tablet,Warehouse B,88,69,2025-02-17 21:32:00,19
15192,ORD_15193,22322,Jovees Fairness Lotion SPF 25 - Liquorice with UV Protection 200 ml,Warehouse B,27,12,2025-02-17 16:43:00,15
15193,ORD_15194,1716,Rozucor F 10 Tablet,Warehouse B,75,62,2025-02-17 11:16:00,13
15194,ORD_15195,28368,Caredot Tablet,Warehouse A,82,70,2025-02-17 05:13:00,12
15195,ORD_15196,26673,NOTE EYESHADOW PENCIL 06 1.6 gm,Warehouse C,35,28,2025-02-17 13:40:00,7
15196,ORD_15197,22849,OpenTech® Tempered Glass Screen Protector Compatible for iPhone 12 Pro Max with Edge to Edge Coverage and Easy Installatio...,Warehouse B,60,43,2025-02-17 02:17:00,17
15197,ORD_15198,10714,Oxetol 300 Tablet,Warehouse A,25,11,2025-02-17 14:29:00,14
15198,ORD_15199,19595,Revlon Colorburst Matte Balm - Audacious (245),Warehouse B,94,86,2025-02-17 16:21:00,8
15199,ORD_15200,24512,Makeup Revolution Super Serum Foundation F4 25 ml,Warehouse A,48,29,2025-02-17 02:06:00,19
15200,ORD_15201,29770,Perfume Body Spray - Affair,Warehouse B,116,97,2025-02-17 08:23:00,19
15201,ORD_15202,10328,One Ginger Morning Bath & Shower Gel,Warehouse A,47,29,2025-02-17 00:17:00,18
15202,ORD_15203,18007,Strozip 4mg Tablet,Warehouse B,83,68,2025-02-17 09:10:00,15
15203,ORD_15204,32455,Revolution Pro Full Cover Camouflage Concealer-C13 8.5 ml,Warehouse C,90,78,2025-02-17 10:43:00,12
15204,ORD_15205,25874,"Conscious Chemist Retinol Body Cream | Reduces Uneven Skin Tone, Scars | All Skin Types, Fragrance Free & Cruelty Free | 1...",Warehouse A,54,39,2025-02-17 20:37:00,15
15205,ORD_15206,24494,Ofencer 200mg Tablet,Warehouse B,46,35,2025-02-17 13:08:00,11
15206,ORD_15207,16200,"Kottakkal ayurveda® Vibha Soap - 75 gm, Ideal for Beautiful Skin & Freshness of Body - Pack of 4",Warehouse B,63,47,2025-02-17 15:22:00,16
15207,ORD_15208,7957,CEDO Samsung M31 / F41 / M31 Prime Tempered Glass | Screen Protector Full HD Quality Edge to Edge Coverage for Samsung Gal...,Warehouse B,80,69,2025-02-17 21:04:00,11
15208,ORD_15209,6217,Aldigesic Injection,Warehouse B,106,97,2025-02-17 14:01:00,9
15209,ORD_15210,30450,"boAt Blaze Smart Watch with 1.75"" HD Display, Fast Charge, Apollo 3 Blue Plus Processor, 24x7 Heart Rate & SpO2 Monitor, M...",Warehouse C,83,71,2025-02-17 21:11:00,12
15210,ORD_15211,9642,"River Fox SMPS Power Adapter 12 V 2A DC (2.5mm Pin) for Set Top Box/DTH, LED Strip Lights, CCTV Camera - Black",Warehouse A,60,41,2025-02-17 11:51:00,19
15211,ORD_15212,19783,Gabalis-NT 400mg/10mg Tablet,Warehouse A,26,17,2025-02-17 07:38:00,9
15212,ORD_15213,14623,Cbsc Cream,Warehouse A,90,72,2025-02-17 03:02:00,18
15213,ORD_15214,12438,Streetwear Nail Enamel (Matte) - Rebel Black 8 Ml,Warehouse A,17,5,2025-02-17 12:46:00,12
15214,ORD_15215,35203,boAt Dual Port Rapid Car Charger (Qualcomm Certified) with Quick Charge 3.0 + Free Micro USB Cable - (Black),Warehouse C,66,57,2025-02-17 05:34:00,9
15215,ORD_15216,31685,Bonjour Paris Nail Polish - Nail Care Tranparent Cuticle Oil 9 ml,Warehouse A,30,14,2025-02-17 20:25:00,16
15216,ORD_15217,28696,Arctic Hunter Backpack 35L Laptop Bag for Office Travel Business Laptop Backpack Fit Up to 17-inch Laptop Water-resistant ...,Warehouse C,91,83,2025-02-17 02:33:00,8
15217,ORD_15218,18094,Axogrip Tablet SR,Warehouse A,72,57,2025-02-17 08:41:00,15
15218,ORD_15219,18541,"Portronics My Buddy K5 Portable Laptop Tabletop Stand with Aluminium Frame, Adjustable Height, Compatible with All Laptops...",Warehouse C,96,81,2025-02-17 11:29:00,15
15219,ORD_15220,30152,Palette Intensive Colour Cream Long Lasting Intensity 5-68 Medium Chestnut,Warehouse B,55,40,2025-02-17 06:06:00,15
15220,ORD_15221,25819,Fragrance Body Spray Bleu Spring,Warehouse A,67,54,2025-02-17 07:56:00,13
15221,ORD_15222,18622,"Spa Exfoliating Body Scrub Glove - Dead Skin Cell Remover, Double Sided Exfoliator Mitt - Remove Blackheads, Bumps and Imp...",Warehouse A,52,40,2025-02-17 19:32:00,12
15222,ORD_15223,3767,Matra Charcoal Peel Off Black Mask (Free Brush) 100 gm,Warehouse B,53,40,2025-02-17 05:13:00,13
15223,ORD_15224,7910,Lypin 10mg Tablet,Warehouse B,59,40,2025-02-17 11:23:00,19
15224,ORD_15225,4629,Regnol 75mg/10mg Tablet,Warehouse C,106,95,2025-02-17 11:58:00,11
15225,ORD_15226,273,BETANIF 50 MG/20 MG TABLET,Warehouse B,102,90,2025-02-17 12:40:00,12
15226,ORD_15227,15992,Vdzol 40 Injection,Warehouse B,118,99,2025-02-17 07:16:00,19
15227,ORD_15228,13017,Ajmal 2 Distraction & 2 Magnetize Deo & Neea EDP Pack of 3 20 ml,Warehouse A,70,57,2025-02-17 12:40:00,13
15228,ORD_15229,31776,Glimmer Premium Nail Enamel Burnt Red 10 ml,Warehouse A,40,30,2025-02-17 15:08:00,10
15229,ORD_15230,34335,Genera Tablet,Warehouse A,36,19,2025-02-17 08:19:00,17
15230,ORD_15231,34153,Paperkraft Beethoven- Blue Ceramic Roller Ball Pen (Pack of 1) | Classy Chrome & Gold tone finish|Premium Gifting Product...,Warehouse C,47,39,2025-02-17 16:57:00,8
15231,ORD_15232,36754,Ofowor Tablet,Warehouse A,16,6,2025-02-17 06:26:00,10
15232,ORD_15233,20421,Parvis-MF Oral Suspension Mango,Warehouse A,75,61,2025-02-17 02:24:00,14
15233,ORD_15234,36995,Arzole-DSR Capsule,Warehouse A,27,12,2025-02-17 13:56:00,15
15234,ORD_15235,36339,Fixderma Cosmetic Laboratories (FCL) Soap Free Body Wash - Oatsilk 200 ml,Warehouse B,75,61,2025-02-17 12:27:00,14
15235,ORD_15236,1628,Trihexy 2mg Tablet,Warehouse C,83,65,2025-02-17 05:18:00,18
15236,ORD_15237,32340,Theolar 40mg Tablet,Warehouse C,48,33,2025-02-17 08:06:00,15
15237,ORD_15238,12514,Hotclav 250mg/125mg Tablet,Warehouse C,26,11,2025-02-17 07:55:00,15
15238,ORD_15239,31875,Sepnim 100mg/10mg Tablet,Warehouse C,38,28,2025-02-17 09:25:00,10
15239,ORD_15240,11767,Pikkme Back Cover for ASUS Zenfone Max Pro M1 (TPU | Black | Solid),Warehouse C,79,71,2025-02-17 13:08:00,8
15240,ORD_15241,34158,Attiic Online Holster for Mobile Cell Phone | Holster Mobile Pouch | Waist Belt Case | Universal Case | Waist Bag Mobile P...,Warehouse B,40,33,2025-02-17 02:57:00,7
15241,ORD_15242,13995,Cefocad 50mg Dry Syrup,Warehouse B,88,78,2025-02-17 09:08:00,10
15242,ORD_15243,17959,Kiazin M 5mg/10mg Tablet,Warehouse A,68,50,2025-02-17 12:12:00,18
15243,ORD_15244,1717,TVS ELECTRONICS USB Gold Keyboard (Black),Warehouse C,53,38,2025-02-17 12:09:00,15
15244,ORD_15245,17957,AEIDESS Tempered Glass Screen Protector Compatible For Oneplus Nord 2 5G with Edge to Edge Coverage and Easy Installation Kit,Warehouse C,82,71,2025-02-17 18:11:00,11
15245,ORD_15246,28776,Brillare Pure Castor Oil 200 ml,Warehouse C,89,81,2025-02-17 22:53:00,8
15246,ORD_15247,19821,Cefti S 250mg/125mg Injection,Warehouse B,75,66,2025-02-17 09:44:00,9
15247,ORD_15248,22291,Bubblegum Flavoured Condoms,Warehouse B,101,88,2025-02-17 07:12:00,13
15248,ORD_15249,31422,Bella Voste Eyeshadow Wine & Dine 10 2.6 gm,Warehouse C,18,8,2025-02-17 08:35:00,10
15249,ORD_15250,20772,Premium Perfume - Icon,Warehouse C,28,17,2025-02-17 18:50:00,11
15250,ORD_15251,18654,"Beauty Soap For Glowing Skin - Jasmine & Vitamin E, Offer",Warehouse B,31,23,2025-02-17 01:00:00,8
15251,ORD_15252,1989,Fycef 50mg Dry Syrup,Warehouse B,36,23,2025-02-17 02:48:00,13
15252,ORD_15253,27252,"IFB 20 L Convection Microwave Oven (20SC2, Metallic Silver, With Starter Kit)",Warehouse B,93,87,2025-02-17 12:39:00,6
15253,ORD_15254,7899,Insight Cosmetics Pastel Color Nail Polish - 34 9 ml,Warehouse B,41,24,2025-02-17 08:03:00,17
15254,ORD_15255,17903,"Sitishield Cambridge N95 Mask – Large, Black",Warehouse C,100,87,2025-02-17 17:30:00,13
15255,ORD_15256,3690,Lakme Absolute 3D Lipstick Plum Spell 3.6 Gm,Warehouse B,75,56,2025-02-17 03:53:00,19
15256,ORD_15257,28800,Pikkme Tempered Glass Screen Protector for Samsung Galaxy M21 / M21 2021 / M30s Edge to Edge Coverage with Easy Installati...,Warehouse C,35,24,2025-02-17 08:43:00,11
15257,ORD_15258,22916,Combistar 500 mg/600 mg Tablet,Warehouse B,12,3,2025-02-17 14:31:00,9
15258,ORD_15259,22278,Meto 12.5mg Tablet ER,Warehouse A,61,53,2025-02-17 00:18:00,8
15259,ORD_15260,4622,"Mysore Sandal Body Wash, 200 ml with Free Loofah | Pamper Your Skin for an Exclusive Glow with Exquisite Fragrance",Warehouse B,22,9,2025-02-17 08:11:00,13
15260,ORD_15261,18641,Miss Rose Skin Perfector Brick Highlighter 7003 - 126N 05 13 gm,Warehouse C,70,52,2025-02-17 04:03:00,18
15261,ORD_15262,30970,Redigrel 10mg Tablet,Warehouse B,100,83,2025-02-17 11:51:00,17
15262,ORD_15263,28342,Levsym M 5mg/10mg Tablet,Warehouse C,23,4,2025-02-17 10:51:00,19
15263,ORD_15264,3445,"Jantughna Vati - Anti Infection, 500mg",Warehouse C,100,88,2025-02-17 16:23:00,12
15264,ORD_15265,13103,Blue Heaven Bling Nailpaint 707 (Plum Flash) 8 ml,Warehouse C,25,13,2025-02-17 15:22:00,12
15265,ORD_15266,5798,Roxzine 25mg Tablet,Warehouse A,98,80,2025-02-17 16:02:00,18
15266,ORD_15267,27774,Organic Harvest Kumkumadi Tailam Oil 30 ml,Warehouse A,46,37,2025-02-17 17:55:00,9
15267,ORD_15268,1730,Zerinom 125mg Injection,Warehouse A,104,89,2025-02-17 06:22:00,15
15268,ORD_15269,18664,Nature's Essence Lacto Bleach Natural Milk Bleach Without Activator 100 ML,Warehouse A,88,70,2025-02-17 07:23:00,18
15269,ORD_15270,4614,Ajmal Aurum Carbon Wisal Dahab Deodorant Spray (Pack of 3) 200 ml,Warehouse C,102,96,2025-02-17 13:55:00,6
15270,ORD_15271,11750,Aloe Veda Clarifying Herbal Face Wash - Turmeric 100 ml,Warehouse A,99,92,2025-02-17 21:02:00,7
15271,ORD_15272,31784,Xylovir 800mg Tablet,Warehouse A,52,44,2025-02-17 16:09:00,8
15272,ORD_15273,35743,"Redmi K50i 5G (Phantom Blue, 8GB RAM, 256GB Storage)| Flagship Mediatek Dimensity 8100 Processor | 144Hz Liquid FFS Display",Warehouse B,111,96,2025-02-17 23:33:00,15
15273,ORD_15274,10781,"Gaiatop Handheld Mini Portable Fan, Hand & Desk Fan, 4000 mAh Rechargeable USB Small Fan, Battery Operated Personal Fan wi...",Warehouse C,31,14,2025-02-17 22:14:00,17
15274,ORD_15275,14365,OnePlus Warp Charge 65 Power Adapter (in) OnePlus USB White,Warehouse A,99,80,2025-02-17 15:44:00,19
15275,ORD_15276,24995,"SHOPEE Photography Photo Light Lamp Bulb Single Holder E27 Socket Bracket Studio EU Plug,Black (Pack of 1)",Warehouse B,27,18,2025-02-17 21:44:00,9
15276,ORD_15277,8280,Ajmal Wisal Deodorants Spray (Pack of 3) 200 ml,Warehouse B,42,30,2025-02-17 21:04:00,12
15277,ORD_15278,1145,PC-Cold Syrup,Warehouse C,108,95,2025-02-17 03:19:00,13
15278,ORD_15279,20492,Ajmal CD 99 Mukhallat Concentrated Perfume Oil Floral Oriental And Sacred Love Deodorant Floral Musky Fragrance 214 ml,Warehouse C,35,18,2025-02-17 01:42:00,17
15279,ORD_15280,33793,Oftru 200mg Tablet,Warehouse A,89,79,2025-02-17 00:35:00,10
15280,ORD_15281,29798,"Pure Clay Mask, Exfoliate & Refine Pores",Warehouse C,15,10,2025-02-17 09:15:00,5
15281,ORD_15282,26233,Ajmal Shine EDP Floral Powdery Perfume 75ml for Women and Sacrifice for HER EDP Floral Musky Perfume 50ml for Women +1 Per...,Warehouse B,26,16,2025-02-17 09:05:00,10
15282,ORD_15283,24209,"RENEE Talk Matte Crayon Lipstick - Mauve Melody & Nude Roar 4.5gm each, Hydrating and Long-Lasting Matte Lip Color | Enric...",Warehouse A,38,22,2025-02-17 07:10:00,16
15283,ORD_15284,28986,Cosmic Byte Meteoroid RGB Laptop Cooling Pad with 6 Fan Upto 17 inch laptops (Black/Blue),Warehouse B,26,12,2025-02-17 22:03:00,14
15284,ORD_15285,22132,"ZEBRONICS Juke BAR 9750 PRO 5.1.2 Surround Dolby Atmos 525 Watt Soundbar with Subwoofer, Dual Wireless Rear Satellites, HD...",Warehouse A,45,26,2025-02-17 17:38:00,19
15285,ORD_15286,30373,Uniprogestin M 200mg Capsule,Warehouse A,65,50,2025-02-17 21:12:00,15
15286,ORD_15287,5726,T-LET-H Tablet,Warehouse C,29,16,2025-02-17 22:16:00,13
15287,ORD_15288,30705,Cosmic Byte C1070T Interstellar Wired Gamepad,Warehouse B,6,1,2025-02-17 00:18:00,5
15288,ORD_15289,11940,"boAt Wave Call Smart Watch, Smart Talk with Advanced Dedicated Bluetooth Calling Chip & Airdopes 121v2 in-Ear True Wireles...",Warehouse A,87,69,2025-02-17 05:47:00,18
15289,ORD_15290,24859,"Callmate 20000mAh Power Bank, 15W Fast Charging| Buit-in Cables | 4 Output Ports and 3 Input | for iPhone, Smartphones & O...",Warehouse A,48,42,2025-02-17 08:51:00,6
15290,ORD_15291,13404,Moha: Rose and Almond Bath Soap | Bathing Soap For Face & Body | Unisex Bathing Bar (Pack of 3),Warehouse A,21,15,2025-02-17 08:25:00,6
15291,ORD_15292,2073,EZVIZ by Hikvision| Made in India | WiFi Indoor Home Security/Baby Monitor Camera|2 Way Talk | 360° Pan/Tilt | Night Visio...,Warehouse B,64,48,2025-02-17 12:52:00,16
15292,ORD_15293,36577,Kitopan D 10mg/40mg Tablet,Warehouse B,30,11,2025-02-17 05:06:00,19
15293,ORD_15294,5519,Nervmax-D 50/20 Capsule DR,Warehouse C,101,91,2025-02-17 14:31:00,10
15294,ORD_15295,25648,Eeon-SR Tablet,Warehouse A,51,34,2025-02-17 08:27:00,17
15295,ORD_15296,8367,Phoscut 800 Tablet,Warehouse A,61,51,2025-02-17 10:44:00,10
15296,ORD_15297,32712,Vyneuron PG Capsule,Warehouse A,70,56,2025-02-17 04:58:00,14
15297,ORD_15298,17570,D-Flam-MR Tablet,Warehouse A,95,80,2025-02-17 02:43:00,15
15298,ORD_15299,14859,Vialet Tablet,Warehouse A,35,18,2025-02-17 14:14:00,17
15299,ORD_15300,35230,Robustrion Smart Trifold Hard Back Flip Stand Case Cover for Samsung Galaxy Tab S8 Plus / S7 Plus / S7 FE Tablet Cover 12....,Warehouse C,87,68,2025-02-17 13:21:00,19
15300,ORD_15301,15185,Tamsulaw D 0.4mg/0.5mg Tablet,Warehouse C,88,71,2025-02-17 11:16:00,17
15301,ORD_15302,16366,"Maybelline New York Fit me Concealer,30 Honey 6.8 ml",Warehouse A,51,44,2025-02-17 23:26:00,7
15302,ORD_15303,34699,"Sounce Air Pods 3 Case Cover with Keychain Neck, Protective Silicone Case Skin Compatible with Air Pods 3rd Generation (20...",Warehouse C,76,62,2025-02-17 21:15:00,14
15303,ORD_15304,13783,The Moms Co. Baby Shampoo 400 ml,Warehouse C,84,78,2025-02-17 04:58:00,6
15304,ORD_15305,29688,Turbolax 500mg Capsule,Warehouse A,57,42,2025-02-17 19:06:00,15
15305,ORD_15306,19943,Cefprotec 1gm Injection,Warehouse C,73,59,2025-02-17 03:34:00,14
15306,ORD_15307,27813,"HP DHS-2101 2.0 USB Portable Multimedia Wired Black Speaker with 3.5mm AUX Connectivity, Black",Warehouse B,34,19,2025-02-17 10:11:00,15
15307,ORD_15308,17747,boAt Bassheads 152 Masaba Edition in Ear Wired Earphones with Mic(Black Star),Warehouse A,76,59,2025-02-17 10:42:00,17
15308,ORD_15309,12363,MI 138.8 cm (55 inches) 5X Series 4K Ultra HD LED Smart Android TV L55M6-ES (Grey),Warehouse B,107,88,2025-02-17 21:35:00,19
15309,ORD_15310,1331,Cetzine Oral Drops,Warehouse C,22,12,2025-02-17 05:39:00,10
15310,ORD_15311,12359,Apimox CV Dry Syrup,Warehouse B,105,89,2025-02-17 06:01:00,16
15311,ORD_15312,4146,Diominic Dca Tablet,Warehouse B,20,4,2025-02-17 03:10:00,16
15312,ORD_15313,32786,"Panasonic KX-TS400SX Integrated Corded Telephone System, Black",Warehouse A,46,33,2025-02-17 18:33:00,13
15313,ORD_15314,30360,Ultra Sheer Dry Touch SPF 50 Sun Block,Warehouse B,74,58,2025-02-17 06:26:00,16
15314,ORD_15315,25061,Vominil 4mg Tablet MD,Warehouse C,75,57,2025-02-17 16:10:00,18
15315,ORD_15316,33608,Megmator D3 10mg/1000IU Tablet,Warehouse B,55,41,2025-02-17 10:55:00,14
15316,ORD_15317,17553,"Maybelline New York Sensational Liquid Matte Lipstick 05, Keep It Mellow 7 gm",Warehouse B,103,87,2025-02-17 14:19:00,16
15317,ORD_15318,4017,HealthVit Tulsi Drops Natural Immunity Booster - 30ml,Warehouse C,91,82,2025-02-17 09:05:00,9
15318,ORD_15319,2747,Offer 400mg Tablet,Warehouse A,78,73,2025-02-17 20:21:00,5
15319,ORD_15320,8691,CLAVIER Pulse in-Ear Headphones/Earphones with Stereo Mic for All Smartphones with Carrying Case (Black),Warehouse B,104,92,2025-02-17 03:13:00,12
15320,ORD_15321,210,Zoviclovir 800 Tablet,Warehouse B,54,43,2025-02-17 13:13:00,11
15321,ORD_15322,34038,"Syvo WT 3130 Aluminum Tripod (50 Inches), Universal Lightweight Tripod with Mobile Phone Holder Mount & Carry Bag for All ...",Warehouse A,41,24,2025-02-17 07:20:00,17
15322,ORD_15323,34381,"Gadget Deals Hard Disk Cover/ Hard Disk Drive Pouch case for 2.5"" HDD Cover WD Seagate Slim Sony Dell Toshiba (Black)",Warehouse B,41,25,2025-02-17 04:00:00,16
15323,ORD_15324,1305,"Portronics Key2-A Combo of Multimedia Wireless Keyboard & Mouse, Compact Light-Weight for PCs, Laptops and Smart TV, Black",Warehouse A,94,79,2025-02-17 12:20:00,15
15324,ORD_15325,15892,Ozicin 500mg Tablet,Warehouse A,103,96,2025-02-17 16:15:00,7
15325,ORD_15326,12340,N Par 100mg/325mg Tablet,Warehouse C,75,57,2025-02-17 17:08:00,18
15326,ORD_15327,15207,Edoclof-MR Tablet,Warehouse C,44,30,2025-02-17 11:28:00,14
15327,ORD_15328,26267,Cefik-S Injection,Warehouse C,32,23,2025-02-17 08:35:00,9
15328,ORD_15329,28221,Pack 40 Tablet,Warehouse C,104,87,2025-02-17 00:11:00,17
15329,ORD_15330,16389,Rinclave 200mg/28.5mg Tablet,Warehouse A,60,47,2025-02-17 07:18:00,13
15330,ORD_15331,1166,"GM 3245 Meridian 2 Pin Flex Box Cord Length 4.8 to 5 Mtr. with Handle, Indicator & International Socket (Assorted Color)",Warehouse A,80,75,2025-02-17 02:08:00,5
15331,ORD_15332,12775,Sarrato N 100mg/15mg Tablet,Warehouse B,96,88,2025-02-17 07:58:00,8
15332,ORD_15333,22096,Orant 200mg Tablet,Warehouse B,30,16,2025-02-17 09:22:00,14
15333,ORD_15334,33087,"SEMINES Tabletop Laptop Stand 7 Height Adjustable, Aluminium, Ventilated, Foldable, Portable Laptop Holder for Desk & Tabl...",Warehouse A,58,46,2025-02-17 06:44:00,12
15334,ORD_15335,8378,"OnePlus 11 5G (Titan Black, 16GB RAM, 256GB Storage)",Warehouse B,73,62,2025-02-17 09:37:00,11
15335,ORD_15336,31942,"Vaadi Herbals Value Luxurious Saffron Skin Whitening Therapy Soap, 75g (Pack of 3)",Warehouse C,95,83,2025-02-17 17:11:00,12
15336,ORD_15337,20355,Guggulhills - Tablets,Warehouse B,45,36,2025-02-17 11:10:00,9
15337,ORD_15338,1162,T Mox Dry Syrup,Warehouse C,54,36,2025-02-17 18:53:00,18
15338,ORD_15339,10947,Wella Professionals SP Hydrate Mask for Dry Hair 200 ml,Warehouse C,72,53,2025-02-17 09:03:00,19
15339,ORD_15340,18826,Vomital 2mg Injection,Warehouse B,67,52,2025-02-17 12:59:00,15
15340,ORD_15341,2443,Halox S Ointment,Warehouse A,86,81,2025-02-17 13:55:00,5
15341,ORD_15342,35129,Camlin Kokuyo Scholar Mathematical Drawing Instruments FREE camlin pen pencil,Warehouse C,32,23,2025-02-17 17:40:00,9
15342,ORD_15343,2857,Zonate-SB 1000mg/500mg Injection,Warehouse B,15,8,2025-02-17 15:32:00,7
15343,ORD_15344,15539,Manther LF Dry Syrup,Warehouse B,51,46,2025-02-17 12:41:00,5
15344,ORD_15345,2050,Elmox 250 Capsule,Warehouse A,54,44,2025-02-17 10:30:00,10
15345,ORD_15346,1150,Cefinex-O Tablet,Warehouse B,117,98,2025-02-17 19:09:00,19
15346,ORD_15347,37004,Herbal Pure Rose Water Skin Toner,Warehouse B,79,64,2025-02-17 12:41:00,15
15347,ORD_15348,32312,Gemblue Biocare Charcoal Massage Gel 500 ml,Warehouse C,54,38,2025-02-17 04:28:00,16
15348,ORD_15349,28310,Aviglen Forte Tablet,Warehouse B,52,43,2025-02-17 21:05:00,9
15349,ORD_15350,34356,Goldpride 200mg Tablet,Warehouse A,81,73,2025-02-17 08:03:00,8
15350,ORD_15351,34124,EGOTUDE Silicon Soft Case Camera Protect Microfiber Lining Cover for iPhone 13 (Black),Warehouse B,50,45,2025-02-17 08:25:00,5
15351,ORD_15352,4590,English Lavender Deodorant Roll On Antiperspirant - For Women,Warehouse A,75,57,2025-02-17 18:38:00,18
15352,ORD_15353,7108,Sirona Hair Removal Cream 100 gm,Warehouse C,53,37,2025-02-17 06:27:00,16
15353,ORD_15354,28856,Heampro 100mg Injection,Warehouse A,39,28,2025-02-17 04:40:00,11
15354,ORD_15355,2713,Elderyl D Syrup,Warehouse A,65,50,2025-02-17 23:22:00,15
15355,ORD_15356,10276,Tobravas Eye Drop,Warehouse B,64,48,2025-02-17 14:12:00,16
15356,ORD_15357,18669,FREXCEZ USB 3.0 Type C Female to USB A Male Connector/Converter/Adapter Compatible for All Type-C Devices (Multi-Color),Warehouse B,33,21,2025-02-17 09:16:00,12
15357,ORD_15358,34103,GlycoDab,Warehouse A,95,89,2025-02-17 10:35:00,6
15358,ORD_15359,14458,"boAt Stone 1200 14W Bluetooth Speaker with Upto 9 Hours Battery, RGB LEDs, IPX7 and TWS Feature(Jazzy Blue)",Warehouse A,53,37,2025-02-17 02:13:00,16
15359,ORD_15360,35483,"Gizga Essentials Portable Mobile Tabletop Stand, Precise Cutout to Enable Charging During Use, Sturdy Metal, Mobile Chargi...",Warehouse C,112,95,2025-02-17 21:51:00,17
15360,ORD_15361,5478,Ajmal 2 Persuade & Distraction Deodorant Pack of 3 Deodorants 200 ml,Warehouse A,25,9,2025-02-17 19:05:00,16
15361,ORD_15362,19872,Dyazo Upgraded 6 Fan Cooling Pad Laptop Raiser with Adjustable Height & Mute Fans for | for Laptop & Notebooks 10-15.6 inc...,Warehouse A,36,20,2025-02-17 00:11:00,16
15362,ORD_15363,13832,Ezydapa M 10mg/500mg Tablet ER,Warehouse B,104,90,2025-02-17 09:52:00,14
15363,ORD_15364,35766,Baidyanath Mahabringraj Oil 200 ml,Warehouse A,28,19,2025-02-17 04:06:00,9
15364,ORD_15365,28296,Beauty People Matte Lucious Liquid Lip Colorblush - L13 ,Warehouse C,53,34,2025-02-17 23:00:00,19
15365,ORD_15366,10849,Cefunis 250mg Tablet,Warehouse A,50,44,2025-02-17 15:16:00,6
15366,ORD_15367,13121,"realme 9 5G SE (Azure Glow, 8GB RAM, 128GB Storage)",Warehouse A,61,45,2025-02-17 00:23:00,16
15367,ORD_15368,24545,Mcef 50 Dry Syrup,Warehouse B,21,15,2025-02-17 01:43:00,6
15368,ORD_15369,34578,Herbal Pineapple Soap,Warehouse B,44,28,2025-02-17 07:12:00,16
15369,ORD_15370,13307,Rejuvenating UBTAN Lip Balm - Rose 5 gm,Warehouse C,56,43,2025-02-17 17:59:00,13
15370,ORD_15371,18733,"POSH Display Port DP Male to HDMI Female Adapter Cable for DELL, HP, AMD",Warehouse B,99,93,2025-02-17 09:27:00,6
15371,ORD_15372,13091,"EMBOX Cube Extension Boards with USB Port with Universal Sockets and USB (2.4 A) Charging Ports (QC 3.0) with Indicator, ...",Warehouse C,82,73,2025-02-17 13:27:00,9
15372,ORD_15373,16270,Olmetor 20 Tablet,Warehouse C,33,21,2025-02-17 10:46:00,12
15373,ORD_15374,8289,Olarc 10mg Tablet,Warehouse A,38,19,2025-02-17 13:52:00,19
15374,ORD_15375,2967,Febrinil 125mg Suspension,Warehouse C,97,79,2025-02-17 07:53:00,18
15375,ORD_15376,4608,Buds,Warehouse C,62,56,2025-02-17 15:24:00,6
15376,ORD_15377,26791,I Am Eyeconic Matte Neon Pure Pigments EXPLOSIVE ORANGE 2 gm,Warehouse A,86,75,2025-02-17 20:28:00,11
15377,ORD_15378,37005,Neem Capsules,Warehouse C,93,83,2025-02-17 20:14:00,10
15378,ORD_15379,4905,Perfumed Talc - Fresh Flower Shower,Warehouse A,65,49,2025-02-17 18:26:00,16
15379,ORD_15380,17764,"realme narzo 50A Prime (Flash Black, 4GB RAM+128GB Storage) FHD+ Display | 50MP AI Triple Camera (No Charger Variant)",Warehouse B,45,40,2025-02-17 21:30:00,5
15380,ORD_15381,7829,"Laprite Keyboard Protector Cover for 2022 ASUS TUF Dash 15 15.6"" FX517ZM FX517ZM-AS73, TUF Gaming F15 FX507ZM-ES74, TUF Ga...",Warehouse C,43,27,2025-02-17 10:04:00,16
15381,ORD_15382,3681,ZOUK Multicolored Printed Handmade Vegan Leather Women's Office Bag for 15.6 inch Laptop with Double Handles - WavBeach,Warehouse B,37,18,2025-02-17 17:53:00,19
15382,ORD_15383,10270,Safpime 1000mg Injection,Warehouse B,76,68,2025-02-17 06:02:00,8
15383,ORD_15384,25788,Moxilup 250mg Capsule,Warehouse C,66,48,2025-02-17 22:36:00,18
15384,ORD_15385,429,Pikkme Samsung Galaxy M12 / F12 / A12 Flip Cover| PU Leather Finish | 360 Protection | Wallet & Stand | Strong Magnetic Fl...,Warehouse A,74,62,2025-02-17 03:52:00,12
15385,ORD_15386,24547,Vitopride 4mg Tablet,Warehouse B,45,31,2025-02-17 03:40:00,14
15386,ORD_15387,1746,Nu Bolic 50mg Injection,Warehouse C,54,47,2025-02-17 03:33:00,7
15387,ORD_15388,813,"Amazon Basics Magic Slate 8.5-inch LCD Writing Tablet with Stylus Pen, for Drawing, Playing, Noting by Kids & Adults, Black",Warehouse C,53,37,2025-02-17 05:24:00,16
15388,ORD_15389,36751,"Belkin 65W Gan Dual USB C Pd 3.0 Fast Charger with Pps Technology, Compact Size, USB-C, Type C Fast Charger for iPhone, Ma...",Warehouse B,69,59,2025-02-17 00:08:00,10
15389,ORD_15390,8310,Bella Vita Organic Noseglow Natural Nose Scrub 20 gm,Warehouse C,27,17,2025-02-17 18:53:00,10
15390,ORD_15391,13825,Rabclear D 10mg/20mg Tablet,Warehouse A,103,88,2025-02-17 17:27:00,15
15391,ORD_15392,31673,"Aroma® NB120 Tehalka Pro Bluetooth Wireless In Ear Headset Neckband with Long Lasting Playtime 40 Hrs,Smart Voice Assistan...",Warehouse B,28,12,2025-02-17 09:39:00,16
15392,ORD_15393,22985,Fusikab B Cream,Warehouse C,82,77,2025-02-17 06:45:00,5
15393,ORD_15394,16257,"HP 300 Dual Mode Black Mouse, Switch Between Two PCs via Bluetooth or 2.4 GHz Wireless, Smart TV Connectivity, 1200 to 360...",Warehouse B,22,13,2025-02-17 03:45:00,9
15394,ORD_15395,18700,Razer Basilisk V3 Customizable Ergonomic Gaming Wired Mouse: Chroma RGB Lighting - 26K DPI Optical Sensor - 11 Programmabl...,Warehouse A,15,7,2025-02-17 09:07:00,8
15395,ORD_15396,7837,BKN® Spiral Charger Cable Protector Data Cable Saver Charging Cords Protective for All Universal Earphone & Cable Cover (B...,Warehouse B,43,34,2025-02-17 03:58:00,9
15396,ORD_15397,34358,"Sery Color Flirt Nail Paint Glitter, Rose Gold Hint 10 ml",Warehouse C,8,3,2025-02-17 14:33:00,5
15397,ORD_15398,29909,"Tukzer Single 13 to 27-inch(33 to 68.5cm) LCD Monitor Desk Mount Stand, Height Adjustable Arm Mount, Fully Adjustable, Til...",Warehouse B,11,2,2025-02-17 09:35:00,9
15398,ORD_15399,22215,Rampace 2.5mg Tablet,Warehouse A,18,7,2025-02-17 15:15:00,11
15399,ORD_15400,13138,"Brustro Artists Wiro Bound Sketch Book, A3 Size, 120 Pages, 160 GSM (Acid Free)",Warehouse B,102,92,2025-02-17 06:47:00,10
15400,ORD_15401,17543,Vrodic 75 Injection,Warehouse A,41,32,2025-02-17 02:13:00,9
15401,ORD_15402,34310,"CodersParadise Pack of 57 Harry Potter Movie Stickers for Laptop, Journal, Diary, Guitar, Mobile Case - Aesthetic Waterpro...",Warehouse A,53,34,2025-02-17 21:37:00,19
15402,ORD_15403,10908,"Sery Color Flirt Nail Paint Matte, Blue Fly 10 ml",Warehouse B,58,40,2025-02-17 18:46:00,18
15403,ORD_15404,12459,"Maybelline New York Instant Age Rewind Concealer, Medium, 6g and Maybelline New York Instant Age Rewind Concealer, Carame...",Warehouse C,21,15,2025-02-17 18:46:00,6
15404,ORD_15405,7033,MyGlamm Lip Volumizer Instant Mega Plumping Lip Gloss 2.9 gm,Warehouse C,80,61,2025-02-17 03:49:00,19
15405,ORD_15406,5578,Dioflox Suspension,Warehouse C,117,99,2025-02-17 13:03:00,18
15406,ORD_15407,28625,M.G.R.J® Tempered Glass Screen Protector for Huami Amazfit T Rex/Amazfit T Rex Pro (Pack of 2),Warehouse A,107,99,2025-02-17 21:54:00,8
15407,ORD_15408,10580,Hidden Desire For Women,Warehouse C,47,34,2025-02-17 03:24:00,13
15408,ORD_15409,2235,"truke Buds S1 Bluetooth 5.1 Truly Wireless in Ear Earbuds with Mic for Clear Calls, Environmental Noise Cancellation(ENC),...",Warehouse A,84,65,2025-02-17 21:40:00,19
15409,ORD_15410,24953,Flawless Day Cream,Warehouse B,65,46,2025-02-17 05:53:00,19
15410,ORD_15411,10577,boAt bassheads 105 Wired in Ear Earphones with Mic (Green),Warehouse A,23,15,2025-02-17 12:15:00,8
15411,ORD_15412,22652,Blaze - Eau De Parfum,Warehouse B,83,65,2025-02-17 01:19:00,18
15412,ORD_15413,34219,Ceftag 1000mg Injection,Warehouse C,84,65,2025-02-17 02:18:00,19
15413,ORD_15414,6280,Trajectory Vegan Leather 15.6 Inch Laptop Messenger MacBook Office Bag with 2 Years Warranty and Dual Compartment with Exp...,Warehouse B,82,66,2025-02-17 21:38:00,16
15414,ORD_15415,18009,EGOTUDE Silicone Soft Case Camera Protection Microfiber Lining Back Cover for iPhone 14 (Navy Blue),Warehouse C,106,92,2025-02-17 16:12:00,14
15415,ORD_15416,17863,"Blaupunkt SBA40 60W Bluetooth Soundbar Speaker with Bluetooth, AUX, USB, Mini Soundbar for TV/PC/Projectors/Tablets",Warehouse B,90,77,2025-02-17 21:47:00,13
15416,ORD_15417,4537,Gold + Charcoal Dual System Facial Sheet Mask,Warehouse A,47,35,2025-02-17 07:12:00,12
15417,ORD_15418,2171,"TRIVETY Cream Conceal Concealer, Green Corrector Concealer (MULTI, 24 g Concealer (green, yellow, orange, 8 g) set of 3 Pr...",Warehouse C,14,7,2025-02-17 03:58:00,7
15418,ORD_15419,17657,"Upix® AC Remote No. 18A, Compatible for Voltas AC Remote Control (Exactly Same Remote Will Only Work)",Warehouse B,72,57,2025-02-17 12:03:00,15
15419,ORD_15420,2863,ZOUK Multicolor Graphic Printed Handmade Vegan Leather Women's Office Bag for 15.6 inch Laptop with Double Handles - Paisley,Warehouse B,51,46,2025-02-17 08:35:00,5
15420,ORD_15421,10200,My Passion For Him - EDP 30 ml,Warehouse C,67,53,2025-02-17 17:56:00,14
15421,ORD_15422,9163,Hand Made Soap - Vetiver,Warehouse B,45,30,2025-02-17 03:34:00,15
15422,ORD_15423,36680,Purifying Cleanser 100 ml + Purifying Toner 100 ml,Warehouse A,58,41,2025-02-17 03:38:00,17
15423,ORD_15424,30886,BB Dily Blemish Balm spf 20 60g,Warehouse C,52,41,2025-02-17 23:21:00,11
15424,ORD_15425,6695,Faber-Castell Tack-It - 90 pieces (Light Green),Warehouse A,20,15,2025-02-17 16:19:00,5
15425,ORD_15426,7779,Moisturizing Body Bath - Green Tea & Milk,Warehouse C,67,61,2025-02-17 03:23:00,6
15426,ORD_15427,6333,Flormar Kiss Me More Lip Tattoo 03 Skin 3.8 gm,Warehouse C,97,78,2025-02-17 03:27:00,19
15427,ORD_15428,17671,ORDERSHOCK Rudra and Trishul Tattoo Waterproof Men and Women Temporary Tattoo Sticker,Warehouse B,61,56,2025-02-17 10:04:00,5
15428,ORD_15429,23131,Longlast Condoms,Warehouse B,72,53,2025-02-17 13:37:00,19
15429,ORD_15430,13805,Lrz M 5mg/10mg Tablet,Warehouse A,21,3,2025-02-17 15:05:00,18
15430,ORD_15431,23123,"Deltoid Lite Face Masks In Royal Blue, Grey & Sky Blue Knit Fabrics With Bindings - Assorted, 3C2002, Small",Warehouse A,116,97,2025-02-17 10:39:00,19
15431,ORD_15432,21326,"Dell (Renewed) OPTIPLEX 3040 Tiny Desktop (Intel Core i3 6th gen 3.2ghz, 8 GB RAM, 480gb SSD, Windows 11 (Upgraded), MS Of...",Warehouse C,74,64,2025-02-17 13:22:00,10
15432,ORD_15433,31557,Redmi Note 12 5G Frosted Green 6GB RAM 128GB ROM | 1st Phone with 120Hz Super AMOLED and Snapdragon® 4 Gen 1 | 48MP AI Tri...,Warehouse A,52,39,2025-02-17 15:22:00,13
15433,ORD_15434,19726,"ProElite Smart PU Flip Case Cover for Apple iPad 9.7"" 2017 2018 Air 1 Air 2 (A1893/A1954) (Black) with Pencil Holder",Warehouse C,22,11,2025-02-17 17:15:00,11
15434,ORD_15435,8753,Sardip P 50mg/325mg Tablet,Warehouse A,69,60,2025-02-17 21:50:00,9
15435,ORD_15436,1645,Ajmal Wisal & Silver Shade & Sacrificeiihim & Raindropss Deo & Neea EDP Pack of 5 20 ml,Warehouse C,47,29,2025-02-17 06:53:00,18
15436,ORD_15437,33145,POPIO Tempered Glass Screen Protector Compatible for OnePlus 6T / OnePlus 7 with Edge to Edge Coverage and Easy Installati...,Warehouse B,25,9,2025-02-17 16:54:00,16
15437,ORD_15438,10551,L Cbit MK Kid 2.5mg/4mg Tablet,Warehouse B,28,19,2025-02-17 18:49:00,9
15438,ORD_15439,4705,World Shopper processer CPU Fan i3/i5/i7 LGA115x CPU Fan E97379 003 Core i3 i5 i7 Socket 1150 1155 1156 4-Pin Connector CP...,Warehouse A,74,55,2025-02-17 07:26:00,19
15439,ORD_15440,8797,"SHENY AMAZING MAKEUP COMBO,1 PRIMER,1 CONCEALER FOR GILRS",Warehouse C,71,55,2025-02-17 18:37:00,16
15440,ORD_15441,15027,"EvoFox Falcon X35 Gaming Mouse Pad with Micro-Textured Speed Surface, Non-Slip Rubber Base, Anti-fray Stitched Edges and W...",Warehouse A,62,46,2025-02-17 09:43:00,16
15441,ORD_15442,32386,"Adult Diaper Pants - Unisex, M",Warehouse A,77,61,2025-02-17 14:11:00,16
15442,ORD_15443,19717,Wecool Moonwalk M1 Bluetooth Truly Wireless in Ear Earbuds with Mic (Black),Warehouse C,17,1,2025-02-17 19:45:00,16
15443,ORD_15444,3448,"{2022 NEW UPDATE} Attrrix® True Wireless Earbuds with Power Bank Charge your phone, Upto 220 Hours Total playback (Chargin...",Warehouse C,103,94,2025-02-17 04:29:00,9
15444,ORD_15445,2261,Pumpkin Seeds - Roasted & Salted,Warehouse C,77,70,2025-02-17 11:21:00,7
15445,ORD_15446,11850,Casflox OZ 200mg/500mg Tablet,Warehouse A,20,5,2025-02-17 22:39:00,15
15446,ORD_15447,24932,Onsitego 2 Year Extended Warranty for Small Household Appliances from Rs. 4001-5000 (Email Delivery - No Physical Kit),Warehouse B,47,42,2025-02-17 10:53:00,5
15447,ORD_15448,20703,Zinase-D Tablet,Warehouse B,19,3,2025-02-17 18:45:00,16
15448,ORD_15449,25988,Flormar Glam Strobing Cream 02 Peach 35 ml,Warehouse B,102,93,2025-02-17 12:34:00,9
15449,ORD_15450,8175,Lotus Herbals Youthrx Activating Serum + Creme 30 Ml,Warehouse C,68,50,2025-02-17 09:45:00,18
15450,ORD_15451,3382,STRIFF Laptop Stand Adjustable Laptop Computer Stand Multi-Angle Stand Phone Stand Portable Foldable Laptop Riser Notebook...,Warehouse A,15,3,2025-02-17 22:21:00,12
15451,ORD_15452,18255,"WeCool C1 Car Mobile Holder with One Click Technology,360° Rotational, Strong Suction Cup,Compatible with 4 to 6 Inch Devi...",Warehouse B,78,70,2025-02-17 14:54:00,8
15452,ORD_15453,33180,Etilol 0.5mg/20mg Tablet,Warehouse A,105,92,2025-02-17 07:10:00,13
15453,ORD_15454,10426,AILKIN 20W PD Charger for iPhone Original 20W PD Fast Type C Wall Charger with Charging Compatible Compatible with iPhone1...,Warehouse A,31,18,2025-02-17 04:00:00,13
15454,ORD_15455,20484,Tea Tree & Vetiver Aroma Radical Refresher Conditioner,Warehouse B,13,1,2025-02-17 11:29:00,12
15455,ORD_15456,14439,Ajmal Mukhallat Raaqi Concentrated Perfume Oil Floral Fruity And Blu Homme Deodorant Aquatic Woody Fragrance 210 ml,Warehouse B,17,3,2025-02-17 13:00:00,14
15456,ORD_15457,22646,"Fashion Colour Shimmer Brick And Blusher, Shade 01 8 gm",Warehouse C,45,38,2025-02-17 18:35:00,7
15457,ORD_15458,18223,"Fashion Colour Non - Transfer Matt Waterproof Lipstick, 36 Royal Violet 2.6 gm",Warehouse B,26,9,2025-02-17 23:06:00,17
15458,ORD_15459,15033,AKAI HA-TS50 50W Bluetooth Tower Speaker Wooden Cabinet Subwoofer Echo Sound Control Full Control Remote Led Display USB F...,Warehouse C,87,69,2025-02-17 18:22:00,18
15459,ORD_15460,16135,Cardivas 3.125 Tablet,Warehouse C,98,80,2025-02-17 06:42:00,18
15460,ORD_15461,33543,MyGlamm LIT Matte Lipliner Pencil-Pretty Mess (Brown)-1.14 gm | 5HR Feather-Proof | With Vegetable Wax | Highly-pigmented ...,Warehouse B,93,81,2025-02-17 00:57:00,12
15461,ORD_15462,26257,Valzaar SM Capsule,Warehouse B,52,34,2025-02-17 04:14:00,18
15462,ORD_15463,1395,"Fashion Colour Terra Cotta Blusher, Shade 20 8 gm",Warehouse C,96,82,2025-02-17 13:41:00,14
15463,ORD_15464,14386,ACESHLEY Band 2022 Silicone Realme Band Strap with Black Metal Buckle Compatible for Realme Smart Band RMA 183 Black (Trac...,Warehouse A,67,49,2025-02-17 02:36:00,18
15464,ORD_15465,34083,Sorbiline Syrup,Warehouse C,112,96,2025-02-17 20:33:00,16
15465,ORD_15466,1943,Reswas Syrup,Warehouse B,24,6,2025-02-17 12:46:00,18
15466,ORD_15467,28266,CEDO OnePlus Nord 2T (5G) Case Back Cover Shockproof Bumper Crystal Clear | 360 Degree Protection TPU+PC | Camera Protecti...,Warehouse C,23,9,2025-02-17 16:03:00,14
15467,ORD_15468,29712,Makeup Revolution Power Eyeshadow Palette Ready Set Go,Warehouse A,110,93,2025-02-17 14:59:00,17
15468,ORD_15469,3480,A Clin Gel,Warehouse B,57,41,2025-02-17 12:45:00,16
15469,ORD_15470,17690,Impride-M 1 Tablet,Warehouse C,48,38,2025-02-17 20:57:00,10
15470,ORD_15471,24574,TELESIN Battery Charger 3-Channel USB Battery Quick Charger with Type-C Cord for GoPro Hero 10/9 Black (Only Charger - Black),Warehouse B,54,35,2025-02-17 12:25:00,19
15471,ORD_15472,27803,Biocef 1g Injection,Warehouse A,91,86,2025-02-17 20:49:00,5
15472,ORD_15473,24570,Cypon Capsule,Warehouse C,101,87,2025-02-17 05:35:00,14
15473,ORD_15474,30835,"Wings Phantom 105 Wireless in Ear Earbuds with Mic, RGB LED Gaming Design. 60 Hours Mega Playtime, 13 mm HD BASS Drivers, ...",Warehouse C,74,60,2025-02-17 17:47:00,14
15474,ORD_15475,4030,Gold Pack,Warehouse C,45,35,2025-02-17 11:03:00,10
15475,ORD_15476,20801,"Fashion Colour Face & Body Hi - Lite Bronzer, Shade 01 4 gm",Warehouse C,103,88,2025-02-17 04:51:00,15
15476,ORD_15477,986,Lotus Herbals Berryscrub Strawberry & Aloe Vera Exfoliating Face Wash 80 Gm,Warehouse A,112,94,2025-02-17 10:28:00,18
15477,ORD_15478,34577,Bilactam XL 200 mg/125 mg Tablet,Warehouse A,27,22,2025-02-17 07:08:00,5
15478,ORD_15479,23090,Zyfix 50mg Dry Syrup,Warehouse C,26,7,2025-02-17 07:40:00,19
15479,ORD_15480,25675,Spin Tree 20mg/40mg Tablet,Warehouse C,101,91,2025-02-17 05:35:00,10
15480,ORD_15481,34912,JOKIN Bluetooth Speaker Karaoke Machine Speaker WS-04 Karaoke Mic System Speaker for Home Office Party,Warehouse C,45,28,2025-02-17 09:36:00,17
15481,ORD_15482,24210,iBOND 65 Watt Warp Charger for Oneplus 65W Wrap Charging with USB to C Cable Charger Compatible for OnePlus 10/10 Pro/9/9 ...,Warehouse A,101,89,2025-02-17 19:00:00,12
15482,ORD_15483,36229,Telmipil H 80mg/12.5mg Tablet,Warehouse A,55,49,2025-02-17 20:48:00,6
15483,ORD_15484,26279,Nuzith 200mg Oral Suspension,Warehouse C,83,74,2025-02-17 11:52:00,9
15484,ORD_15485,9788,Gold Face Pack,Warehouse B,25,17,2025-02-17 17:09:00,8
15485,ORD_15486,27815,Adglim P 30mg Tablet,Warehouse C,20,4,2025-02-17 11:38:00,16
15486,ORD_15487,12346,Flormar Kiss Me More Lip Tattoo 06 Doll 3.8 gm,Warehouse C,29,19,2025-02-17 09:16:00,10
15487,ORD_15488,13403,ONCRO� Fast Charging 30Pin to USB Data Syncing and Charging Cable for Samsung Galaxy Tab 2 10.1 P5110/P5100/P3100 7.1 Char...,Warehouse A,30,24,2025-02-17 10:55:00,6
15488,ORD_15489,21541,VITRO I AM NATURAL Aloe vera & Jojoba shampoo 250 ml,Warehouse A,44,29,2025-02-17 08:49:00,15
15489,ORD_15490,9093,Root Restore Oil,Warehouse B,75,61,2025-02-17 23:10:00,14
15490,ORD_15491,7817,Pedxim 200mg Tablet,Warehouse A,104,98,2025-02-17 08:20:00,6
15491,ORD_15492,3479,Glow - Handmade Sandal Turmeric Bathing Bar With Natural Chunks,Warehouse B,36,31,2025-02-17 04:03:00,5
15492,ORD_15493,36812,Superdrug Vitamin E Micellar Oil Pads X60 1's,Warehouse A,97,90,2025-02-17 07:15:00,7
15493,ORD_15494,22148,"JBL Commercial CSLM20B Auxiliary Omnidirectional Lavalier Microphone With Battery For Content Creation, Voiceover/Dubbing,...",Warehouse B,81,68,2025-02-17 20:09:00,13
15494,ORD_15495,8344,Clovis-P Tablet,Warehouse A,29,10,2025-02-17 07:33:00,19
15495,ORD_15496,35452,Sernaz V1 Tablet VT,Warehouse C,51,36,2025-02-17 01:03:00,15
15496,ORD_15497,36235,TheGiftKart Translucent Hybrid Back Case Cover for OnePlus Nord CE 2 LITE 5G | Smoked Matte Back | 360 Degree Protection |...,Warehouse A,110,91,2025-02-17 03:37:00,19
15497,ORD_15498,2740,"upReale Universal PUBG & Free Fire Game Pro Player Full Hand Gaming Gloves, Anti-Sweat Breathable, Touch Finger Nano-Silve...",Warehouse B,47,30,2025-02-17 14:06:00,17
15498,ORD_15499,20811,"BOBO Non-Toxic TPU and Plastic Dry Bag Case for iPhone Xs Max XR XS X 8 7 6S 6 Plus, Samsung Galaxy S9 S8 + Note 8 6 5 4, ...",Warehouse B,59,46,2025-02-17 14:45:00,13
15499,ORD_15500,17645,Daventyl-Plus 100 Tablet,Warehouse A,31,14,2025-02-17 02:05:00,17
15500,ORD_15501,25682,Nactolax D 150mg/50mg Tablet,Warehouse C,38,23,2025-02-17 12:13:00,15
15501,ORD_15502,18800,Alosia-P Oral Suspension,Warehouse A,35,21,2025-02-17 13:09:00,14
15502,ORD_15503,20664,Pure Hands Tulsi Soap,Warehouse A,70,53,2025-02-17 03:45:00,17
15503,ORD_15504,67,"Panasonic Evolta AA Alkaline 1.5V Battery,20 Times Longer Lasting Than Standard zinc Carbon Batteries,Anti-Leak Seal,Prote...",Warehouse B,64,56,2025-02-17 02:15:00,8
15504,ORD_15505,16337,Maryaj After Dark EDP Woody Aromatic Perfume And Ajmal Carbon Homme Deodorant Citrus Spicy Fragrance 300 ml,Warehouse C,22,3,2025-02-17 17:12:00,19
15505,ORD_15506,27531,"Pradarashamaka Vati - Gynce Care, 500 mg",Warehouse C,47,32,2025-02-17 14:22:00,15
15506,ORD_15507,28909,"VAGHBHATT Large Metal Hair Clips - 4 Inch Large Claw Clips for Women with Thick Hair, 2 Packs Big Gold Hair Clips for Styl...",Warehouse A,86,80,2025-02-17 13:48:00,6
15507,ORD_15508,32865,HUDA BB Professional Waterproof 24 Hours Stay Jet Black Sketch Pen Eyeliner,Warehouse B,97,78,2025-02-17 20:54:00,19
15508,ORD_15509,33617,Gemblue Biocare Fruit Face and Body Scrub 500 ml,Warehouse C,43,29,2025-02-17 18:06:00,14
15509,ORD_15510,5184,Arias By Lara Dutta Revitalizing Night Cream 50 gm,Warehouse B,53,34,2025-02-17 06:41:00,19
15510,ORD_15511,21204,Beauty People Matte Lucious Liquid Lip Colorroyalty - Devine - L27 ,Warehouse B,108,99,2025-02-17 19:03:00,9
15511,ORD_15512,13302,Azicore 500mg Tablet,Warehouse C,62,55,2025-02-17 04:50:00,7
15512,ORD_15513,7119,Blenior Wax Strips Complete Set Sensitive 41 Pcs 1's,Warehouse A,115,99,2025-02-17 19:01:00,16
15513,ORD_15514,31951,New MISS DOLL FIIME POWDER Pore-less Oil Control Compact Powder To Absorbs- All Day Matte Finish Face Makeup Fii Me Matte-...,Warehouse B,89,76,2025-02-17 14:52:00,13
15514,ORD_15515,2532,"Acko 1 Year Extended Warranty for Appliances below 10,000 (Email Delivery)",Warehouse B,39,32,2025-02-17 20:02:00,7
15515,ORD_15516,31417,Dolomed 650mg Tablet,Warehouse B,88,69,2025-02-17 10:45:00,19
15516,ORD_15517,19903,Micid DSR Capsule,Warehouse C,67,53,2025-02-17 06:42:00,14
15517,ORD_15518,17735,"SanDisk Extreme microSD UHS I Card 64GB for 4K Video on Smartphones,Action Cams 170MB/s Read,80MB/s Write",Warehouse A,80,61,2025-02-17 00:11:00,19
15518,ORD_15519,25738,CP PLUS 3+1 Coaxial Pure Copper CCTV Camera Cable (90 Meter) White,Warehouse B,18,1,2025-02-17 08:56:00,17
15519,ORD_15520,32743,"Portronics Clamp M Car Mobile Holder with 360° Rotational, Strong Suction Cup, One Click Release Button Compatible with 4 ...",Warehouse C,26,9,2025-02-17 06:54:00,17
15520,ORD_15521,11878,Norma 5mg Tablet,Warehouse A,27,10,2025-02-17 12:58:00,17
15521,ORD_15522,1574,Microflox DX Eye Drop,Warehouse B,93,88,2025-02-17 05:46:00,5
15522,ORD_15523,29093,Medimade Green Tea Premium Soap 100 gm,Warehouse B,30,25,2025-02-17 20:23:00,5
15523,ORD_15524,25530,Tea Tree Skin Clearing Scrub,Warehouse A,83,66,2025-02-17 06:03:00,17
15524,ORD_15525,35392,Penegra 25 Tablet,Warehouse B,23,9,2025-02-17 22:08:00,14
15525,ORD_15526,31239,Moroccan Argan Oil Shampoo For Well Moisturised & Conditioned Hair,Warehouse C,81,69,2025-02-17 01:03:00,12
15526,ORD_15527,191,Metwohn 1000mg Tablet,Warehouse C,106,88,2025-02-17 14:28:00,18
15527,ORD_15528,4466,CP PLUS 2MP Full HD Smart Wi-fi CCTV Home Security Camera | 360° with Pan Tilt | 2Way Talk | Cloud Monitor | Motion Detect...,Warehouse C,67,51,2025-02-17 18:43:00,16
15528,ORD_15529,8434,Ultra Overnight Sanitary Pads With Wings - XXL Plus,Warehouse C,20,1,2025-02-17 11:22:00,19
15529,ORD_15530,11069,F Gear Milestone Olive Casual 20 Ltrs Laptop Backpack (3376),Warehouse A,94,78,2025-02-17 23:17:00,16
15530,ORD_15531,26348,Olicold Tablet,Warehouse A,63,44,2025-02-17 04:54:00,19
15531,ORD_15532,18926,"Samsung Galaxy M32 Prime Edition (Light Blue, 4GB RAM, 64GB)",Warehouse A,44,26,2025-02-17 12:32:00,18
15532,ORD_15533,33330,Daily Life Forever52 Foundation Brush Nx004 1's,Warehouse C,44,32,2025-02-17 01:02:00,12
15533,ORD_15534,12631,Tramlik 50mg Tablet,Warehouse B,27,8,2025-02-17 08:39:00,19
15534,ORD_15535,27465,"Acko 1 Year Extended Warranty for Laptops from Rs 20,000 to Rs 30,000 (E-mail delivery)",Warehouse B,32,21,2025-02-17 18:20:00,11
15535,ORD_15536,9245,Evoxil-CV Duos Tablet,Warehouse C,49,32,2025-02-17 09:43:00,17
15536,ORD_15537,28138,HALEEZY,Warehouse A,66,61,2025-02-17 14:17:00,5
15537,ORD_15538,36552,Mactor 10 Tablet,Warehouse B,35,23,2025-02-17 22:12:00,12
15538,ORD_15539,32229,Latur A 400mg/30mg Tablet,Warehouse A,94,84,2025-02-17 07:12:00,10
15539,ORD_15540,5999,Rastrol 10 Tablet,Warehouse A,97,80,2025-02-17 21:42:00,17
15540,ORD_15541,13949,Ecosprin AV 150/20 Capsule,Warehouse B,71,65,2025-02-17 07:52:00,6
15541,ORD_15542,11589,Bathing Soap - Ayurvedic Classic 18 Herbs,Warehouse B,41,32,2025-02-17 12:31:00,9
15542,ORD_15543,15300,Premium Quality 100% Organic Beard & Stache Wax,Warehouse B,59,45,2025-02-17 21:20:00,14
15543,ORD_15544,6529,AmazonBasics UV Protection Lens Filter - 58 mm,Warehouse B,61,48,2025-02-17 11:14:00,13
15544,ORD_15545,25318,ASUS Prime H510M-Emicroatx Motherboard Lga1200 for 11Th & 10Th Gen Processor Ddr4,Warehouse A,95,80,2025-02-17 20:25:00,15
15545,ORD_15546,19368,"EOD Elite Collection Long Lasting Waterproof 100% Vegan Made in India Matte Liquid Lipstick Combo of 2 Lip Gloss(Maroon, W...",Warehouse B,44,27,2025-02-17 10:06:00,17
15546,ORD_15547,31663,"OneAudio USB C Hub 7 in 2 Adapter PD Power Delivery, SD/TF Card Reader, 4K USB C to HDMI, 2 USB 3.0 Ports Type C for 2016 ...",Warehouse B,34,19,2025-02-17 21:42:00,15
15547,ORD_15548,16842,Ajmal Nightingale And Distraction For Men & Women And Sacred Love Deodorants Pack of 3 200 ml,Warehouse C,20,2,2025-02-17 13:30:00,18
15548,ORD_15549,16844,"Buransh Eyelid Tape, Invisible Double Eyelid Stickers, Waterproof Eyelid Lifter Strips with Fork Rod (300 PC)",Warehouse C,39,27,2025-02-17 04:38:00,12
15549,ORD_15550,32130,Cefirest O Dry Syrup,Warehouse C,32,24,2025-02-17 23:38:00,8
15550,ORD_15551,8991,TheGiftKart Transparent Crystal Clear Shockproof TPU Back Cover Case for Samsung Galaxy S10 Lite (Transparent),Warehouse B,61,48,2025-02-17 04:21:00,13
15551,ORD_15552,7226,Hand & Nail Cream,Warehouse A,44,25,2025-02-17 04:24:00,19
15552,ORD_15553,14096,Parcet 10mg Tablet,Warehouse B,20,9,2025-02-17 09:59:00,11
15553,ORD_15554,23338,Soulflower Cool Aloe Vera Soap 150 gm,Warehouse A,50,44,2025-02-17 22:55:00,6
15554,ORD_15555,12764,Ascend Eau De Parfum Oriental Perfume - Office Wear For Men & Women,Warehouse A,76,63,2025-02-17 19:10:00,13
15555,ORD_15556,32868,LIRAMARK USB 3.0 Type C Female to USB A Male Connector/Converter/Adapter Compatible for All Type-C Devices (Black),Warehouse C,70,65,2025-02-17 18:48:00,5
15556,ORD_15557,305,"ZEBRONICS Zeb-Thunder Bluetooth Wireless Over Ear Headphone FM, mSD, 9 hrs Playback with Mic (Black)",Warehouse A,13,4,2025-02-17 03:17:00,9
15557,ORD_15558,31892,Sensitive Toothbrush - Gentle Soft Bristles,Warehouse C,44,25,2025-02-17 01:44:00,19
15558,ORD_15559,34800,Pro Keratin & Argan Oil Smooth Therapy Shampoo,Warehouse A,83,68,2025-02-17 18:14:00,15
15559,ORD_15560,29081,Maryaj Pebble Style EDP Spicy Woody Perfume And Ajmal Sacrifice II For Him Deodorant Fruity Aromatic Fragrance 300 ml,Warehouse A,85,71,2025-02-17 07:45:00,14
15560,ORD_15561,36569,Elthrocin 500mg Tablet,Warehouse B,16,9,2025-02-17 22:14:00,7
15561,ORD_15562,15874,GO SHOPS FireBoltt 360 SpO2 Smart Watch Charger 2 Pin USB Fast Charger Magnetic Charging Cable Adapter (smart watch charge...,Warehouse C,101,91,2025-02-17 05:37:00,10
15562,ORD_15563,27309,Strawberry Bathing Soap,Warehouse A,71,52,2025-02-17 09:16:00,19
15563,ORD_15564,35882,"Krayons Cute Pop Matte Lipstick, Waterproof, Longlasting, 3.5gm Each (Pack of 3)",Warehouse C,26,15,2025-02-17 23:53:00,11
15564,ORD_15565,22062,Vega Mini Flat Brush (R1 - MB) 68 gm,Warehouse A,28,10,2025-02-17 15:25:00,18
15565,ORD_15566,31380,WOW Imagine Soft Silicone Case for Apple iPhone 7 | 8 - Shockproof 360 Degree All Sides Protection with Anti Dust Plugs Sl...,Warehouse A,63,44,2025-02-17 22:46:00,19
15566,ORD_15567,717,Traxo 1000mg Injection,Warehouse B,76,62,2025-02-17 06:02:00,14
15567,ORD_15568,26297,Nucell-TX Cream,Warehouse A,23,8,2025-02-17 15:34:00,15
15568,ORD_15569,30344,Radiant Pearl Cellular Lightening 1 Facial Kit,Warehouse A,72,67,2025-02-17 07:38:00,5
15569,ORD_15570,34902,Cortel M 50 Tablet ER,Warehouse A,43,33,2025-02-17 06:46:00,10
15570,ORD_15571,9529,Nude Edition Eyeshadow Palette 18 (Multi Color) Shimmery Finish,Warehouse C,85,68,2025-02-17 15:36:00,17
15571,ORD_15572,14419,Onoff OZ 200mg/500mg Tablet,Warehouse C,36,21,2025-02-17 02:18:00,15
15572,ORD_15573,7601,Rebinew AC 200mg/20mg Capsule,Warehouse B,113,99,2025-02-17 10:01:00,14
15573,ORD_15574,29194,Azpik 250mg Tablet,Warehouse A,28,9,2025-02-17 21:32:00,19
15574,ORD_15575,16411,Cadpride 2mg Tablet,Warehouse C,71,59,2025-02-17 12:38:00,12
15575,ORD_15576,3935,"GPS Colour Your Dreams 88A for HP CC388A Toner Cartridge for HP Laserjet P1007, P1008,M1213nf, M1136MFP, M126nw MFP, M1218...",Warehouse A,40,29,2025-02-17 16:24:00,11
15576,ORD_15577,3244,Baby Lips Color - Alia Loves New York,Warehouse C,29,19,2025-02-17 01:59:00,10
15577,ORD_15578,9524,"LAPSTER HDMI Switch Splitter, 2 Port Bi-Directional Manual HDMI Switch 2 in 1 Out or 1 in 2 Out Splitter Supports 4K 2K 3D...",Warehouse C,103,95,2025-02-17 19:18:00,8
15578,ORD_15579,23342,Lotus Herbals Safe Sun 3 In 1 Matte-Look Daily Sunblock Pa+++ Spf-40 100 Gm,Warehouse B,19,13,2025-02-17 22:25:00,6
15579,ORD_15580,27308,"Storite HDMI Extender Female to Female Coupler Adapter for HDTV, Laptop PC, Projector - Black (3 Pack)",Warehouse C,38,27,2025-02-17 23:32:00,11
15580,ORD_15581,6388,"AILKIN 45W USB-C Charger, Samsung Ultra Fast Charger Type C for Samsung Galaxy S22 Ultra/S22+/S22/S21 Ultra/S21 Plus 5G/No...",Warehouse A,78,69,2025-02-17 22:57:00,9
15581,ORD_15582,23418,Alocet D 5 mg/10 mg/5 mg Syrup,Warehouse A,84,78,2025-02-17 14:42:00,6
15582,ORD_15583,7666,Lakme 9To5 Primer + Matte Perfect Cover Foundation C380 Cool Walnut 25 Ml,Warehouse A,108,91,2025-02-17 13:44:00,17
15583,ORD_15584,25180,Hadran-D Tablet,Warehouse C,26,17,2025-02-17 13:55:00,9
15584,ORD_15585,26557,Bioron D 50mg/10mg Tablet,Warehouse A,33,16,2025-02-17 19:48:00,17
15585,ORD_15586,25335,Ligolane Tablet,Warehouse C,40,26,2025-02-17 02:48:00,14
15586,ORD_15587,30244,Brimochek Eye Drop,Warehouse C,36,31,2025-02-17 15:57:00,5
15587,ORD_15588,31054,THERA-WAX (Wax for Physiotherapy)- 500gm,Warehouse B,32,18,2025-02-17 19:28:00,14
15588,ORD_15589,3273,Oracon 200mg Capsule,Warehouse A,69,52,2025-02-17 09:13:00,17
15589,ORD_15590,15379,Colorbar Bubble Glow Sheet Mask 28 gm,Warehouse C,30,17,2025-02-17 00:43:00,13
15590,ORD_15591,24721,"Axe Africa 3 In 1 Body, Face & Hair Wash for Men, Long-Lasting Refreshing Mandarin & Sandalwood Fragrance for Up To 12hrs,...",Warehouse B,37,30,2025-02-17 01:49:00,7
15591,ORD_15592,11557,Robustrion Deer Pattern Flip Stand Case Cover for Samsung Galaxy Tab A8 10.5 inch [SM-X200/X205/X207] 2022 - Vine Red,Warehouse C,114,98,2025-02-17 20:16:00,16
15592,ORD_15593,36928,"L'Oreal Paris Casting Creme Gloss Small Pack, 316 Burgundy 45 Gm",Warehouse C,18,12,2025-02-17 13:15:00,6
15593,ORD_15594,33026,Clapidox O 200mg/200mg Tablet,Warehouse C,83,64,2025-02-17 02:15:00,19
15594,ORD_15595,11369,"realme 10 (Rush White, 8GB Ram) (128 GB Storage)",Warehouse B,91,83,2025-02-17 09:28:00,8
15595,ORD_15596,9851,Nyaflox 200mg Tablet,Warehouse C,58,46,2025-02-17 20:17:00,12
15596,ORD_15597,16926,Linzol 100mg Syrup,Warehouse A,75,69,2025-02-17 15:46:00,6
15597,ORD_15598,23695,Droxivent 250mg Tablet DT,Warehouse A,114,98,2025-02-17 09:13:00,16
15598,ORD_15599,27912,Geminor MP 2 LS  Tablet SR,Warehouse A,95,86,2025-02-17 10:38:00,9
15599,ORD_15600,26924,"Chidakash 7 in 1 Keyboard Cleaner Set, Computer MacBook Earphone Cleaning Kit, Electronic Cleaner Kit, Tablet and Screen D...",Warehouse A,64,47,2025-02-17 00:23:00,17
15600,ORD_15601,9961,Afdase 5mg Tablet,Warehouse B,41,34,2025-02-17 07:50:00,7
15601,ORD_15602,16899,Panasonic CR-2450/5BE Lithium Coin Battery - Pack of 5,Warehouse B,75,68,2025-02-17 23:00:00,7
15602,ORD_15603,1505,"Makeup Revolution Ultimate Lights Cheek Glow Palette For Cheek, Eyes,Face, Forhead",Warehouse B,34,20,2025-02-17 15:50:00,14
15603,ORD_15604,12822,"Samsung Galaxy Buds Live Bluetooth Truly Wireless in Ear Earbuds with Mic, Upto 21 Hours Playtime, Mystic Black",Warehouse A,19,3,2025-02-17 13:11:00,16
15604,ORD_15605,30037,Mamaearth Charcoal Black Longstay Kajal & Cherry Tinted 100% Natural Lip Balm Combo,Warehouse B,108,89,2025-02-17 00:28:00,19
15605,ORD_15606,14097,Riofenac-P Oral Suspension,Warehouse C,53,38,2025-02-17 13:26:00,15
15606,ORD_15607,30251,"Wayona USB C Cable 65W Nylon Braided Type C Fast Charging Charger Lead Compatible with Samsung Galaxy A71 A51 A40 A20E, M3...",Warehouse B,102,90,2025-02-17 10:46:00,12
15607,ORD_15608,14405,Rabzia 20 Tablet,Warehouse B,65,49,2025-02-17 22:06:00,16
15608,ORD_15609,9441,Nervsenz Tablet SR,Warehouse A,64,57,2025-02-17 10:17:00,7
15609,ORD_15610,322,Chymonet AP Tablet,Warehouse C,12,4,2025-02-17 21:07:00,8
15610,ORD_15611,1204,Parox 12.5mg Tablet CR,Warehouse B,58,52,2025-02-17 15:06:00,6
15611,ORD_15612,15750,Gemblue Biocare Wine & Beer Scrub 500 ml,Warehouse C,22,12,2025-02-17 20:10:00,10
15612,ORD_15613,1536,Entero Injection,Warehouse B,60,43,2025-02-17 09:26:00,17
15613,ORD_15614,15752,"IFB 6.5 Kg 5 Star Top Load Washing Machine Aqua Conserve (TL-REW 6.5KG AQUA, White, Hard Water Wash, Smart Sense)",Warehouse A,42,32,2025-02-17 09:46:00,10
15614,ORD_15615,9963,"Apple 2022 11-inch iPad Pro (Wi-Fi, 128GB) - Space Grey (4th Generation)",Warehouse B,36,19,2025-02-17 14:26:00,17
15615,ORD_15616,7454,Hyaluronic Acid Moisture Emulsion,Warehouse C,44,31,2025-02-17 14:04:00,13
15616,ORD_15617,11384,Charmacy Milano Sketch Eyeliner Dark Brunette 0.6 ml,Warehouse B,114,96,2025-02-17 03:31:00,18
15617,ORD_15618,9006,Melbees by Yellow Chimes Hair Clips for Girls Kids Hair Clip Hair Accessories for Girls Set of 24 PCS Cute Characters Tiny...,Warehouse A,60,48,2025-02-17 18:36:00,12
15618,ORD_15619,2088,Saxim 200mg Tablet,Warehouse A,88,72,2025-02-17 06:10:00,16
15619,ORD_15620,23753,"Vivo Y16 (Drizzling Gold, 4GB RAM, 64GB Storage) with No Cost EMI/Additional Exchange Offers",Warehouse C,107,91,2025-02-17 17:33:00,16
15620,ORD_15621,11401,realme Narzo 50 Pro 5G (Hyper Blue 8GB RAM+128GB Storage) Dimensity 920 5G Processor |90Hz Super AMOLED Display,Warehouse B,105,93,2025-02-17 18:12:00,12
15621,ORD_15622,14104,Severt 16mg Tablet,Warehouse C,99,92,2025-02-17 15:31:00,7
15622,ORD_15623,20188,CEFLOX 500 MG TABLET,Warehouse A,48,40,2025-02-17 20:46:00,8
15623,ORD_15624,24739,TheGiftKart Flip Back Cover Case for Samsung Galaxy M33 5G | Genuine Leather Finish | Designer Button | Inbuilt Pockets & ...,Warehouse A,85,69,2025-02-17 16:56:00,16
15624,ORD_15625,2113,"Hilary Rhoda BB Compact Mineral Powder for Face Makeup, Waterproof Long Lasting Natural Glow Compact Powder for Women & Gi...",Warehouse C,69,50,2025-02-17 14:55:00,19
15625,ORD_15626,15412,"HP 15s, Ryzen 5-5500U, 16GB RAM/512GB SSD 15.6-inches(39.6 cm) FHD, Micro-Edge, Anti-Glare Display/Alexa Built-in/Windows ...",Warehouse B,56,39,2025-02-17 22:18:00,17
15626,ORD_15627,25183,Ajmal Diza EDP Fruity Floral Perfume And Jannatul Firdaus Concentrated Perfume Oil Oriental 110 ml,Warehouse A,114,99,2025-02-17 00:54:00,15
15627,ORD_15628,20599,Ifytrox 125mg Injection,Warehouse B,59,46,2025-02-17 03:35:00,13
15628,ORD_15629,3081,"SENS NUTON 1 with 1.7 IPS Display, Orbiter, 5ATM & 150+ Watch Faces & Free Additional Strap (Royal Silver)",Warehouse B,93,85,2025-02-17 09:08:00,8
15629,ORD_15630,19396,HELLO ZONE Rubber Dotted Back Cover for Poco F1,Warehouse C,58,52,2025-02-17 18:35:00,6
15630,ORD_15631,20201,DeBelle Gel Nail Lacquer Mauve Orchid Dark Mauve Nail Polish 8 ml,Warehouse A,78,69,2025-02-17 02:20:00,9
15631,ORD_15632,36080,Trbotel 250mg Tablet,Warehouse A,15,1,2025-02-17 16:43:00,14
15632,ORD_15633,2112,Crispa N 100 mg/500 mg Tablet,Warehouse B,16,8,2025-02-17 11:14:00,8
15633,ORD_15634,27984,Ximenov 100 Tablet DT,Warehouse A,90,72,2025-02-17 19:00:00,18
15634,ORD_15635,33403,"Pagaria 2 in 1 LCD Display Bluetooth 5.0 Transmitter Receiver 3.5mm Stereo Audio Adapter for Car, TV, Speakers, Built in M...",Warehouse C,88,72,2025-02-17 16:42:00,16
15635,ORD_15636,34757,Ornoderm RF Cream,Warehouse B,75,58,2025-02-17 22:54:00,17
15636,ORD_15637,23799,Xiac 125mg Injection,Warehouse B,75,65,2025-02-17 23:43:00,10
15637,ORD_15638,36824,Fortafen Plus 100mg/500mg Tablet,Warehouse C,99,87,2025-02-17 16:54:00,12
15638,ORD_15639,23796,Casotec Basic Case for Samsung Galaxy M13 4G (Thermoplastic Polyurethane_Clear),Warehouse B,21,6,2025-02-17 00:42:00,15
15639,ORD_15640,16825,"Boult Audio Anchor Bluetooth Wireless Over Ear Headphones with Mic, Active Noise Cancellation, 30H Playtime, AUX Option, B...",Warehouse B,108,95,2025-02-17 13:45:00,13
15640,ORD_15641,21660,Bountiful Moisture Body Wash - Murumuru Butter & Rose Aroma,Warehouse A,48,37,2025-02-17 03:03:00,11
15641,ORD_15642,15387,EGOTUDE Slim Fit Silicone Soft Logo Cut Matte Back Cover Case for iPhone 14 Plus (Sierra Blue),Warehouse C,88,78,2025-02-17 20:16:00,10
15642,ORD_15643,36418,Aceta SP  Tablet,Warehouse A,100,91,2025-02-17 08:11:00,9
15643,ORD_15644,5696,Brush & Pumice - Foot (with Handle),Warehouse B,60,50,2025-02-17 15:49:00,10
15644,ORD_15645,15841,Canon PG-47 Ink Cartridge (Black),Warehouse B,108,95,2025-02-17 05:14:00,13
15645,ORD_15646,12184,Telmetake-H 40 Tablet,Warehouse A,52,36,2025-02-17 23:46:00,16
15646,ORD_15647,2766,Fashionury Ultra-Hybrid Soft Crystal Clear Back Case Cover for iPhone 12/12 Pro | Shockproof Design | Camera Protection Bu...,Warehouse A,114,99,2025-02-17 16:45:00,15
15647,ORD_15648,29214,Dicpar-SP Tablet,Warehouse A,34,22,2025-02-17 09:19:00,12
15648,ORD_15649,29060,NOTE ULTRA BLACK DIPLINER 4.5 ml,Warehouse B,30,17,2025-02-17 05:17:00,13
15649,ORD_15650,16495,Beauty People Blow Out Eyeshadow Palette - 15 Colors 01 Intense 18 gm,Warehouse B,21,3,2025-02-17 12:51:00,18
15650,ORD_15651,3987,Arias Sanitizer Spray (Pack of 3 X 600 ml),Warehouse A,108,94,2025-02-17 22:03:00,14
15651,ORD_15652,5003,Ranbiotic 40mg Injection,Warehouse B,18,3,2025-02-17 05:50:00,15
15652,ORD_15653,23293,Koltus 5mg Tablet,Warehouse B,80,72,2025-02-17 08:12:00,8
15653,ORD_15654,35952,"USB C Hub, iSkey Adapter USB C Dongle for MacBook Pro, 6 in 1 USB C to HDMI Multiport Adapter Compatible with USB C Laptop...",Warehouse B,62,45,2025-02-17 02:14:00,17
15654,ORD_15655,26291,Cefaq 100mg Tablet DT,Warehouse B,29,10,2025-02-17 15:16:00,19
15655,ORD_15656,2929,Pexizin 10mg Tablet,Warehouse B,27,20,2025-02-17 01:25:00,7
15656,ORD_15657,33475,"Aditya Labels 110 X 300 Meters Thermal Transfer Barcode Labels Ribbon Premium Wax For Printer TSC, Zebra, Citzen, Datamax,...",Warehouse A,24,6,2025-02-17 09:59:00,18
15657,ORD_15658,31476,L.A Girl Shockwave Neon Eye Liner - Vivid ( Purple ) 1.2 gm,Warehouse A,69,64,2025-02-17 00:44:00,5
15658,ORD_15659,35089,Ekolac B Sachet (1gm Each),Warehouse A,81,74,2025-02-17 20:01:00,7
15659,ORD_15660,17248,"Mivi DuoPods A350 Earbuds- 50hrs Playtime True Wireless in Ear Earbuds with mic. Rich Bass, 13mm Dynamic Drivers, Fast Cha...",Warehouse A,42,30,2025-02-17 08:32:00,12
15660,ORD_15661,2770,"insta360 ONE RS Twin Edition Waterproof Optical Zoom, 1x 4K 60fps Action Camera & 5.7K 360 Camera with Interchangeable Len...",Warehouse C,36,28,2025-02-17 07:59:00,8
15661,ORD_15662,11032,Asozen 100 Tablet,Warehouse A,108,98,2025-02-17 21:01:00,10
15662,ORD_15663,27175,Leekuf Syrup,Warehouse A,57,43,2025-02-17 10:33:00,14
15663,ORD_15664,18895,F&D 15 Watts F210X 2.1 Channel Multimedia Bluetooth Speakers (Black),Warehouse A,59,54,2025-02-17 12:07:00,5
15664,ORD_15665,54,"Maybelline New York Fit Me Matte+Poreless Liquid Foundation Tube, 330 Toffee 18 gm",Warehouse C,34,20,2025-02-17 07:52:00,14
15665,ORD_15666,26368,Flormar Color Up Lip Crayon 08 Cranberry 3.2 gm,Warehouse C,58,48,2025-02-17 15:17:00,10
15666,ORD_15667,34021,Essential Oil - Fennel Seed,Warehouse C,61,46,2025-02-17 16:38:00,15
15667,ORD_15668,20054,Citoage Syrup,Warehouse C,75,70,2025-02-17 08:37:00,5
15668,ORD_15669,31716,SWAPKART Type C to 3.5mm Splitter Audio Jack Converter Adapter Headphones Jack Compatible with only OnePlus Devices 6 6T 7...,Warehouse C,95,87,2025-02-17 17:05:00,8
15669,ORD_15670,20055,Ajmal Prose EDP & Vibrant Ether EDT Pack of 2 350 ml,Warehouse B,40,22,2025-02-17 06:01:00,18
15670,ORD_15671,10135,Procold Tablet,Warehouse C,64,50,2025-02-17 23:15:00,14
15671,ORD_15672,35944,Pikkme Samsung Galaxy M33 5G Flip Cover | PU Leather Finish | 360 Protection | Wallet & Stand | Strong Magnetic Flip Case ...,Warehouse A,49,44,2025-02-17 18:45:00,5
15672,ORD_15673,25611,Mecofree Injection,Warehouse A,20,9,2025-02-17 19:00:00,11
15673,ORD_15674,21604,Pikkme Flip Cover for Samsung Galaxy M31 / F41 / M31 Prime PU Leather Wallet Flip Case for Samsung Galaxy M31 / F41 / M31 ...,Warehouse C,12,2,2025-02-17 23:20:00,10
15674,ORD_15675,11196,Kofcross L Syrup,Warehouse A,27,19,2025-02-17 22:21:00,8
15675,ORD_15676,30350,Kodak 126 cm (50 inches) Bezel-Less Design Series 4K Ultra HD Smart Android LED TV 50UHDX7XPROBL (Black),Warehouse C,12,6,2025-02-17 02:16:00,6
15676,ORD_15677,6676,ZUPERIA Diamond Studded Stylish Analogue Watch with Rose Gold Dot Bracelet for Girls & Women,Warehouse C,60,42,2025-02-17 16:28:00,18
15677,ORD_15678,29222,Fadox-CV Tablet,Warehouse C,44,38,2025-02-17 09:49:00,6
15678,ORD_15679,234,Makeup Revolution Hyaluronic Fixing Spray 100 ml,Warehouse A,82,77,2025-02-17 01:19:00,5
15679,ORD_15680,10063,Conape 2mg Tablet,Warehouse A,57,40,2025-02-17 10:49:00,17
15680,ORD_15681,3833,Urimax 0.2 Capsule MR,Warehouse A,52,33,2025-02-17 05:48:00,19
15681,ORD_15682,14298,Arata Advanced Curl Care Leave-In Conditioner Moisturizes & Deep Conditions For Soft Curls 100 ml,Warehouse A,28,15,2025-02-17 15:32:00,13
15682,ORD_15683,5962,Cefilar 200mg Tablet,Warehouse C,105,91,2025-02-17 03:27:00,14
15683,ORD_15684,5970,Duzest 30 Tablet,Warehouse A,45,30,2025-02-17 04:50:00,15
15684,ORD_15685,25508,Car CA  Syrup,Warehouse B,73,56,2025-02-17 22:02:00,17
15685,ORD_15686,25518,Oflice 200 Tablet,Warehouse A,36,29,2025-02-17 00:31:00,7
15686,ORD_15687,9249,Clobetaz S Ointment,Warehouse C,99,92,2025-02-17 22:50:00,7
15687,ORD_15688,7699,Flormar Style Matic Lipliner SL10 Vivid Red 0.35 gm,Warehouse A,45,27,2025-02-17 06:59:00,18
15688,ORD_15689,25509,Spigen Liquid Crystal Back Cover Case for Samsung Galaxy S23 (TPU | Crystal Clear),Warehouse B,94,76,2025-02-17 20:17:00,18
15689,ORD_15690,35947,Basil (Sweet) Essential Oil - 100% Pure & Natural,Warehouse C,17,2,2025-02-17 07:33:00,15
15690,ORD_15691,21123,"HUION Anti-fouling Artist Glove for Graphics Pen Drawing Tablet Monitor Light Box Tracing Board (Black, Free Size)",Warehouse B,70,52,2025-02-17 06:45:00,18
15691,ORD_15692,27285,Arofix-O Tablet,Warehouse C,90,76,2025-02-17 20:01:00,14
15692,ORD_15693,27312,"Rode SC7 3.5mm TRS to TRSS Patch Cable For Tablet, Smartphone (Red, Black, Grey)",Warehouse A,55,45,2025-02-17 03:04:00,10
15693,ORD_15694,5549,Ajmal Carbon Raindrops Wisal Dahab Deodorant Spray (Pack of 3) 200 ml,Warehouse A,12,1,2025-02-17 07:52:00,11
15694,ORD_15695,30354,Coversyl Plus  HD Tablet,Warehouse A,108,99,2025-02-17 15:17:00,9
15695,ORD_15696,14166,Lakme Absolute Argan Oil Serum Foundation With Spf 45 W160 WARM SAND 15 Ml,Warehouse C,58,40,2025-02-17 06:05:00,18
15696,ORD_15697,31012,Peach Milk Moisturiser SPF 24 PA Sunscreen Lotion,Warehouse C,22,8,2025-02-17 01:27:00,14
15697,ORD_15698,6003,Voorkoms Stars Temporary Body Tattoo Waterproof For Girls Men Women Beautiful & Popular Water Transfer Size 11CM x 6CM - 1Pcs,Warehouse C,57,48,2025-02-17 07:41:00,9
15698,ORD_15699,11024,WOW IMAGINE for Samsung Galaxy F13 M13 4G Slim Ultra Soft Rubberised Back Cover Inner Velvet Fabric Lining Matte Silicone ...,Warehouse B,106,95,2025-02-17 03:59:00,11
15699,ORD_15700,9060,Insight Cosmetics Color Rich Lipstick - Choco Break 4.2 gm,Warehouse C,75,57,2025-02-17 06:02:00,18
15700,ORD_15701,23470,Crimont LC Kid 2.5mg/4mg Tablet,Warehouse A,30,14,2025-02-17 06:45:00,16
15701,ORD_15702,8454,"Arata Vitamin C Night Repair Gel With Pomegranate, Hyaluronic Acid & Cucumber 50 ml",Warehouse C,99,94,2025-02-17 22:27:00,5
15702,ORD_15703,17234,Street Wear Playfull Matte Lip Crayon - Yolo Plum 2.9 gm,Warehouse B,21,8,2025-02-17 14:38:00,13
15703,ORD_15704,28116,Dynotrek Arrival 13-13.3 Inch Laptop Sleeve Case Cover with Handle Compatible for MacBook Pro 13 M2/M1 Pro/M1 Max 14.2 202...,Warehouse C,98,91,2025-02-17 17:25:00,7
15704,ORD_15705,33334,Atropa 0.6mg Injection,Warehouse A,39,27,2025-02-17 11:38:00,12
15705,ORD_15706,19006,Welcorate 250mg Tablet ER,Warehouse C,80,73,2025-02-17 13:37:00,7
15706,ORD_15707,1090,Women's & Girl's All in 1 Fashion TYA 6155 Multicolor Makeup Kit - (Pack of 1),Warehouse B,106,98,2025-02-17 01:33:00,8
15707,ORD_15708,16449,Canvasify Medium Grain Artist Canvas Board (8 x 8 Inch) Pack of 4,Warehouse A,32,17,2025-02-17 11:10:00,15
15708,ORD_15709,17373,"Fire-Boltt India's No 1 Smartwatch Brand Ring Bluetooth Calling with SpO2 & 1.7” Metal Body with Blood Oxygen Monitoring, ...",Warehouse C,58,45,2025-02-17 03:01:00,13
15709,ORD_15710,7201,Berina A36 Deep Golden Blonde Hair Color Cream 60 gm,Warehouse A,88,74,2025-02-17 19:18:00,14
15710,ORD_15711,2295,"Mi 67W Sonic Charge Combo |Mi/Xiaomi/Redmi Charger|Superfast 6A Type C Included| Laptops, Tablets & Mobile Charger|(Adapte...",Warehouse B,112,94,2025-02-17 05:15:00,18
15711,ORD_15712,30337,Ramistar 5 Tablet,Warehouse C,54,40,2025-02-17 13:22:00,14
15712,ORD_15713,302,Sadhev Depigmentation & Detanning Bathing Bar - Sandal & Saffron 125 gm,Warehouse B,18,6,2025-02-17 08:38:00,12
15713,ORD_15714,412,ORICAL SALES uniq 6 Cms Cosmetic Pouch(S_Multi),Warehouse A,54,43,2025-02-17 11:56:00,11
15714,ORD_15715,34975,Enem 0.1% Cream,Warehouse A,52,35,2025-02-17 02:59:00,17
15715,ORD_15716,23367,Levomast 5mg Tablet,Warehouse C,31,19,2025-02-17 16:27:00,12
15716,ORD_15717,18954,Moxyril-CV 500mg/125mg Tablet,Warehouse B,74,59,2025-02-17 22:46:00,15
15717,ORD_15718,36561,Lime Bath Soap - 99.9% Germ Protection,Warehouse A,28,21,2025-02-17 13:30:00,7
15718,ORD_15719,18955,S.F.R. COLOR matte mini blusher I pocket blusher I matte mini cheek pearls blusher (Peach),Warehouse C,72,59,2025-02-17 18:50:00,13
15719,ORD_15720,18956,"DARK HORSE Laptop Bag Leather Briefcase 15.6 Inch Messenger Bag Satchel for Men, Padded Laptop Compartment 12 Liters , Wat...",Warehouse A,89,70,2025-02-17 04:45:00,19
15720,ORD_15721,16442,"Tukzer RGB Gaming Mouse Pad with 4 USB HUB, Large Extended Soft Mouse Pad, LED Glowing Backlight 13 Lighting Modes| for Co...",Warehouse A,59,40,2025-02-17 03:38:00,19
15721,ORD_15722,23387,"ZEBRONICS A22FHD LED (21.5"") (54.61 cm) LED 1920x1080 Pixels FHD Resolution Monitor with HDMI + VGA Dual Input, Built-in S...",Warehouse C,44,33,2025-02-17 22:18:00,11
15722,ORD_15723,25091,"Fairness Naturals Hair Removal Cream Fair & Soft - Rose, Sensitive Skin",Warehouse A,85,66,2025-02-17 23:17:00,19
15723,ORD_15724,26310,Ajmal Blu & Aurum & Evoke silver Edition Homme & Shadow Homme Deo & Aretha EDP Pack of 4 20 ml,Warehouse B,29,12,2025-02-17 11:24:00,17
15724,ORD_15725,5551,St.Botanica Hair Oil - Go Anti-Hair Fall 150 ml,Warehouse A,73,56,2025-02-17 23:27:00,17
15725,ORD_15726,23363,Robustrion Tempered Glass Screen Protector for iPad 10.2 inch 9th Gen Generation 2021 8th Gen 2020 7th Gen 2019,Warehouse C,97,78,2025-02-17 08:52:00,19
15726,ORD_15727,8421,Clove Essentail Oil - 100% Pure & Natural,Warehouse A,18,6,2025-02-17 15:44:00,12
15727,ORD_15728,14161,Ifcof L Syrup,Warehouse A,20,10,2025-02-17 15:42:00,10
15728,ORD_15729,21092,Mehndi - Black,Warehouse C,109,98,2025-02-17 10:51:00,11
15729,ORD_15730,31896,"ELV Desktop Cell Phone Tabletop Stand, Tablet Stand, Aluminum Stand Holder for Mobile Phone and Tablet (Up to 10.1 inch) -...",Warehouse C,79,60,2025-02-17 03:47:00,19
15730,ORD_15731,3816,"Narciso Rodriguez Narciso Eau De Parfum for her, 50ml",Warehouse C,111,99,2025-02-17 21:08:00,12
15731,ORD_15732,18968,Sansui 60 cm (24 Inches) HD Ready LED TV JSY24NSHD (Black),Warehouse C,32,19,2025-02-17 03:28:00,13
15732,ORD_15733,17410,CROSSVOLT Advanced HD+ Tempered Glass Compatible with Google pixel 6a with Military-Grade Anti-Explosion Edge-to-Edge Cove...,Warehouse C,45,36,2025-02-17 00:17:00,9
15733,ORD_15734,21994,Depinac Injection,Warehouse C,113,94,2025-02-17 12:45:00,19
15734,ORD_15735,24830,Alrozith 500 Tablet,Warehouse B,44,34,2025-02-17 17:48:00,10
15735,ORD_15736,18971,BhringAmla Conditioner With Bhringraj & Amla For Intense Hair Treatment,Warehouse C,42,23,2025-02-17 22:44:00,19
15736,ORD_15737,25103,Advansed Men Hair Cream - Anti Hairfall,Warehouse B,74,59,2025-02-17 14:43:00,15
15737,ORD_15738,23412,HP USB 3.2 32GB Type C OTG Flash Drive x5600c (Grey & Black),Warehouse B,30,13,2025-02-17 04:48:00,17
15738,ORD_15739,30089,"Hair Spray - Strong Hold, Argan Oil & Bhringraj",Warehouse A,30,15,2025-02-17 02:41:00,15
15739,ORD_15740,14049,Micobrex F Cream,Warehouse B,65,48,2025-02-17 16:24:00,17
15740,ORD_15741,4429,"Amazon Basics USB 2.0 Extension Cable for Personal Computer, Printer, 2-Pack - A-Male to A-Female - 3.3 Feet (1 Meter, Black)",Warehouse A,37,32,2025-02-17 00:01:00,5
15741,ORD_15742,21580,Zulu-P Tablet,Warehouse B,48,38,2025-02-17 20:41:00,10
15742,ORD_15743,24836,Eveready Red 1012 AAA Batteries - Pack of 10,Warehouse B,82,68,2025-02-17 02:21:00,14
15743,ORD_15744,34554,LIMPUS Cleansing Detox Foot Patches pack of 20 pads foot cleaning detoxing pads (20 pads),Warehouse C,93,88,2025-02-17 14:50:00,5
15744,ORD_15745,25546,Teneryl M 500mg/20mg Tablet SR,Warehouse C,66,49,2025-02-17 17:49:00,17
15745,ORD_15746,13730,Frankincense Oil,Warehouse B,24,19,2025-02-17 12:04:00,5
15746,ORD_15747,3484,30W Ultra Fast Type-C Charger for Realme 6S Charger Original Adapter Like Wall Charger | Mobile Charger | Qualcomm QC 3.0 ...,Warehouse A,55,39,2025-02-17 23:02:00,16
15747,ORD_15748,3314,"Face Mask - Printed, Adjustable, Medium, Black & Pink",Warehouse A,40,22,2025-02-17 06:56:00,18
15748,ORD_15749,8682,Retozol Eye Drop,Warehouse C,71,63,2025-02-17 09:47:00,8
15749,ORD_15750,24109,"(Renewed) DELL Latitude 5490 Core i5 7th Gen Laptop, 8 GB RAM, 256GB SSD, Intel HD Graphics, 14 inch (36.83 cms) HD Scree...",Warehouse B,47,38,2025-02-17 23:15:00,9
15750,ORD_15751,1019,Gustone 200mg Soft Gelatin Capsule,Warehouse B,37,24,2025-02-17 21:03:00,13
15751,ORD_15752,24649,F&D 11 Watts F-203G 2.1 Wired Channel Multimedia Speakers System (Black),Warehouse C,49,35,2025-02-17 15:20:00,14
15752,ORD_15753,11978,Madxone 500mg Injection,Warehouse A,32,26,2025-02-17 12:40:00,6
15753,ORD_15754,27474,Autofy A-12 X-Grip Premium Bike Mobile Charger & Phone Holder Bike Mobile Holder Version 2 for All Bikes Scooters (5V-2A B...,Warehouse B,84,68,2025-02-17 00:12:00,16
15754,ORD_15755,31719,Nanovisc Eye Drop,Warehouse C,52,47,2025-02-17 08:49:00,5
15755,ORD_15756,15261,TheGiftKart Ultra-Hybrid Crystal Clear Back Case Cover for iPhone 11 | Shockproof Design | Camera Protection Bump | Hard C...,Warehouse A,19,2,2025-02-17 22:06:00,17
15756,ORD_15757,9520,"Mouthwash Liquid - Original, Removes 99.9% Germs",Warehouse A,70,56,2025-02-17 07:53:00,14
15757,ORD_15758,35396,JXL 8018 8 Inch Active Bass Tube Subwoofer with Inbuilt Amplifier 4200W (Black),Warehouse A,80,70,2025-02-17 14:43:00,10
15758,ORD_15759,32518,"Super Slim Toothbrush Value Pack  - Red, Green, Blue, Purple, Soft",Warehouse B,105,97,2025-02-17 21:28:00,8
15759,ORD_15760,15240,Allpain 100mg Tablet,Warehouse B,63,51,2025-02-17 07:56:00,12
15760,ORD_15761,34411,Babygesic 250mg/5ml Syrup,Warehouse B,41,35,2025-02-17 10:30:00,6
15761,ORD_15762,8924,LF KIA Seltos Car Accessories Navigation or Music System (Stereo) Touch Screen Guard 10.25inch (Company Fitted) - Clear,Warehouse A,69,55,2025-02-17 20:39:00,14
15762,ORD_15763,17318,Selflame P 100mg/325mg Tablet,Warehouse A,76,64,2025-02-17 14:18:00,12
15763,ORD_15764,34393,Dynotrek Protector 17-17.3 inch Laptop Sleeve Case Cover with Charger Pouch Compatible for Notebook/Pavilion Envy 17/ Insp...,Warehouse A,56,42,2025-02-17 00:52:00,14
15764,ORD_15765,32876,Parker Jotter Standard CT Ball Pen (Blue),Warehouse B,22,3,2025-02-17 21:10:00,19
15765,ORD_15766,5661,Oflonit 200mg Tablet,Warehouse C,25,20,2025-02-17 09:31:00,5
15766,ORD_15767,31708,"Fashion Colour Non - Transfer Matt Waterproof Lipstick, 41 Lavender 2.6 gm",Warehouse A,28,17,2025-02-17 11:46:00,11
15767,ORD_15768,5664,"NiTHO Drive PRO One Gaming Racing Wheel with Separate Shifter and Pedals, Zero Dead Zone Steering Wheel with 28 Action But...",Warehouse B,22,5,2025-02-17 14:16:00,17
15768,ORD_15769,2133,Fashion Colour Insta Glow Facial Kit 100 gm,Warehouse A,61,43,2025-02-17 08:41:00,18
15769,ORD_15770,24011,SHAKU OnePlus 11R 5G Back Camera Lens Screen Protector Anti Shock/Anti-Scratch/Clear/Camera Tempered Glass for (pack of 2),Warehouse B,109,97,2025-02-17 16:09:00,12
15770,ORD_15771,31834,Enova 25mg Tablet,Warehouse A,30,15,2025-02-17 02:30:00,15
15771,ORD_15772,33913,Cefnid T 1000 mg/125 mg Injection,Warehouse B,104,98,2025-02-17 22:28:00,6
15772,ORD_15773,25393,Zerodol TH OD 200 mg/16 mg Capsule SR,Warehouse C,50,38,2025-02-17 08:03:00,12
15773,ORD_15774,16986,M.G.R.J® PC Plastic Frame Shell Anti Scratch Shockproof Case Cover Compatible for Apple Watch Series 8/7 (45mm) (Black),Warehouse B,49,44,2025-02-17 18:51:00,5
15774,ORD_15775,657,Genpen-DSR Capsule,Warehouse B,14,1,2025-02-17 15:04:00,13
15775,ORD_15776,29586,NARE Smart Standard Multi-Purpose Laptop Table with Dock Stand/Study Table/Bed Table/Foldable and Portable/Ergonomic & Rou...,Warehouse A,31,22,2025-02-17 18:20:00,9
15776,ORD_15777,25395,Turmeric Essentail Oil - 100% Pure & Natural,Warehouse B,91,82,2025-02-17 17:01:00,9
15777,ORD_15778,16581,NESA Foundation Brush Cream Powder Makeup Brush,Warehouse C,13,6,2025-02-17 13:08:00,7
15778,ORD_15779,15775,Avlodin 50mg Tablet,Warehouse C,59,43,2025-02-17 14:31:00,16
15779,ORD_15780,4328,SKE Universal Full 100% Waterproof and Dustproof Plastic Pouch Mobile Cover Use in Rainy Seasons for Rain Protection |Touc...,Warehouse C,87,76,2025-02-17 01:06:00,11
15780,ORD_15781,12202,Cotbolt Silicon Case Compatible for Fire TV Stick 2021 Remote Control 3rd Generation Alexa Voice Firetvstick Cover (Black)...,Warehouse B,107,88,2025-02-17 21:39:00,19
15781,ORD_15782,32147,Bathing Brush,Warehouse A,40,26,2025-02-17 07:33:00,14
15782,ORD_15783,10002,"Reequil Unveil Neck, Knee & Elbow Brightening Cream 30 gm",Warehouse B,118,99,2025-02-17 05:02:00,19
15783,ORD_15784,26904,Gentopic Cream,Warehouse A,76,62,2025-02-17 15:46:00,14
15784,ORD_15785,16939,Allure Eyebrow Brush - (320) 1's,Warehouse B,11,4,2025-02-17 14:58:00,7
15785,ORD_15786,30654,Eylac-O Eye Drop,Warehouse B,31,17,2025-02-17 07:34:00,14
15786,ORD_15787,33904,Smart Tech 2.5 Inch (6.35 cm) Laptop SATA Hard Drive HDD/SSD Enclosure USB C 3.1 with OTG Cable External Sata Hard Disk Tr...,Warehouse C,106,95,2025-02-17 07:20:00,11
15787,ORD_15788,27911,Molifen Tablet,Warehouse C,25,10,2025-02-17 04:18:00,15
15788,ORD_15789,28031,PureSense Rejuvenating Refreshing Grapefruit Body Mist 100 ml,Warehouse C,90,83,2025-02-17 13:39:00,7
15789,ORD_15790,3555,Temur 20mg Tablet,Warehouse A,85,78,2025-02-17 09:09:00,7
15790,ORD_15791,31664,"FUR JADEN Faux Leather 15.6 Inch Premium Laptop Backpack 32L with Internal Organizer, 2 Large Compartments",Warehouse B,40,30,2025-02-17 16:00:00,10
15791,ORD_15792,2572,International Creamy Perfection Soap Bar,Warehouse C,41,35,2025-02-17 18:06:00,6
15792,ORD_15793,5853,Wireless Bluetooth Headphones Earphones for vivo iQOO Z6 Pro Original Sports Bluetooth Wireless Earphone with Deep Bass an...,Warehouse C,73,67,2025-02-17 20:51:00,6
15793,ORD_15794,13659,"Motorola a10 Dual Sim keypad Mobile with 1750 mAh Battery, Expandable Storage Upto 32GB, Wireless FM with Recording - Rose...",Warehouse B,95,81,2025-02-17 01:41:00,14
15794,ORD_15795,35346,N Met 500mg Tablet SR,Warehouse C,112,94,2025-02-17 16:21:00,18
15795,ORD_15796,33453,Hair Oil - The Irish Royale Beard Fragrance,Warehouse B,90,72,2025-02-17 21:54:00,18
15796,ORD_15797,16521,Travel Pro Liven Up Pack,Warehouse C,23,4,2025-02-17 10:49:00,19
15797,ORD_15798,24658,Texavil MF 500mg/250mg Tablet,Warehouse B,49,36,2025-02-17 22:40:00,13
15798,ORD_15799,10043,"Doodle | The Happiness 2023 Wiro Bound Planner with Sticker Sheets | A5 | Hard Bound | Undated | Yearly, Monthly, Daily Pl...",Warehouse A,103,95,2025-02-17 01:18:00,8
15799,ORD_15800,1353,Sery Colorflirt Nail Paint Shadow Grey 10 ml,Warehouse C,81,75,2025-02-17 15:25:00,6
15800,ORD_15801,14063,Welrab 20mg Tablet,Warehouse B,42,27,2025-02-17 20:07:00,15
15801,ORD_15802,17198,Viltrox EF-EOS M Electronic AF Auto Focus Lens Mount Adapter for Canon EF/EF-S Lens to Canon EOS-M (EF-M Mount) Mirrorless...,Warehouse C,74,58,2025-02-17 00:36:00,16
15802,ORD_15803,19051,Atorsum 80mg Tablet,Warehouse B,90,75,2025-02-17 11:34:00,15
15803,ORD_15804,23484,Cgox 150mg Tablet,Warehouse A,71,56,2025-02-17 11:11:00,15
15804,ORD_15805,5382,Kleral Milk Barley Milk Shampoo 250 ml,Warehouse A,94,86,2025-02-17 14:42:00,8
15805,ORD_15806,1809,Astigo Compatible Remote for LG LED TV Model (Exactly Same Remote only),Warehouse B,96,88,2025-02-17 03:43:00,8
15806,ORD_15807,13540,"HydraClear Oil Free Summer Moisturiser with Hyaluronic Acid, Niacinamide & Salicylic Acid | For Excess Oily & Acne Prone S...",Warehouse C,89,74,2025-02-17 09:03:00,15
15807,ORD_15808,6909,Feroact Tablet,Warehouse A,41,36,2025-02-17 17:46:00,5
15808,ORD_15809,5391,Telsed H 40mg/12.5mg Tablet,Warehouse B,69,57,2025-02-17 13:15:00,12
15809,ORD_15810,29302,"Caprigo Super Heavy Duty TV Wall Mount Bracket for 32 to 55 Inch LED/HD/Smart TV’s, Universal Fixed TV Wall Mount Stand (M...",Warehouse A,43,30,2025-02-17 11:03:00,13
15810,ORD_15811,15678,Rozudoc 5 Tablet,Warehouse C,72,53,2025-02-17 16:56:00,19
15811,ORD_15812,23529,"Shiseido Innerglow Cheek powder, 02-Twighlight Hour, 50g",Warehouse B,49,42,2025-02-17 02:02:00,7
15812,ORD_15813,30292,Memjet 0.2mg Injection,Warehouse C,92,74,2025-02-17 22:21:00,18
15813,ORD_15814,15812,"Xerina Cream for Dry skin (50 gm, Pack of 2)",Warehouse C,93,78,2025-02-17 10:15:00,15
15814,ORD_15815,13701,Gabamak 300mg/500mcg Tablet,Warehouse C,87,80,2025-02-17 13:20:00,7
15815,ORD_15816,13270,Tracon 100 Capsule,Warehouse B,31,14,2025-02-17 08:39:00,17
15816,ORD_15817,30196,"SANNIDHI Satin Head Bands 10 Pcs Bowknot Elastic Head Hair Bands for Babies, Kids and Girls - Multicolor",Warehouse C,59,54,2025-02-17 20:48:00,5
15817,ORD_15818,32183,OpenTech® Tempered Glass Screen Protector Compatible for Samsung Galaxy M13 5G with Edge to Edge Coverage and Easy Install...,Warehouse B,36,22,2025-02-17 17:19:00,14
15818,ORD_15819,17161,Sounce Waterproof New Bike Phone Mount Anti Shake and Stable 360‚° Rotation Bike Bicycles Accessories for Any Smartphone G...,Warehouse C,57,47,2025-02-17 14:34:00,10
15819,ORD_15820,12707,Bio-Oil Dry Skin Gel 100 ml,Warehouse A,15,3,2025-02-17 14:59:00,12
15820,ORD_15821,5012,Cozymin Forte Suspension,Warehouse C,28,19,2025-02-17 23:10:00,9
15821,ORD_15822,20078,Acphy M 200mg/10mg Tablet SR,Warehouse B,65,60,2025-02-17 17:49:00,5
15822,ORD_15823,5461,Plum Green Tea Skin Clarifying Concentrate Serum 30 ml,Warehouse B,24,11,2025-02-17 08:12:00,13
15823,ORD_15824,26576,"truke BTG X1 True Gaming in Ear Earbuds with 12mm Titanium Drivers, True Gaming Mode with 20RGB Case Design, 48H Playtime,...",Warehouse B,49,41,2025-02-17 22:37:00,8
15824,ORD_15825,23667,Godreejj Professional Probio Keratin Revive Shampoo (1000ml),Warehouse A,103,98,2025-02-17 23:35:00,5
15825,ORD_15826,1031,PureSense Almond and Walnut Body Scrub 140ml,Warehouse C,19,7,2025-02-17 15:56:00,12
15826,ORD_15827,2124,Ultimate Hair Repair Shampoo + Moroccan Argan Hair Conditioner,Warehouse B,61,44,2025-02-17 19:51:00,17
15827,ORD_15828,24022,"Hand Sanitiser - Germ Protection, Original",Warehouse C,61,51,2025-02-17 10:14:00,10
15828,ORD_15829,5924,Mindlev-M Tablet,Warehouse B,108,99,2025-02-17 16:18:00,9
15829,ORD_15830,29329,"D2Q Original 20w Fast Charging Cable For iPhone Charger Compatible For Apple iPhone 11, 12, 13, 14 Series (20w ONLY Cable)...",Warehouse B,82,72,2025-02-17 19:38:00,10
15830,ORD_15831,13207,Foxtale Morning Glory Routine (Dewy) Skin Care Kit | Cleanser Face Wash 100ml + Ceramide Moisturizer 50ml + Vitamin C Face...,Warehouse B,104,85,2025-02-17 09:36:00,19
15831,ORD_15832,27425,Shampoo - Perfect Straight,Warehouse B,19,14,2025-02-17 09:14:00,5
15832,ORD_15833,4335,Rhymestore® 4 Pin USB Fast Charger Magnetic Charging Cable Adapter for Fire-Boltt Thunder watch & Fire-Boltt Talk Smartwat...,Warehouse B,22,3,2025-02-17 16:46:00,19
15833,ORD_15834,16568,"Sunscreen - For All Skin, SPF 30",Warehouse A,102,97,2025-02-17 00:11:00,5
15834,ORD_15835,9794,Sounce Adjustable Xiaomi Mi Band 3/ Mi Band 4 Watch Strap Silicone Adjustable Men Women- Set of 5 (Multi-Colored),Warehouse C,104,93,2025-02-17 20:36:00,11
15835,ORD_15836,17532,Troxom-TZ 1000mg/125mg Injection,Warehouse C,18,11,2025-02-17 19:16:00,7
15836,ORD_15837,5486,"Fire-Boltt 360 SpO2 Full Touch Large Display Round Smart Watch with in-Built Games, 8 Days Battery Life, IP67 Water Resist...",Warehouse B,35,21,2025-02-17 09:55:00,14
15837,ORD_15838,25898,Reequil Pore Refining Face Toner For Open Large Pores 100 ml,Warehouse B,34,19,2025-02-17 21:51:00,15
15838,ORD_15839,18024,HASTHIP® DIY Oil Painting Paint by Numbers for Adults and Kids Gift Kits Pre-Printed Canvas Beginner with Brushes and Pigm...,Warehouse B,58,39,2025-02-17 00:05:00,19
15839,ORD_15840,5596,"NoiseFit Force Rugged Round Dial Bluetooth calling Smart Watch with 1.32"" HD screen, Functional Crown, 550 NITS, 7 days ba...",Warehouse C,26,17,2025-02-17 00:39:00,9
15840,ORD_15841,11768,"Pinzo Sticky Note Memo Pad With 8 Index Tabs, Bright Neon Colors",Warehouse C,13,5,2025-02-17 10:26:00,8
15841,ORD_15842,18032,Sun Screen Cream SPF30,Warehouse C,99,80,2025-02-17 22:38:00,19
15842,ORD_15843,5279,Olmark A Tablet,Warehouse A,56,49,2025-02-17 19:04:00,7
15843,ORD_15844,18034,"Seagate One Touch 2TB External HDD with Password Protection – Silver, for Windows and Mac, with 3 yr Data Recovery Service...",Warehouse B,82,73,2025-02-17 00:14:00,9
15844,ORD_15845,13990,Ovatop 75mg Tablet,Warehouse C,49,36,2025-02-17 23:54:00,13
15845,ORD_15846,35697,Ajmal 3 Blu Deo & Prose EDP Pack of 4 20 ml,Warehouse A,57,46,2025-02-17 10:11:00,11
15846,ORD_15847,33123,Minty-FD Tablet,Warehouse A,21,16,2025-02-17 18:04:00,5
15847,ORD_15848,18041,Techgadget Wireless USB Bluetooth Music Receiver Adapter for Home Theatre Car Speakers MP3 (N-1215),Warehouse B,47,36,2025-02-17 07:49:00,11
15848,ORD_15849,31165,Norlax TZ 400mg/600mg Tablet,Warehouse C,58,48,2025-02-17 11:01:00,10
15849,ORD_15850,15082,Sepmax DS Tablet,Warehouse A,12,2,2025-02-17 02:57:00,10
15850,ORD_15851,10684,Nilcold-DM Syrup,Warehouse B,70,65,2025-02-17 08:39:00,5
15851,ORD_15852,20427,VapoRub,Warehouse A,67,54,2025-02-17 09:56:00,13
15852,ORD_15853,22803,ACED® M2 PUBG Triggers Controller for Mobile Gaming for BGMI/Free Fire/COD Mobile/etc- PUBG Trigger - Gaming Triggers for ...,Warehouse B,103,89,2025-02-17 02:51:00,14
15853,ORD_15854,2211,HP USB 3.1 Flash Drive 32GB 796L,Warehouse C,43,27,2025-02-17 06:34:00,16
15854,ORD_15855,13572,"Seagate One Touch 2TB External HDD with Password Protection – Black, for Windows and Mac, with 3 yr Data Recovery Service...",Warehouse A,34,17,2025-02-17 03:49:00,17
15855,ORD_15856,21015,Milaan Empty Makeup Powder Foundation Case Air Cushion Puff BB Cream Container 15g Gold,Warehouse A,71,63,2025-02-17 11:56:00,8
15856,ORD_15857,36532,Boujee Beauty Big Blending Brush B107 135 gm,Warehouse A,73,56,2025-02-17 09:15:00,17
15857,ORD_15858,31285,Medimade Charcoal Clay Face Mask (Pack of 2) 1's,Warehouse B,46,30,2025-02-17 09:07:00,16
15858,ORD_15859,6475,Loflocin 500mg Tablet,Warehouse A,66,52,2025-02-17 14:59:00,14
15859,ORD_15860,2126,Hydro Replenish Under Eye Recovery Gel,Warehouse A,94,83,2025-02-17 16:57:00,11
15860,ORD_15861,19155,Wet Look Hair Gel,Warehouse C,53,45,2025-02-17 08:33:00,8
15861,ORD_15862,35338,Cedopil 200mg Tablet,Warehouse C,85,68,2025-02-17 18:47:00,17
15862,ORD_15863,23603,Atyad AP Syrup,Warehouse B,89,80,2025-02-17 22:55:00,9
15863,ORD_15864,20284,"Verilux ® USB C Hub, 6 in 1 Aluminum Multiport Adapter with 4K HDMI(30Hz), PD 87W&USB C Data Transfer, USB 3.0/2.0 Port, S...",Warehouse A,34,23,2025-02-17 03:12:00,11
15864,ORD_15865,23611,"Majestique Nail Scissors for Fingernails, Shaving, Moustache, Beard, Eyebrow and Toenails – Sharp Cuticle Scissors Profess...",Warehouse B,8,1,2025-02-17 02:49:00,7
15865,ORD_15866,11578,Viozid 1000mg Injection,Warehouse A,96,83,2025-02-17 16:31:00,13
15866,ORD_15867,23609,Zigat D Eye Drop,Warehouse C,33,26,2025-02-17 00:07:00,7
15867,ORD_15868,15348,The Natural Wash Herbal Beetroot Lip Balm An Ayurvedic Balm For Soft And Supple Lips 5 Gm,Warehouse A,71,64,2025-02-17 06:35:00,7
15868,ORD_15869,29594,Orgazi 500mg Tablet,Warehouse B,110,96,2025-02-17 08:34:00,14
15869,ORD_15870,33927,Amozo Designed for iPhone 14 Pro Max Cover | Ultra Hybrid Drop and Camera Protection Back Cover Case for iPhone 14 PRO MAX...,Warehouse B,82,77,2025-02-17 09:44:00,5
15870,ORD_15871,30020,Nocturin 5mg Tablet,Warehouse C,65,55,2025-02-17 07:02:00,10
15871,ORD_15872,24036,Teemol 0.5% Eye Drop,Warehouse C,73,54,2025-02-17 13:44:00,19
15872,ORD_15873,2804,Insight Cosmetics Non Transfer Matte Lipstick - Outlandish 4.2 gm,Warehouse B,30,23,2025-02-17 06:10:00,7
15873,ORD_15874,36023,Elwiflam Sp 50mg/325mg/10mg Tablet,Warehouse B,100,89,2025-02-17 22:29:00,11
15874,ORD_15875,1904,Lakme Color Crush Nailart M20 Candy Pink 6 Ml,Warehouse C,86,68,2025-02-17 07:47:00,18
15875,ORD_15876,27153,"Luxor 4 Subject Single Ruled Notebook - Size - 10.8x14.0 cm, 70 GSM, 240 Pages",Warehouse B,104,99,2025-02-17 12:17:00,5
15876,ORD_15877,16554,Faber-Castell Fabric Colours - 10ml Each (Pack of 12),Warehouse B,95,76,2025-02-17 10:19:00,19
15877,ORD_15878,3874,Tripnec D 50mg/325mg Tablet,Warehouse B,61,49,2025-02-17 09:16:00,12
15878,ORD_15879,15342,Lenphor Timeless Eye Liner Berry Blue 03 1.2 Gm,Warehouse A,61,45,2025-02-17 11:20:00,16
15879,ORD_15880,3657,"Portronics Power Brick II 20K 20000mAh Power Bank with 2.4A Max Output, Dual Input (Type C + Micro) Dual USB Output(White)",Warehouse B,32,13,2025-02-17 01:33:00,19
15880,ORD_15881,32159,iFFALCON 80 cm (32 inches) HD Ready Smart LED TV 32F53 (Black),Warehouse B,44,31,2025-02-17 20:09:00,13
15881,ORD_15882,20574,Glimmer Premium Nail Enamel Dragon Fruit 10 ml,Warehouse A,93,79,2025-02-17 19:46:00,14
15882,ORD_15883,21857,Oxyglow Facial Kit - Fruit 165 gm,Warehouse A,101,91,2025-02-17 22:02:00,10
15883,ORD_15884,21626,Jumbocef Forte Injection,Warehouse A,81,68,2025-02-17 14:25:00,13
15884,ORD_15885,16576,Josrik S 250mg/125mg Injection,Warehouse B,7,2,2025-02-17 05:38:00,5
15885,ORD_15886,35038,Lafix 100  Tablet DT,Warehouse C,40,28,2025-02-17 07:48:00,12
15886,ORD_15887,1220,"MARVIK Trail Loop Band Compatible with Apple Watch Band Ultra 42mm 44mm 45mm 49mm, Nylon Weave Sport Loop Adjustable Strap...",Warehouse A,46,38,2025-02-17 03:30:00,8
15887,ORD_15888,24809,"Fashion Colour Vivid Matte Lipstick, 8 Deep Red 3.8 gm",Warehouse C,73,63,2025-02-17 20:22:00,10
15888,ORD_15889,104,iVoltaa 3.5mm Metal Braided Aux (Auxiliary) to 2X Female Aux Audio Splitter Cable for Tablet - 0.82 Feet (25 Cms) - Space ...,Warehouse C,19,8,2025-02-17 09:57:00,11
15889,ORD_15890,8954,Glory Foot Cream,Warehouse C,38,21,2025-02-17 04:22:00,17
15890,ORD_15891,32591,Jovees Face Wash - Pearl Whitening 60 ml,Warehouse C,41,26,2025-02-17 05:08:00,15
15891,ORD_15892,14718,"KINIVO Premium 4K HDMI Switch/Splitter HDMI Switcher - Supports 4K @ 60Hz, 3D, Full HD and Ultra HD (240BN - 2 Port)",Warehouse C,30,14,2025-02-17 11:30:00,16
15892,ORD_15893,32093,Dolodase Injection,Warehouse B,18,9,2025-02-17 20:25:00,9
15893,ORD_15894,4235,Medimade Aloe Vera Face Wash 160 ml,Warehouse C,30,25,2025-02-17 10:52:00,5
15894,ORD_15895,3182,Batiste Dry Hair Shampoo - Fruity & Cheeky Cherry 50 ml + Floral & Flirty Blush 50 ml,Warehouse A,99,84,2025-02-17 23:49:00,15
15895,ORD_15896,34510,Onsitego 1 Year Extended Warranty for Small Household Appliances from Rs. 1001-1500 (Email Delivery - No Physical Kit),Warehouse B,29,21,2025-02-17 08:46:00,8
15896,ORD_15897,36805,Activated Charcoal Peel-Off Mask,Warehouse B,20,10,2025-02-17 20:18:00,10
15897,ORD_15898,20934,Almond & Rose Soap,Warehouse C,80,70,2025-02-17 07:35:00,10
15898,ORD_15899,12213,Allergo 120mg Tablet,Warehouse B,24,17,2025-02-17 07:48:00,7
15899,ORD_15900,14331,Probact 500mg/500mg Injection,Warehouse A,74,57,2025-02-17 18:12:00,17
15900,ORD_15901,13615,Omimac D Capsule,Warehouse C,95,81,2025-02-17 15:44:00,14
15901,ORD_15902,29481,Nandika Beauty Hair Oil - Red Onion 100 ml,Warehouse B,28,18,2025-02-17 07:15:00,10
15902,ORD_15903,34501,"Wings Phantom 860 Wireless Earphones with 50 Hours of Battery Backup with Low Latency 40 ms, Gaming Designed case, LED Lig...",Warehouse B,16,11,2025-02-17 01:23:00,5
15903,ORD_15904,9423,Canto Tel 80mg Tablet,Warehouse C,69,54,2025-02-17 21:30:00,15
15904,ORD_15905,9922,Rabett D 30mg/20mg Capsule SR,Warehouse A,26,18,2025-02-17 05:40:00,8
15905,ORD_15906,25195,Glimighty-M1 Forte Tablet PR,Warehouse C,68,55,2025-02-17 08:26:00,13
15906,ORD_15907,9923,Tapic EM 1000 mg/125 mg Injection,Warehouse A,40,22,2025-02-17 23:47:00,18
15907,ORD_15908,5650,Zithral 500mg Tablet,Warehouse B,99,94,2025-02-17 02:49:00,5
15908,ORD_15909,31328,Speed GM Cream,Warehouse A,90,72,2025-02-17 15:14:00,18
15909,ORD_15910,14738,Gludase 50mg Tablet,Warehouse A,42,24,2025-02-17 16:06:00,18
15910,ORD_15911,2108,(Renewed) boAT 103 Bluetooth Wireless Active Black In Ear Earphone with mic (Black),Warehouse B,93,81,2025-02-17 07:31:00,12
15911,ORD_15912,7389,Insta Eye Liner - Black,Warehouse C,83,68,2025-02-17 13:06:00,15
15912,ORD_15913,5430,"COSLUXE Mini Finger Powder Puff 4 pcs Finger Makeup finger beauty blender Sponges, Mini Soft Cosmetic Finger Puff, Perfect...",Warehouse B,30,19,2025-02-17 04:37:00,11
15913,ORD_15914,12060,SanDisk Ultra Flair 256GB USB 3.0 Flash Drive,Warehouse B,51,46,2025-02-17 16:04:00,5
15914,ORD_15915,29549,"DOMS Smart Stationery Kit (10 pcs in KIT) with Transparent Zipper Bag, Multicolour (DTL06557)",Warehouse A,13,4,2025-02-17 13:58:00,9
15915,ORD_15916,7383,CEDO Samsung M30 Back Cover | Matte Soft Silicon Flexible | Camera Bump Protection | All Side Shock Proof Rubberised Back ...,Warehouse A,98,87,2025-02-17 04:19:00,11
15916,ORD_15917,32885,"TAGG Sonic Angle 2 14W Portable Bluetooth Speakers Wireless with Dedicated Bass Radiator || Dual Stereo, Waterproof, 10 hr...",Warehouse A,85,74,2025-02-17 15:55:00,11
15917,ORD_15918,33421,Sirox 150mg Tablet,Warehouse A,36,23,2025-02-17 08:24:00,13
15918,ORD_15919,16694,Montair Plus Tablet,Warehouse C,91,85,2025-02-17 21:34:00,6
15919,ORD_15920,35007,"Samsung Original Type C to C Cable - 3.28 Feet (1 Meter) Compatible with Smartphone,White",Warehouse C,44,35,2025-02-17 19:02:00,9
15920,ORD_15921,8604,Ajmal Carbon Carbon Wisal Deodorant Spray (Pack of 3) 200 ml,Warehouse B,50,45,2025-02-17 22:45:00,5
15921,ORD_15922,35291,Cillimox-CV Dry Syrup,Warehouse B,75,70,2025-02-17 22:07:00,5
15922,ORD_15923,33961,Safeflox OZ 200mg/500mg Tablet,Warehouse A,79,66,2025-02-17 15:18:00,13
15923,ORD_15924,12052,"Lenovo 600 Bluetooth 5.0 Silent Mouse: Compact, Portable, Dongle-Free Multi-Device connectivity with Microsoft Swift Pair...",Warehouse B,102,89,2025-02-17 03:59:00,13
15924,ORD_15925,13592,Phlogam Tablet,Warehouse C,91,79,2025-02-17 06:35:00,12
15925,ORD_15926,16712,Leeglim M Forte 2mg/1000mg Tablet,Warehouse C,22,14,2025-02-17 09:41:00,8
15926,ORD_15927,33563,Quantum CAT6 RJ45 Ethernet Patch Cable/LAN/Router Cable Ultra Hi-Speed Gigabit Upto 1000Mbps with Heavy Duty Gold Plated C...,Warehouse C,52,35,2025-02-17 08:24:00,17
15927,ORD_15928,23900,Preace Spas 80mg/100mg Tablet,Warehouse A,26,18,2025-02-17 04:48:00,8
15928,ORD_15929,23889,Otek-AF Ear Drop,Warehouse B,78,68,2025-02-17 09:29:00,10
15929,ORD_15930,20602,Cedoze Tablet,Warehouse A,96,84,2025-02-17 12:22:00,12
15930,ORD_15931,23906,L.A Girl Gel Liner KitVery Black 3 gm,Warehouse B,21,15,2025-02-17 08:23:00,6
15931,ORD_15932,36431,Love Earth Lip Tint & Cheek Tint Multipot Combo (Rose Pink & Ruby Pink) with Richness of Jojoba Oil and Vitamin E for Lip...,Warehouse B,109,98,2025-02-17 08:03:00,11
15932,ORD_15933,21709,Apanta L 75mg/40mg Capsule SR,Warehouse A,17,2,2025-02-17 04:39:00,15
15933,ORD_15934,578,Spigen Ultra Hybrid Back Cover Case for iPhone SE 2022 | iPhone SE 2020 | iPhone 7 | iPhone 8 (TPU + Poly Carbonate | Black),Warehouse B,76,69,2025-02-17 08:34:00,7
15934,ORD_15935,31032,"Temporary Tattoos Kit Semi Permanent Tattoo, Jagua Gel Freehand Gel/Ink 84 Pcs Free Tattoo Stickers Stencils,DIY Tattoos F...",Warehouse A,63,58,2025-02-17 16:39:00,5
15935,ORD_15936,5880,Nicka K RADIANT LIQUID SHADOW- EARTHLY BRONZE 5 gm,Warehouse B,54,47,2025-02-17 12:08:00,7
15936,ORD_15937,9413,Satreetha Ayurvedic Shampoo,Warehouse A,23,18,2025-02-17 17:30:00,5
15937,ORD_15938,12951,"Ajaml Wisal Deodorants Spray - For Women (200 ml, Pack of 3) + 1 Perfume Tester",Warehouse A,88,77,2025-02-17 09:45:00,11
15938,ORD_15939,9020,"Fashion Colour Kiss Lip No Transfer Lipstick, 14 Khaki Light 2.6 gm",Warehouse A,27,13,2025-02-17 21:58:00,14
15939,ORD_15940,12722,"Pebble Venus Smartwatch for Women with Advance Bluetooth Calling, Multiple Sports Mode, Female Health Suite, Multiple Watc...",Warehouse B,36,22,2025-02-17 08:10:00,14
15940,ORD_15941,30219,Wet N Wild Color Icon Eyeshadow Glitter Single - Toasty 1.4 gm,Warehouse A,80,67,2025-02-17 00:43:00,13
15941,ORD_15942,33426,"Portronics Key2-A Combo of Multimedia Wireless Keyboard & Mouse, Compact Light-Weight for PCs, Laptops and Smart TV, White",Warehouse A,99,90,2025-02-17 21:45:00,9
15942,ORD_15943,23927,Ubtan Face Wash,Warehouse B,99,85,2025-02-17 18:12:00,14
15943,ORD_15944,31335,Sri Sri Tattva Ayush-64 Tablet 60's,Warehouse A,39,20,2025-02-17 14:32:00,19
15944,ORD_15945,1880,Pental-D 10mg/40mg Tablet,Warehouse A,27,22,2025-02-17 19:47:00,5
15945,ORD_15946,32111,Basesailor Samsung Charger Original 25W C-Type Super Fast Charger Adapter with Cable Set Charger for Galaxy S22/S21+/S21 U...,Warehouse C,20,15,2025-02-17 23:29:00,5
15946,ORD_15947,15826,Innisfree No-Sebum Mineral Powder,Warehouse A,99,80,2025-02-17 15:52:00,19
15947,ORD_15948,32881,Gliflosal M 10mg/500mg Tablet SR,Warehouse C,27,16,2025-02-17 16:33:00,11
15948,ORD_15949,3972,Acesam 100mg/325mg/15mg Tablet,Warehouse A,26,17,2025-02-17 10:57:00,9
15949,ORD_15950,23546,Manish Malhotra Nail Lacquer - Chromatic Crepe 12 Ml,Warehouse B,21,10,2025-02-17 08:46:00,11
15950,ORD_15951,1501,Euthyrox 75 Tablet,Warehouse B,106,94,2025-02-17 01:16:00,12
15951,ORD_15952,17110,Allure Large Eyeshadow Brush - (233) 1's,Warehouse A,57,44,2025-02-17 13:55:00,13
15952,ORD_15953,15800,Mumzole 20mg Capsule,Warehouse A,69,60,2025-02-17 00:42:00,9
15953,ORD_15954,9455,Faces Canada Ultimepro Hd Whopper Lashes Mascara 5 Gm,Warehouse C,64,52,2025-02-17 18:19:00,12
15954,ORD_15955,26882,FIBMET 160MG/500MG TABLET,Warehouse B,33,18,2025-02-17 14:23:00,15
15955,ORD_15956,15478,Milivo 250mg Tablet,Warehouse C,46,28,2025-02-17 16:09:00,18
15956,ORD_15957,17081,"Apcute Tattoo For Women Set of - 2 Piece | Mehndi Tattoo stencil for Women, Girls and kids Easy to use in just 4 steps Pre...",Warehouse A,56,42,2025-02-17 04:24:00,14
15957,ORD_15958,5630,Kidoxyl 250mg Suspension,Warehouse A,45,28,2025-02-17 17:38:00,17
15958,ORD_15959,15686,Roximeg 150mg Tablet,Warehouse A,69,57,2025-02-17 13:44:00,12
15959,ORD_15960,29605,"ProElite Smart Flip Case Cover for Realme Pad X 11 inch Translucent Back with Stylus Pen, Navy",Warehouse C,45,39,2025-02-17 03:34:00,6
15960,ORD_15961,12711,Flormar Nail Enamel 311 Purple Scarlet 11 ml,Warehouse C,66,54,2025-02-17 23:22:00,12
15961,ORD_15962,16540,Rose Face Pack,Warehouse B,28,12,2025-02-17 10:21:00,16
15962,ORD_15963,15214,Ulcireb 20mg Tablet,Warehouse C,105,90,2025-02-17 09:30:00,15
15963,ORD_15964,25134,Diclaro-SP Tablet,Warehouse C,91,73,2025-02-17 01:51:00,18
15964,ORD_15965,17098,Vistadex Syrup,Warehouse A,83,67,2025-02-17 11:47:00,16
15965,ORD_15966,2458,X Til 125mg Dry Syrup,Warehouse A,78,60,2025-02-17 10:44:00,18
15966,ORD_15967,1374,ADISA 35L Large Laptop Backpack Office Bag College Travel Back Pack with rain Cover (Navy),Warehouse C,66,53,2025-02-17 07:48:00,13
15967,ORD_15968,15798,Genaro Syrup,Warehouse C,82,75,2025-02-17 22:18:00,7
15968,ORD_15969,28091,St.Botanica Body Wash - White Tea & Bamboo 250 ml,Warehouse B,80,61,2025-02-17 11:00:00,19
15969,ORD_15970,29616,Ecsopan 40mg Injection,Warehouse C,27,14,2025-02-17 06:27:00,13
15970,ORD_15971,6844,Onsitego 1 Year Extended Warranty for Small Home & Kitchen Appliances from Rs. 5001-6000 (Email Delivery - No Physical Kit),Warehouse A,34,21,2025-02-17 22:23:00,13
15971,ORD_15972,6435,Revlon Colorstay Full Cover Foundation - Early Tan 30 ml,Warehouse B,70,64,2025-02-17 20:31:00,6
15972,ORD_15973,24807,Moxicon  Eye Ointment,Warehouse B,41,23,2025-02-17 00:04:00,18
15973,ORD_15974,21717,Wottagirl! Fragrant Body Splash - Mystic Island,Warehouse B,86,73,2025-02-17 05:57:00,13
15974,ORD_15975,28090,"Amazon Brand - Solimo 3A Fast Charging Tough Type C USB Data Cable for Smartphone - 1 Meter, White",Warehouse C,88,71,2025-02-17 16:17:00,17
15975,ORD_15976,21611,HP Pavilion AMD Ryzen 7 5800H 15.6 inches(39.6cm) FHD Gaming Laptop (16GB/512GB SSD/Windows 11 Home/NVIDIA RTX 3050 Graphi...,Warehouse A,16,9,2025-02-17 12:08:00,7
15976,ORD_15977,6907,MG Enterprise Round Empty Luxurious Portable Air Cushion Puff Box BB Cream Container Case White,Warehouse A,59,53,2025-02-17 08:27:00,6
15977,ORD_15978,15764,"MAXELL Lr41 Ag3 Lr736 392 392a 192 Sr41 BUTTON COIN CELL BATTERY (for watches,toys.digital thermometer) 5 PIECES",Warehouse C,59,43,2025-02-17 07:34:00,16
15978,ORD_15979,6450,Blue Set - Eau De Toilette + Deodorant,Warehouse B,50,33,2025-02-17 02:53:00,17
15979,ORD_15980,4241,Anac Plus 100 mg/500 mg Tablet,Warehouse B,92,79,2025-02-17 01:03:00,13
15980,ORD_15981,19303,Faces Canada Ultime Pro Gel Lustre Nail Lacquer Submarine Blue 44 9 Ml,Warehouse A,75,57,2025-02-17 19:49:00,18
15981,ORD_15982,31662,Levosome Capsule SR,Warehouse C,20,4,2025-02-17 11:39:00,16
15982,ORD_15983,16663,Pikkme Mi Redmi 9A / 9i / 9A Sport Flip Case | Vintage Leather Finish | Inside TPU with Card Pockets | Wallet Stand | Magn...,Warehouse C,23,10,2025-02-17 20:19:00,13
15983,ORD_15984,20254,PopSockets Basic PopGrip – Black,Warehouse C,114,98,2025-02-17 15:12:00,16
15984,ORD_15985,25203,Wibatol O 250mg/500mg Tablet,Warehouse B,42,23,2025-02-17 23:20:00,19
15985,ORD_15986,7316,Activated Charcoal Bodywash,Warehouse C,92,80,2025-02-17 23:53:00,12
15986,ORD_15987,27970,"Samsung Galaxy Tab A7 Lite 8.7 inches, Slim Metal Body, Dolby Atmos Sound, RAM 3 GB, ROM 32 GB Expandable, Wi-Fi-only Tabl...",Warehouse C,29,14,2025-02-17 20:01:00,15
15987,ORD_15988,14735,Noxib 90mg Tablet,Warehouse B,59,40,2025-02-17 02:06:00,19
15988,ORD_15989,2460,Aceclokas 200mg Tablet SR,Warehouse A,83,70,2025-02-17 13:13:00,13
15989,ORD_15990,2837,Sandal Fairness Facial Kit,Warehouse C,63,53,2025-02-17 08:57:00,10
15990,ORD_15991,31028,Hair Conditioner Damage Repair,Warehouse A,37,26,2025-02-17 20:27:00,11
15991,ORD_15992,12728,Amitoss 250mg Injection,Warehouse B,85,75,2025-02-17 03:46:00,10
15992,ORD_15993,20941,"Oblivion USB LED LAMP Night Light, Plug in Small Led Nightlight Mini Portable for PC and Laptop (Pack of 10)",Warehouse C,29,24,2025-02-17 14:01:00,5
15993,ORD_15994,36911,Canon Compatible for Canon Pixma Ink Bottle (Cyan),Warehouse C,29,10,2025-02-17 17:11:00,19
15994,ORD_15995,29277,Toothbrush - Gum Expert (Soft),Warehouse B,32,18,2025-02-17 18:19:00,14
15995,ORD_15996,8485,GZ 500mg Tablet,Warehouse B,60,47,2025-02-17 16:36:00,13
15996,ORD_15997,4372,Dylo Aqua 75mg Injection,Warehouse C,42,24,2025-02-17 06:43:00,18
15997,ORD_15998,5948,Lakme Absolute 3D Cover Foundation Neutral Honey 15 Ml,Warehouse C,23,5,2025-02-17 14:58:00,18
15998,ORD_15999,29270,Walnut Scrub,Warehouse B,103,86,2025-02-17 08:32:00,17
15999,ORD_16000,19097,E Mycin 100mg Suspension,Warehouse A,36,24,2025-02-17 15:40:00,12
16000,ORD_16001,23556,Myglamm Lit Nail Enamel - Cheap Thrills 7 ML,Warehouse A,80,70,2025-02-17 13:57:00,10
16001,ORD_16002,3302,XGMO®360 Degree Car Rear View Mirror Mobile Phone Holder Mount Stand Compatible with All Smartphones,Warehouse C,85,76,2025-02-17 11:53:00,9
16002,ORD_16003,6657,Azijeev 500mg Tablet,Warehouse B,17,10,2025-02-17 22:33:00,7
16003,ORD_16004,15326,"SanDisk Ultra® microSDXC™ UHS-I Card, 64GB, 140MB/s R, 10 Y Warranty, for Smartphones",Warehouse C,48,30,2025-02-17 04:28:00,18
16004,ORD_16005,28220,Hydra White Intense Whitening Hydrating Toner,Warehouse C,64,59,2025-02-16 18:16:00,5
16005,ORD_16006,26285,Parag Fragrances Oud Attar 4 in 1 Collection (Oud 4 in 1),Warehouse B,67,59,2025-02-16 23:11:00,8
16006,ORD_16007,1003,Oxalen Tablet,Warehouse C,98,84,2025-02-16 20:18:00,14
16007,ORD_16008,22104,POPIO Tempered Glass for Gopro Hero 9 / GoPro Hero 10 / GoPro Hero 11 Action Camera 3 Glass Edge To Edge (Transparent) Ful...,Warehouse C,105,91,2025-02-16 02:13:00,14
16008,ORD_16009,10142,Mega-CV 150mg Injection,Warehouse A,24,16,2025-02-16 18:00:00,8
16009,ORD_16010,32973,TheGiftKart Translucent Hybrid Back Case Cover for Redmi 10A / 10A Sport | Smoked Matte Back | 360 Degree Protection | Pro...,Warehouse A,36,31,2025-02-16 02:35:00,5
16010,ORD_16011,22110,"JBL Tune 700BT by Harman, 27-Hours Playtime with Quick Charging, Wireless Over Ear Headphones with Mic, Dual Pairing, AUX...",Warehouse B,113,95,2025-02-16 02:26:00,18
16011,ORD_16012,14673,"Dish TV Free to Air DTH Connection (Hindi), Zing Super FTA Set Top Box with 200+ Channels & Services. No Recharge for 2 Ye...",Warehouse A,79,66,2025-02-16 10:22:00,13
16012,ORD_16013,26643,"MAKE UP FOR LIFE 12 Hr Liquid Lip Gloss-116, Light Pink Mauve, 5 g",Warehouse B,92,84,2025-02-16 19:04:00,8
16013,ORD_16014,12542,ORICO 2.5 inch External Hard Drive Enclosure USB 3.0 to SATA III for 7mm and 9.5mm SATA HDD SSD Tool Free [UASP Supported]...,Warehouse A,12,7,2025-02-16 22:40:00,5
16014,ORD_16015,18718,Vega Flat Brush (E20 - FB) 118 gm,Warehouse C,90,78,2025-02-16 02:27:00,12
16015,ORD_16016,36741,Kwik Shaver - Shaving Razor With 2 Blades,Warehouse A,96,91,2025-02-16 16:00:00,5
16016,ORD_16017,1590,"Mi 10000mAH Li-Polymer, Micro-USB and Type C Input Port, Power Bank 3i with 18W Fast Charging (Midnight Black)",Warehouse A,111,99,2025-02-16 15:55:00,12
16017,ORD_16018,8384,MB Pod 200mg Tablet DT,Warehouse B,71,52,2025-02-16 08:49:00,19
16018,ORD_16019,35699,Wayona Type C To Type C Long Fast Charging Cable Type C Charger Cord Compatible With Samsung S22 S20 S20 Fe 2022 S22 Ultra...,Warehouse C,107,99,2025-02-16 20:04:00,8
16019,ORD_16020,4954,"Wet n Wild Lipstick, Berry (Matte)",Warehouse A,116,97,2025-02-16 01:02:00,19
16020,ORD_16021,32625,Atopil 10mg Tablet,Warehouse B,99,88,2025-02-16 15:15:00,11
16021,ORD_16022,26290,"truke Yoga Mystic lite Wireless in Ear Earphone with mic, with 50H of Playtime, ENC, Real Silicon Design, USB-C Fast Charg...",Warehouse C,106,89,2025-02-16 03:31:00,17
16022,ORD_16023,5169,"COOLCOLD 2.5 inch USB 3.0 External Hard Drive Enclosure for SATA I/II/III HDD and SATA SSD, SATA to USB3.0 Transparent Har...",Warehouse A,86,67,2025-02-16 09:54:00,19
16023,ORD_16024,22071,Urtipod 200mg/125mg Tablet,Warehouse B,54,39,2025-02-16 07:58:00,15
16024,ORD_16025,28202,Gabavent M 300mg/500mcg Tablet,Warehouse B,62,47,2025-02-16 05:32:00,15
16025,ORD_16026,22070,"HP Ink Tank 315 All-in-one Colour Printer with Upto 6000 Black and 8000 Colour Pages Included in The Box - Print, Scan & C...",Warehouse B,82,75,2025-02-16 04:35:00,7
16026,ORD_16027,3414,TIZUM Multi Purpose Earphone Carrying Case (Grey),Warehouse C,71,55,2025-02-16 22:26:00,16
16027,ORD_16028,32514,Herbal Peach Lip Balm,Warehouse B,42,36,2025-02-16 11:23:00,6
16028,ORD_16029,4963,Duloctus M 20mg/750mcg Tablet,Warehouse C,65,57,2025-02-16 06:11:00,8
16029,ORD_16030,28824,Nashi Argan Hydrating Styling Spray Mask / Without Washing / 150ml,Warehouse A,35,28,2025-02-16 15:52:00,7
16030,ORD_16031,27828,Risnia 2mg Tablet,Warehouse C,63,58,2025-02-16 01:51:00,5
16031,ORD_16032,35130,WOW IMAGINE Shock Proof Clear Back Case Mobile Cover for Samsung Galaxy A21s | (Hard | Hybrid PC + TPU | Full Armour Devic...,Warehouse C,104,90,2025-02-16 11:30:00,14
16032,ORD_16033,13172,"Lava Blaze 5G (Glass Blue, 6GB RAM, UFS 2.2 128GB Storage) | 5G Ready | 50MP AI Triple Camera | Upto 9GB Expandable RAM | ...",Warehouse A,21,5,2025-02-16 13:45:00,16
16033,ORD_16034,12541,"Camlin Kokuyo Fine Point Sketch Pen - 12 Shades, Multicoloured",Warehouse C,51,39,2025-02-16 16:06:00,12
16034,ORD_16035,26615,Medthiosid 4mg Injection,Warehouse A,41,23,2025-02-16 12:03:00,18
16035,ORD_16036,18920,18 Months Warranty VIRATECK Original Battery for Micromax in 1 / in 1b / in Note 1 / E6746 / E7746 / E6523 / E7533 (1ICP5/...,Warehouse C,45,38,2025-02-16 02:16:00,7
16036,ORD_16037,5974,Odds UP Syrup,Warehouse C,79,65,2025-02-16 08:39:00,14
16037,ORD_16038,10246,Telmiril 40 Tablet,Warehouse B,22,11,2025-02-16 22:54:00,11
16038,ORD_16039,22199,Apple iPhone 14 Pro (256 GB) - Space Black,Warehouse A,72,62,2025-02-16 16:42:00,10
16039,ORD_16040,29147,Casio MJ-120Da 150 Steps Check and Correct Desktop Calculator with Tax & GT Keys & On Display Indication of Active Constan...,Warehouse B,40,22,2025-02-16 02:08:00,18
16040,ORD_16041,27796,Peach and Avocado Nourishing Luxury Body Wash,Warehouse A,22,12,2025-02-16 06:37:00,10
16041,ORD_16042,14862,Dipromild 0.0125% Cream,Warehouse C,26,19,2025-02-16 05:05:00,7
16042,ORD_16043,34373,Telmiheal 40mg Tablet,Warehouse A,43,33,2025-02-16 07:46:00,10
16043,ORD_16044,1021,PROTOUCH Skin Lift Device | For Fine line & wrinkles | Reduces puffiness & Anti ageing | Bright & Firm skin | Portable | F...,Warehouse B,81,64,2025-02-16 15:23:00,17
16044,ORD_16045,28186,Atosta 40 Tablet,Warehouse B,110,95,2025-02-16 12:04:00,15
16045,ORD_16046,10114,Visken 10mg Tablet,Warehouse A,84,72,2025-02-16 11:13:00,12
16046,ORD_16047,22034,"Emilydeals Charger for Fitbit Versa 3/Versa 4/Sense/Sense 2, Replacement Charging Cable Cord for Fitbit Sense/Sense 2/Vers...",Warehouse A,102,96,2025-02-16 06:44:00,6
16047,ORD_16048,35238,Sivanna Colors You Glow Bounce Highlighter - HF6012 01 11 gm,Warehouse A,47,39,2025-02-16 04:56:00,8
16048,ORD_16049,27851,Glimmer Nail Polish Red Lips 5 ml,Warehouse A,51,38,2025-02-16 00:39:00,13
16049,ORD_16050,26316,Miss Rose 2 In 1 Creamy Matte Lipstick 7102 - 001M 42 2.1 gm,Warehouse C,42,28,2025-02-16 01:48:00,14
16050,ORD_16051,22023,Mainglic M 80mg/500mg Tablet,Warehouse A,68,50,2025-02-16 01:01:00,18
16051,ORD_16052,22019,Thiace 100mg/4mg Tablet,Warehouse A,42,32,2025-02-16 22:48:00,10
16052,ORD_16053,18959,Motinorm Drops,Warehouse A,101,96,2025-02-16 14:09:00,5
16053,ORD_16054,26326,"Ustraa Rebel Cologne Soap with Oak & Walnut, 125 gm (Pack of 3)",Warehouse C,72,65,2025-02-16 23:35:00,7
16054,ORD_16055,5823,Rinkon Motivation (Pack of 13 stickers) Inspiration Vinyl Sticker Motivation Quotes Stickers for Laptop Trackpad All Model...,Warehouse A,66,52,2025-02-16 03:07:00,14
16055,ORD_16056,36696,"Ceptics India to USA Converter Plug - Type B Canada Travel Adapter, 2 in 1 USA, Japan Plug - Dual Input USA Travel Adapter...",Warehouse A,84,73,2025-02-16 16:07:00,11
16056,ORD_16057,18973,Valuzin 200mg Tablet SR,Warehouse C,33,14,2025-02-16 07:35:00,19
16057,ORD_16058,100,Black Set - Eau De Toilette + Deodorant,Warehouse C,115,99,2025-02-16 01:54:00,16
16058,ORD_16059,8666,AmazonBasics USB 3.1 Type-C to 3 Port USB Hub with Ethernet Adapter - White,Warehouse A,108,98,2025-02-16 22:39:00,10
16059,ORD_16060,8432,Melzap MD 0.25 Tablet,Warehouse A,94,77,2025-02-16 20:06:00,17
16060,ORD_16061,28142,Megavog 0.2mg Tablet MD,Warehouse C,93,83,2025-02-16 16:54:00,10
16061,ORD_16062,36698,"Fashion Colour Kiss Lip No Transfer Lipstick, 96 Fuscous 2.6 gm",Warehouse B,82,63,2025-02-16 06:23:00,19
16062,ORD_16063,19447,L.A GIRL Pro Natural Liquid Conceal 970 - Light Ivory,Warehouse C,105,97,2025-02-16 23:02:00,8
16063,ORD_16064,8439,"tizum Foldable Tablet/Mobile Phone Tabletop Stand Holder, Adjustable Angle, Anti-Slip Pads, Cradle, Dock Compatible for Ip...",Warehouse C,102,87,2025-02-16 07:38:00,15
16064,ORD_16065,13177,Deodorant Roll On For Women - Original,Warehouse C,46,37,2025-02-16 05:24:00,9
16065,ORD_16066,5408,"Portronics My Buddy K2 Portable Laptop Stand with 7 Adjustable Level, Ergonomic Design, Multifunctional for All Laptops(Si...",Warehouse A,70,51,2025-02-16 08:31:00,19
16066,ORD_16067,16937,"SUGAR Cosmetics - Goddess Of Flawless - BB Cream with SPF 30-07 Vanilla Latte (Fair Shades) - Long Lasting, Lightweight BB...",Warehouse A,54,44,2025-02-16 20:14:00,10
16067,ORD_16068,16935,Passion Indulge BATH BAR-BASIL ( PACK OF 3 ) 1's,Warehouse C,105,92,2025-02-16 18:46:00,13
16068,ORD_16069,35923,Spantra Curly Hair Shampoo 300 ml,Warehouse A,22,17,2025-02-16 11:16:00,5
16069,ORD_16070,32726,Stbotanica Sour Apple & Cinnamon Body Wash - With Shea & Vitamin E 250 ml,Warehouse A,77,66,2025-02-16 09:07:00,11
16070,ORD_16071,7483,Tough Lee Tempered Glass for Apple iPhone 14/13 / 13 Pro (6.1 inch) - Case Friendly Screen Coverage & Earpiece Dust Resist...,Warehouse A,44,33,2025-02-16 10:46:00,11
16071,ORD_16072,11083,Kimirica Madagascar Vanilla Silicone Free Moisturizing Scented Body Lotion for Hydrated skin with Tucuma & Shea Butter 10...,Warehouse A,54,48,2025-02-16 05:59:00,6
16072,ORD_16073,8989,Amazon Basics 6-Feet DisplayPort (not USB port) to HDMI Cable Black,Warehouse A,52,37,2025-02-16 01:09:00,15
16073,ORD_16074,32717,"Viaxos All in One USB Universal Worldwide International Travel Adapter Plug for Laptops, Cameras (Supports Over 150 Countr...",Warehouse C,16,5,2025-02-16 18:08:00,11
16074,ORD_16075,32238,Aloe Veda Herbal Conditioning Shampoo 200 ml,Warehouse C,91,76,2025-02-16 02:51:00,15
16075,ORD_16076,11397,"Print Master India Premium Flatlay Tabletop Photography Backdrop Background, Double Sided Waterproof Paper for Food, Small...",Warehouse B,42,32,2025-02-16 13:53:00,10
16076,ORD_16077,29419,Triple Vitamin Moisturising Body Lotion,Warehouse B,53,41,2025-02-16 21:23:00,12
16077,ORD_16078,11283,"Syncwire USB Type C to 3.5 mm Audio Jack Connector, Headphones Jack Converter Compatible with Galaxy S8, S8 Plus, S9, S9 P...",Warehouse A,50,31,2025-02-16 00:41:00,19
16078,ORD_16079,27493,Hexa Advanced Soap,Warehouse C,42,29,2025-02-16 03:22:00,13
16079,ORD_16080,7696,Anti Ageing Face Wash With Hyluronic Acid & Active Vitamin C,Warehouse C,87,73,2025-02-16 19:36:00,14
16080,ORD_16081,5708,Nandika Repair and Nourish Hair Conditioner - Argan Oil 500 ml,Warehouse A,109,94,2025-02-16 01:34:00,15
16081,ORD_16082,25619,Hello Sun SunBlock & Anti-Tan Lotion SPF40,Warehouse B,87,70,2025-02-16 21:21:00,17
16082,ORD_16083,1786,Amazon Brand - Solimo TPU Transparent Mobile Soft & Flexible Shockproof Back Cover with Cushioned Edges for iPhone 13- Clear,Warehouse C,72,65,2025-02-16 00:49:00,7
16083,ORD_16084,16876,Valimai Tablet Screen Guard Glass Compatible for Redmi Pad 10.61 Inch (2022),Warehouse A,59,42,2025-02-16 16:27:00,17
16084,ORD_16085,23269,Lenphor Timeless Eye Liner Silver Snow 04 1.2 Gm,Warehouse B,47,32,2025-02-16 01:49:00,15
16085,ORD_16086,7705,Vasolip 40mg Tablet,Warehouse C,65,48,2025-02-16 19:16:00,17
16086,ORD_16087,4507,Prolet 50 Tablet,Warehouse B,46,39,2025-02-16 23:19:00,7
16087,ORD_16088,25339,Zanox OZ 200mg/500mg Tablet,Warehouse C,72,55,2025-02-16 07:00:00,17
16088,ORD_16089,34040,Wipeout Germ Killing Face Wash,Warehouse A,82,73,2025-02-16 19:47:00,9
16089,ORD_16090,25630,Feamp-MR Tablet,Warehouse B,52,39,2025-02-16 20:06:00,13
16090,ORD_16091,21129,Ajmal Sacred Love Perfume Deodorant 200ml Body Spray Gift For Women,Warehouse C,56,51,2025-02-16 01:05:00,5
16091,ORD_16092,979,Prasaranyadi Kwath,Warehouse C,56,46,2025-02-16 11:13:00,10
16092,ORD_16093,15260,"AmazonBasics Highlighter - Chisel Tip, Pack of 12 (Multicolor)",Warehouse A,47,31,2025-02-16 12:21:00,16
16093,ORD_16094,11137,Lipril 2.5 Tablet,Warehouse A,51,45,2025-02-16 12:05:00,6
16094,ORD_16095,29373,"Spigen Thin Fit PC and TPU Back Cover, Compatible for Samsung Galaxy S21 FE 5G - Black",Warehouse A,27,12,2025-02-16 06:37:00,15
16095,ORD_16096,11096,Lexxa 500mg Tablet,Warehouse C,70,59,2025-02-16 08:19:00,11
16096,ORD_16097,7479,Ktrax 10mg Tablet,Warehouse B,73,65,2025-02-16 00:24:00,8
16097,ORD_16098,17347,Rose & Geranium Sugar Soap,Warehouse A,85,80,2025-02-16 02:34:00,5
16098,ORD_16099,9514,Half Moon 30L Waterproof 15.6 inch Laptop Office School College Bag Backpack for Men Women Boys & Girls,Warehouse A,84,69,2025-02-16 22:27:00,15
16099,ORD_16100,20019,Pmg 2 Tablet PR,Warehouse B,47,35,2025-02-16 09:48:00,12
16100,ORD_16101,36526,Zebronics Zeb-Calyx Wired in Ear Earphones with Mic (Black),Warehouse A,35,29,2025-02-16 14:44:00,6
16101,ORD_16102,2123,"Amazon Brand - Solimo Anti Dust Plug Mobile Cover (Soft & Flexible Back case) for Nothing Phone 1, TPU, Ruddy",Warehouse B,52,46,2025-02-16 13:02:00,6
16102,ORD_16103,13167,CEDO Case iQOO 7 (5G) Case Back Cover Shockproof Bumper Crystal Clear | 360 Degree Protection TPU+PC | Camera Protection |...,Warehouse C,60,48,2025-02-16 02:48:00,12
16103,ORD_16104,11109,Ajmal Shadow Homme & Sacrificeiihim & Carbon & Avid Deo & Yearn EDP Pack of 5 20 ml,Warehouse A,40,24,2025-02-16 08:50:00,16
16104,ORD_16105,7653,"Waylon 22mm Sports Smart Watch Strap Compatible with Noise ColorFit Ultra/Ultra 2, Vision, Caliber, Pro 3, Active/GPS, Buz...",Warehouse A,79,62,2025-02-16 10:04:00,17
16105,ORD_16106,192,Ethamswift 125mg Injection,Warehouse C,42,35,2025-02-16 23:55:00,7
16106,ORD_16107,23369,Tusqe D 5mg/2mg/10mg Syrup,Warehouse A,33,14,2025-02-16 11:35:00,19
16107,ORD_16108,4455,SYGA Desk Pad Protector Waterproof PU Desk Mat Blotters on Desktop Laptop Computer Gaming Keyboard Mouse Pad Non-Slip Desk...,Warehouse A,84,71,2025-02-16 19:24:00,13
16108,ORD_16109,33997,"Fashion Colour Dual Face Powder & Blusher, Shade 04 7.5 gm",Warehouse B,75,58,2025-02-16 12:11:00,17
16109,ORD_16110,17338,Bella Voste | 4-in-1 MAKEUP STICK | Cruelty Free | Weightless | Long lasting | Velvet Matte Finish formula Provides Full C...,Warehouse B,34,15,2025-02-16 09:20:00,19
16110,ORD_16111,4423,Ajmal Aurum Carbon Carbon Deodorant Spray (Pack of 3) 200 ml,Warehouse B,78,64,2025-02-16 12:19:00,14
16111,ORD_16112,11126,Lenphor Nail Tint Blood Stain 29 12 Ml,Warehouse A,61,52,2025-02-16 17:58:00,9
16112,ORD_16113,2155,TheGiftKart Translucent Hybrid OnePlus 10R 5G / 10R Prime 5G Back Case Cover | Smoked Matte Back | 360 Degree Protection |...,Warehouse A,106,92,2025-02-16 12:30:00,14
16113,ORD_16114,10796,Insight Cosmetics Matte Lipstick - Mauve Magic 4.2 gm,Warehouse A,34,24,2025-02-16 20:29:00,10
16114,ORD_16115,15271,"boAt BassHeads 122 Wired in Ear Earphones with Heavy Bass, Integrated Controls and Mic (Gun Metal)",Warehouse C,107,90,2025-02-16 17:25:00,17
16115,ORD_16116,5662,AmazonBasics AAA Performance Alkaline Batteries (20-Pack) - Appearance May Vary,Warehouse A,59,54,2025-02-16 19:56:00,5
16116,ORD_16117,27470,Mapperz 15 Shades Highlighter Concealer and Contour Palette Contour Powder as Used Bronzer- (Multi),Warehouse B,57,41,2025-02-16 15:15:00,16
16117,ORD_16118,11348,"ikis 2 pcs Portable Mini USB Dragon Fan with 2 Leaf Connect with Laptop, Smartphone, Powerbank, USB Adapter/Hub (Multicolour)",Warehouse B,54,49,2025-02-16 03:52:00,5
16118,ORD_16119,7484,"SanDisk Ultra Dual Drive Go USB Type C Pendrive for Mobile, Navy Blue, 512GB, 5Y Warranty",Warehouse A,79,67,2025-02-16 22:47:00,12
16119,ORD_16120,23420,Glycerine Soap,Warehouse A,27,22,2025-02-16 16:12:00,5
16120,ORD_16121,32727,WARMEE Body & Hand Warmers Heat Pouch (Pack of 20 Body + 12 Hand),Warehouse A,20,1,2025-02-16 05:28:00,19
16121,ORD_16122,11143,Naprolix D 500mg/10mg Tablet,Warehouse A,24,5,2025-02-16 05:57:00,19
16122,ORD_16123,7619,"JBL Flip 6 Wireless Portable Bluetooth Speaker with JBL Pro Sound, Upto 12 Hours Playtime, IP67 Water & Dustproof, PartyBo...",Warehouse A,30,13,2025-02-16 19:43:00,17
16123,ORD_16124,17316,Actioner DX Syrup,Warehouse C,59,46,2025-02-16 21:22:00,13
16124,ORD_16125,4900,Ronyglim-MV 1 Tablet SR,Warehouse A,91,78,2025-02-16 11:50:00,13
16125,ORD_16126,26402,"MOCA 360 Protective Laptop Sleeve for 14-inch MacBook Pro M1 Pro/Max 2021 A2442, 13.5-14.4 Inch Surface Laptop Studio 202...",Warehouse C,66,49,2025-02-16 03:52:00,17
16126,ORD_16127,21498,Klorzid 25mg Tablet,Warehouse A,33,14,2025-02-16 01:16:00,19
16127,ORD_16128,109,Reliance Smart - E-Gift Card - Flat 1% Off - Redeemable in Stores,Warehouse C,78,68,2025-02-16 16:48:00,10
16128,ORD_16129,5082,Norpregalin 75mg/10mg Tablet,Warehouse A,64,49,2025-02-16 03:29:00,15
16129,ORD_16130,19354,Nistrom 2mg Tablet,Warehouse B,27,18,2025-02-16 07:38:00,9
16130,ORD_16131,19353,CEDO Basic Case for Samsung M53 (5G) with Rotating Ring Holder & Kickstand in-Built (Plastic|Black),Warehouse C,19,12,2025-02-16 02:32:00,7
16131,ORD_16132,33014,"Vivo V23 5G (Stardust Black, 12GB RAM, 256GB Storage)",Warehouse B,93,81,2025-02-16 07:09:00,12
16132,ORD_16133,36729,"Marklif Premium Metal Folding Portable Laptop Stand Non-Slip Base Bracket, Tabletop Risers for 10-17 Inch Laptop & Keyboar...",Warehouse B,87,71,2025-02-16 13:05:00,16
16133,ORD_16134,5865,Lipibay 20mg Tablet,Warehouse B,95,87,2025-02-16 09:31:00,8
16134,ORD_16135,8590,Lakme Color Crush Nail Art F1 6 Ml,Warehouse C,58,48,2025-02-16 02:00:00,10
16135,ORD_16136,3082,TP-Link 8 Port 10/100Mbps Fast Ethernet Switch | Desktop Ethernet Splitter | Ethernet Network Hub | Plug and Play | Fanles...,Warehouse B,102,94,2025-02-16 23:29:00,8
16136,ORD_16137,21718,Lipicura 10mg Tablet,Warehouse A,80,65,2025-02-16 19:51:00,15
16137,ORD_16138,35285,Relaxate Plus 25mg/10mg Tablet,Warehouse A,60,44,2025-02-16 22:25:00,16
16138,ORD_16139,14729,"BlueRigger Digital Optical Audio Toslink Cable (6 Feet / 1.8 Meter) With 8 Channel (7.1) Audio Support (for Home Theatre, ...",Warehouse A,60,44,2025-02-16 12:01:00,16
16139,ORD_16140,2337,Unirab D 30mg/20mg Capsule SR,Warehouse C,49,35,2025-02-16 23:45:00,14
16140,ORD_16141,5872,Bella Voste Sugar Baby Nail Paints Shade 366 10 Ml,Warehouse A,63,56,2025-02-16 16:28:00,7
16141,ORD_16142,19324,CEFACIN 250 MG TABLET DT,Warehouse C,90,73,2025-02-16 04:35:00,17
16142,ORD_16143,9902,Diatin-M 500mg/20mg Tablet,Warehouse C,109,96,2025-02-16 16:04:00,13
16143,ORD_16144,19326,Nimek Para Plus Suspension,Warehouse A,100,89,2025-02-16 17:02:00,11
16144,ORD_16145,14725,Sommeil 0.5mg Tablet,Warehouse C,17,4,2025-02-16 01:13:00,13
16145,ORD_16146,3083,"Juarez JRZ23UK/NA 23"" Concert Size Ukulele Kit, AQUILA Strings, Sapele Body, Rosewood Fingerboard, Matte Finish, with Bag ...",Warehouse B,47,37,2025-02-16 05:48:00,10
16146,ORD_16147,27951,Sounce Soft TPU Front Protection Case Cover for Amazfit GTS 2 Mini/BIP U/Bip U Pro/BIP Lite/Bip S/Bip S Lite Smart Watch (...,Warehouse B,52,37,2025-02-16 08:42:00,15
16147,ORD_16148,8607,Flormar BB Cream BB02 Fair/Light 35 ml,Warehouse A,100,89,2025-02-16 15:43:00,11
16148,ORD_16149,27933,"BigPassport USB Wired Over Ear Headphones with Noise-Cancelling with mic for PC & Laptop, Model- Pro-Boom 722 Black",Warehouse B,48,43,2025-02-16 00:15:00,5
16149,ORD_16150,14110,"Swiss Beauty Eye Define Auto Kajal Longwear And Smudge Proof, Eye Makeup, Sb-E3, Black, 0.35G - Long Stay, Waterproof, Eye...",Warehouse A,61,55,2025-02-16 18:36:00,6
16150,ORD_16151,31056,Aqua Plus Eye Drop,Warehouse A,96,79,2025-02-16 00:23:00,17
16151,ORD_16152,31698,Amlorite 5mg Tablet,Warehouse B,20,15,2025-02-16 01:49:00,5
16152,ORD_16153,34472,Faces Canada Splash Nail Enamel Silver Frost 61 8 Ml,Warehouse C,32,23,2025-02-16 16:30:00,9
16153,ORD_16154,35322,Atek 40mg Tablet,Warehouse B,34,17,2025-02-16 15:41:00,17
16154,ORD_16155,28023,"BenQ GW2480 24 inch (60 cm) 1920 x 1080 Pixels IPS Full HD Ultra-Slim Bezel Monitor- Eye Care, Anti-Glare, Brightness Inte...",Warehouse B,40,24,2025-02-16 00:03:00,16
16155,ORD_16156,2565,Lincopic 250mg Capsule,Warehouse B,37,32,2025-02-16 00:27:00,5
16156,ORD_16157,8578,"Faber-Castell Paint Brush Set - Flat, Pack of 7 (Navy Blue)",Warehouse A,20,12,2025-02-16 15:29:00,8
16157,ORD_16158,8297,TheGiftKart Crystal Clear Back Cover Case for Samsung Galaxy A73 5G | 360 Degree Protection | Shock Proof Design | Transpa...,Warehouse B,20,14,2025-02-16 17:55:00,6
16158,ORD_16159,1540,Vitamin E Face Pack,Warehouse B,109,95,2025-02-16 15:01:00,14
16159,ORD_16160,16919,Flormar Touch Up Concealer 40 Light 4 ml,Warehouse C,32,23,2025-02-16 21:24:00,9
16160,ORD_16161,14796,"GOVO GOKIXX 621 Bluetooth Neckband, 22 Hours Battery, ENC Technology, Fast Charge, Smart Magnetic Buds, Gaming Mode, 10mm ...",Warehouse C,100,85,2025-02-16 17:56:00,15
16161,ORD_16162,27890,Noroxin 400mg Tablet,Warehouse B,91,85,2025-02-16 13:28:00,6
16162,ORD_16163,19099,Litazith 500mg Tablet,Warehouse C,80,61,2025-02-16 16:45:00,19
16163,ORD_16164,5966,Organic Harvest Sunscreen Cream - SPF 60 (Acne/Oily Skin) 100 gm,Warehouse B,29,14,2025-02-16 21:28:00,15
16164,ORD_16165,9827,Volicure 0.3mg Tablet,Warehouse B,93,87,2025-02-16 16:30:00,6
16165,ORD_16166,26370,Mcaffeine Damage Repair Shampoo & Conditioner - Latte Coffee Routine 500 ml,Warehouse C,102,92,2025-02-16 08:53:00,10
16166,ORD_16167,35255,Incolor Gel Effect Matte Nail Enamel Combo 17 Pack Of 02 (96-93) 15 Ml,Warehouse C,68,62,2025-02-16 21:38:00,6
16167,ORD_16168,2313,Fragrance Body Spray - 1 Good Morning & 2 Storm,Warehouse A,51,33,2025-02-16 14:35:00,18
16168,ORD_16169,21935,OnePlus Nord Buds CE Bluetooth Truly Wireless in Ear Earbuds,Warehouse A,97,88,2025-02-16 16:21:00,9
16169,ORD_16170,1556,"MI 10T 5G Cosmic Black, 8GB RAM, 128GB Storage - |Additional Exchange/No Cost EMI Offers",Warehouse C,84,73,2025-02-16 14:22:00,11
16170,ORD_16171,21931,Spigen AlignMaster Tempered Glass Screen Guard for iPhone 11 / Xr - 2 Pack,Warehouse B,49,31,2025-02-16 03:27:00,18
16171,ORD_16172,35369,"Magnetic Wireless Charger 3 in 1-15W Wireless Charging Station for Multiple Devices, Mag-Safe Charger Stand for iPhone 12 ...",Warehouse B,85,77,2025-02-16 17:18:00,8
16172,ORD_16173,8472,Pentel EnerGel Click Roller Gel Pen - Pack of 4 (BLUE PENS),Warehouse C,68,58,2025-02-16 11:55:00,10
16173,ORD_16174,19434,"Printme™ Silicone Protective Case Cover for OnePlus Earbuds Z TWS, Anti Fall Anti Dust, with Hook Earphone Case *Case Cove...",Warehouse B,86,75,2025-02-16 15:53:00,11
16174,ORD_16175,19066,Etheric Sandal + Rose Petal Combo for skin whitening (100+100 Gm),Warehouse B,29,16,2025-02-16 05:26:00,13
16175,ORD_16176,26385,Lenoflox 500mg Tablet,Warehouse C,25,14,2025-02-16 19:01:00,11
16176,ORD_16177,8478,"Samsung Galaxy Watch5 Bluetooth (44 mm, Graphite, Compatible with Android only)",Warehouse A,32,26,2025-02-16 20:33:00,6
16177,ORD_16178,19430,Avanep Eye Drop,Warehouse B,38,22,2025-02-16 19:01:00,16
16178,ORD_16179,14694,7X Activated Charcoal Peel Off Mask - Infused With Vitamin C & Menthol,Warehouse B,21,5,2025-02-16 21:45:00,16
16179,ORD_16180,5949,Ajmal Prose EDP & Primitive Forest EDT Pack of 2 350 ml,Warehouse C,28,15,2025-02-16 07:45:00,13
16180,ORD_16181,8481,Touch & Glow Advanced Fairness Face Wash,Warehouse A,89,76,2025-02-16 03:15:00,13
16181,ORD_16182,14066,SD CASS® Hanging Car Rear View Mirror Mobile Phone Holder Mount Stand 360 Degree RotationalCompatible with All Smartphones,Warehouse C,51,33,2025-02-16 09:41:00,18
16182,ORD_16183,19090,Cefobik 200mg Tablet,Warehouse A,78,69,2025-02-16 20:36:00,9
16183,ORD_16184,35355,Pel DS 100mg Dry Syrup,Warehouse C,46,36,2025-02-16 18:46:00,10
16184,ORD_16185,1541,TheGiftKart Ultra-Hybrid Crystal Clear Back Cover Case for iPhone 11 | Anti-Slip Grip Built-in | Bold Camera Protection Bu...,Warehouse B,37,24,2025-02-16 12:46:00,13
16185,ORD_16186,26453,"Parker Jotter Stainless GT Ball Pen, Steel",Warehouse A,62,53,2025-02-16 20:20:00,9
16186,ORD_16187,35318,Proxy 10mg Tablet,Warehouse A,99,81,2025-02-16 18:00:00,18
16187,ORD_16188,5914,Win 650mg Tablet DT,Warehouse B,109,95,2025-02-16 23:10:00,14
16188,ORD_16189,35312,SHAPERZ Eye Shadow Shields Eyes Tips Sticker Wrap Pad Application Tool | Hypoallergic Moon Shaped Makeup Sheets/Precision ...,Warehouse C,22,16,2025-02-16 17:19:00,6
16189,ORD_16190,12924,Xenart MF 500mg/250mg Tablet,Warehouse B,48,30,2025-02-16 09:10:00,18
16190,ORD_16191,35224,Olive & Oat Face Wash,Warehouse A,35,20,2025-02-16 06:05:00,15
16191,ORD_16192,10192,Seagate Portable 1TB External HDD – USB 3.0 for PC Laptop and Mac (STGX1000400),Warehouse C,33,21,2025-02-16 23:40:00,12
16192,ORD_16193,35447,Leezine 5mg Tablet,Warehouse C,23,8,2025-02-16 01:55:00,15
16193,ORD_16194,1104,Passion Bazaar Forehead Multicolor Bindi Gift-able For Women’s & Girl’s,Warehouse C,101,86,2025-02-16 14:17:00,15
16194,ORD_16195,28248,Boostim LB 625 Tablet,Warehouse C,63,57,2025-02-16 09:17:00,6
16195,ORD_16196,10178,Depsol 25mg Tablet,Warehouse A,52,45,2025-02-16 18:21:00,7
16196,ORD_16197,26650,Havpod-CV Dry Syrup,Warehouse A,82,77,2025-02-16 20:01:00,5
16197,ORD_16198,18827,"Vinayakart Magnetic Eyeliner and 3 False Eyelashes. 3D Chemical Fiber Free Glue Three Magnetic False Eyelashes, Set Easy t...",Warehouse B,97,90,2025-02-16 05:29:00,7
16198,ORD_16199,10175,Bendaz Suspension,Warehouse B,44,34,2025-02-16 02:34:00,10
16199,ORD_16200,18752,"HP - HPFD5600C-128 USB Type C 128GB 3.2 Pen Drive, Grey & Black",Warehouse B,62,54,2025-02-16 09:35:00,8
16200,ORD_16201,19544,Akai PartyMate Bluetooth Party Speaker PM-60T 60W Karaoke System Portable Trolley Outdoor Speaker/Inbuilt Battery/Wireless...,Warehouse C,84,79,2025-02-16 06:06:00,5
16201,ORD_16202,26269,"Storite PU Leather Multipurpose 24 File Sleeve to Store A4 Professional Files and Folders, Certificate, Legal Size Documen...",Warehouse B,62,50,2025-02-16 21:07:00,12
16202,ORD_16203,31093,Nim Xtra 100mg Tablet,Warehouse C,21,11,2025-02-16 23:13:00,10
16203,ORD_16204,6048,Ola S1 Pro Charger Holder | Ola S1 Matel Charger Bracket Wall Mount with Key Lock Protection,Warehouse B,18,10,2025-02-16 13:22:00,8
16204,ORD_16205,970,"pTron Bullet Pro 36W PD Quick Charger, 3 Port Fast Car Charger Adapter - Compatible with All Smartphones & Tablets (Black)",Warehouse B,98,89,2025-02-16 15:12:00,9
16205,ORD_16206,6047,Utegest 100mg Injection,Warehouse C,25,10,2025-02-16 11:52:00,15
16206,ORD_16207,22247,"Samsung 27-inch(68.5cm) FHD, 1800R Curved Monitor, VA Panel, Slim Design, AMD FreeSync, Flicker Free, HDMI, Audio Ports (L...",Warehouse B,77,71,2025-02-16 02:39:00,6
16207,ORD_16208,18677,"Fashion Colour Soft Lip Mousse, 22 Smoky Rose 8 gm",Warehouse C,101,96,2025-02-16 21:31:00,5
16208,ORD_16209,19565,"Chambor Smooth On Eye Liner, Carbon Black #101",Warehouse A,81,71,2025-02-16 18:46:00,10
16209,ORD_16210,21496,Glucolive MV 1mg/500mg/0.3mg Tablet,Warehouse C,108,93,2025-02-16 15:10:00,15
16210,ORD_16211,13008,s.Oliver Black Label Women Shower Gel 150 ml,Warehouse C,60,51,2025-02-16 12:55:00,9
16211,ORD_16212,18697,Allure Tapered Face Brush - (108) 1's,Warehouse B,53,40,2025-02-16 07:48:00,13
16212,ORD_16213,10261,Cello Signature Ethos Ball Pen | Blue Ball Pen | Pack of 1 | Best Ball Pens for Smooth Writing | Gifting Pens | Premium Ba...,Warehouse C,52,37,2025-02-16 05:16:00,15
16213,ORD_16214,33105,"BigPassport USB Wired Over Ear Headphones with Noise-Cancelling with mic for PC, Laptop, Computer Model- Pro-Tech 440 Black",Warehouse B,24,5,2025-02-16 00:08:00,19
16214,ORD_16215,14016,Lukalov M 5mg/10mg Tablet,Warehouse C,12,7,2025-02-16 18:15:00,5
16215,ORD_16216,26255,"DIZORO Camera Lens Protector Compatible for iPhone 13/iPhone 13 Mini, [Anti-Scratch] Premium Tempered Glass Film Aluminum ...",Warehouse C,106,88,2025-02-16 19:10:00,18
16216,ORD_16217,992,"Apple Watch Series 8 [GPS + Cellular 45 mm] Smart Watch w/Silver Aluminium Case with White Sport Band. Fitness Tracker, Bl...",Warehouse C,67,62,2025-02-16 10:26:00,5
16217,ORD_16218,18785,"Portronics Ruffpad 15 Re-Writable LCD Screen 38.1cm (15-inch) Writing Pad for Drawing, Playing, Handwriting Gifts for Kids...",Warehouse B,63,55,2025-02-16 07:48:00,8
16218,ORD_16219,14713,Pierre Cardin Paris - Hd Blur Foundation Light,Warehouse B,63,46,2025-02-16 07:02:00,17
16219,ORD_16220,30662,iTronix USB Charging Cable for BoAt Wave Call/BoAt Wave Lite Smartwatches (Cable Only),Warehouse C,58,46,2025-02-16 16:55:00,12
16220,ORD_16221,30685,WC Wicked Cushions Premium Replacement Ear Cushions for Bose QC35 ii & QC35 (QuietComfort 35) Headphones - Black,Warehouse A,55,41,2025-02-16 08:21:00,14
16221,ORD_16222,2339,Dabur Glucose-D Energy Drink,Warehouse A,77,63,2025-02-16 00:44:00,14
16222,ORD_16223,12594,Erpetol 0.5% Eye Drop,Warehouse A,33,26,2025-02-16 04:23:00,7
16223,ORD_16224,19380,Daily Life Forever52 Waterproof Smoothenin Eye Pencil Pitch F502 1 Gm,Warehouse B,33,24,2025-02-16 16:13:00,9
16224,ORD_16225,3078,Flormar Quick Dry Nail Enamel QD21 Blackstar Red 11 ml,Warehouse C,91,72,2025-02-16 07:19:00,19
16225,ORD_16226,31048,Lakme Absolute Mattereal Mousse Concealer 01 Sand 9 Gm,Warehouse C,57,40,2025-02-16 00:58:00,17
16226,ORD_16227,19377,Spigen EZ Fit Tempered Glass Screen Guard for iPhone 12 and iPhone 12 Pro - 2 Pack,Warehouse B,28,12,2025-02-16 13:04:00,16
16227,ORD_16228,34485,Vega Pumice Stone Brush With Handle (PD - 01N) 94 gm,Warehouse C,87,68,2025-02-16 08:16:00,19
16228,ORD_16229,35303,"ZENAKU Type C to lightning USB Cable 8 Pin Fast charger Cord Compatible with APPLE iPhone 14, 13, 12, 11, SE, iPad and oth...",Warehouse B,68,56,2025-02-16 22:10:00,12
16229,ORD_16230,5903,Soulflower Herbal Super Rich Conditioner 250 ml,Warehouse C,11,5,2025-02-16 21:28:00,6
16230,ORD_16231,31045,Hyqutrin M Ointment,Warehouse C,81,62,2025-02-16 05:04:00,19
16231,ORD_16232,10213,Amazon Brand - Solimo Back Cover for Redmi Note 9 Pro/Redmi Note Pro Max/Poco M2 Pro (Silicone | Clear),Warehouse A,34,17,2025-02-16 23:08:00,17
16232,ORD_16233,14059,Maryaj Eau De Parfum Wild Stripes For Him 100 Ml,Warehouse A,78,68,2025-02-16 03:22:00,10
16233,ORD_16234,28129,Zydiclo Injection,Warehouse A,74,64,2025-02-16 05:03:00,10
16234,ORD_16235,101,"DigiTek (DTR-210SS) Portable Selfie Stick with Wireless Remote and 3 Legs Tripod Base, Compatible for iPhone/OnePlus/Samsu...",Warehouse B,75,58,2025-02-16 16:42:00,17
16235,ORD_16236,6027,Bare Anatomy EXPERT Anti-Dandruff Shampoo | Targets Oily Scalp and Sheds Dry Flakes | 250ml,Warehouse A,77,69,2025-02-16 23:52:00,8
16236,ORD_16237,22183,SC Plus 0.5mg/10mg Tablet,Warehouse C,71,55,2025-02-16 10:29:00,16
16237,ORD_16238,4920,Crysendo Compatible with JABRA Evolve 30/20 UC/BIZ2400 Headset | 60mm Extra Thick Replacement Headphone Cushion Foam Spong...,Warehouse B,23,4,2025-02-16 17:43:00,19
16238,ORD_16239,26244,TA Technology Ahead Bt-Receiver Car Wireless Bluetooth Receiver Adapter 3.5 mm Aux Audio Stereo Music Home Hands Free Car ...,Warehouse B,64,47,2025-02-16 16:47:00,17
16239,ORD_16240,10220,Nandax 50mg Injection,Warehouse C,37,29,2025-02-16 07:05:00,8
16240,ORD_16241,12921,Rabgem 20mg Injection,Warehouse B,51,42,2025-02-16 16:53:00,9
16241,ORD_16242,22179,"anchor by panasonic 22061 6A Power Strip 4 Socket Spike Guard with Single Switch (1.5 m, White and Blue)",Warehouse C,71,54,2025-02-16 01:42:00,17
16242,ORD_16243,1603,Voizbest 20 Tablet,Warehouse C,63,48,2025-02-16 00:30:00,15
16243,ORD_16244,2618,Telecad 20mg Tablet,Warehouse A,36,22,2025-02-16 12:55:00,14
16244,ORD_16245,22176,"Hair & Scalp Oil - Avacado & Coriander, For Tri-Dosha",Warehouse A,40,34,2025-02-16 02:40:00,6
16245,ORD_16246,23325,Faces Canada Hishine Nail Enamel Top Coat 136 9 Ml,Warehouse A,73,57,2025-02-16 05:59:00,16
16246,ORD_16247,26371,Ajmal Aurum EDP Fruity Floral Perfume 75ml for Women and Blu Dreams EDP Citurs Fruity Perfume 100ml for Men +1 Perfume Tes...,Warehouse B,10,4,2025-02-16 19:32:00,6
16247,ORD_16248,15242,"Redmi 11 Prime 5G (Chrome Silver, 4GB RAM 64GB ROM) | Prime Design | MTK Dimensity 700 | 50 MP Dual Cam | 5000mAh | 7 Band 5G",Warehouse B,72,56,2025-02-16 00:09:00,16
16248,ORD_16249,7859,RiaTech 1 Male to 2 Female 3.5mm Audio Jack to Headphone Microphone Splitter Converter Adaptor Cable(Specially Design for ...,Warehouse A,56,48,2025-02-16 01:12:00,8
16249,ORD_16250,22974,"Lakme 9 To 5 Pure Rouge Blusher, Coral Punch, 6 g",Warehouse A,44,26,2025-02-16 04:13:00,18
16250,ORD_16251,3778,Jaclo-PS Tablet,Warehouse A,87,69,2025-02-16 21:46:00,18
16251,ORD_16252,21229,Rotin CV 10mg/75mg Tablet,Warehouse A,35,30,2025-02-16 23:50:00,5
16252,ORD_16253,15132,"Zipline Synthetic Leather Executive SMALL messenger bag Briefcase for upto 13"" Laptop/Tablet for men women with multiple c...",Warehouse A,70,53,2025-02-16 03:30:00,17
16253,ORD_16254,29503,Lolin NodeMCU ESP8266 CP2102 NodeMCU WIFI Serial Wireless Module,Warehouse B,61,44,2025-02-16 23:28:00,17
16254,ORD_16255,36591,Ceficad OF 200mg/200mg Tablet,Warehouse C,54,36,2025-02-16 13:54:00,18
16255,ORD_16256,5736,"SpiffySky USB 2.0 to RS-232 Serial Cable for Printer, Projector, Scanner, Router, Modem (Blue)",Warehouse C,86,71,2025-02-16 00:25:00,15
16256,ORD_16257,10837,Zeasorb AF Dusting Powder,Warehouse B,39,26,2025-02-16 04:24:00,13
16257,ORD_16258,2723,Ceflik SB 500mg/250mg Injection,Warehouse A,64,58,2025-02-16 13:13:00,6
16258,ORD_16259,20940,Reusable Menstrual Cups - Small,Warehouse C,71,63,2025-02-16 23:21:00,8
16259,ORD_16260,30749,Salflute 100 Axacap,Warehouse A,100,83,2025-02-16 17:14:00,17
16260,ORD_16261,20222,Cetgrain 20 mg/500 mg Tablet,Warehouse B,30,14,2025-02-16 00:44:00,16
16261,ORD_16262,28887,Alldase 1500IU Injection,Warehouse A,68,59,2025-02-16 13:52:00,9
16262,ORD_16263,35787,"Pidilite Fevicryl Acrylic Colour, Acrylic Paint Art and Craft Paint, DIY Paint, Rich Pigment, Non-Cracking Paint for Canva...",Warehouse B,61,50,2025-02-16 06:14:00,11
16263,ORD_16264,17757,Podocef 100 Dry Syrup,Warehouse C,81,72,2025-02-16 19:45:00,9
16264,ORD_16265,5433,Metaz 0.1% Cream,Warehouse B,23,7,2025-02-16 09:10:00,16
16265,ORD_16266,10830,Faces Canada Splash Nail Enamel Walnut 118 8 Ml,Warehouse A,95,81,2025-02-16 07:44:00,14
16266,ORD_16267,9604,Aloe Veda Herbal Hair Oil 200 ml,Warehouse A,27,22,2025-02-16 22:18:00,5
16267,ORD_16268,26789,VMT Stock OnePlus11R 5G Back Cover PC Back Case with Bumper Drop Protection Case Cover for OnePlus 11R 5G,Warehouse A,95,83,2025-02-16 05:24:00,12
16268,ORD_16269,32300,Evorcold 5mg/325mg/5mg Tablet,Warehouse C,28,18,2025-02-16 19:21:00,10
16269,ORD_16270,13603,"Nokia 105 Dual SIM, Keypad Mobile Phone with Wireless FM Radio | Blue",Warehouse B,87,78,2025-02-16 05:09:00,9
16270,ORD_16271,28863,White Perfect - Anti-Dullness Scrub,Warehouse B,18,13,2025-02-16 23:27:00,5
16271,ORD_16272,23878,"JOXRA Screen Cleaner Kit 100 ml for LED and LCD TV, Computer Monitor, Laptop, and iPad Screens - Pack of 2",Warehouse B,21,8,2025-02-16 18:58:00,13
16272,ORD_16273,32304,Michael Kors Sexy Ruby Eau de Parfum 50ml,Warehouse B,17,1,2025-02-16 17:29:00,16
16273,ORD_16274,7778,Ezm P 0.25mg/20mg Tablet,Warehouse C,68,59,2025-02-16 20:10:00,9
16274,ORD_16275,7788,"Portronics Conch Gama in-Ear Wired Earphone, 1.2m Tangle Free Cable, in-Line Mic, Noise Isolation 3.5mm Aux Port and High ...",Warehouse C,94,78,2025-02-16 05:24:00,16
16275,ORD_16276,36131,Pre Shave Gel Tube - Ultra Comfort,Warehouse B,57,39,2025-02-16 00:52:00,18
16276,ORD_16277,13589,Omituss P Syrup Mixed Fruit,Warehouse A,63,57,2025-02-16 18:26:00,6
16277,ORD_16278,23352,"Redmi 11 Prime 5G (Meadow Green, 6GB RAM, 128GB Storage) | Prime Design | MTK Dimensity 700 | 50 MP Dual Cam | 5000mAh | 7...",Warehouse C,51,33,2025-02-16 14:56:00,18
16278,ORD_16279,11489,Moxpic CA Syrup,Warehouse A,85,74,2025-02-16 13:00:00,11
16279,ORD_16280,17669,Emerest 8mg Tablet,Warehouse A,72,56,2025-02-16 00:51:00,16
16280,ORD_16281,4551,"Virtutron 2.4 Amp 2 Port USB Car Charger Adapter Compatible for All Mobile Cellular Phones iPhone X/Xr/Xs/Max/8/7/Plus, Vi...",Warehouse C,67,54,2025-02-16 18:56:00,13
16281,ORD_16282,1859,Nature Cell Lightening Excel Night Cream Bxl Walnut Scrub 50 Gm,Warehouse C,25,9,2025-02-16 19:41:00,16
16282,ORD_16283,13621,Berina Hair Spray- Super Firm Hold (Gold) 250 ml,Warehouse B,86,67,2025-02-16 11:35:00,19
16283,ORD_16284,37070,Ajmal 3 Avid And 1 Persuade Deodorants Pack of 4 200 ml,Warehouse B,25,15,2025-02-16 13:26:00,10
16284,ORD_16285,28934,"ZEBRONICS Zeb-Action Portable BT Speaker with TWS Function, USB,mSD, AUX, FM, Mic & Fabric Finish(Red)",Warehouse A,49,38,2025-02-16 23:20:00,11
16285,ORD_16286,610,Cefogram Tzb 500 mg/62.5 mg Injection,Warehouse B,113,94,2025-02-16 09:42:00,19
16286,ORD_16287,29480,Ofloxiya-OZ Tablet,Warehouse A,26,9,2025-02-16 19:15:00,17
16287,ORD_16288,25698,Luminous Oils Rejuvenating Handwash,Warehouse B,73,68,2025-02-16 07:56:00,5
16288,ORD_16289,33410,"Belkin Apple Certified Lightning To Type C Cable, Fast Charging For Iphone, Ipad, Air Pods, 3.3 Feet (1 Meters)  White",Warehouse A,38,20,2025-02-16 08:00:00,18
16289,ORD_16290,23118,Robustrion Deer Pattern Flip Stand Case Cover for Samsung Galaxy Tab A8 10.5 inch [SM-X200/X205/X207] 2022 - Dark Green,Warehouse A,64,45,2025-02-16 01:40:00,19
16290,ORD_16291,32925,Robustrion Pack of 1 Anti-Scratch & Smudge Proof Premium Tempered Glass Screen Protector for Lenovo Tab M10 HD 2nd Gen TB-...,Warehouse B,26,19,2025-02-16 03:55:00,7
16291,ORD_16292,9589,Oil Control Face Pack,Warehouse A,46,32,2025-02-16 13:12:00,14
16292,ORD_16293,4557,Ajmal 2 Silver Shade And 2 Persuade Deodorants Pack of 4 200 ml,Warehouse C,70,63,2025-02-16 22:16:00,7
16293,ORD_16294,23847,Allure Concealer Buffer Brush (ASB142) 1's,Warehouse A,25,9,2025-02-16 21:53:00,16
16294,ORD_16295,13817,Malacure 250mg Tablet,Warehouse B,30,24,2025-02-16 07:25:00,6
16295,ORD_16296,20220,Lenphor I Craze Eye Liner Hazelaar Brown 1.7 Ml,Warehouse B,74,56,2025-02-16 00:48:00,18
16296,ORD_16297,7405,TheGiftKart Tough Armor Bumper Back Case Cover for OnePlus 6T / OnePlus 7 | Ring Holder & Kickstand in-Built | 360 Degree ...,Warehouse C,91,82,2025-02-16 06:11:00,9
16297,ORD_16298,22986,"CROXEY SW6 New Version-Car Phone Holder Mount, Rearview Mirror Phone Holder for Car, 360°Rotatable and Car Phone Holder, M...",Warehouse A,101,86,2025-02-16 18:31:00,15
16298,ORD_16299,3347,Massage Cream - Skin Whitening,Warehouse C,109,95,2025-02-16 15:03:00,14
16299,ORD_16300,7844,Redu 50mg Tablet,Warehouse B,100,88,2025-02-16 03:35:00,12
16300,ORD_16301,33260,"Lenovo IdeaPad Slim 3 Intel Core i3 11th Gen 14"" (35.56cm) FHD Thin & Light Laptop (8GB/512GB SSD/Windows 11/Office 2021/2...",Warehouse B,30,15,2025-02-16 23:47:00,15
16301,ORD_16302,7849,"DishanKart Ivory Sheets For Drawing, Sketching, Painting, A4 Size - 210 GSM, 11.5 inches x 8.5 inches x 0.1 inch, 25 Sheets",Warehouse C,105,91,2025-02-16 03:32:00,14
16302,ORD_16303,28853,Trit 2mg Tablet,Warehouse C,63,48,2025-02-16 09:05:00,15
16303,ORD_16304,32095,Rapidotzz Pack of 3 Replacement Belts/Straps Compatible for Fitbit Charge2 Bands Replacement Wristband Straps (Set 3),Warehouse C,108,91,2025-02-16 19:49:00,17
16304,ORD_16305,28838,Mamaearth Moisturizing Daily Lotion For Babies 200 ml,Warehouse B,54,44,2025-02-16 16:06:00,10
16305,ORD_16306,3337,Melanite-C Cream,Warehouse A,68,56,2025-02-16 07:05:00,12
16306,ORD_16307,3795,Tariclav 500mg/125mg Tablet,Warehouse C,63,50,2025-02-16 08:56:00,13
16307,ORD_16308,17562,Cepharon 250mg Capsule,Warehouse B,39,31,2025-02-16 07:02:00,8
16308,ORD_16309,25636,Kleral Milk Almond Milk Oil 150 ml,Warehouse B,54,38,2025-02-16 12:10:00,16
16309,ORD_16310,34048,Cefikos AZ 200mg/250mg Tablet,Warehouse C,89,73,2025-02-16 03:30:00,16
16310,ORD_16311,10972,Sinokof-DX Syrup,Warehouse C,107,98,2025-02-16 15:20:00,9
16311,ORD_16312,25639,PROSALIC OINTMENT,Warehouse A,76,66,2025-02-16 16:54:00,10
16312,ORD_16313,31222,Moxysun-CV Dry Syrup,Warehouse A,67,62,2025-02-16 20:24:00,5
16313,ORD_16314,23773,Batiste Dry Hair Shampoo - Clean & Classic Original 50 ml + Coconut & Exotic Tropical 50 ml + Fruity & Cheeky Cherry 50 ml,Warehouse C,17,2,2025-02-16 08:52:00,15
16314,ORD_16315,36773,Maybelline New York The Blushed Nudes Eyeshadow Palette 9 Gm,Warehouse B,47,35,2025-02-16 13:27:00,12
16315,ORD_16316,8887,Yoromol 650mg Tablet,Warehouse A,99,87,2025-02-16 14:49:00,12
16316,ORD_16317,10906,Ajmal Desert Rose EDP Floral Oriental Perfume And Wisal Dhahab Deodorant Fruity Floral Fragrance 300 ml,Warehouse A,100,88,2025-02-16 10:59:00,12
16317,ORD_16318,30381,"eliide Disco King (Newly Launched) Bluetooth Speaker – 6Hrs Playback, Torch, BT V5.0, USB & TF Card, TWS Technology, Porta...",Warehouse A,92,80,2025-02-16 07:11:00,12
16318,ORD_16319,17651,Flusol 150mg Tablet,Warehouse B,105,87,2025-02-16 12:58:00,18
16319,ORD_16320,26804,FLUT-T EYE DROP,Warehouse B,19,4,2025-02-16 09:23:00,15
16320,ORD_16321,28951,Lenphor Smudge Me Eye Pencil Misty Green 03 1.2 Gm,Warehouse C,17,1,2025-02-16 10:47:00,16
16321,ORD_16322,10914,Basil & Parsley Body Cleanser Fmcg 200 Ml,Warehouse A,98,83,2025-02-16 18:49:00,15
16322,ORD_16323,30379,Diclotin P 50mg/325mg Tablet,Warehouse C,60,42,2025-02-16 06:01:00,18
16323,ORD_16324,15405,"Amkette Flexi Tabletop Phone Holder, Flexible Telescopic Long Arm Mount with 360 Degree Rotatable Clamp Compatible with Al...",Warehouse B,33,14,2025-02-16 01:32:00,19
16324,ORD_16325,3332,Lazcort 6mg Tablet,Warehouse C,45,35,2025-02-16 05:02:00,10
16325,ORD_16326,13628,"NICONI White Chocolate Liposoluble Wax for Face, Arm, Leg, Underarm & Bikini | Hair Removal Wax for Women & Men | Tan Remo...",Warehouse C,42,25,2025-02-16 10:01:00,17
16326,ORD_16327,28957,Activated Charcoal Shampoo With Menthol,Warehouse A,7,1,2025-02-16 15:17:00,6
16327,ORD_16328,1760,Corcid D 10 mg/20 mg Capsule,Warehouse B,104,99,2025-02-16 02:14:00,5
16328,ORD_16329,7761,Oten CT 20mg/12.5mg Tablet,Warehouse A,40,27,2025-02-16 10:52:00,13
16329,ORD_16330,23596,Douxrab Ace 200mg/20mg Capsule SR,Warehouse B,27,8,2025-02-16 16:38:00,19
16330,ORD_16331,33286,Amcold Syrup,Warehouse C,16,10,2025-02-16 04:06:00,6
16331,ORD_16332,19925,Maryaj After Dark EDP Woody Aromatic Perfume And Ajmal Evoke Silver Edition Him Deodorant Spicy Floral Fragrance 300 ml,Warehouse B,22,12,2025-02-16 01:48:00,10
16332,ORD_16333,1761,"Canon PIXMA G3020 NV Wi-Fi Mono/Colour, Print,Scan,Copy,High Volume Printing, 5.08 cm LCD, User Replaceable Print Heads an...",Warehouse A,18,4,2025-02-16 02:31:00,14
16333,ORD_16334,25677,Defseil 6mg Tablet,Warehouse C,44,32,2025-02-16 19:46:00,12
16334,ORD_16335,21848,Reynolds BRITE BP 25 CT JAR - BLUE Ball Pen I Lightweight Ball Pen With Comfortable Grip for Extra Smooth Writing I School...,Warehouse B,67,49,2025-02-16 20:28:00,18
16335,ORD_16336,11416,Wonder 25 mm Strong Acrylic Adhesive Clear Double Sided Tape Heat Resistant Double-sided Transparent Clear Adhesive Tape 2...,Warehouse B,41,30,2025-02-16 11:04:00,11
16336,ORD_16337,23239,"SPIN CART USB 2.0 Printer Cable, A Male to B Male High speed Cord 1.5 Meter - Color white Compatible For HP, Canon, Epson,...",Warehouse C,90,79,2025-02-16 17:16:00,11
16337,ORD_16338,35843,Etonco 100mg Injection,Warehouse B,97,78,2025-02-16 06:42:00,19
16338,ORD_16339,27524,Superdrug Argan Oil Clay Mask 15 ml,Warehouse A,91,74,2025-02-16 19:03:00,17
16339,ORD_16340,33297,Yougaba 75mg Capsule,Warehouse C,109,96,2025-02-16 00:36:00,13
16340,ORD_16341,17569,Alexvyan Pink Hair Brush Rake Hairbrush Cleaner of Metal Wire Comb Cleaner Tool Brush Rake Cleaner with Handle for Home an...,Warehouse C,53,36,2025-02-16 23:59:00,17
16341,ORD_16342,17574,Nxclav 500mg/125mg Tablet,Warehouse A,88,70,2025-02-16 13:25:00,18
16342,ORD_16343,5345,OpenTech® Military-Grade Tempered Glass Screen Protector Compatible for iPhone 13 Mini with Edge to Edge Coverage and Easy...,Warehouse A,31,26,2025-02-16 03:56:00,5
16343,ORD_16344,33875,MANCODE 2 in 1 Beard & Face Wash 200 ml,Warehouse B,113,94,2025-02-16 20:43:00,19
16344,ORD_16345,11423,"Apple 20W USB-C Power Adapter (for iPhone, iPad & AirPods)",Warehouse A,74,61,2025-02-16 15:07:00,13
16345,ORD_16346,29445,Oflopen 50mg/5ml Suspension,Warehouse C,111,98,2025-02-16 15:55:00,13
16346,ORD_16347,23208,Daily Life Forever52 Velvet Rose Matte Lipstick Rs014 2.5 gm,Warehouse B,59,49,2025-02-16 16:54:00,10
16347,ORD_16348,25658,"ESR USB-C to Lightning Cable, 6.5 ft (2 m), MFi-Certified, PD Fast Charging Cable for iPhone 14/14 Plus/14 Pro/14 Pro Max,...",Warehouse B,80,70,2025-02-16 06:57:00,10
16348,ORD_16349,9562,Athdom P 5 mg/250 mg Suspension,Warehouse A,25,7,2025-02-16 00:42:00,18
16349,ORD_16350,4276,Azitras 100mg/5ml Suspension,Warehouse C,102,87,2025-02-16 11:18:00,15
16350,ORD_16351,32756,Fexoquit 180mg Tablet,Warehouse B,15,5,2025-02-16 01:40:00,10
16351,ORD_16352,33395,BAFOYA Lipstick Ultra Smooth Waterproof Long Lasting Lipstick,Warehouse C,41,35,2025-02-16 14:07:00,6
16352,ORD_16353,25673,Vomica 2mg Oral Drops,Warehouse C,33,15,2025-02-16 12:22:00,18
16353,ORD_16354,17538,S11 Razor & Cartridge Pack,Warehouse A,111,93,2025-02-16 13:51:00,18
16354,ORD_16355,19950,Spigen Ultra Hybrid Back Cover Case for iPhone 12 and iPhone 12 Pro (TPU + Poly Carbonate | Crystal Clear),Warehouse C,20,10,2025-02-16 14:51:00,10
16355,ORD_16356,8902,Tusq Oral Drops,Warehouse C,46,27,2025-02-16 03:20:00,19
16356,ORD_16357,10941,Xorcet 5mg Syrup,Warehouse A,62,52,2025-02-16 12:48:00,10
16357,ORD_16358,17558,"Loofah/Sponge Scrubber/Body Bath - Dual Side, Cream, BH-061D CRM",Warehouse C,99,86,2025-02-16 08:22:00,13
16358,ORD_16359,12717,AmazonBasics - Casual Backpack/Office Bag/ for a 15.6-inch Laptop,Warehouse A,82,74,2025-02-16 00:28:00,8
16359,ORD_16360,7720,Spigen EZ Fit Tempered Glass Screen Protector Guard for Apple Watch Ultra (49mm) - 2 Pack,Warehouse B,41,27,2025-02-16 21:04:00,14
16360,ORD_16361,16858,Moximac Eye Drop,Warehouse A,58,46,2025-02-16 23:57:00,12
16361,ORD_16362,16856,Ajmal Majmua And Selfie CP & Prose EDP Pack of 3 20 ml,Warehouse C,42,25,2025-02-16 18:47:00,17
16362,ORD_16363,8906,"CableCreation XLR Cable, 3 FT XLR Male to XLR Female Balanced 3 PIN Microphone Cable,Black 0.9M",Warehouse C,47,34,2025-02-16 12:17:00,13
16363,ORD_16364,15394,Aston Andia Self Adhesive Transparent Cable Clips Wire Holder Sticky Heavy Duty Cable Clips Tidy and Organizer Drop Cord M...,Warehouse B,31,18,2025-02-16 03:38:00,13
16364,ORD_16365,27509,Oroz OZ 200mg/500mg Tablet,Warehouse C,85,67,2025-02-16 07:45:00,18
16365,ORD_16366,26817,Lafz Ruzbeh No Alcohol No Gas Premium Body Spray - For Men 120 ml,Warehouse A,23,10,2025-02-16 09:14:00,13
16366,ORD_16367,23763,"Puka Fan Brush Professional Face Makeup Highlighter, Wooden Makeup Brush (Pack of 1)",Warehouse A,43,37,2025-02-16 01:44:00,6
16367,ORD_16368,33281,Eezed 1000mg Injection,Warehouse A,111,94,2025-02-16 17:05:00,17
16368,ORD_16369,13776,Maxispas DS Syrup,Warehouse B,20,9,2025-02-16 05:12:00,11
16369,ORD_16370,7602,Rosgla 10mg Tablet,Warehouse A,70,61,2025-02-16 16:34:00,9
16370,ORD_16371,15354,Lavivogli M 500mg/0.2mg Tablet,Warehouse A,36,24,2025-02-16 17:30:00,12
16371,ORD_16372,26864,Drospas 80mg Tablet,Warehouse C,96,81,2025-02-16 11:57:00,15
16372,ORD_16373,33954,Tacren 0.25 Capsule,Warehouse B,41,22,2025-02-16 11:34:00,19
16373,ORD_16374,36018,Clovia Botaniqa Hydrating Body Wash 250 ml,Warehouse A,83,67,2025-02-16 06:50:00,16
16374,ORD_16375,15312,MEF-Proxyvon 250mg/10mg Tablet,Warehouse A,94,81,2025-02-16 06:38:00,13
16375,ORD_16376,21052,"Fashion Colour Kiss Lip No Transfer Lipstick, 56 Scarlet 2.6 gm",Warehouse B,78,61,2025-02-16 14:14:00,17
16376,ORD_16377,13691,"NISUN PU Leather Small Pocket Sized Credit Card Holder Name Card Case Wallet with Magnetic Shut for Men & Women ( Brown, 1...",Warehouse B,27,11,2025-02-16 00:55:00,16
16377,ORD_16378,17299,Lenphor Flawless Compact Honey 04 13 Gm,Warehouse A,40,26,2025-02-16 01:56:00,14
16378,ORD_16379,29297,Telispa-AM Tablet,Warehouse B,52,37,2025-02-16 19:51:00,15
16379,ORD_16380,25416,Voloxia M 500 mg/0.2 mg Tablet ER,Warehouse C,106,87,2025-02-16 02:26:00,19
16380,ORD_16381,7538,"Lakme Absolute Blur Perfect Matte Face Primer, Peach, Makeup Primer for Poreless Smooth Long Lasting Makeup - Waterproof B...",Warehouse A,30,24,2025-02-16 15:26:00,6
16381,ORD_16382,35997,Dynotrek Tipple 14-15 Inch Laptop Sleeve Case Cover with Shoulder Strap Waterproof Briefcase Sling Bag Compatible for Chro...,Warehouse B,23,16,2025-02-16 07:41:00,7
16382,ORD_16383,36005,Man - 5th Element Eau De Toilette Deodorant,Warehouse A,75,63,2025-02-16 22:56:00,12
16383,ORD_16384,25417,Bathing Soap - Gold,Warehouse C,57,41,2025-02-16 06:22:00,16
16384,ORD_16385,17054,Richdox 200mg Tablet,Warehouse C,59,52,2025-02-16 17:07:00,7
16385,ORD_16386,13681,Skullcandy Dime True Wireless in-Ear Bluetooth Earbuds Compatible with iPhone and Android/Charging Case and Microphone/Gre...,Warehouse B,42,30,2025-02-16 04:43:00,12
16386,ORD_16387,52,"Sitishield D95 Mask – Medium, Black",Warehouse A,47,35,2025-02-16 12:30:00,12
16387,ORD_16388,11293,House Of Makeup Nail Lacquer - Cerise 12 ml,Warehouse B,59,41,2025-02-16 05:57:00,18
16388,ORD_16389,4366,Spantra Sea buckthorn Shampoo 300 ml,Warehouse A,51,32,2025-02-16 15:15:00,19
16389,ORD_16390,25427,Faces Canada Ultime Pro A Matte Made In Heaven Ink Liner Black 1.2 Ml,Warehouse B,103,86,2025-02-16 19:50:00,17
16390,ORD_16391,3299,Ocelv-M Tablet,Warehouse C,36,30,2025-02-16 11:13:00,6
16391,ORD_16392,29290,House of Aroma Stress Soother Fragrance Oil 10 ml,Warehouse B,38,30,2025-02-16 11:39:00,8
16392,ORD_16393,23574,Pure Aloe Vera Skin Gel,Warehouse C,53,37,2025-02-16 10:56:00,16
16393,ORD_16394,11297,Ceph-IN 250 DT Tablet,Warehouse C,49,35,2025-02-16 16:48:00,14
16394,ORD_16395,7524,"Dot & key Lip Plumping Mask Vitamin C + E (Lingenberry), 15ml",Warehouse C,47,40,2025-02-16 16:20:00,7
16395,ORD_16396,29284,"Classmate Notebook - Unruled, 72 Pages, 240 mm x 180 mm - Pack Of 4",Warehouse A,14,9,2025-02-16 01:09:00,5
16396,ORD_16397,20102,Molid L 5mg/10mg Tablet,Warehouse B,79,73,2025-02-16 13:20:00,6
16397,ORD_16398,15310,Refreshing Fruit Pack,Warehouse C,35,27,2025-02-16 14:27:00,8
16398,ORD_16399,13673,Themipan 40 Injection,Warehouse C,94,79,2025-02-16 21:01:00,15
16399,ORD_16400,3295,boAt BassHeads 100 in-Ear Wired Headphones with Mic (Black),Warehouse A,95,82,2025-02-16 22:56:00,13
16400,ORD_16401,35970,Rezilent 850mg Tablet SR,Warehouse B,56,51,2025-02-16 17:12:00,5
16401,ORD_16402,17030,Rose Oil,Warehouse A,48,42,2025-02-16 22:10:00,6
16402,ORD_16403,4292,Natural Fairness Saffron Soap,Warehouse A,57,44,2025-02-16 19:11:00,13
16403,ORD_16404,19999,Oraclofen SP 100mg/325mg/15mg Tablet,Warehouse A,89,80,2025-02-16 23:34:00,9
16404,ORD_16405,32916,Patchouli Pure Aroma Essential Oil,Warehouse A,100,86,2025-02-16 05:16:00,14
16405,ORD_16406,7662,"(Renewed) Fire-Boltt Ninja 3 Full Touch 1.69 "" Display & 60 Sports Modes Smartwatch with IP68, Sp02 Tracking, Over 100 Clo...",Warehouse C,38,21,2025-02-16 23:26:00,17
16406,ORD_16407,17429,Akfix CV 200mg/125mg Tablet,Warehouse C,55,44,2025-02-16 10:24:00,11
16407,ORD_16408,6365,AmazonBasics Neoprene 15.6-inches Laptop Sleeve (Navy),Warehouse C,74,56,2025-02-16 17:38:00,18
16408,ORD_16409,13758,"Verilux® USB C Hub, USB Hub with 4 USB Ports, High Speed Aluminum Type C Hub Compatible with MacBook, Windows, C-Type Smar...",Warehouse A,29,21,2025-02-16 09:57:00,8
16409,ORD_16410,30347,Cefditran 200mg Tablet,Warehouse A,43,29,2025-02-16 03:20:00,14
16410,ORD_16411,31238,Naxiflox-OZ Tablet,Warehouse C,96,79,2025-02-16 08:54:00,17
16411,ORD_16412,4306,URBN 25 Watt Type C PD Samsung Charger | BIS Certified | PD Wall Adapter | for Samsung Galaxy FE20/S22/S20/Plus/M Series/N...,Warehouse A,104,96,2025-02-16 13:34:00,8
16412,ORD_16413,11381,"YOUTH MOBI (Pack of 2 Tempered Glass Screen Protector Compatible for Samsung Galaxy Watch 4 (44mm) / Watch 5 (44mm) (1.4"" ...",Warehouse B,9,3,2025-02-16 00:16:00,6
16413,ORD_16414,12331,"Motorola a10 Dual Sim keypad Mobile with 1750 mAh Battery, Expandable Storage Upto 32GB, Wireless FM with Recording - Dark...",Warehouse B,48,41,2025-02-16 04:06:00,7
16414,ORD_16415,34018,Safepro 500mg Tablet,Warehouse A,85,79,2025-02-16 06:34:00,6
16415,ORD_16416,4297,New CH 6.25mg Tablet,Warehouse C,93,76,2025-02-16 19:29:00,17
16416,ORD_16417,1205,Cefap 200mg Tablet,Warehouse B,64,54,2025-02-16 02:23:00,10
16417,ORD_16418,8960,Peppermint Oil,Warehouse B,106,93,2025-02-16 05:12:00,13
16418,ORD_16419,15366,Superdrug Avocado & Manuka Shampoo 400 ml,Warehouse B,71,59,2025-02-16 23:11:00,12
16419,ORD_16420,17302,Isotrax 10 Soft Gelatin Capsule,Warehouse A,32,13,2025-02-16 16:52:00,19
16420,ORD_16421,36784,19MM Vintage Watch Belt Compatible for BOAT STORM/NOISE COLORFIT PRO 2/ NOISE COLORFIT PULSE,Warehouse B,83,65,2025-02-16 04:32:00,18
16421,ORD_16422,13700,"SWAMEY 30x60 Mini Compact Binoculars for Kids and Adults, Portable Pocket Foldable Binoculars for Waterproof Bird Watchin...",Warehouse B,88,82,2025-02-16 07:43:00,6
16422,ORD_16423,23547,"Flash Acrylic Colour (Black, 200 ml)",Warehouse B,43,24,2025-02-16 06:05:00,19
16423,ORD_16424,4375,Ofdip 200 Tablet,Warehouse C,57,38,2025-02-16 11:08:00,19
16424,ORD_16425,14535,Cotton Balls,Warehouse B,77,60,2025-02-16 09:30:00,17
16425,ORD_16426,25456,"Ambrane Unbreakable 60W / 3A Fast Charging 1.5m Braided Type C to Type C Cable for Smartphones, Tablets, Laptops & Other T...",Warehouse C,48,38,2025-02-16 20:24:00,10
16426,ORD_16427,3845,Minobose 0.2mg Tablet,Warehouse B,56,48,2025-02-16 06:20:00,8
16427,ORD_16428,3116,"3M Scotch Scissors | 6"" Multipurpose | Comfort Grip Handle and Stainless Steel Blades | Paper, Photos, Crafts",Warehouse A,89,83,2025-02-16 02:34:00,6
16428,ORD_16429,34738,CGX-SP Tablet,Warehouse C,65,49,2025-02-16 01:54:00,16
16429,ORD_16430,23634,"Bathing Soap - Malai Cream (for Smooth, Radiant & Nourished Skin)",Warehouse B,21,14,2025-02-16 01:06:00,7
16430,ORD_16431,6308,Fashionury Protective Soft Silicone Shockproof Protection Back Case Cover for Realme C35 / Realme Narzo 50A Prime- Transpa...,Warehouse A,94,82,2025-02-16 09:49:00,12
16431,ORD_16432,11179,Keyet-CV 200mg/125mg Tablet,Warehouse C,65,57,2025-02-16 07:05:00,8
16432,ORD_16433,31523,Elecious Natural Henna Powder For Hair Colour and Growth (200 Grams),Warehouse C,70,64,2025-02-16 09:08:00,6
16433,ORD_16434,11206,Glimmer Premium Nail Enamel Midnightplum 10 ml,Warehouse A,83,67,2025-02-16 11:29:00,16
16434,ORD_16435,33336,Moxiall 250mg/125mg Tablet,Warehouse B,49,31,2025-02-16 08:16:00,18
16435,ORD_16436,17223,Qpen 100mg Tablet,Warehouse A,38,20,2025-02-16 21:58:00,18
16436,ORD_16437,14524,"Mobomart Pro 5 Bluetooth Truly Wireless Ear Earbuds, Blutooth 5.0 Earbuds",Warehouse C,99,85,2025-02-16 19:50:00,14
16437,ORD_16438,27490,Beardo Beard Activator Roller (0.5 mm),Warehouse A,50,34,2025-02-16 21:54:00,16
16438,ORD_16439,16864,Fnc 400 Tablet,Warehouse A,43,27,2025-02-16 00:36:00,16
16439,ORD_16440,20942,TOSHIBA 126 cm (50 inches) C350LP Series 4K Ultra HD Smart LED Google TV 50C350LP (Silver),Warehouse A,61,49,2025-02-16 22:46:00,12
16440,ORD_16441,7804,"Fashion Colour Duo Contour Stick, Shade 02 3.8 gm",Warehouse C,59,42,2025-02-16 10:25:00,17
16441,ORD_16442,17702,"Samsung 23 L Solo Microwave Oven (MS23J5133AG/TL, Healthy Cook, Black)",Warehouse B,52,33,2025-02-16 15:46:00,19
16442,ORD_16443,11466,Glendan 2mg/5ml Syrup,Warehouse B,66,59,2025-02-16 10:21:00,7
16443,ORD_16444,23088,Farrow Quinch X1 High Definition Pen Camcorder with Free 32 GB Micro SD Card + C Type OTG & Card Reader Wireless Black,Warehouse A,67,50,2025-02-16 22:35:00,17
16444,ORD_16445,31843,Rastik-D Tablet,Warehouse B,59,47,2025-02-16 16:17:00,12
16445,ORD_16446,31206,"PRAUSH (Formerly Plume) P06 - Professional Highlighter Fan Brush, Multicolor",Warehouse C,53,48,2025-02-16 22:26:00,5
16446,ORD_16447,9422,Flormar Eye Shadow Palette Sunset 9 gm,Warehouse C,80,73,2025-02-16 01:35:00,7
16447,ORD_16448,21199,PC SQUARE Laptop Tabletop Stand/ Computer Tablet Stand 6 Angles Adjustable Aluminum Ergonomic Foldable Portable Desktop Ho...,Warehouse A,34,17,2025-02-16 01:30:00,17
16448,ORD_16449,25721,Arata Natural Regenerating 5 in 1 Anti-Hairfall Super Shampoo Prevents Hairfall & Thinning 300 ml,Warehouse C,60,47,2025-02-16 00:00:00,13
16449,ORD_16450,35110,Vertilix 16mg Tablet,Warehouse A,29,14,2025-02-16 01:20:00,15
16450,ORD_16451,12683,"7X Beard Oil - Sandalwood, 7 Premium Oils Supports Beard Growth & Nourishment",Warehouse A,76,64,2025-02-16 00:04:00,12
16451,ORD_16452,6316,"Zeiss Pre-Moistened Lens Cleaning Wipes for Spectacles, Binoculars, Mobiles, Tablets, Laptops, LCD Display, Cameras (2 Pac...",Warehouse A,69,61,2025-02-16 05:05:00,8
16452,ORD_16453,4244,NAC Gel,Warehouse B,80,75,2025-02-16 13:17:00,5
16453,ORD_16454,17728,Essential Souls Clear Skin Serum 20 ml,Warehouse C,56,48,2025-02-16 19:40:00,8
16454,ORD_16455,1156,Pure Hands Moisturizing Hand Wash - Tulsi & Aloe,Warehouse C,73,56,2025-02-16 23:18:00,17
16455,ORD_16456,26796,Ikonic Teasing Brush - Green 1's,Warehouse C,96,91,2025-02-16 12:09:00,5
16456,ORD_16457,789,Itracil 100 Capsule,Warehouse B,22,11,2025-02-16 19:05:00,11
16457,ORD_16458,10867,SPYKART New Trending Universal 360 ° Rotation Car Dashboard Mobile Phone Holder Mount for All Mobile Phone 3.5-7 inch (Pol...,Warehouse B,73,61,2025-02-16 15:33:00,12
16458,ORD_16459,23852,Ajmal Sacrifice for HER EDP Floral Musky Perfume 50ml for Women and Wisal Dhahab EDP Fruity Floral Perfume 50ml for Men +1...,Warehouse C,96,79,2025-02-16 04:53:00,17
16459,ORD_16460,11464,Diazox MR 250 mg/50 mg/500 mg Tablet,Warehouse A,103,87,2025-02-16 17:47:00,16
16460,ORD_16461,11209,Alikast FX 10mg/120mg Tablet,Warehouse A,27,11,2025-02-16 11:21:00,16
16461,ORD_16462,14300,Azirant 500 Tablet,Warehouse B,91,72,2025-02-16 17:17:00,19
16462,ORD_16463,29233,L Zolide 600mg Tablet,Warehouse B,34,22,2025-02-16 16:39:00,12
16463,ORD_16464,17285,Bioact 500mg Tablet,Warehouse A,12,5,2025-02-16 17:24:00,7
16464,ORD_16465,57,Histafree 120 Tablet,Warehouse B,74,67,2025-02-16 11:13:00,7
16465,ORD_16466,31519,Vdlzin-M Tablet,Warehouse B,57,48,2025-02-16 12:42:00,9
16466,ORD_16467,3309,"MARS HD Liquid Matte Concealer and Contour Stick (58542-2, White 9.6g) Matte Finish",Warehouse C,41,27,2025-02-16 23:24:00,14
16467,ORD_16468,30266,Gatsun Forte Eye Drop,Warehouse A,46,33,2025-02-16 14:16:00,13
16468,ORD_16469,32731,Trinox S 1000mg/500mg Injection,Warehouse A,57,50,2025-02-16 23:45:00,7
16469,ORD_16470,33919,Orange & Lemon Clarifying Face Gel,Warehouse B,50,41,2025-02-16 12:00:00,9
16470,ORD_16471,32151,Plantas Forever Young Age Defence Organic Face Massage Cream 50 gm,Warehouse C,30,15,2025-02-16 10:40:00,15
16471,ORD_16472,12705,Cologne - Scuba For Men,Warehouse A,100,81,2025-02-16 04:28:00,19
16472,ORD_16473,23441,Digway Plastic Set Top Box Stand with 2 Remote Holder (Black),Warehouse A,17,4,2025-02-16 04:51:00,13
16473,ORD_16474,36031,MORPHE Original 35G Bronze GOAL Edition Glitter and Metallic Eye Shades Eyeshadow Palette,Warehouse B,109,94,2025-02-16 06:32:00,15
16474,ORD_16475,4414,Serie Expert Prokeratin Liss Unlimited Smoothing Masque,Warehouse B,30,11,2025-02-16 03:56:00,19
16475,ORD_16476,15361,TheGiftKart Ultra-Hybrid Crystal Clear Back Cover Case for iPhone 14 Pro MAX | Camera & Screen Protection Bumps | Shockpro...,Warehouse B,64,46,2025-02-16 04:58:00,18
16476,ORD_16477,11336,Ultra Sensual Eau De Parfum,Warehouse B,19,12,2025-02-16 15:12:00,7
16477,ORD_16478,35929,"Deodorant Roll On, Silver Protect, Antibacterial Odour Protection For 48h Freshness",Warehouse C,13,2,2025-02-16 19:43:00,11
16478,ORD_16479,30772,Itomit 100mg Capsule,Warehouse A,72,63,2025-02-16 12:34:00,9
16479,ORD_16480,30318,"ProElite Smart Deer Flip case Cover for Samsung Galaxy Tab A7 10.4 inch SM-T500/T505/T507, Wine Red",Warehouse C,75,62,2025-02-16 07:01:00,13
16480,ORD_16481,11189,Oxra S 10mg/100mg Tablet,Warehouse A,58,49,2025-02-16 05:24:00,9
16481,ORD_16482,29211,Voglinorm 0.3 Tablet,Warehouse B,48,30,2025-02-16 02:56:00,18
16482,ORD_16483,9501,Onsitego 2 Year Extended Warranty for Small Household Appliances from Rs. 3001-4000 (Email Delivery - No Physical Kit),Warehouse C,99,83,2025-02-16 03:26:00,16
16483,ORD_16484,20074,Vilact M 500 Tablet,Warehouse B,100,90,2025-02-16 04:36:00,10
16484,ORD_16485,35963,Yevonate 60mg Injection,Warehouse B,88,76,2025-02-16 13:39:00,12
16485,ORD_16486,1810,Antiseptic Liquid 250 ml + Laundry Sanitizer- Spring Blossom 480 ml,Warehouse A,82,64,2025-02-16 16:58:00,18
16486,ORD_16487,13708,Solotravel Electronic Gadget Accessories Nylon Organizer Bag For Cables Charger Power Cord Power Bank Hard Disk Headphone...,Warehouse A,100,87,2025-02-16 06:21:00,13
16487,ORD_16488,35061,Tiniflox 400mg/600mg Tablet,Warehouse A,94,77,2025-02-16 18:12:00,17
16488,ORD_16489,29337,Jovees Sandalwood Protection Day Cream (spf-16) 50 gm,Warehouse A,93,82,2025-02-16 07:33:00,11
16489,ORD_16490,26449,Oac 50mg Tablet,Warehouse B,94,78,2025-02-16 11:05:00,16
16490,ORD_16491,22819,Cruxol 250mg Syrup,Warehouse C,70,62,2025-02-16 19:11:00,8
16491,ORD_16492,21849,Dezz 6mg Oral Suspension,Warehouse B,17,4,2025-02-16 11:16:00,13
16492,ORD_16493,31427,CEDO iPhone X/XS Case Back Cover Shockproof Bumper Crystal Clear | 360 Degree Protection TPU+PC | Camera Protection | Acry...,Warehouse C,70,63,2025-02-16 15:43:00,7
16493,ORD_16494,550,"Honor Watch GS 3 Smartwatch with 1.43"" AMOLED Touch Screen, Heart Rate, Sleep and Blood Oxygen, Dual GPS, Bluetooth Callin...",Warehouse C,104,86,2025-02-16 09:35:00,18
16494,ORD_16495,33773,Rabesym LS 75mg/20mg Capsule SR,Warehouse B,92,87,2025-02-16 01:44:00,5
16495,ORD_16496,33692,Vinthromycin 500 Tablet,Warehouse C,103,96,2025-02-16 22:56:00,7
16496,ORD_16497,6628,Bonjour Paris Photo Match Concealer Stick cum Primer - Natural 3.2 gm,Warehouse C,108,89,2025-02-16 22:08:00,19
16497,ORD_16498,9279,"Sery Color Flirt Nail Paint Matte, Salmon Brick, Pink 10 ml",Warehouse A,104,94,2025-02-16 12:36:00,10
16498,ORD_16499,30073,"Apple Earphone with Lightning Connector 6/7/8/X/11/12/13/14 Max Sound Bass (White, in The Ear)",Warehouse A,27,11,2025-02-16 09:06:00,16
16499,ORD_16500,24353,"Toothpaste - Gum Care, Expert Protection, Save Rs. 20/-",Warehouse B,73,65,2025-02-16 07:46:00,8
16500,ORD_16501,16008,"Tuarso 43W Car Charger Fast Charging,Tuarso Aluminum Alloy Car Mobile Charger Dual-Port Fast Charging At The Same Time (PD...",Warehouse B,47,38,2025-02-16 07:01:00,9
16501,ORD_16502,4031,CLOUDD CR2032 3V Lithium Button Battery Pack 2,Warehouse A,66,52,2025-02-16 22:24:00,14
16502,ORD_16503,7275,"Vivo Y22 (Metaverse Green, 6GB RAM, 128GB Storage) with No Cost EMI/Additional Exchange Offers",Warehouse B,48,37,2025-02-16 08:35:00,11
16503,ORD_16504,27096,"Arganicare Coconut Hydrating Conditioner With Certified Organic Argan And Coconut Oil For Dull, Very Dry And Frizzy Hair, ...",Warehouse A,42,24,2025-02-16 11:09:00,18
16504,ORD_16505,12811,"Gizga Essentials Earphone Earpod Cleaning Pen for AirPod, Earbuds, Headphones, Wireless Earphones, 5-in-1 Multifunctional ...",Warehouse C,56,41,2025-02-16 21:33:00,15
16505,ORD_16506,33579,SKYSHOP® LBSTAR BM10 World's Smallest Mobile Phone Dual Sim Support with Bluetooth Dialer (Grey Color),Warehouse B,87,77,2025-02-16 00:05:00,10
16506,ORD_16507,29592,Clavlon LB 500mg/125mg Tablet,Warehouse A,107,98,2025-02-16 04:57:00,9
16507,ORD_16508,27024,Lamovate Cream,Warehouse B,19,8,2025-02-16 11:55:00,11
16508,ORD_16509,24092,Acrocip 250mg Tablet,Warehouse A,51,39,2025-02-16 14:59:00,12
16509,ORD_16510,30875,Noserch-MF Oral Suspension,Warehouse B,86,70,2025-02-16 02:38:00,16
16510,ORD_16511,25023,Original 25W USB-C Super Fast Charger True 25W Pd Charging Adapter Compatible for Samsung (White) (White),Warehouse B,65,48,2025-02-16 19:22:00,17
16511,ORD_16512,30189,"Belkin Apple Certified Lightning To Type C Cable, Tough Unbreakable Braided Fast Charging For Iphone, Ipad, Air Pods, 3.3 ...",Warehouse B,65,53,2025-02-16 23:47:00,12
16512,ORD_16513,16560,"Tribit [Upgraded Version] StormBox Pro 40W 5.3 Channel Wireless, Bluetooth Tower Subwoofer - Black",Warehouse C,96,91,2025-02-16 15:12:00,5
16513,ORD_16514,9265,Medimade Coffee Fixing Hair Gel 100 gm,Warehouse A,20,3,2025-02-16 11:35:00,17
16514,ORD_16515,7122,Deeflam KP 50mg/500mg Tablet,Warehouse C,112,93,2025-02-16 17:18:00,19
16515,ORD_16516,6701,Amazon Brand - Solimo Back Cover Case for Vivo U10 / Vivo Y12 / Vivo Y17 / Vivo Y15 2019 | Compatible for Vivo U10 / Vivo ...,Warehouse B,59,41,2025-02-16 01:51:00,18
16516,ORD_16517,29717,Zimking 200mg Tablet,Warehouse A,56,47,2025-02-16 22:56:00,9
16517,ORD_16518,11569,Arpizol 2mg Tablet,Warehouse A,58,39,2025-02-16 02:50:00,19
16518,ORD_16519,4033,Procus ONE Virtual Reality Headset 40MM Lenses -For IOS and Android – (Black),Warehouse B,27,22,2025-02-16 12:38:00,5
16519,ORD_16520,9091,Nike Deodorant for Men (A Spicy Attitude/Aromatic Addiction/Urban Wood/The Perfume) Pack of 4 (200ml each),Warehouse B,43,32,2025-02-16 11:03:00,11
16520,ORD_16521,16475,"pTron Tangent Lite Bluetooth 5.0 Earphones with Mic, Hi-Fi Stereo Sound Neckband, 8Hrs Playtime, Lightweight Snug-fit in-E...",Warehouse B,35,29,2025-02-16 04:46:00,6
16521,ORD_16522,16000,"SanDisk Ultra UHS I 64GB SD Card 140MB/s for DSLR and Mirrorless Cameras, 10Y Warranty",Warehouse B,18,13,2025-02-16 08:36:00,5
16522,ORD_16523,13488,NOTE LUMINOUS SILK COMPACT POWDER 202 10 gm,Warehouse B,80,65,2025-02-16 10:34:00,15
16523,ORD_16524,13356,Spunky Avatar Perfume Spray,Warehouse A,47,36,2025-02-16 06:22:00,11
16524,ORD_16525,16470,Action Pro Stainless Steel Tripod Mount Adapter Compatible with GoPro Hero 11 10 9 8 7 6 5 4 3+ 3 Mount to 1/4 Thread Used...,Warehouse C,98,83,2025-02-16 17:57:00,15
16525,ORD_16526,36848,Trinzy MT 5mg/10mg Tablet,Warehouse B,83,64,2025-02-16 02:42:00,19
16526,ORD_16527,33490,Myolin NT 200mg/5mg Tablet,Warehouse C,94,78,2025-02-16 15:41:00,16
16527,ORD_16528,6927,Urban Gabru Insta Glow SPF 50 Fairness Cream 50 gm,Warehouse B,91,76,2025-02-16 20:20:00,15
16528,ORD_16529,4096,O3+ Bridal Facial Kit Vitamin C Glowing Skin (136gm),Warehouse B,28,18,2025-02-16 11:13:00,10
16529,ORD_16530,20688,Ajmal Asher Concentrated Perfume Oil Oriental And Wisal Deodorant Floral Musky Fragrance 212 ml,Warehouse C,57,51,2025-02-16 15:46:00,6
16530,ORD_16531,3102,Daily Life Forever52 Blush Brush Nx014 1's,Warehouse B,37,26,2025-02-16 14:19:00,11
16531,ORD_16532,13532,Ajmal Impress Concentrated Perfume Oil Citrus Attar And Selfie Concentrated Perfume Oil Woody Aromatic Attar 20 ml,Warehouse A,44,39,2025-02-16 11:11:00,5
16532,ORD_16533,27099,Lazithro 500mg Tablet,Warehouse A,64,52,2025-02-16 06:55:00,12
16533,ORD_16534,11563,Novadine Pessaries,Warehouse B,51,38,2025-02-16 05:02:00,13
16534,ORD_16535,388,Lulifast 1% Cream,Warehouse B,13,2,2025-02-16 16:35:00,11
16535,ORD_16536,15579,SUGAR Cosmetics Charcoal Patrol Bubble Mask 20 gm,Warehouse C,106,87,2025-02-16 01:57:00,19
16536,ORD_16537,30114,Maryaj Goldie EDP Fruity Floral Perfume And Ajmal Aurum Femme Deodorant Fruity Floral Fragrance 300 ml,Warehouse C,56,51,2025-02-16 20:18:00,5
16537,ORD_16538,12743,Acer 139 cm (55 inches) H Series 4K Ultra HD Android Smart LED TV AR55AR2851UDPRO (Black),Warehouse B,100,89,2025-02-16 15:18:00,11
16538,ORD_16539,26978,Radicip 500mg Tablet,Warehouse A,73,66,2025-02-16 12:41:00,7
16539,ORD_16540,5545,Rem 10mg Tablet,Warehouse A,27,11,2025-02-16 04:46:00,16
16540,ORD_16541,16598,AND EterlR EDP & ChicC Mist Pack of 2 250 ml,Warehouse C,58,51,2025-02-16 15:06:00,7
16541,ORD_16542,24559,Lemotek+ Tablet,Warehouse C,106,95,2025-02-16 01:53:00,11
16542,ORD_16543,31642,LG 80 cm (32 inches) HD Ready Smart LED TV 32LM563BPTC (Dark Iron Gray),Warehouse C,58,46,2025-02-16 12:56:00,12
16543,ORD_16544,5560,LOHAYA Air Conditioner Remote Compatible for Voltas & Lloyd Split/Window AC Remote Control (Please Match The Image with Yo...,Warehouse C,64,49,2025-02-16 07:05:00,15
16544,ORD_16545,29711,"Voice Magic Remote AKB75855501 for LG AN-MR20GA AN-MR19BA Smart TV Magic Remote Replacement, with Pointer Function",Warehouse C,64,59,2025-02-16 21:43:00,5
16545,ORD_16546,4108,"iQOO Neo 7 5G (Frost Blue, 12GB RAM, 256GB Storage) | Dimensity 8200, only 4nm Processor in The Segment | 50% Charge in 10...",Warehouse A,75,67,2025-02-16 00:59:00,8
16546,ORD_16547,24790,Nolin-P Tablet,Warehouse B,102,85,2025-02-16 19:31:00,17
16547,ORD_16548,13449,Moudzer 100mg/325mg Tablet,Warehouse B,71,52,2025-02-16 03:06:00,19
16548,ORD_16549,29580,Shower Gel - Warm Vanilla Sugar,Warehouse B,79,63,2025-02-16 05:57:00,16
16549,ORD_16550,16460,Mickcef 50mg Syrup,Warehouse B,18,5,2025-02-16 20:02:00,13
16550,ORD_16551,34919,"Amazon Basics 4G LTE WiFi USB Dongle Stick with All SIM Support | Plug & Play Data Card with up to 150Mbps Data Speed, Hot...",Warehouse A,65,46,2025-02-16 07:11:00,19
16551,ORD_16552,32011,Rekocet-SP Tablet,Warehouse C,68,54,2025-02-16 02:45:00,14
16552,ORD_16553,29587,Jovees Sun Defense Skin Toner - Neem 100 ml,Warehouse B,94,80,2025-02-16 16:40:00,14
16553,ORD_16554,29862,Elecsera Bonjour False-Fake Eyelashes With Glue Set Natural (Pair of 6),Warehouse C,50,34,2025-02-16 21:46:00,16
16554,ORD_16555,34931,"IFB 30 L Convection Microwave Oven (30FRC2, Floral Pattern & Black, With Starter Kit)",Warehouse B,14,6,2025-02-16 10:27:00,8
16555,ORD_16556,4208,Trimar O Ear Drop,Warehouse C,74,68,2025-02-16 18:08:00,6
16556,ORD_16557,6620,Tufderm Cream,Warehouse B,42,35,2025-02-16 08:56:00,7
16557,ORD_16558,24343,"Portronics Ruffpad 12E Re-Writable LCD Writing Pad with 30.4cm (12 inch) Writing Area, Single Tap Erase, Smart Lock, Long ...",Warehouse A,101,93,2025-02-16 03:18:00,8
16558,ORD_16559,11970,Didcort 6mg Tablet,Warehouse B,30,23,2025-02-16 01:30:00,7
16559,ORD_16560,16201,Aloe Cucumber Gel,Warehouse A,33,18,2025-02-16 10:54:00,15
16560,ORD_16561,7104,Gith Suspension,Warehouse A,81,73,2025-02-16 12:13:00,8
16561,ORD_16562,9398,Vega Grooming Comb (AC - 03) 40 gm,Warehouse A,78,60,2025-02-16 23:43:00,18
16562,ORD_16563,27290,Ajmal Aurum Femme & Sacredlove Deo & Ascend EDP Pack of 3 20 ml,Warehouse A,91,82,2025-02-16 03:27:00,9
16563,ORD_16564,29633,𝟐𝟎𝟐𝟐 𝐔𝐩𝐠𝐫𝐚𝐝𝐞𝐝 for Apple Watch Charger Magnetic Fast Charging Cable [Portable] Magnetic Wireless Charging Compa...,Warehouse B,102,95,2025-02-16 02:29:00,7
16564,ORD_16565,3216,Pure & Gentle Bathing Bar,Warehouse A,43,36,2025-02-16 05:03:00,7
16565,ORD_16566,36241,Neuolo KT Eye Drop,Warehouse B,50,34,2025-02-16 08:59:00,16
16566,ORD_16567,20779,"Sery Color Flirt Nail Paint Matte, Irresistable Lilac 10 ml",Warehouse C,70,62,2025-02-16 18:10:00,8
16567,ORD_16568,2922,JULEX IR Security CCTV False Outdoor Camera Fake Dummy Security Camera Realistic Looking Dummy Security CCTV Fake Bullet C...,Warehouse A,101,93,2025-02-16 23:42:00,8
16568,ORD_16569,1890,Faces Canada Weightless Matte Finish Lipstick Peach Candy 14 4 Gm,Warehouse A,52,35,2025-02-16 10:31:00,17
16569,ORD_16570,29600,Clavcare Forte Dry Syrup,Warehouse B,58,53,2025-02-16 20:19:00,5
16570,ORD_16571,1267,"Fire-Boltt Ninja 2 Max 1.5"" Full Touch Display, SpO2, Heart Rate, 20 Sports Mode & Sleep Monitor, Gesture,Camera & Music C...",Warehouse C,79,68,2025-02-16 16:47:00,11
16571,ORD_16572,12013,Arjuna Tablets,Warehouse A,59,41,2025-02-16 12:36:00,18
16572,ORD_16573,16606,Passion Indulge FACE MUDD PACK-PEARL LIGHT (SMALL) 100 gm,Warehouse A,52,42,2025-02-16 00:45:00,10
16573,ORD_16574,4049,"Zebronics Zeb-Buds 30 3.5Mm Stereo Wired In Ear Earphones With Mic For Calling, Volume Control, Multifunction Button, 14Mm...",Warehouse B,106,88,2025-02-16 22:29:00,18
16574,ORD_16575,11865,Corsair TM30 Performance 3 Grams Thermal Paste (Silver),Warehouse B,102,88,2025-02-16 11:08:00,14
16575,ORD_16576,11781,"Fire TV Stick 4K Max streaming device, Wi-Fi 6, Alexa Voice Remote (includes TV controls)",Warehouse B,88,79,2025-02-16 02:54:00,9
16576,ORD_16577,30870,"Duracell Ultra Alkaline AA Batteries, pack of 8",Warehouse C,25,11,2025-02-16 02:09:00,14
16577,ORD_16578,33788,"Doodle Unicorn Wiro Hard Bound Spiral Notebook Diary with Bookmark Dangler (A5,160 Ruled Pages, 80GSM, Multicolor)",Warehouse B,61,45,2025-02-16 09:33:00,16
16578,ORD_16579,30845,"Yves Rocher Pomegranate Pink Berries Energizing Bath and Shower Gel, 200ml",Warehouse A,86,69,2025-02-16 12:37:00,17
16579,ORD_16580,2977,"GreatDio® A4 Document File Clear Bag, Transparent Envelope Holder Storage Case, Organizer, Clear Plastic Container for Pap...",Warehouse B,94,84,2025-02-16 18:34:00,10
16580,ORD_16581,364,Dclorav S 50mg/10mg Tablet,Warehouse B,76,69,2025-02-16 13:07:00,7
16581,ORD_16582,9177,Welrab 20mg Injection,Warehouse B,37,21,2025-02-16 08:03:00,16
16582,ORD_16583,30808,CZARTECH Tempered Glass For iPhone XR/11 Screen Protector With Easy Cleaning Kit (Pack of 1),Warehouse B,100,88,2025-02-16 02:17:00,12
16583,ORD_16584,1891,Coldex AM Syrup,Warehouse B,31,24,2025-02-16 15:59:00,7
16584,ORD_16585,15836,Closil Cream,Warehouse C,77,70,2025-02-16 15:43:00,7
16585,ORD_16586,11886,Sennazole 400mg Tablet,Warehouse A,54,43,2025-02-16 09:26:00,11
16586,ORD_16587,4203,"Elizabeth Arden Flawless Finish Sponge-On Cream Makeup, Ecru , 23g",Warehouse B,41,29,2025-02-16 05:11:00,12
16587,ORD_16588,16601,Blemish Control Formula,Warehouse B,98,80,2025-02-16 12:08:00,18
16588,ORD_16589,15674,Swiss Beauty OIL Control 2 in 1 Compact Powder 20g - NATURAL NUDE (03),Warehouse B,72,53,2025-02-16 11:55:00,19
16589,ORD_16590,26969,Medonim-P Tablet,Warehouse A,91,81,2025-02-16 14:22:00,10
16590,ORD_16591,20419,Amazon Brand - Solimo Back Cover Case for Realme X2 / Realme XT | Compatible for Realme X2 / Realme XT Back Cover Case | 3...,Warehouse B,68,51,2025-02-16 08:23:00,17
16591,ORD_16592,27275,CP PLUS 2MP Full HD Smart Wi-f CCTV Home Security Camera |360° with Pan Tilt | View & Talk | Motion Alert | Night Vision |...,Warehouse B,50,32,2025-02-16 19:13:00,18
16592,ORD_16593,23987,Oaky Premium Keyboard Skin Cover Compatible with MacBook Air 13.6 inch M2 A2681 2022 & MacBook Pro 14/16 inch M1 Pro/Max A...,Warehouse B,21,15,2025-02-16 06:59:00,6
16593,ORD_16594,34964,Myglamm Glow Iridescent Brightening Sheet Mask Rosehip Extract Vitamin Elixir 20 Ml,Warehouse C,69,60,2025-02-16 16:08:00,9
16594,ORD_16595,33676,Comet Busters Round Red Velvet Bindi (15mm) (BIN941),Warehouse A,96,81,2025-02-16 07:18:00,15
16595,ORD_16596,29805,Fozid 1000mg Injection,Warehouse C,53,48,2025-02-16 08:38:00,5
16596,ORD_16597,31917,Lupihist  Syrup,Warehouse C,96,87,2025-02-16 18:57:00,9
16597,ORD_16598,34887,ADISA 15.6 inch Laptop Backpack Office Bag College Travel Back Pack 32 Ltrs (z-Teal),Warehouse B,83,69,2025-02-16 06:41:00,14
16598,ORD_16599,343,Hoxacip 250mg Tablet,Warehouse C,111,98,2025-02-16 02:42:00,13
16599,ORD_16600,24485,Mildox 200mg Tablet DT,Warehouse B,41,36,2025-02-16 10:47:00,5
16600,ORD_16601,24960,EGOTUDE Silicone Soft Case Camera Protection Microfiber Lining Back Cover for iPhone 14 Pro (Deep Purple),Warehouse A,20,5,2025-02-16 03:44:00,15
16601,ORD_16602,9191,"Fashion Colour Jersy Girl Kiss Proof No Transfer Lipstick, 2 Purple 2 gm",Warehouse B,101,90,2025-02-16 06:19:00,11
16602,ORD_16603,25113,"MYVN Compatible 30W WARP/6A DASH Type C charging charger cable Data Sync Fast Charging Cable Compatible for OnePlus 8,8 PR...",Warehouse C,54,40,2025-02-16 06:46:00,14
16603,ORD_16604,24346,Imusun 10mg Tablet,Warehouse B,24,19,2025-02-16 21:58:00,5
16604,ORD_16605,31391,Ajmal 2 Wisal Dhahab And 2 Nightingale Deodorants Pack of 4 200 ml,Warehouse B,19,14,2025-02-16 09:21:00,5
16605,ORD_16606,2042,Amazon Basics USB Type C to USB 3.1 Gen1 Type-A Female Lightning Adapter (OTG) - Black,Warehouse A,71,56,2025-02-16 21:05:00,15
16606,ORD_16607,20594,Faces Canada Ultime Pro Lip Definer Nude Brown 08 0.35 Gm,Warehouse B,61,52,2025-02-16 05:42:00,9
16607,ORD_16608,2891,TheGiftKart Flip Back Cover Case for Samsung Galaxy M53 5G | Genuine Leather Finish | Designer Button | Inbuilt Pockets & ...,Warehouse A,38,20,2025-02-16 13:49:00,18
16608,ORD_16609,25088,Evizole 100mg Capsule,Warehouse A,72,58,2025-02-16 10:44:00,14
16609,ORD_16610,24710,Cnpaxet 37.5mg Tablet,Warehouse C,54,47,2025-02-16 12:05:00,7
16610,ORD_16611,33769,Glimmer Premium Nail Enamel Burgandy Wine 10 ml,Warehouse B,10,4,2025-02-16 04:37:00,6
16611,ORD_16612,15755,Ginkosan VP 60mg/800mg/5mg Tablet,Warehouse A,110,95,2025-02-16 11:38:00,15
16612,ORD_16613,32821,Tropenor 100mg/125mg Suspension,Warehouse C,52,39,2025-02-16 22:01:00,13
16613,ORD_16614,29859,Oflac OZ 200mg/500mg Tablet,Warehouse C,103,87,2025-02-16 19:00:00,16
16614,ORD_16615,24423,"Tukzer 3.5"" LED Selfie Ring Light |Flexible Arm Desk Mount Clamp for Live Stream, Makeup, Online Meetings, Recording, Phot...",Warehouse A,89,80,2025-02-16 14:58:00,9
16615,ORD_16616,15585,"CAPRIGO Heavy Duty 2 Feet Projector Ceiling Mount Stand, Universal Full Motion Adjustable Projector Wall & Ceiling Mount B...",Warehouse C,12,1,2025-02-16 06:46:00,11
16616,ORD_16617,20840,Rutibro SR 200 Tablet,Warehouse A,80,67,2025-02-16 05:32:00,13
16617,ORD_16618,31369,"SanDisk iXpand USB 3.0 Flash Drive Flip 128GB for iOS and Windows, Metalic",Warehouse C,106,91,2025-02-16 14:39:00,15
16618,ORD_16619,16534,Asus BP1504 39.62 cm (15.6-inch) Laptop Backpack (Dark Grey),Warehouse C,60,54,2025-02-16 21:55:00,6
16619,ORD_16620,33515,65W Charging Cable for Oneplus 10 Dash Warp Charger Cable for 9 / 9R / Nord 2T / Nord CE 2 Lite 5G / 10R (6 Months Service...,Warehouse A,33,27,2025-02-16 03:47:00,6
16620,ORD_16621,6949,"Hair Brush Comb - Golden, BB1202",Warehouse C,32,16,2025-02-16 23:17:00,16
16621,ORD_16622,16644,Terlin DX Syrup,Warehouse B,19,8,2025-02-16 00:35:00,11
16622,ORD_16623,13360,Albutamol LS Syrup,Warehouse B,76,63,2025-02-16 20:07:00,13
16623,ORD_16624,33535,Nourishing Cream - Almond,Warehouse C,83,69,2025-02-16 00:39:00,14
16624,ORD_16625,24950,TheGiftKart Back Cover Case for OnePlus 9R (Hybrid TPU & PC | Smoked Back | Black Bumper),Warehouse C,74,69,2025-02-16 18:31:00,5
16625,ORD_16626,14479,Repsia D Capsule,Warehouse B,64,55,2025-02-16 08:12:00,9
16626,ORD_16627,6789,"ZEBRONICS Zeb-Vita Plus Mini 16 w Soundbar Supporting LED Display, USB, SD Card, AUX, FM, TWS & Call Function. (Grey)",Warehouse A,110,93,2025-02-16 10:10:00,17
16627,ORD_16628,31405,Khelni 35 Colour Eyeshadow Palette Makeup Kit With 11Pcs Makeup Brush Set Professional Kabuki Foundation Blending Blush Co...,Warehouse C,51,41,2025-02-16 14:41:00,10
16628,ORD_16629,32082,"Liquid Handwash - Sea Minerals, Refill Pack",Warehouse C,63,47,2025-02-16 15:57:00,16
16629,ORD_16630,3889,"OnePlus Warp Charge Type-C Cable (150cm, Red)",Warehouse C,21,10,2025-02-16 01:28:00,11
16630,ORD_16631,1947,"Tecno POP 6 Pro (Peaceful Blue, 2GB RAM,32GB Storage) | Front Flash | 8MP Dual Camera",Warehouse A,24,11,2025-02-16 15:15:00,13
16631,ORD_16632,529,Creafine 10000 Capsule,Warehouse C,58,51,2025-02-16 03:03:00,7
16632,ORD_16633,37108,Hair Serum - Anti Danduruff,Warehouse C,18,6,2025-02-16 21:56:00,12
16633,ORD_16634,25066,SumoL Plus DS Oral Suspension,Warehouse C,56,46,2025-02-16 01:26:00,10
16634,ORD_16635,24444,Aclon-TP Tablet,Warehouse B,24,19,2025-02-16 17:10:00,5
16635,ORD_16636,12814,Soulflower Sunscreen SPF 50+ Hand Cream with Aloe Vera and Shea Butter 50 gm,Warehouse B,97,78,2025-02-16 05:04:00,19
16636,ORD_16637,2423,"COSLUXE IMAGIC 12 COLOR CONCEALER PALETTE, 19.5g",Warehouse B,15,1,2025-02-16 04:49:00,14
16637,ORD_16638,34875,Uniball Eye Ball Point Pen - Pack of 5 (BLACK),Warehouse B,34,29,2025-02-16 22:02:00,5
16638,ORD_16639,480,Bella Vita Organic Rose 3 In 1 Tinty For Lips 8 gm,Warehouse B,112,98,2025-02-16 13:11:00,14
16639,ORD_16640,34802,Sim 10mg Tablet,Warehouse A,45,26,2025-02-16 10:22:00,19
16640,ORD_16641,6906,Zindom 10mg Tablet,Warehouse C,48,30,2025-02-16 20:09:00,18
16641,ORD_16642,14449,SERY Mattish Lipstick Stay the Night 3.5 gm,Warehouse A,63,58,2025-02-16 12:48:00,5
16642,ORD_16643,24248,Terbibest 250mg Tablet,Warehouse B,33,14,2025-02-16 06:47:00,19
16643,ORD_16644,30077,"Philips Audio MMS2625B 32W 2.1 Channel Wireless Bluetooth, Wired Multimedia Computer Speaker - Black",Warehouse C,75,62,2025-02-16 18:30:00,13
16644,ORD_16645,19410,Robustrion Anti-Scratch & Smudge Proof Tempered Glass Screen Protector for Xiaomi Mi Pad 5 11 inch,Warehouse B,53,44,2025-02-16 18:09:00,9
16645,ORD_16646,34827,"Glam21 oil free illuminator 02, 65.5 gm with UV filter sun protection for highlighting and contouring, suitable for all skin",Warehouse A,36,27,2025-02-16 03:52:00,9
16646,ORD_16647,33469,"Storite PU Leather 14 Inch Laptop Shoulder Messenger Sling Office Business Travel Bag for Men & Women (Brown, 40cm x 29cm ...",Warehouse A,95,89,2025-02-16 11:18:00,6
16647,ORD_16648,20536,"EVATON Silicone Case Cover Compatible with Boat Airdopes 141,148, with Safety Ring (Back)",Warehouse B,66,59,2025-02-16 17:18:00,7
16648,ORD_16649,7160,Zapcase Thermoplastic Polyurethane Back Case Cover for iPhone 11 | Compatible for iPhone 11 Back Case Cover | Scratch-Resi...,Warehouse C,89,81,2025-02-16 11:01:00,8
16649,ORD_16650,31908,Myglamm Lit Matte Nail Enamel - Tea 7 ML,Warehouse C,94,85,2025-02-16 23:24:00,9
16650,ORD_16651,29954,Omnipin D 10mg/20mg Capsule,Warehouse C,20,14,2025-02-16 17:25:00,6
16651,ORD_16652,24838,HP 5 ltrs (2 cms)backpack(1D0M5PA_black),Warehouse B,75,56,2025-02-16 10:47:00,19
16652,ORD_16653,401,Boya ByM1 Auxiliary Omnidirectional Lavalier Condenser Microphone with 20ft Audio Cable (Black),Warehouse C,31,16,2025-02-16 17:57:00,15
16653,ORD_16654,13570,Stengard 40mg Tablet,Warehouse C,65,57,2025-02-16 08:32:00,8
16654,ORD_16655,7299,Dompar 10mg/500mg Tablet,Warehouse A,77,67,2025-02-16 14:06:00,10
16655,ORD_16656,9082,Bio Kelp - Fresh Growth Protein Shampoo,Warehouse A,105,96,2025-02-16 02:36:00,9
16656,ORD_16657,33479,"Lux Body Wash Fragrant Skin Black Orchid Scent & Juniper Oil SuperSaver XL Pump Bottle with Long Lasting Fragrance, Glycer...",Warehouse C,70,54,2025-02-16 14:05:00,16
16657,ORD_16658,31894,"The Man Company Anti-Graying Hair & Beard Serum for Men Enriched with Bhringraj, Arcolys, & Shikakai | Hair Shine & Nouris...",Warehouse B,99,84,2025-02-16 20:49:00,15
16658,ORD_16659,34781,Spantra Green Tea Sugar Scrub 125 gm,Warehouse B,34,16,2025-02-16 18:00:00,18
16659,ORD_16660,415,Sanitary Pads,Warehouse B,23,7,2025-02-16 04:55:00,16
16660,ORD_16661,13353,Global Desi Soulful Trance Eau De Parfum 100ML & Magical Maze Body Mist 200ML Pack of 2 for Women Crafted by Ajmal,Warehouse C,55,40,2025-02-16 00:10:00,15
16661,ORD_16662,7311,Cognitriz M Kid 2.5mg/4mg Tablet,Warehouse A,92,84,2025-02-16 16:57:00,8
16662,ORD_16663,36233,Itvas 200mg Capsule,Warehouse B,48,35,2025-02-16 00:58:00,13
16663,ORD_16664,29695,Lupifenac S 50 mg/10 mg Tablet,Warehouse B,55,36,2025-02-16 20:31:00,19
16664,ORD_16665,4221,Stanla-H Tablet,Warehouse B,85,77,2025-02-16 07:36:00,8
16665,ORD_16666,34851,"Juarez Lindenwood Acoustic Guitar Kit, 38 Inches Cutaway, 38C With Bag, Strings, Pick And Strap, 3TS Sunburst",Warehouse B,110,94,2025-02-16 06:46:00,16
16666,ORD_16667,24151,THE SKIN DIET COMPANY Banana Under-eye cream for Women | Reduces fine-lines | Reduces Puffiness | Brightens under-eye | Re...,Warehouse A,14,6,2025-02-16 21:30:00,8
16667,ORD_16668,11892,"BESTOR® USB C to HDMI Adapter, 6 in 1 USB C Hub Laptop USB C Adapter MacBook HDMI Multiport Adapter Docking Hub Station wi...",Warehouse B,61,50,2025-02-16 03:26:00,11
16668,ORD_16669,5532,"HP 100 Wired Keyboard With Usb Compatibility,Numeric Keypad, Full Range Of 109 Key(Including 12 Function Keys And 3 Hotkey...",Warehouse B,76,63,2025-02-16 07:21:00,13
16669,ORD_16670,36825,"3M Scotch Titanium Scissors | 8"" Multipurpose | Easy-Clean, Non-Stick Blades | Ergonomic Handles | for Fabric, Crafts, Tap...",Warehouse B,52,36,2025-02-16 21:40:00,16
16670,ORD_16671,341,"boAt Deuce USB 300 2 in 1 Type-C & Micro USB Stress Resistant, Sturdy Cable with 3A Fast Charging & 480mbps Data Transmiss...",Warehouse A,74,61,2025-02-16 06:26:00,13
16671,ORD_16672,24066,Cintaflux 1mg Tablet,Warehouse A,87,73,2025-02-16 00:41:00,14
16672,ORD_16673,14432,Xfenac 100mg/500mg Tablet,Warehouse C,56,44,2025-02-16 09:25:00,12
16673,ORD_16674,36221,Revlon Water Tight Mascara - Black 8 Ml,Warehouse A,69,61,2025-02-16 11:24:00,8
16674,ORD_16675,25201,Aconlax Mzs Oral Suspension,Warehouse C,96,78,2025-02-16 07:20:00,18
16675,ORD_16676,34927,Glimex M 1mg/500mg Tablet,Warehouse C,37,31,2025-02-16 22:58:00,6
16676,ORD_16677,16656,"ESR Rebound Magnetic Case Compatible with iPad Pro 12.9 Inch (2022/2021/2020, 6th/5th/4th Gen), Convenient Magnetic Attach...",Warehouse B,34,20,2025-02-16 21:24:00,14
16677,ORD_16678,15517,"SJCAM SJ4000 WiFi 12MP Optical Full HD WiFi Sports Action Camera 170°Wide FOV 30M Waterproof DV Camcorder, Gold",Warehouse B,14,3,2025-02-16 01:01:00,11
16678,ORD_16679,9211,Maryaj Grey Stone EDP Aromatic Woody Perfume For Me And Ajmal Wisal Dhahab Deodorant Fruity Floral Fragrance 300 ml,Warehouse C,51,41,2025-02-16 18:22:00,10
16679,ORD_16680,25079,Face & Beard Wash,Warehouse A,94,77,2025-02-16 08:53:00,17
16680,ORD_16681,24597,Smooth & Shine Shampoo,Warehouse A,11,4,2025-02-16 21:04:00,7
16681,ORD_16682,36323,TheGiftKart Shockproof Crystal Clear Back Cover Case for Redmi 11 Prime 5G | 360 Degree Protection | Protective Design | T...,Warehouse B,15,5,2025-02-16 05:21:00,10
16682,ORD_16683,6913,"TE Selvet Cloth Microfiber Cleaning Cloths for Tablet, Smatphone Phone, Laptop, Camera, LCD Tv Screens and Any Other Delic...",Warehouse B,98,89,2025-02-16 12:55:00,9
16683,ORD_16684,37127,Smooth & Shine Conditioner,Warehouse C,72,61,2025-02-16 13:11:00,11
16684,ORD_16685,29900,Robustrion Anti-Scratch & Smudge Proof Tempered Glass Screen Protector Guard for iPad 10th Generation 10.9 inch,Warehouse B,65,47,2025-02-16 07:23:00,18
16685,ORD_16686,24614,"ESR Armorite Screen Protector Compatible with iPhone 14 Pro, Ultra-Tough Tempered-Glass, Easy Alignment Frame, 2 Pack",Warehouse A,102,90,2025-02-16 17:05:00,12
16686,ORD_16687,30154,NOTE NAIL ENAMEL 06 9 ml,Warehouse C,62,43,2025-02-16 15:22:00,19
16687,ORD_16688,3190,Fedrine Tablet,Warehouse B,103,96,2025-02-16 22:36:00,7
16688,ORD_16689,2858,TheGiftKart Back Cover For Samsung Galaxy M31 Prime / F41 / M31 ( Poly Carbonate|Black ),Warehouse A,15,10,2025-02-16 16:26:00,5
16689,ORD_16690,6658,"Dove Lavender & Chamomile Go Fresh Body Wash Pump Bottle with Relaxing Floral Scent, Gentle & Mild Body Cleanser for Nouri...",Warehouse A,24,19,2025-02-16 15:38:00,5
16690,ORD_16691,11532,"JBL C50HI, Wired in Ear Headphones with Mic, One Button Multi-Function Remote, Lightweight & Comfortable fit (Blue)",Warehouse A,81,67,2025-02-16 00:04:00,14
16691,ORD_16692,16377,Sitahenz-D 100 Tablet,Warehouse B,20,14,2025-02-16 16:26:00,6
16692,ORD_16693,7184,Pocket Comb - Colour May Vary,Warehouse B,61,55,2025-02-16 16:01:00,6
16693,ORD_16694,16503,Deflagard 6mg Tablet,Warehouse A,66,58,2025-02-16 01:23:00,8
16694,ORD_16695,24189,Bisulide P 100mg/325mg Tablet,Warehouse B,74,61,2025-02-16 16:45:00,13
16695,ORD_16696,34898,Glivin 2mg Tablet,Warehouse A,33,15,2025-02-16 03:20:00,18
16696,ORD_16697,24738,Anti Wrinkle Cream,Warehouse B,13,6,2025-02-16 12:51:00,7
16697,ORD_16698,24772,"Wiffy  transparent color changing jelly moisturizing lipstick (pink, 3.6 g)  (PINK, 3.6 g)",Warehouse A,45,29,2025-02-16 23:04:00,16
16698,ORD_16699,33440,Asclavmox CL Dry Syrup,Warehouse C,17,8,2025-02-16 14:32:00,9
16699,ORD_16700,29582,Life On Coconut Shampoo & Shower Gel,Warehouse A,20,6,2025-02-16 17:40:00,14
16700,ORD_16701,6937,"Smart Watch for Men & Women - ID116 Latest Bluetooth Phone Watch 1.3"" LED with Daily Activity Tracker, Heart Rate Sensor, ...",Warehouse B,20,3,2025-02-16 07:57:00,17
16701,ORD_16702,15904,Nicka K DUO HIGHLIGHTER 2 gm,Warehouse A,53,44,2025-02-16 07:38:00,9
16702,ORD_16703,27213,"Tough Lee Camera Lens Protector Tempered Glass for Apple iPhone 14, iPhone 14 Plus (Transparent) Pack of 1",Warehouse B,85,75,2025-02-16 17:10:00,10
16703,ORD_16704,1967,Glyciphage 850 Tablet,Warehouse C,97,83,2025-02-16 17:20:00,14
16704,ORD_16705,33531,ANTONIA Cover Case Compatible for AirPods Gen 1 & 2 | Tan - PU Leather Protective Case with Button Lock & Metal Keychain |...,Warehouse C,20,15,2025-02-16 02:13:00,5
16705,ORD_16706,24533,SKYVIK TRUHOLD Magnetic AC Air-Vent/Dashboard Car Mount Mobile Phone Holder,Warehouse C,99,85,2025-02-16 02:32:00,14
16706,ORD_16707,29844,"DIGITEK® (DMP 60N) Professional Monopod with 4 Extendable Sections & Dual Mount Thread Adapter (1/4inch and 3/8inch), Load...",Warehouse A,78,60,2025-02-16 19:56:00,18
16707,ORD_16708,30108,Majmua Concentrated Oriental Perfume Free From Alcohol For Unisex,Warehouse A,109,94,2025-02-16 00:20:00,15
16708,ORD_16709,16241,Celitol 50mg Dry Syrup,Warehouse B,76,64,2025-02-16 11:40:00,12
16709,ORD_16710,9078,Itu 10mg Tablet,Warehouse A,69,52,2025-02-16 03:29:00,17
16710,ORD_16711,32880,"Samsung Galaxy A14 5G (Dark Red, 6GB, 128GB Storage) | Triple Rear Camera (50 MP Main) | Upto 12 GB RAM with RAM Plus | Tr...",Warehouse B,107,94,2025-02-16 16:49:00,13
16711,ORD_16712,33751,"TheGiftKart Back Cover for Samsung Galaxy S20 FE / S20 FE 5G (Polycarbonate, TPU | Black)",Warehouse C,44,32,2025-02-16 16:30:00,12
16712,ORD_16713,32042,Glimper MV 1mg/500mg/0.3mg Tablet SR,Warehouse B,93,74,2025-02-16 00:33:00,19
16713,ORD_16714,15888,Beauty People Smart Nails - All That Jazz 3 - D Nail Polish Starlit - Jazz - 1031 12 ml,Warehouse C,81,74,2025-02-16 18:44:00,7
16714,ORD_16715,20302,"Minimalist Aha , Bha & Pha 5 Peeling Solution 30 ml",Warehouse B,92,75,2025-02-16 23:39:00,17
16715,ORD_16716,31458,7SEVEN® Bluetooth Voice command Samsung Smart 4K Tv Remote Control Replacement of Original BN59-01312F Samsung Ultra Curve...,Warehouse B,34,24,2025-02-16 01:22:00,10
16716,ORD_16717,15708,Samsung Level U2 (Black)- Original Bluetooth in Ear Wireless Stereo Headset with Mic,Warehouse A,70,60,2025-02-16 01:04:00,10
16717,ORD_16718,12191,Depot 101 Normalizing Daily Shampoo 50 ml,Warehouse B,66,59,2025-02-16 07:19:00,7
16718,ORD_16719,33519,BRUSTRO A3 Double Sided Self Healing Eco Friendly 5 Layers Cutting Mat Metric/Imperial 45cm x 30cm Black,Warehouse C,20,4,2025-02-16 07:51:00,16
16719,ORD_16720,27073,Medimade Coconut Milk Moisturizing Body Lotion (Pack of 2) 1's,Warehouse C,50,40,2025-02-16 00:30:00,10
16720,ORD_16721,416,Herbal Broad Spectrum Sunscreen SPF 50+ With Turmeric,Warehouse C,66,54,2025-02-16 22:47:00,12
16721,ORD_16722,36444,Rosuflo 20mg Tablet,Warehouse B,30,20,2025-02-16 09:54:00,10
16722,ORD_16723,24446,"Stylus Pen, Active Stylus Pen Compatible for iOS and Android Touchscreens/Phones, Rechargeable Stylus Pen with Dual Touch ...",Warehouse B,107,89,2025-02-16 21:53:00,18
16723,ORD_16724,11523,Mr.Kool Choco O-reo Flavor Milkshake Hot Milk Drink Mix Powder,Warehouse B,102,85,2025-02-16 21:24:00,17
16724,ORD_16725,16672,Allure eye liner and eye applicator makeup brushes,Warehouse A,72,66,2025-02-16 01:37:00,6
16725,ORD_16726,25076,Penseil 40 Tablet,Warehouse C,79,70,2025-02-16 14:11:00,9
16726,ORD_16727,24895,Biotique Bio Pistachio Youthful Nourishing & Revitalizing Face Pack 50 gm,Warehouse B,77,64,2025-02-16 16:19:00,13
16727,ORD_16728,30900,Lakme Absolute Plump & Shine Lip Gloss Pink Shine 3 Gm,Warehouse A,20,3,2025-02-16 23:58:00,17
16728,ORD_16729,16110,Lumaglobe 40mg/240mg Tablet,Warehouse C,51,35,2025-02-16 09:13:00,16
16729,ORD_16730,14369,Flormar Full Color Nail Enamel FC50 Miami Sunset 8 ml,Warehouse C,101,82,2025-02-16 09:10:00,19
16730,ORD_16731,9305,Cloxaid 250 mg/250 mg Capsule,Warehouse C,38,28,2025-02-16 17:22:00,10
16731,ORD_16732,3517,Fintrox SB 1000mg/500mg Injection,Warehouse C,61,47,2025-02-16 20:27:00,14
16732,ORD_16733,4707,Onsitego 2 Year Extended Warranty for Small Household Appliances from Rs. 1001-1500 (Email Delivery - No Physical Kit),Warehouse A,27,17,2025-02-16 18:24:00,10
16733,ORD_16734,14604,Ronzille Glitter Liquid Eyeliner Blue Green Shimmery Finish (Pack Of 2),Warehouse B,102,85,2025-02-16 06:55:00,17
16734,ORD_16735,1731,GM-Care SR 500 Tablet,Warehouse C,30,12,2025-02-16 15:16:00,18
16735,ORD_16736,7885,Ajmal Blu & Aurum & Evoke silver Edition Homme & Shadow Homme Deo & Prose EDP Pack of 4 20 ml,Warehouse A,42,32,2025-02-16 15:43:00,10
16736,ORD_16737,21242,Matra Activated Charcoal Mask - Bentonite and Aloevera (Free Brush) 100 gm,Warehouse A,72,59,2025-02-16 06:44:00,13
16737,ORD_16738,22939,Berina A12 Red Violet Blonde Hair Color Cream 60 gm,Warehouse C,34,24,2025-02-16 06:18:00,10
16738,ORD_16739,17897,Bonjour Paris Photo Match Mousse Foundation - Rose Ivory 30 ml,Warehouse B,95,77,2025-02-16 04:32:00,18
16739,ORD_16740,35730,"Samsung 870 EVO 500GB SATA 6.35 cm (2.5"") Internal Solid State Drive (SSD) (MZ-77E500)",Warehouse A,87,80,2025-02-16 04:44:00,7
16740,ORD_16741,35141,Qtajas 100mg Tablet SR,Warehouse C,25,18,2025-02-16 01:01:00,7
16741,ORD_16742,22906,Clonavish 0.25 Tablet MD,Warehouse B,48,42,2025-02-16 14:41:00,6
16742,ORD_16743,32932,Amecort 4mg Tablet,Warehouse A,105,96,2025-02-16 19:05:00,9
16743,ORD_16744,32328,Almide 750mg Tablet,Warehouse A,92,76,2025-02-16 00:59:00,16
16744,ORD_16745,6247,Rosagon-Gold 10 Capsule,Warehouse C,71,52,2025-02-16 20:39:00,19
16745,ORD_16746,34664,Pendom-OD Capsule SR,Warehouse A,118,99,2025-02-16 21:38:00,19
16746,ORD_16747,28775,Sarzole 100mg Capsule,Warehouse A,54,35,2025-02-16 00:54:00,19
16747,ORD_16748,32352,Amla Hair Repair Serum,Warehouse A,41,31,2025-02-16 23:40:00,10
16748,ORD_16749,27636,Symbiotik P Tablet,Warehouse C,94,86,2025-02-16 00:40:00,8
16749,ORD_16750,896,Bhringraj Ayurvedic Oil,Warehouse C,93,88,2025-02-16 05:48:00,5
16750,ORD_16751,25959,FIAMA Shower Gel Lemongrass Jojoba 100ml + FIAMA Shower Gel Peach Avocado 100 ml,Warehouse B,40,27,2025-02-16 06:17:00,13
16751,ORD_16752,4698,"F&D F6000X Powerful 270 W Bluetooth Home Audio Speaker & Home Theater System (5.1, Black)",Warehouse C,43,24,2025-02-16 05:11:00,19
16752,ORD_16753,31769,"Pure Radiance Under Eye Cream - For Dark Circles, Puffiness, Wrinkles & Bags",Warehouse B,41,30,2025-02-16 08:38:00,11
16753,ORD_16754,10607,Wybifix 50mg Dry Syrup,Warehouse B,51,35,2025-02-16 18:30:00,16
16754,ORD_16755,12664,Ndjey 25mg Injection,Warehouse A,83,76,2025-02-16 01:16:00,7
16755,ORD_16756,2232,"Portronics Xlife Smart Wireless Ear Otoscope Cleaner with 6 LED Lights, FHD 1080 Camera, 3 Mega pixels Endoscope, Control ...",Warehouse B,80,66,2025-02-16 12:17:00,14
16756,ORD_16757,31556,Mirah Belle Organic Goat Milk Baby Soap 125 gm,Warehouse C,105,98,2025-02-16 23:28:00,7
16757,ORD_16758,33190,T Lac 10mg Tablet,Warehouse C,47,39,2025-02-16 21:31:00,8
16758,ORD_16759,31151,Quitderm-RF Cream,Warehouse C,55,46,2025-02-16 13:18:00,9
16759,ORD_16760,22663,"Belkin Smartphone Apple Certified Lightning To Type C Cable, Fast Charging For Iphone, Ipad, Air Pods, 3.3 Feet (1 Meters)...",Warehouse C,78,62,2025-02-16 23:04:00,16
16760,ORD_16761,17877,"Fashion Colour Kiss Lip No Transfer Lipstick, 28 Wineberry 2.6 gm",Warehouse A,45,29,2025-02-16 08:46:00,16
16761,ORD_16762,15116,Vector 50 mg/10 mg Tablet,Warehouse A,94,88,2025-02-16 13:58:00,6
16762,ORD_16763,19843,Kesini Ayurvedic Herbal Hair Wash Powder,Warehouse A,63,49,2025-02-16 11:13:00,14
16763,ORD_16764,10693,HUDA BB®Liquid Matte Minis Lipstick (Pink -Edition Lipstick-4) With Waterproof Sketch Eyeliner & Black Eyeconic Kajal Set ...,Warehouse B,89,79,2025-02-16 03:33:00,10
16764,ORD_16765,27607,"FIRSTZON 24 color eyeshadow palette | shimmer eyeshadow powder palette | long-lasting and waterproof eyeshadow palette, Mu...",Warehouse C,16,7,2025-02-16 19:56:00,9
16765,ORD_16766,30737,"Lenovo ThinkBook 15 G3 Ryzen 3 15.6"" FHD Thin and Light Laptop (8GB RAM/512GB SSD/Windows 11 Home/Fingerprint Reader/Miner...",Warehouse A,23,12,2025-02-16 01:38:00,11
16766,ORD_16767,12670,"L'Oreal Paris Flash Cat Eye Eyeliner, Black 0.6 Gm",Warehouse A,87,81,2025-02-16 02:19:00,6
16767,ORD_16768,17993,"Age Defying Multi-Vitamin Moisturiser With Vitamin A, E & C",Warehouse C,92,84,2025-02-16 09:25:00,8
16768,ORD_16769,6230,Maxdro-M Tablet,Warehouse B,95,76,2025-02-16 08:50:00,19
16769,ORD_16770,21274,"Dumbel MOSO 12V 2A DC Power Supply Adapter, AC 100-240V to DC 12 Volt Transformer. SMPS for LCD Monitor, TV, LED Strip, CC...",Warehouse C,90,73,2025-02-16 09:17:00,17
16770,ORD_16771,1413,KAPA Acrylic Hawkeye Clear Back Camera Lens Protector Back Cover Compatible for Apple iPhone XR (Black),Warehouse B,68,51,2025-02-16 20:17:00,17
16771,ORD_16772,12882,Precell M 750mcg/75mg Capsule,Warehouse B,94,81,2025-02-16 13:47:00,13
16772,ORD_16773,28738,Lotus Herbals Probrite Illuminating Radiance Serum+Creme 30 Ml,Warehouse C,39,33,2025-02-16 01:06:00,6
16773,ORD_16774,18026,Olet 1.25mg Tablet,Warehouse C,99,82,2025-02-16 09:24:00,17
16774,ORD_16775,28733,72% Alcohol Based Hand sanitizer,Warehouse A,11,6,2025-02-16 00:34:00,5
16775,ORD_16776,5281,"Redgear MT02 Keyboard with LED Modes, Windows Key Lock, Floating & Double Injected Keycaps, Control Knob and Ergonomic Des...",Warehouse C,113,95,2025-02-16 00:14:00,18
16776,ORD_16777,7339,HP 805 Black Original Ink Cartridge,Warehouse A,79,73,2025-02-16 18:51:00,6
16777,ORD_16778,21285,Flormar Style Matic Lipliner SL09 Chocolate 0.35 gm,Warehouse C,96,88,2025-02-16 01:11:00,8
16778,ORD_16779,17869,mCaffeine Latte Coffee Shampoo for Damage Repair with Coconut Milk & Keratin | Moisturizes and Nourishes Dry Hair | Sulpha...,Warehouse C,18,2,2025-02-16 16:06:00,16
16779,ORD_16780,32936,Vocid-D Capsule,Warehouse A,65,59,2025-02-16 16:34:00,6
16780,ORD_16781,28729,Gemscare Softgel Capsule,Warehouse B,62,49,2025-02-16 23:49:00,13
16781,ORD_16782,4656,Fresh Spicy,Warehouse B,108,98,2025-02-16 18:04:00,10
16782,ORD_16783,34175,Baralgan D 40mg Tablet,Warehouse B,69,60,2025-02-16 20:00:00,9
16783,ORD_16784,22790,Berina A6 Violet Hair Color Cream 60 gm,Warehouse C,19,14,2025-02-16 04:55:00,5
16784,ORD_16785,34182,ABOUTTHEFIT iPad 10.2 9th 8th 7th Generation Keyboard Case - Smart Case with Wireless Keyboard Tablet Detachable Bluetooth...,Warehouse C,29,12,2025-02-16 22:41:00,17
16785,ORD_16786,7932,OneAssist Mobile 1 Year Extended Warranty Plan - 10001 to 15000,Warehouse B,62,48,2025-02-16 02:28:00,14
16786,ORD_16787,22883,"Deltoid Lite Face Masks In Rose, Pink & Aqua Knit Fabrics With Bindings - Assorted, 3C2001, Large",Warehouse C,58,43,2025-02-16 07:06:00,15
16787,ORD_16788,12434,Welldoll SP 100mg/325mg/15mg Tablet,Warehouse C,51,40,2025-02-16 07:02:00,11
16788,ORD_16789,25844,Cleansing Lotion,Warehouse A,12,6,2025-02-16 04:31:00,6
16789,ORD_16790,12389,Betavue 8mg Tablet,Warehouse C,79,65,2025-02-16 20:03:00,14
16790,ORD_16791,19848,GEOCARTER Multi-Purpose Wall Mount Mobile Holder Accessories Mobile Phone Charging Stand | Self Adhesive Smartphone AC TV ...,Warehouse A,84,69,2025-02-16 10:15:00,15
16791,ORD_16792,30413,Micromax X513+ Black,Warehouse B,26,18,2025-02-16 11:31:00,8
16792,ORD_16793,35171,Sri Sri Tattva Immugen 500 mg Tablet 60's,Warehouse C,108,93,2025-02-16 18:46:00,15
16793,ORD_16794,13062,Charlie - Gold Edt,Warehouse A,97,88,2025-02-16 10:29:00,9
16794,ORD_16795,7922,Neutrapime 250mg Injection,Warehouse C,80,61,2025-02-16 01:56:00,19
16795,ORD_16796,34638,"SMILEDRIVE Portable Bluetooth Mobile Conference Call Speaker with Omnidirectional Mic, Echo & Noise Cancellation",Warehouse B,38,31,2025-02-16 01:56:00,7
16796,ORD_16797,35656,Mothercare Orthodontic Soothers for 0 Months+ - Beige (Pack of 2),Warehouse B,94,78,2025-02-16 14:49:00,16
16797,ORD_16798,28666,Jubiglim M 2 Tablet PR,Warehouse B,51,40,2025-02-16 05:30:00,11
16798,ORD_16799,18161,Cortifast 6mg Tablet,Warehouse C,114,97,2025-02-16 19:45:00,17
16799,ORD_16800,884,Azetro 250mg Tablet,Warehouse B,50,36,2025-02-16 17:45:00,14
16800,ORD_16801,969,Azicol 200mg Syrup,Warehouse A,55,49,2025-02-16 03:17:00,6
16801,ORD_16802,19572,"Fashion Colour Satin Smooth Lip Definer, 4 Hot Chilly 1.41 gm",Warehouse C,47,40,2025-02-16 17:37:00,7
16802,ORD_16803,815,Rts All In One Universal Global Power International Travel Adaptor 2 Usb Charging Port Europe Uk/Usa/Eu/Aus Worldwide Wall...,Warehouse B,29,12,2025-02-16 15:35:00,17
16803,ORD_16804,27894,"3M Post-it Sticky Notes Pad | Assorted colours | Pack of 3 (100 Sheets each) | 3"" x 3"" | For notes, reminders, study, scho...",Warehouse B,92,87,2025-02-16 07:32:00,5
16804,ORD_16805,26406,Acer 127 cm (50 inches) I Series 4K Ultra HD Android Smart LED TV AR50AR2851UDFL (Black),Warehouse B,100,92,2025-02-16 04:39:00,8
16805,ORD_16806,27891,Derivent S 231mg/69mg/4mg Tablet,Warehouse A,80,61,2025-02-16 14:06:00,19
16806,ORD_16807,33046,Canon GI-790 Yellow/Cyan/Magneta Ink Bottle,Warehouse C,61,42,2025-02-16 04:39:00,19
16807,ORD_16808,5941,NOTE EYEBROW PENCIL 02 1.2 gm,Warehouse B,51,34,2025-02-16 23:57:00,17
16808,ORD_16809,3425,Bobbi Brown Primer Plus Hydrating 3 In 1 Setting Spray 100ml/3.4oz,Warehouse A,76,64,2025-02-16 09:30:00,12
16809,ORD_16810,32562,Nidtrex 5mg Tablet,Warehouse A,56,50,2025-02-16 07:50:00,6
16810,ORD_16811,10030,Revlon Colorstay Gel Envy Long Wear Nail Enamel - Pocket Aces 11.6 Ml,Warehouse A,99,81,2025-02-16 16:42:00,18
16811,ORD_16812,35348,Opidep 100 Tablet,Warehouse B,43,37,2025-02-16 21:56:00,6
16812,ORD_16813,14075,Glimmer Premium Nail Enamel Dark Pink 10 ml,Warehouse B,89,72,2025-02-16 18:44:00,17
16813,ORD_16814,28060,COMMA Abaca – A5 Size – Hard Bound Notebook with Elastic Band Closure & Pen Loop – 192 Pages – 80gsm Natural Shade Paper –...,Warehouse C,26,15,2025-02-16 22:34:00,11
16814,ORD_16815,15548,Codica 5mg Tablet,Warehouse A,22,13,2025-02-16 11:17:00,9
16815,ORD_16816,34536,Dell Mobile Wireless Mouse MS3320W - Titan Gray - 3yrs Adv. Exc Serv,Warehouse B,25,9,2025-02-16 11:34:00,16
16816,ORD_16817,21625,Prickly Heat Powder - Cool Chandan With Sandalwood Fragrance,Warehouse B,109,94,2025-02-16 09:42:00,15
16817,ORD_16818,22262,"Arata Natural Mini Face Revitalizing Gift Box with Face Wash (50 Ml), Face Serum Cream (50 Ml), Face Serum Gel (50 Ml) 150 ml",Warehouse B,54,49,2025-02-16 14:11:00,5
16818,ORD_16819,33032,Nusoft moisturizer soap - moisturizer soap(pack of 4)75g,Warehouse C,64,57,2025-02-16 02:34:00,7
16819,ORD_16820,3655,"L'Oreal Paris Rouge Signature Matte Liquid Lipstick,115 I Am Worth It 7 Gm",Warehouse B,70,54,2025-02-16 18:54:00,16
16820,ORD_16821,19151,Amozo Back Cover For iPhone 12/ 12 Pro ( TPU|Black ),Warehouse A,19,12,2025-02-16 14:35:00,7
16821,ORD_16822,10012,Telpress AM 40mg/5mg Tablet,Warehouse A,46,38,2025-02-16 10:43:00,8
16822,ORD_16823,21851,Betaday 20mg Tablet,Warehouse A,72,63,2025-02-16 02:12:00,9
16823,ORD_16824,24777,Zayn & Myza Arise No Alcohol Body Spray For Men 150 ml,Warehouse A,33,18,2025-02-16 10:33:00,15
16824,ORD_16825,31599,Melaroc Tablet,Warehouse C,110,94,2025-02-16 06:01:00,16
16825,ORD_16826,22708,"smashtronics - Adjustable Aluminum Laptop Stand - Foldable, Ventilated, Portable Stand for Desk & Tabletop, Compatible wit...",Warehouse C,86,80,2025-02-16 19:22:00,6
16826,ORD_16827,32371,Zebronics Zeb-Transformer-M Optical USB Gaming Mouse with LED Effect(Black),Warehouse B,97,90,2025-02-16 01:56:00,7
16827,ORD_16828,27656,"Fair and Handsome Fairness Cream for Men, 30gm",Warehouse A,20,1,2025-02-16 02:28:00,19
16828,ORD_16829,22780,Nokia 150 (2020) (Cyan),Warehouse A,20,5,2025-02-16 10:30:00,15
16829,ORD_16830,8055,"MahaGro Herbal Organic Hair Wash, 200g",Warehouse A,95,87,2025-02-16 08:41:00,8
16830,ORD_16831,34221,Flormar Silk Matte Liquid Lipstick 019 Pink Stone 4.5 gm,Warehouse C,82,71,2025-02-16 04:27:00,11
16831,ORD_16832,4719,Samsung EVO Plus 128GB microSDXC UHS-I U3 130MB/s Full HD & 4K UHD Memory Card with Adapter (MB-MC128KA),Warehouse B,59,51,2025-02-16 12:25:00,8
16832,ORD_16833,10559,Rozfine Tablet,Warehouse A,85,71,2025-02-16 08:49:00,14
16833,ORD_16834,8059,Endumont L 5mg/10mg Tablet,Warehouse B,100,94,2025-02-16 18:10:00,6
16834,ORD_16835,25990,Faces Canada Weightless Creme Finish Lipstick Lady In Red 11 4 Gm,Warehouse B,56,38,2025-02-16 04:33:00,18
16835,ORD_16836,9681,Sounce USB 3.0 to Type-C OTG Cable Male-Female Adapter Compatible with All C Type Supported Mobile Smartphone and Other De...,Warehouse C,50,41,2025-02-16 22:18:00,9
16836,ORD_16837,8040,"Khadi Omorose Amla Powder for Skin & Hair Care,Pure & Natural,100 Grams",Warehouse B,89,82,2025-02-16 05:29:00,7
16837,ORD_16838,34656,"OBAGE DT-31 100 Watts Dual Tower Home Theatre System with Optical in, Bluetooth 5.0,USB,FM,AUX",Warehouse B,20,8,2025-02-16 13:39:00,12
16838,ORD_16839,2370,Foaming Face Wash - Himalayan Rose,Warehouse C,62,49,2025-02-16 23:55:00,13
16839,ORD_16840,1703,Oflomac-M Tablet,Warehouse C,106,89,2025-02-16 15:40:00,17
16840,ORD_16841,866,Hot Curl Brush Large - H2 PRL,Warehouse C,49,39,2025-02-16 13:59:00,10
16841,ORD_16842,2215,Moxivin-CV Dry Syrup,Warehouse B,89,76,2025-02-16 04:41:00,13
16842,ORD_16843,32356,"HP M270 Backlit USB Wired Gaming Mouse with 6 Buttons, 4-Speed Customizable 2400 DPI, Ergonomic Design, Breathing LED Ligh...",Warehouse C,27,11,2025-02-16 10:12:00,16
16843,ORD_16844,9651,Heel Repair Ayurvedic Foot Care Cream,Warehouse B,72,57,2025-02-16 07:08:00,15
16844,ORD_16845,6201,Solcep 500mg Capsule,Warehouse A,27,10,2025-02-16 08:17:00,17
16845,ORD_16846,13074,"boAt Stone 260 4W Bluetooth Speaker with Upto 9 Hours Playback, IPX5 and Carabiner(Enigma)",Warehouse C,20,3,2025-02-16 15:07:00,17
16846,ORD_16847,34653,Ultrathin Sensitive Toothbrush - Black,Warehouse B,84,71,2025-02-16 06:41:00,13
16847,ORD_16848,21295,Spigen EZ Fit Optik Pro Tempered Glass Camera Lens Protector Guard for iPhone 14 Pro / 14 Pro Max (Black) - 2 Pack,Warehouse B,101,93,2025-02-16 22:47:00,8
16848,ORD_16849,14625,Spigen Liquid Air Back Cover Case for iPhone XR (TPU | Matte Black),Warehouse C,92,77,2025-02-16 15:52:00,15
16849,ORD_16850,28681,"Oddy Uniwraps Food Wrapping Paper (11"" x 100 Metres, Multicolor)",Warehouse B,105,86,2025-02-16 10:33:00,19
16850,ORD_16851,15060,Bemet-G 2mg/500mg Tablet,Warehouse A,33,18,2025-02-16 01:04:00,15
16851,ORD_16852,13866,Ketoford-MX Sterile Eye Drops,Warehouse B,108,97,2025-02-16 05:43:00,11
16852,ORD_16853,3744,Bilanix Tablet,Warehouse B,48,42,2025-02-16 17:17:00,6
16853,ORD_16854,14636,ALCRAFT Real Leather Green Stone Brown Embossed Handmade Diary with Metal Lock -Size of (H) 10*(L) 7* Brown,Warehouse C,49,30,2025-02-16 16:57:00,19
16854,ORD_16855,34613,Spigen Rugged Armor Back Cover Case Compatible with Samsung Galaxy M51 (TPU | Black),Warehouse A,87,73,2025-02-16 08:45:00,14
16855,ORD_16856,8711,Onsitego 1 Year Extended Warranty for Small Household Appliances from Rs. 5001-6000 (Email Delivery - No Physical Kit),Warehouse C,31,14,2025-02-16 20:54:00,17
16856,ORD_16857,32424,Oladax 5 Tablet,Warehouse A,95,89,2025-02-16 19:47:00,6
16857,ORD_16858,19648,Mefon Forte 500mg/325mg Tablet,Warehouse C,21,9,2025-02-16 17:15:00,12
16858,ORD_16859,12485,"iBELL FM180U Portable FM Radio, USBSDMP3 Player & Dynamic Speaker 4 Band,Black",Warehouse A,95,87,2025-02-16 10:28:00,8
16859,ORD_16860,4807,"Fashion Colour Baked Blusher, Shade 07 8 gm",Warehouse B,80,72,2025-02-16 15:04:00,8
16860,ORD_16861,1654,"Wayona Nylon Braided Usb Syncing And Charging Cable Lightning Cable For Iphone, Ipad (3Ft+6Ft, Black) - Pack Of 2",Warehouse B,78,66,2025-02-16 20:22:00,12
16861,ORD_16862,8181,TheGiftKart Ultra-Hybrid Crystal Clear Back Cover Case for Samsung Galaxy S23 Ultra 5G | 360 Degree Protection | Shockproo...,Warehouse C,20,9,2025-02-16 03:11:00,11
16862,ORD_16863,32429,CRAZY HUDA Combo Waterproof Long lasting Sketch White Eyeliner with Smudge Proof Black Kajal (Pack of2),Warehouse B,89,83,2025-02-16 20:46:00,6
16863,ORD_16864,8136,Aziltence 80mg Tablet,Warehouse B,102,86,2025-02-16 18:22:00,16
16864,ORD_16865,8134,Cucin O Tablet,Warehouse C,101,89,2025-02-16 15:21:00,12
16865,ORD_16866,12476,Makeup Revolution 5D Lash Mascara 14 ml,Warehouse C,53,48,2025-02-16 07:29:00,5
16866,ORD_16867,1675,Gliss Hair Repair Ultimate Oil Elixir Structure Build Up Treatment,Warehouse B,38,26,2025-02-16 17:57:00,12
16867,ORD_16868,31560,CellFAther® Silicone Sport Strap Compatible with Fitbit Sense/Fitbit Versa 3 (Black-Small),Warehouse B,22,10,2025-02-16 08:22:00,12
16868,ORD_16869,34633,Fresogyl Infusion,Warehouse B,32,27,2025-02-16 21:42:00,5
16869,ORD_16870,18287,"iTronix Charging Cable for BoAt Storm/Storm 1.3"" Curved Display/Xtend/Xtend Pro/Xplorer/Wave Connect/Wave Beat/Wave Fit/Wa...",Warehouse C,88,77,2025-02-16 10:50:00,11
16870,ORD_16871,22601,Organic Harvest Under Eye Gel 15 gm,Warehouse B,103,91,2025-02-16 14:07:00,12
16871,ORD_16872,13939,Sk Hynix 8GB Memory Module with 204-Pin SODIMM DDR3 PC3L-12800 1600MHz,Warehouse B,42,30,2025-02-16 15:34:00,12
16872,ORD_16873,28579,Amazon Brand - Solimo Back Cover Case for Mi Redmi 9A / Mi Redmi 9i / Mi Redmi 9A Sport / Mi Redmi 9i Sport | (TPU | Matte...,Warehouse A,44,35,2025-02-16 16:33:00,9
16873,ORD_16874,33172,American Tourister 30 Litres Polyester Black laptop Backpack,Warehouse C,42,23,2025-02-16 23:40:00,19
16874,ORD_16875,22579,Faces Canada Make Up Remover 100 Ml,Warehouse C,66,58,2025-02-16 18:52:00,8
16875,ORD_16876,19693,Spigen Ultra Hybrid Back Cover Case Compatible with iPhone 14 Pro max (TPU + Poly Carbonate | Deep Purple),Warehouse A,59,46,2025-02-16 10:50:00,13
16876,ORD_16877,12470,MOCA Compatible Smart flip Cover case for iPad 9.7 inch 2017 2018 iPad 5th 6th Generation A1893 A1954 A1822 A1823 Smart ca...,Warehouse A,29,12,2025-02-16 13:06:00,17
16877,ORD_16878,30981,Madam 10mg Tablet,Warehouse B,39,25,2025-02-16 23:16:00,14
16878,ORD_16879,18329,Cadither 150mg Injection,Warehouse B,32,23,2025-02-16 00:35:00,9
16879,ORD_16880,13052,Livelyclean Honey Exfoliating Face Cleansing Gel,Warehouse C,45,30,2025-02-16 19:19:00,15
16880,ORD_16881,34285,I AM EYECONIC FINE GLITTER AQUATIC 4 gm,Warehouse B,79,60,2025-02-16 13:55:00,19
16881,ORD_16882,35567,"realme narzo 50 (Speed Black, 4GB RAM+64GB Storage) Helio G96 Processor | 50MP AI Triple Camera | 120Hz Ultra Smooth Display",Warehouse A,82,67,2025-02-16 22:21:00,15
16882,ORD_16883,36970,Ajmal Senora EDP Floral Spicy Perfume 75ml for Women and Desert Rose EDP Floral Oriental Perfume 100ml for Women +1 Perfum...,Warehouse A,12,2,2025-02-16 20:57:00,10
16883,ORD_16884,14972,"Enchanteur Charming Perfumed Body Lotion, 500ml, with Aloe Vera & Olive Butter for Satin Smooth Skin",Warehouse B,45,32,2025-02-16 02:04:00,13
16884,ORD_16885,29658,Wild Turmeric Face Wash,Warehouse B,36,20,2025-02-16 07:30:00,16
16885,ORD_16886,27296,"Amazon Basics High-Speed Braided HDMI Cable - 3 Feet - Supports Ethernet, 3D, 4K and Audio Return (Black)",Warehouse A,20,1,2025-02-16 14:17:00,19
16886,ORD_16887,12464,Rifol 5mg Tablet,Warehouse B,57,44,2025-02-16 15:39:00,13
16887,ORD_16888,5502,Linzonol 600mg Tablet,Warehouse B,21,15,2025-02-16 01:20:00,6
16888,ORD_16889,12139,Sunscreen Gel,Warehouse A,73,65,2025-02-16 07:19:00,8
16889,ORD_16890,25175,PPG MD 0.2 Tablet,Warehouse B,89,70,2025-02-16 08:33:00,19
16890,ORD_16891,31968,"Pebble Cosmos Endure 1.46"" AMOLED Always-On Display Bluetooth Calling IP68 Waterproof Smartwatch 466 * 466 (Glacier Blue)",Warehouse C,36,23,2025-02-16 06:50:00,13
16891,ORD_16892,31375,"Western Digital WD 2TB Elements Portable Hard Disk Drive, USB 3.0, Compatible with PC, PS4 and Xbox, External HDD (WDBHDW0...",Warehouse B,99,82,2025-02-16 03:12:00,17
16892,ORD_16893,29700,Lapster 1.5 mtr USB 2.0 Type A Male to USB A Male Cable for computer and laptop,Warehouse C,42,34,2025-02-16 20:18:00,8
16893,ORD_16894,1889,BLESSBE BB109 Hand Free Neck Fan Rechargeable Mini Kitchen Personal Fan Sports Persons Headphone Design Wearable Neckband ...,Warehouse A,81,76,2025-02-16 08:05:00,5
16894,ORD_16895,13523,Chubs Eyebrow Enhancer With Brush,Warehouse C,86,67,2025-02-16 17:24:00,19
16895,ORD_16896,15950,Betanif Capsule SR,Warehouse B,80,62,2025-02-16 04:25:00,18
16896,ORD_16897,32000,Ajmal Carbon Sacred Love Wisal Deodorant Spray (Pack of 3) 200 ml,Warehouse B,55,42,2025-02-16 13:52:00,13
16897,ORD_16898,4026,Histaplus Tablet,Warehouse C,87,78,2025-02-16 07:25:00,9
16898,ORD_16899,410,Vogliter 0.3mg Tablet,Warehouse A,101,87,2025-02-16 17:53:00,14
16899,ORD_16900,27047,"Face Mask - Pro Tech 95, 6 layered, Xtra Small, MK18002",Warehouse C,78,65,2025-02-16 08:03:00,13
16900,ORD_16901,512,Acegold 100mg Capsule,Warehouse B,27,20,2025-02-16 08:55:00,7
16901,ORD_16902,24757,Alphavog GM 2mg/500mg/0.3mg Tablet,Warehouse A,42,27,2025-02-16 14:22:00,15
16902,ORD_16903,9403,Olive Face Cleansing Gel,Warehouse A,20,12,2025-02-16 09:32:00,8
16903,ORD_16904,22475,Funo 150mg Tablet,Warehouse B,109,97,2025-02-16 15:16:00,12
16904,ORD_16905,8146,Gliss Hair Repair Ultimate Repair Oil Replacement,Warehouse C,66,50,2025-02-16 16:57:00,16
16905,ORD_16906,28504,Fujifilm Instax Mini 11 Instant Camera (Blush Pink) Moments Box with 20 Shots,Warehouse A,85,79,2025-02-16 21:06:00,6
16906,ORD_16907,27707,"Samsung Galaxy M13 (Aqua Green, 6GB, 128GB Storage) | 6000mAh Battery | Upto 12GB RAM with RAM Plus",Warehouse A,29,19,2025-02-16 03:57:00,10
16907,ORD_16908,8157,Esnocort Tablet,Warehouse A,114,97,2025-02-16 15:51:00,17
16908,ORD_16909,6123,"Panasonic eneloop pro Ni‐MH AA Rechargeable Battery, low self discharge for multi use up to 2550 mAh capacity, storage lif...",Warehouse C,90,84,2025-02-16 22:40:00,6
16909,ORD_16910,18422,Spantra Sea buckthorn Conditioner 300 ml,Warehouse A,75,56,2025-02-16 01:25:00,19
16910,ORD_16911,14201,KAPAVER ® Polycarbonate Back Cover Case for Nothing Phone 1 5G (Transparent and Gray),Warehouse B,65,52,2025-02-16 07:58:00,13
16911,ORD_16912,10452,SNAPTRON Return Gifts for Birthday for Kids Party 5 pcs LCD Writing Pads for Kids Writing Tablets Screen 8.5 Birthday Retu...,Warehouse B,110,96,2025-02-16 00:23:00,14
16912,ORD_16913,22563,Amazon Brand - Solimo Transparent Black Case (Hard Back & Soft Bumper Cover) with for Apple iPhone 6S,Warehouse C,37,18,2025-02-16 00:39:00,19
16913,ORD_16914,28476,Fenvolk-P 100mg/325mg Tablet,Warehouse A,64,57,2025-02-16 23:46:00,7
16914,ORD_16915,19688,Ketofen 100mg Tablet,Warehouse A,28,17,2025-02-16 06:13:00,11
16915,ORD_16916,26188,Flormar Extreme Matte Lipstick 013 Terracotta Rose 4 gm,Warehouse B,69,52,2025-02-16 00:47:00,17
16916,ORD_16917,18640,Clominex 50 Tablet,Warehouse B,56,50,2025-02-16 08:42:00,6
16917,ORD_16918,14004,KAPAVER ® Rugged Armor TPU Back Cover Case for OnePlus 7 Pro - (Black),Warehouse B,73,55,2025-02-16 05:08:00,18
16918,ORD_16919,2354,Sugronil Forte 5mg/500mg Tablet,Warehouse C,80,67,2025-02-16 21:42:00,13
16919,ORD_16920,33122,Heseclo MR 100mg/325mg/250mg Tablet,Warehouse C,37,22,2025-02-16 19:44:00,15
16920,ORD_16921,13968,I'mint Green Tea-Vetiver Nourishing & Toning Pack,Warehouse A,18,5,2025-02-16 05:45:00,13
16921,ORD_16922,32439,Dactive 6.5mg Tablet SR,Warehouse B,23,14,2025-02-16 06:43:00,9
16922,ORD_16923,13969,Glimiprime 3mg Tablet,Warehouse A,27,18,2025-02-16 18:39:00,9
16923,ORD_16924,19627,"Dell Vostro 3420 Laptop,12th Gen Intel Core i3-1215U, 8GB & 512GB SSD, 14.0"" (35.56Cms) FHD WVA AG 250 nits, Windows 11 + ...",Warehouse C,43,31,2025-02-16 20:24:00,12
16924,ORD_16925,10378,"Hair Oil - For Strong, Long & Thick Hair",Warehouse A,75,69,2025-02-16 10:53:00,6
16925,ORD_16926,31119,Pedicef 50mg Dry Syrup,Warehouse B,100,84,2025-02-16 13:45:00,16
16926,ORD_16927,18523,Pod 100mg Tablet,Warehouse A,62,50,2025-02-16 05:30:00,12
16927,ORD_16928,30532,Funix B Cream,Warehouse B,10,1,2025-02-16 06:38:00,9
16928,ORD_16929,26143,FREXCEZ Dash Type C Fast Charging Cable Compatible for one plus 8T/ one plus 8 Pro/one plus 8 / one plus 7 / one plus 7T /...,Warehouse C,54,40,2025-02-16 23:05:00,14
16929,ORD_16930,3399,Arias By Lara Dutta Intense Night Repair Serum 50 gm,Warehouse A,67,62,2025-02-16 01:28:00,5
16930,ORD_16931,5216,CEDO Realme Pad Mini (8.7 Inch) Flip Cover | Leather Finish | 360 Degree Rotate Flip Cover | Shockproof Style Case for Rea...,Warehouse B,28,10,2025-02-16 11:07:00,18
16931,ORD_16932,19614,Daily Life Forever52 Fan Brush Nx023 1's,Warehouse B,22,8,2025-02-16 16:24:00,14
16932,ORD_16933,33129,CZARTECH Tempered Glass for Samsung Galaxy M04 | M33 5G | M32 5G I M13 I M13 5G I M12 I M02 | M02s I A32 5G | A13 5G | A02...,Warehouse C,44,33,2025-02-16 00:29:00,11
16933,ORD_16934,14650,Spantra Anti Acne Facial Serum 50 ml,Warehouse B,76,67,2025-02-16 03:57:00,9
16934,ORD_16935,5212,Clogrel-A Capsule SR,Warehouse A,42,24,2025-02-16 12:06:00,18
16935,ORD_16936,10353,Decacole 50mg Injection,Warehouse A,70,52,2025-02-16 15:50:00,18
16936,ORD_16937,6072,Walformin OD 30 Tablet ER,Warehouse B,105,87,2025-02-16 22:43:00,18
16937,ORD_16938,34324,Zucox 90mg Tablet,Warehouse B,20,5,2025-02-16 16:05:00,15
16938,ORD_16939,28395,Ccbest T 20mg/40mg Tablet,Warehouse B,78,62,2025-02-16 12:45:00,16
16939,ORD_16940,21458,Noni Fruit Powder - Supports Healthy Cellular Tissue Growth,Warehouse A,78,72,2025-02-16 19:12:00,6
16940,ORD_16941,22611,Glimmer Premium Nail Enamel Vintage Pink 10 ml,Warehouse C,82,65,2025-02-16 17:13:00,17
16941,ORD_16942,8267,LOHAYA Television Remote Compatible with Samsung Smart LED/LCD/HD TV Remote Control [ Compatible for All Samsung Tv Remote...,Warehouse B,79,72,2025-02-16 06:01:00,7
16942,ORD_16943,22398,Pierre Cardin Paris - Studio Nails 41,Warehouse B,98,92,2025-02-16 20:49:00,6
16943,ORD_16944,14950,Parker Vector Standard Blue Fountain Pen Chrome Trim Fine Nib with 3 Free Ink Cart (Ink - Blue),Warehouse C,34,29,2025-02-16 13:37:00,5
16944,ORD_16945,28376,Gold-Issme Set - Eau De Parfum + Deodorant,Warehouse A,101,88,2025-02-16 06:44:00,13
16945,ORD_16946,30721,Godrej Security Solutions EVE PRO panTilt Smart WiFi Security Camera for Home with 350 Degree 3MP (HD) | 2-Way Audio | Nig...,Warehouse A,46,39,2025-02-16 09:12:00,7
16946,ORD_16947,22556,"Camel Fabrica Acrylic Metallic Color - 10ml Each, 4 Shades",Warehouse A,23,6,2025-02-16 00:05:00,17
16947,ORD_16948,31572,AND Mystique Elegance Eau De Parfum 100ML & Dainty Glam Body Mist 200ML Pack of 2 for Women Crafted by Ajmal,Warehouse C,59,42,2025-02-16 18:04:00,17
16948,ORD_16949,8783,Flormar Waterproof Lipliner 203 Subdued Pink 1.14 gm,Warehouse C,59,44,2025-02-16 16:15:00,15
16949,ORD_16950,35586,House of Aroma Joy Fragrance Oil 100 ml,Warehouse C,36,21,2025-02-16 01:40:00,15
16950,ORD_16951,1436,DR HONEY Glitter shimmer eye liner Silver (Pack of 1) (SILVER),Warehouse B,42,32,2025-02-16 12:00:00,10
16951,ORD_16952,22432,TheGiftKart Best Camera Protection Back Cover Case for Google Pixel 7 | Ultra Clear Soft Case | Inbuilt Dust Plugs & Anti-...,Warehouse C,46,41,2025-02-16 23:51:00,5
16952,ORD_16953,5780,Spigen Rugged Thermoplastic Polyurethane Armor Cover Case Compatible for Headphones Airpods Pro (2019) - Matte Black,Warehouse A,107,90,2025-02-16 12:41:00,17
16953,ORD_16954,2271,"Shower Sponge - Purple & White, Colour May Vary",Warehouse A,91,76,2025-02-16 06:15:00,15
16954,ORD_16955,4853,"Camel Acrylic Color Box - 20ml Tubes, 12 Shades",Warehouse B,112,99,2025-02-16 05:40:00,13
16955,ORD_16956,34330,Ajmal Nightingale And Magnetize For Men & Women And Avid Deodorants Pack of 3 200 ml,Warehouse C,106,90,2025-02-16 14:49:00,16
16956,ORD_16957,22327,"Stylus Pen, Pencil for Apple iPad with Palm Rejection, Power Display, Tilt Sensitivity, Magnetic Adsorption for 2018-2022 ...",Warehouse A,56,37,2025-02-16 01:57:00,19
16957,ORD_16958,3052,Volga-Trio 1/0.2 Tablet SR,Warehouse C,104,89,2025-02-16 00:17:00,15
16958,ORD_16959,6063,"Fashion Colour 2 - In - 1 Face Powder, Shade 03 20 gm",Warehouse B,30,16,2025-02-16 22:23:00,14
16959,ORD_16960,6065,Canon PG-745XL Ink Cartridge (Black),Warehouse A,60,53,2025-02-16 02:03:00,7
16960,ORD_16961,18630,"Dell S2721HNM-Grey 27"" FHD 1920 x 1080 @75 Hz |Minimalistic Design | IPS Panel |Brightness: 300 cd/m²|Colour Gamut: 99% sR...",Warehouse B,29,17,2025-02-16 02:12:00,12
16961,ORD_16962,21484,Neemraj Oil,Warehouse B,16,10,2025-02-16 16:30:00,6
16962,ORD_16963,22292,Vaadi Herbals Bamboo Age Defying Moisturiser - With Grapeseed Extract 60 ml,Warehouse A,64,54,2025-02-16 18:34:00,10
16963,ORD_16964,35207,Etorvas AP 10mg/75mg Capsule,Warehouse C,83,72,2025-02-16 16:45:00,11
16964,ORD_16965,34336,Belkin Essential Series 6-Socket Surge Protector Universal Socket with 6.5ft Heavy Duty Cable (Grey),Warehouse B,62,57,2025-02-16 20:31:00,5
16965,ORD_16966,10327,Ketofly 200mg Tablet,Warehouse A,64,47,2025-02-16 04:56:00,17
16966,ORD_16967,12474,"FIT COLOUR Face Makeup Combo 12 Makeup Brush Set of eye shadow,linear,kajal,mascara,mascara,eye lashes,lipstick,nail paint...",Warehouse C,24,14,2025-02-16 00:51:00,10
16967,ORD_16968,30551,Axylox PD 125mg/125mg Tablet,Warehouse A,66,48,2025-02-16 12:22:00,18
16968,ORD_16969,26178,Green Tea Watery Serum,Warehouse B,100,81,2025-02-16 01:43:00,19
16969,ORD_16970,31744,"JGD PRODUCTS USB 2.0 A to 5 pin Mini USB B Cable for External HDDS/Camera/Card Readers, etc (33 CM)",Warehouse B,109,93,2025-02-16 02:04:00,16
16970,ORD_16971,1120,Zm Zayn Myza Vitamin C Day Cream SPF 15 50 gm,Warehouse B,65,54,2025-02-15 06:37:00,11
16971,ORD_16972,19676,"Sukeshcraft Multiple Cheque Book Holder | Holds Upto 8 Cheque Books, with Key Hook, 2 Photo Slots, 1 Pin & Sim Slot, 13 Cr...",Warehouse B,89,82,2025-02-15 04:01:00,7
16972,ORD_16973,27717,Etorpin 90 Tablet,Warehouse A,41,34,2025-02-15 07:07:00,7
16973,ORD_16974,27722,"pTron Pride Indie in-Ear Wired Earphones with Mic, Stereo Sound, 10mm Drivers, Snug-fit Design, Passive Noise Cancellatio...",Warehouse A,31,20,2025-02-15 14:36:00,11
16974,ORD_16975,27750,Hairwell,Warehouse C,16,1,2025-02-15 03:07:00,15
16975,ORD_16976,19619,"ANOO'S Henna, 300g with brush (100gx3) - Green",Warehouse B,81,74,2025-02-15 13:41:00,7
16976,ORD_16977,8631,Age Protect- Anti Ageing Cream,Warehouse C,102,92,2025-02-15 00:14:00,10
16977,ORD_16978,25118,TIZUM External Hard Drive Case for 2.5-Inch Hard Drive (Grey),Warehouse C,55,39,2025-02-15 23:42:00,16
16978,ORD_16979,32643,Etorvak 90mg Tablet,Warehouse B,49,35,2025-02-15 03:24:00,14
16979,ORD_16980,19601,Beardhood Hair Wax Zero Residue - Strong Hold 100 gm,Warehouse A,37,31,2025-02-15 10:20:00,6
16980,ORD_16981,9738,M.G.R.J® Tempered Glass Screen Protector Compatible for Samsung Galaxy Tab S6 Lite / S6 Lite (2022) (S Pen Compatible) (S...,Warehouse A,89,84,2025-02-15 16:51:00,5
16981,ORD_16982,27759,Supam AQ 75mg Injection,Warehouse A,30,12,2025-02-15 12:39:00,18
16982,ORD_16983,19590,Urban Bazaar Kay Ayurveda Aloe Vera Gel with Organic Glycerin Multi-purpose Aloe Vera Gel for Face and Hair For All Skin &...,Warehouse B,58,52,2025-02-15 05:50:00,6
16983,ORD_16984,32985,Men - Pollution Out Activated Charcoal Deep Clean Face Wash,Warehouse A,44,30,2025-02-15 03:57:00,14
16984,ORD_16985,34520,"STRIFF Foldable Portable Laptop/Tablet Tabletop Stand with 6 Level Height & Angle Adjustment & Air Ventilation, Anti-Slip ...",Warehouse B,41,33,2025-02-15 05:57:00,8
16985,ORD_16986,27688,Wyncoril LS Syrup,Warehouse B,72,60,2025-02-15 10:45:00,12
16986,ORD_16987,7942,TheGiftKart Back Cover Case for Samsung Galaxy M51 (Shockproof | Hybrid TPU & PC | Transparent | Black Bumper),Warehouse A,82,68,2025-02-15 05:31:00,14
16987,ORD_16988,19721,Mahazin M Oral Suspension,Warehouse B,118,99,2025-02-15 16:47:00,19
16988,ORD_16989,26603,Agaplene-C Gel,Warehouse A,24,12,2025-02-15 21:38:00,12
16989,ORD_16990,5257,Sunfold 60K Softgel Capsule,Warehouse B,12,2,2025-02-15 17:59:00,10
16990,ORD_16991,8667,Aalayam Selveer Homemade Herbal Shikakai Powder 200 Grams,Warehouse C,51,37,2025-02-15 21:23:00,14
16991,ORD_16992,5824,Minimalist Alpha Arbutin Face Serum 30 ml,Warehouse A,108,89,2025-02-15 20:59:00,19
16992,ORD_16993,26611,Lenphor Timeless Eye Liner Babe'S Black 02 1.2 Gm,Warehouse A,40,34,2025-02-15 12:16:00,6
16993,ORD_16994,5269,"ESR Cyber Polymer Armor Tough Case with HaloLock for Headphones Compatible with AirPods Pro (2022/2019), MagSafe Ready, Po...",Warehouse C,50,40,2025-02-15 02:50:00,10
16994,ORD_16995,2516,Sivanna Colors Duo Blusher - HF387 01 08 gm,Warehouse C,88,75,2025-02-15 14:37:00,13
16995,ORD_16996,25638,Mirabelle Korea Carrot Fairness Facial Sheet Mask 25 Ml,Warehouse B,37,21,2025-02-15 11:32:00,16
16996,ORD_16997,33302,Meprol 4 Tablet,Warehouse C,49,38,2025-02-15 17:29:00,11
16997,ORD_16998,25162,Clonarest 0.25mg Tablet,Warehouse C,54,49,2025-02-15 01:27:00,5
16998,ORD_16999,1513,COLORflow Samsung M30S / M21 Back Cover | Beautiful Green Marble | Designer Printed Hard CASE Bumper Back Cover for Samsun...,Warehouse C,77,61,2025-02-15 10:34:00,16
16999,ORD_17000,8699,"Aloe Vera Lotion - Moisturizing Body Lotion, For All Skin Types",Warehouse C,57,50,2025-02-15 00:59:00,7
17000,ORD_17001,19568,Evoke - Perfume Mist For Women,Warehouse B,35,28,2025-02-15 20:34:00,7
17001,ORD_17002,21499,Zoxin S 1000 mg/500 mg Injection,Warehouse A,20,4,2025-02-15 21:59:00,16
17002,ORD_17003,24075,Neodine Tablet,Warehouse C,50,31,2025-02-15 17:43:00,19
17003,ORD_17004,21546,Divine Lotus Lotion,Warehouse C,87,80,2025-02-15 05:16:00,7
17004,ORD_17005,27604,Extreme Eau De Toilette,Warehouse B,25,17,2025-02-15 07:56:00,8
17005,ORD_17006,8694,Fujifilm Instax Mini 9 Instant Camera (Ice Blue) Gift Box with 10 Shots,Warehouse A,37,31,2025-02-15 18:41:00,6
17006,ORD_17007,21530,Levoride 50mg Tablet,Warehouse C,37,29,2025-02-15 23:03:00,8
17007,ORD_17008,32969,M19 Wireless Earbuds TWS 5.1 Large Screen Dual LED Digital Display Touch Bluetooth Headphones Mini Compact Portable Sports...,Warehouse A,91,72,2025-02-15 11:37:00,19
17008,ORD_17009,32968,Escirise 10mg Tablet,Warehouse A,112,99,2025-02-15 05:44:00,13
17009,ORD_17010,27570,The Face Shop Smile Foot Peeling Mask (Pack Of 2 X 20 Ml),Warehouse A,53,37,2025-02-15 09:53:00,16
17010,ORD_17011,21509,Bio Honey Gel Foaming Face Wash,Warehouse C,89,76,2025-02-15 18:24:00,13
17011,ORD_17012,1105,Roll on Glass Deodorant - Oceans For Men,Warehouse C,97,91,2025-02-15 19:15:00,6
17012,ORD_17013,27550,"Samsung Galaxy S22 5G (Green, 8GB, 128GB Storage) with No Cost EMI/Additional Exchange Offers",Warehouse C,64,48,2025-02-15 23:43:00,16
17013,ORD_17014,21504,Axiclav 1000mg/200mg Injection,Warehouse C,83,74,2025-02-15 14:40:00,9
17014,ORD_17015,32998,"AirCase C41- Earphone Case Pouch & Travel Organizer for Earphone, Pen Drives, Memory Card, Data Cable (Red Zip)",Warehouse A,108,89,2025-02-15 13:37:00,19
17015,ORD_17016,19894,"Dell MS116 1000Dpi USB Wired Optical Mouse, Led Tracking, Scrolling Wheel, Plug and Play.",Warehouse B,118,99,2025-02-15 00:50:00,19
17016,ORD_17017,34582,AmazonBasics 6-Sheet Cross Cut Paper and Credit Card Shredder,Warehouse A,88,71,2025-02-15 22:59:00,17
17017,ORD_17018,5797,Vermor 10mg Tablet,Warehouse C,109,97,2025-02-15 11:24:00,12
17018,ORD_17019,2493,Medicep 100mg Tablet DT,Warehouse A,69,58,2025-02-15 03:23:00,11
17019,ORD_17020,21473,"GOVO GOKIXX 652 Bluetooth Neckband, 60 Hours Battery, ENC Technology, Fast Charge, Magnetic Buds, Gaming Mode, 10mm Driver...",Warehouse A,50,34,2025-02-15 07:03:00,16
17020,ORD_17021,9587,"MOCA 9 to 11 Inch Tablet Sleeve Bag Carrying Case Fits iPad air 5 10.9"" 2022, iPad Pro 11 2021-2018, iPad 9/8/7th Gen 10....",Warehouse A,32,15,2025-02-15 03:25:00,17
17021,ORD_17022,5341,Neugabid Plus 1500 mcg/75 mg Tablet,Warehouse B,41,27,2025-02-15 03:02:00,14
17022,ORD_17023,1467,5Pcs 3R Permanent Makeup Tattoo Cartridge Needles 1R/1P/1R for Tattoo Eyebrow Eyeliner Lip Microblading Shading(8mm Diameter),Warehouse A,91,82,2025-02-15 21:33:00,9
17023,ORD_17024,35106,Pikkme Redmi 9 Prime/Poco M2 Flip Cover Case | Leather flip Back Covers Cases for Redmi 9 Prime/Poco M2 (Blue),Warehouse A,77,71,2025-02-15 01:37:00,6
17024,ORD_17025,8743,Rozfirst 10 Tablet,Warehouse C,68,61,2025-02-15 21:53:00,7
17025,ORD_17026,8680,I AM EYECONIC FINE GLITTER CHERRY ON THE TOP 4 gm,Warehouse B,64,55,2025-02-15 07:30:00,9
17026,ORD_17027,19775,Bifocan Cream,Warehouse A,51,46,2025-02-15 17:16:00,5
17027,ORD_17028,16567,"JumpStart Electro-Plating Case Compatible iPhone XR, Gold Color Plating Transparent Clear Flexible Soft TPU Silicone Prote...",Warehouse B,34,22,2025-02-15 09:49:00,12
17028,ORD_17029,16978,"ANGELIE 5 PAIR EYELASH, EYELASH GLUE, EYELASH CURLER WITH 24 HRS EYELINER",Warehouse B,90,80,2025-02-15 03:42:00,10
17029,ORD_17030,24040,Dextum 125mg Dry Syrup,Warehouse A,86,68,2025-02-15 04:49:00,18
17030,ORD_17031,24127,"realme Pad X WiFi+5G Tablet | 6GB RAM 128GB ROM (Expandable), 27.9cm (11 inch) WUXGA+ Display | 6nm SD Processor | Dolby A...",Warehouse A,18,4,2025-02-15 07:22:00,14
17031,ORD_17032,29620,Fitbit Versa 4 Fitness Watch (Waterfall Blue/Platinum Aluminium) with 6-Month Premium Membership,Warehouse A,25,19,2025-02-15 23:34:00,6
17032,ORD_17033,7229,Febulin 40mg Tablet,Warehouse B,36,30,2025-02-15 21:42:00,6
17033,ORD_17034,33770,AmazonBasics 15W Qi-Certified Fast Wireless Charging Circular Pad | Compatible with iPhone 13/13 Pro/13 Mini/13 ProMax/12/...,Warehouse C,64,52,2025-02-15 15:08:00,12
17034,ORD_17035,7221,"Neutrogena Gentle Oil-Free Eye Makeup Remover & Cleanser for Sensitive Eyes, Non-Greasy Makeup Remover, Removes Waterproof...",Warehouse C,28,16,2025-02-15 13:48:00,12
17035,ORD_17036,11610,Hot Sip - Ayurveda Khada,Warehouse C,75,65,2025-02-15 11:12:00,10
17036,ORD_17037,16484,DIGITEK® LED D416 Professional Video Light & NP-750 Li-ion Battery with Micro USB Charging | Dimmable 3200k -5600k | Compa...,Warehouse B,94,77,2025-02-15 03:39:00,17
17037,ORD_17038,16417,"Adult Pull Ups - Active Normal Breathable, Small",Warehouse B,102,83,2025-02-15 18:45:00,19
17038,ORD_17039,33764,House Of Makeup Pout Potion Liquid Matte Lipstick - Keeper ,Warehouse A,53,39,2025-02-15 02:41:00,14
17039,ORD_17040,11630,Inflam MR Tablet,Warehouse A,55,41,2025-02-15 09:37:00,14
17040,ORD_17041,24134,Oboe Silicone TV Remote Cover for 2022 Samsung Smart TV Remote QLED TV BN68-13897A TM2280E Anti-Lost with Remote Loop (Black),Warehouse C,80,64,2025-02-15 21:35:00,16
17041,ORD_17042,24159,Candicom 100 Capsule,Warehouse B,35,18,2025-02-15 01:47:00,17
17042,ORD_17043,536,"Chambor Smooth On Eyeliner, Blue No.102 3.5 ml",Warehouse C,92,73,2025-02-15 19:24:00,19
17043,ORD_17044,32051,Nourishing Papaya Body Lotion,Warehouse C,24,16,2025-02-15 18:19:00,8
17044,ORD_17045,7234,"ORUM Smart Multipurpose Foldable Laptop Table with Cup Holder, Study Table, Bed Table, Breakfast Table, Foldable and Porta...",Warehouse B,66,58,2025-02-15 09:06:00,8
17045,ORD_17046,16535,Urolusin 0.4mg Tablet,Warehouse B,57,49,2025-02-15 22:58:00,8
17046,ORD_17047,29606,Losavib H Tablet,Warehouse C,83,76,2025-02-15 14:32:00,7
17047,ORD_17048,6663,Toothbrush Fighter - Soft,Warehouse B,96,84,2025-02-15 22:19:00,12
17048,ORD_17049,2092,Sucrox Syrup,Warehouse A,109,93,2025-02-15 11:48:00,16
17049,ORD_17050,11454,"JBL Wave 200 True Wireless In Ear Earbuds with Mic, 20 Hours Playtime, Deep Bass Sound, Dual Connect Technology, Quick Cha...",Warehouse C,78,67,2025-02-15 12:22:00,11
17050,ORD_17051,11453,Flormar Perfect Coverage Liquid Concealer 003 Light Beige 5 ml,Warehouse A,28,16,2025-02-15 14:37:00,12
17051,ORD_17052,11344,Cypdot Syrup,Warehouse C,105,97,2025-02-15 19:48:00,8
17052,ORD_17053,6563,"boAt Rockerz 550 Bluetooth Wireless Over Ear Headphones with Upto 20 Hours Playback, 50MM Drivers, Soft Padded Ear Cushion...",Warehouse B,38,31,2025-02-15 16:23:00,7
17053,ORD_17054,11340,Bio Bhringraj Therapeutic Oil,Warehouse C,65,59,2025-02-15 08:16:00,6
17054,ORD_17055,23824,Ricxone 1000mg Injection,Warehouse A,29,23,2025-02-15 15:56:00,6
17055,ORD_17056,25290,Calcigard 5 Capsule,Warehouse B,70,62,2025-02-15 23:42:00,8
17056,ORD_17057,16981,Fastorik Suspension,Warehouse C,81,75,2025-02-15 19:43:00,6
17057,ORD_17058,7401,Rejumet 1000 Tablet SR,Warehouse B,82,63,2025-02-15 10:21:00,19
17058,ORD_17059,1138,"Fashion Colour Soft Lip Mousse, 1 Blink Pink 8 gm",Warehouse C,28,18,2025-02-15 17:06:00,10
17059,ORD_17060,17015,Avokast M Syrup,Warehouse A,70,55,2025-02-15 11:43:00,15
17060,ORD_17061,1922,SERY Mattish Lipstick Dark Caramel 3.5 gm,Warehouse C,100,84,2025-02-15 14:30:00,16
17061,ORD_17062,553,Hauser 4 in 1 Retractable Ball Pen Box Pack | Durable Transparent Body | 4 Ink Colors In One Pen | Low Viscosity Ink Syste...,Warehouse C,84,71,2025-02-15 09:48:00,13
17062,ORD_17063,2085,Lomin 400mg Tablet,Warehouse A,13,6,2025-02-15 10:42:00,7
17063,ORD_17064,16700,TheGiftKart Transparent Crystal Clear Back Cover Case for Samsung Galaxy M31s | Shockproof Soft TPU Case | Cushioned Edges...,Warehouse C,81,64,2025-02-15 15:56:00,17
17064,ORD_17065,25182,Digitek (DTR 480LW) (57 Inch) Portable Lightweight Aluminum Tripod for DSLR Cameras & Smartphones with Operating Ht. 4.75 ...,Warehouse B,104,87,2025-02-15 23:12:00,17
17065,ORD_17066,7297,LOHAYA Universal AC Remote Compatible with LG AC Remote Control Model No :- AKB72955306 [ Compatible for LG Split AC Remot...,Warehouse C,51,45,2025-02-15 08:34:00,6
17066,ORD_17067,7295,"Fashion Colour Cc Cream, Shade 02 35 gm",Warehouse B,103,90,2025-02-15 07:59:00,13
17067,ORD_17068,11524,Jovees Revitalising Night Cream - Avocado with Cereal Protein 50 gm,Warehouse B,55,45,2025-02-15 07:24:00,10
17068,ORD_17069,574,XP-PEN Tablet Glove XP-PEN Two-Finger Glove for Drawing Pen Display Writing Tablet Graphics Pad Painting Monitor (One Siz...,Warehouse C,61,45,2025-02-15 00:58:00,16
17069,ORD_17070,36222,Nair Legs & Body Hair Remover Delicate Cream 110 gm,Warehouse C,18,8,2025-02-15 03:43:00,10
17070,ORD_17071,16652,Indocef 250mg Injection,Warehouse A,21,13,2025-02-15 08:52:00,8
17071,ORD_17072,16650,Genxlof-OZ Tablet,Warehouse A,14,8,2025-02-15 21:06:00,6
17072,ORD_17073,25153,"Storite Professional 2 in 1 Screen Cleaning Kit for Laptops, Camera, Lens, TV, Monitor, Smartphone, Tablet (Includes: Clea...",Warehouse C,92,79,2025-02-15 18:10:00,13
17073,ORD_17074,11552,IGORA Royal Natural Extra Light Brown 5-00,Warehouse A,44,27,2025-02-15 21:44:00,17
17074,ORD_17075,16619,Face Gel - Bio Honey,Warehouse C,32,25,2025-02-15 06:14:00,7
17075,ORD_17076,11501,Fashionury Back Case Cover for Samsung Galaxy S21 FE 5G | Crystal Clear Hard Back | Shockproof Design | Camera Protection...,Warehouse B,75,58,2025-02-15 16:28:00,17
17076,ORD_17077,7313,Bglone 25 Injection,Warehouse B,76,58,2025-02-15 17:37:00,18
17077,ORD_17078,32098,Legend Deodorant,Warehouse C,96,87,2025-02-15 02:40:00,9
17078,ORD_17079,29509,Montlevo-D Tablet,Warehouse B,61,53,2025-02-15 04:03:00,8
17079,ORD_17080,6602,Anvip 20mg Tablet,Warehouse B,83,72,2025-02-15 09:56:00,11
17080,ORD_17081,36109,Crucial BX500 240GB 3D NAND SATA 6.35 cm (2.5-inch) SSD (CT240BX500SSD1),Warehouse A,115,97,2025-02-15 02:30:00,18
17081,ORD_17082,23935,"HUDA BB Makeup Combo Set Of 11 Infallible Primer,Matte Me Foundation,Fixer,Loose Face Powder,Eyeliner,Mascara,Eyebrow Penc...",Warehouse A,84,72,2025-02-15 23:29:00,12
17082,ORD_17083,16755,"Maybelline New York Super Stay Crayon Lipstick, 15 Lead the way 1.2 gm",Warehouse B,85,74,2025-02-15 22:27:00,11
17083,ORD_17084,11582,Confect 50mg Oral Suspension,Warehouse B,98,91,2025-02-15 11:37:00,7
17084,ORD_17085,29597,mCaffeine Be Date Ready Body Polishing Gift Kit 350 gm,Warehouse B,64,55,2025-02-15 11:54:00,9
17085,ORD_17086,32068,Ajmal CD 99 Mukhallat Concentrated Perfume Oil Floral Oriental Attar And Aura Concentrated Perfume Oil Floral Fruity Attar 24 ml,Warehouse C,74,60,2025-02-15 01:58:00,14
17086,ORD_17087,24089,Oroxib 120mg Tablet,Warehouse B,85,71,2025-02-15 06:35:00,14
17087,ORD_17088,11687,Manish Malhotra Face And Body Highlighter - Blaze 15 Ml,Warehouse A,26,12,2025-02-15 11:29:00,14
17088,ORD_17089,16382,Deep Action Eucalyptus Mint Anti Germ Gel Toothpaste,Warehouse A,64,56,2025-02-15 07:07:00,8
17089,ORD_17090,4163,Best Served Chilled All Time Favourite Kit,Warehouse B,93,75,2025-02-15 18:44:00,18
17090,ORD_17091,2856,Aptital Syrup Sugar Free,Warehouse A,80,64,2025-02-15 04:10:00,16
17091,ORD_17092,1925,"Kubra KB-1088 Hair and Beard Trimmer with USB Charging, 40 Length Setting, 45 minutes Cordless use, 1 Year Warranty (Black)",Warehouse A,31,21,2025-02-15 22:08:00,10
17092,ORD_17093,2351,"Garnier Fructis, Repairing Hair Mask For Damaged Hair, Repairing & Nourishing, Papaya Hair Food, 390 ml",Warehouse C,97,78,2025-02-15 19:57:00,19
17093,ORD_17094,20933,Tolgress 4mg Capsule,Warehouse A,51,33,2025-02-15 08:00:00,18
17094,ORD_17095,5488,Kidney-9 Ras,Warehouse A,13,3,2025-02-15 06:16:00,10
17095,ORD_17096,20543,"Western Digital WD Green SN350 NVMe 240GB, Upto 2400MB/s, 3 Y Warranty, PCIe Gen 3 NVMe M.2 (2280), Internal Solid State D...",Warehouse C,37,19,2025-02-15 02:48:00,18
17096,ORD_17097,9292,Dove Nourishing Secrets Invigorating Ritual Hand Cream 75ml,Warehouse C,26,13,2025-02-15 16:34:00,13
17097,ORD_17098,32918,Ajmal 2 Persuade And 1 Wisal Dhahab Deodorants Pack of 3 200 ml,Warehouse B,50,43,2025-02-15 13:59:00,7
17098,ORD_17099,20454,Xtrex 25mg Tablet,Warehouse C,82,77,2025-02-15 04:03:00,5
17099,ORD_17100,8908,Oflon 200mg Tablet,Warehouse A,106,88,2025-02-15 00:17:00,18
17100,ORD_17101,20426,VMS Deluxe 70x100mm 125 Micron Lamination Pouch 2 x 100 Sheets,Warehouse A,62,50,2025-02-15 04:45:00,12
17101,ORD_17102,9317,Nicka K NINE COLOR Eyeshadow PALETTE - AUTUMN SPICE 11.7 gm,Warehouse A,21,6,2025-02-15 06:27:00,15
17102,ORD_17103,21175,Dr.Sheth's Spot Clarifying Face Serum - Neem & BHA 30 ml,Warehouse C,31,15,2025-02-15 10:53:00,16
17103,ORD_17104,9326,Somedoc 40mg Injection,Warehouse A,99,81,2025-02-15 00:30:00,18
17104,ORD_17105,21156,Sumitrex 100mg Tablet,Warehouse C,29,17,2025-02-15 08:13:00,12
17105,ORD_17106,34953,Chunziya Beauty Blender Stand with Makeup Sponges - Sets Of 2,Warehouse A,109,97,2025-02-15 07:29:00,12
17106,ORD_17107,8897,Bariderm F Cream,Warehouse A,81,76,2025-02-15 02:40:00,5
17107,ORD_17108,5722,Ajmal Aurum & Wisal & Wisal Dhahab & Sacred Love Deo & Neea EDP Pack of 5 20 ml,Warehouse A,19,6,2025-02-15 11:19:00,13
17108,ORD_17109,1244,Tata Sky Universal Remote,Warehouse A,25,6,2025-02-15 00:44:00,19
17109,ORD_17110,5702,Sanitary Pads - Maxi Nights XL Wings,Warehouse A,111,94,2025-02-15 00:15:00,17
17110,ORD_17111,21099,Metomac 25 Tablet ER,Warehouse A,90,75,2025-02-15 00:07:00,15
17111,ORD_17112,21097,PIXELARTZ Laptop Skin Day Dreaming Abstract Graffiti HD Quality 15.6 Inches Multi Colour (9083),Warehouse A,46,30,2025-02-15 10:01:00,16
17112,ORD_17113,34721,HMGstat-R 10 Tablet,Warehouse B,64,51,2025-02-15 16:47:00,13
17113,ORD_17114,9273,Asmygaba-M Tablet,Warehouse C,50,32,2025-02-15 22:52:00,18
17114,ORD_17115,21073,Rimyflam Tablet,Warehouse A,86,73,2025-02-15 14:29:00,13
17115,ORD_17116,5514,Zubidox 10mg Injection,Warehouse C,85,71,2025-02-15 04:01:00,14
17116,ORD_17117,20522,Minocort Tablet,Warehouse B,55,37,2025-02-15 12:29:00,18
17117,ORD_17118,5515,Biosoft White Chocolate Premium Titanium Hd Wax 350 S gm,Warehouse C,40,23,2025-02-15 13:23:00,17
17118,ORD_17119,21068,Yves Rocher Sensual Body Lotion Bourbon Vanilla 390 ml,Warehouse C,39,25,2025-02-15 12:48:00,14
17119,ORD_17120,34908,Waterproof Concealer Matte Full Coverage pro Concealer Oil Free & Lightweight. highly pigmented Pack Of 3 with Highlighter...,Warehouse B,69,52,2025-02-15 02:31:00,17
17120,ORD_17121,32818,Jolevo 500mg Tablet,Warehouse C,84,77,2025-02-15 16:40:00,7
17121,ORD_17122,27504,Lakme 9 To 5 Weightless Mousse Lip & Cheek Color Pink Plush 9 Gm,Warehouse B,92,82,2025-02-15 08:38:00,10
17122,ORD_17123,35096,"uhuru Gaming Mouse RGB Wired for Laptop - USB Optical Mouse with High Precision Sensor, 5 Adjustable 4800 DPI, 6 Programma...",Warehouse B,27,15,2025-02-15 17:52:00,12
17123,ORD_17124,9559,Ajmal Jannatul Firdaus Concentrated Perfume Oil Oriental Attar And Asher Concentrated Perfume Oil Oriental Attar 22 ml,Warehouse A,105,93,2025-02-15 22:53:00,12
17124,ORD_17125,34960,D Mox LB 250mg/250mg Capsule,Warehouse B,118,99,2025-02-15 19:51:00,19
17125,ORD_17126,34705,Bacantus D Syrup,Warehouse A,36,20,2025-02-15 14:35:00,16
17126,ORD_17127,34563,"URBN 10000 mAh 20W Super Fast Charging Ultra Compact Nano Lithium_ion Power Bank with Quick Charge & Power Delivery, Type ...",Warehouse B,79,64,2025-02-15 08:17:00,15
17127,ORD_17128,20683,Fillace TH 100mg/4mg Tablet,Warehouse A,86,76,2025-02-15 00:16:00,10
17128,ORD_17129,5638,Memocetam 800mg Tablet,Warehouse C,90,83,2025-02-15 09:23:00,7
17129,ORD_17130,32841,Predmet 16 Tablet,Warehouse C,31,14,2025-02-15 11:57:00,17
17130,ORD_17131,9176,Mayonil 5mg Tablet,Warehouse A,65,60,2025-02-15 09:34:00,5
17131,ORD_17132,5550,OpenTech® Tempered Glass Screen Protector Compatible for iPhone 7 Plus / 8 Plus Edge to Edge Coverage with Easy Installati...,Warehouse A,8,1,2025-02-15 05:05:00,7
17132,ORD_17133,34879,Hair Spa For Dandruff Free Hair,Warehouse A,51,39,2025-02-15 19:16:00,12
17133,ORD_17134,27277,KUSH Square Empty Makeup Eyeshadow Palette Blush Lipgloss Powder DIY Case 12 Grid,Warehouse B,36,27,2025-02-15 08:00:00,9
17134,ORD_17135,20614,Color Protection & Radiance Conditioner - For Color-Treated Hair,Warehouse B,66,57,2025-02-15 18:49:00,9
17135,ORD_17136,32833,Car Air Freshener 2 in 1 - Ocean Spray,Warehouse C,35,22,2025-02-15 00:36:00,13
17136,ORD_17137,20970,"SKY BUYER Bluetooth Calling Smart Touchscreen Smart Watch Bluetooth 1.3 HD Screen with Daily Activity Tracker, Heart Rate ...",Warehouse B,71,55,2025-02-15 23:43:00,16
17137,ORD_17138,32830,"(Renewed) realme narzo 50i (Mint Green, 2GB RAM+32GB Storage) - 6.5"" inch Large Display | 5000mAh Battery Without Offers",Warehouse B,99,80,2025-02-15 23:37:00,19
17138,ORD_17139,2116,Fibagin 150mg Tablet,Warehouse B,86,78,2025-02-15 21:07:00,8
17139,ORD_17140,2399,"GIZGA 2.5"" Hard Drive Case Self Tattoo Hard Shell (Black)",Warehouse C,54,36,2025-02-15 15:35:00,18
17140,ORD_17141,2418,Rupali Hd pro Conceal (3pcs) Concealer (8g Each) DermaColor Foundation Palette 12 Color (set of 4),Warehouse A,96,83,2025-02-15 20:55:00,13
17141,ORD_17142,32851,Ajmal Senora EDP Floral Spicy Perfume 75ml for Women and Wisal EDP Floral Musky Perfume 50ml for Women +1 Perfume Tester FREE,Warehouse C,68,49,2025-02-15 06:27:00,19
17142,ORD_17143,20698,Intensely Rich Kajal Rich Kajal Irk001 0.30 Gm,Warehouse A,55,50,2025-02-15 15:06:00,5
17143,ORD_17144,20882,Wilclox Capsule,Warehouse B,88,73,2025-02-15 23:07:00,15
17144,ORD_17145,20700,Anti-Wrinkle Face Sheet Mask,Warehouse B,62,47,2025-02-15 05:52:00,15
17145,ORD_17146,1312,Roarx Nothing Phone 1 Fast Charger Adapter 20W (Affordable) Original 45 watt Alternate (Max 20 watt) | 1.5% Charge in 1 Mi...,Warehouse C,95,88,2025-02-15 02:00:00,7
17146,ORD_17147,20870,Etifit T 60mg/4mg Tablet,Warehouse C,79,62,2025-02-15 08:41:00,17
17147,ORD_17148,9108,"SanDisk Ultra Dual Drive Go 256GB USB Type C Pendrive for Mobile (5Y - SDDDC3-256G-I35, Black)",Warehouse A,39,28,2025-02-15 05:36:00,11
17148,ORD_17149,34804,Mumbai Tattoo Tattoo Needle Cartridge 7RS Black Box ( Pack Of 20 ),Warehouse A,22,6,2025-02-15 12:15:00,16
17149,ORD_17150,27028,Chipodox 200mg Tablet,Warehouse C,71,63,2025-02-15 12:46:00,8
17150,ORD_17151,20782,"KB BB Cream Foundation of Green Tea Moisture, Shade-02 | 30g Each (Pk of 02), 60g",Warehouse B,81,67,2025-02-15 08:55:00,14
17151,ORD_17152,5599,Spartech 200mg Tablet,Warehouse B,68,63,2025-02-15 16:55:00,5
17152,ORD_17153,9097,Epm 5mg Tablet,Warehouse C,36,29,2025-02-15 03:10:00,7
17153,ORD_17154,34900,Cepmox Capsule,Warehouse C,85,66,2025-02-15 12:00:00,19
17154,ORD_17155,21041,PV 750mcg/75mg Capsule,Warehouse B,48,37,2025-02-15 14:57:00,11
17155,ORD_17156,1528,Norace P 100mg/325mg Tablet,Warehouse B,46,41,2025-02-15 15:23:00,5
17156,ORD_17157,33022,Kcid O Oral Suspension,Warehouse A,87,81,2025-02-15 06:13:00,6
17157,ORD_17158,34483,CEDO Lenovo Tab M10 / M10 HD 10.1 inch TB-X505X Flip Cover | Leather Finish | 360 Degree Rotate Flip Cover | Shockproof St...,Warehouse B,30,18,2025-02-15 15:01:00,12
17158,ORD_17159,27993,Allure Pencil Brush - (230s) 1's,Warehouse C,94,83,2025-02-15 16:26:00,11
17159,ORD_17160,32582,"VEMIGON Hard PC Case Compatible for Apple Watch Series 8 and 7 45mm with Tempered Glass Screen Protector, Full Coverage, T...",Warehouse A,95,86,2025-02-15 01:20:00,9
17160,ORD_17161,5118,"AmazonBasics USB C to Lightning Aluminum with Nylon Braided MFi Certified Charging Cable (Grey, 1.2 meter)",Warehouse A,108,93,2025-02-15 04:02:00,15
17161,ORD_17162,9916,"Samsung Galaxy F23 5G (Forest Green, 6GB, 128GB Storage) | Travel Adapter to be Purchased Separately",Warehouse C,92,74,2025-02-15 02:53:00,18
17162,ORD_17163,21830,Yogamet-GMP 2 Tablet,Warehouse B,85,74,2025-02-15 18:12:00,11
17163,ORD_17164,35292,Nimfaith-P Tablet,Warehouse A,85,77,2025-02-15 04:59:00,8
17164,ORD_17165,2570,Gemblue Biocare Winter Protection cream 500 ml,Warehouse A,94,78,2025-02-15 03:18:00,16
17165,ORD_17166,19253,Inhaler - Formula 2 With 2 cc,Warehouse C,90,77,2025-02-15 15:23:00,13
17166,ORD_17167,26485,"RETSOL LS 450 Laser Barcode Scanner BIS Approved, Handheld 1 D USB Wired Barcode Reader Optical Laser High Speed for POS S...",Warehouse A,105,89,2025-02-15 14:34:00,16
17167,ORD_17168,26442,"CONA Standy Multiplug 3 in 1 - (White) - Multiplug with Stand, 125 Volt",Warehouse B,72,65,2025-02-15 05:37:00,7
17168,ORD_17169,5925,Oldol 50mg Injection,Warehouse B,35,25,2025-02-15 16:13:00,10
17169,ORD_17170,26437,"Sony MDR-ZX110AP Wired On-Ear Headphones with tangle free cable, 3.5mm Jack, Headset with Mic for phone calls and 1 Year W...",Warehouse C,19,2,2025-02-15 06:25:00,17
17170,ORD_17171,19246,L-Bert 125 Oral Suspension,Warehouse B,87,69,2025-02-15 08:19:00,18
17171,ORD_17172,27998,Chaksu Seed Powder - Regular Seed-water Wash As Collyrium Supports Eye Health,Warehouse C,104,87,2025-02-15 07:01:00,17
17172,ORD_17173,33036,Men - Energy Bright Anti-Dullness Face Wash With Coffee Bean,Warehouse B,96,88,2025-02-15 19:48:00,8
17173,ORD_17174,19299,Antiseptic Liquid 1 L + Laundry Sanitizer- Spring Blossom 480 ml,Warehouse B,69,62,2025-02-15 06:24:00,7
17174,ORD_17175,21822,Faces Canada Ultime Pro Longstay Liquid Matte Lipstick Sultry Rogue 13 6 Ml,Warehouse A,79,61,2025-02-15 02:04:00,18
17175,ORD_17176,27963,"iClever Bluetooth Mouse Multi-Device Silent Mouse, Dual Mode Bluetooth + 2.4G Wireless Mouse, Silent Work, Rechargeable, S...",Warehouse A,72,61,2025-02-15 00:37:00,11
17176,ORD_17177,19319,Kaslocold Plus Tablet,Warehouse A,33,21,2025-02-15 20:22:00,12
17177,ORD_17178,19320,Nimulid Kid 50mg Tablet MD,Warehouse A,82,65,2025-02-15 14:00:00,17
17178,ORD_17179,27962,"(Renewed) realme narzo 50A (Oxygen Blue, 4GB RAM + 128GB Storage)-MediaTek Helio G85 Processor | 50MP Camera Without Offers",Warehouse B,66,48,2025-02-15 07:03:00,18
17179,ORD_17180,1074,"Fast Charger for Xiomi Redmi Note 3, Redmi Note 5 Pro, Redmi Note 5, Mi Note 4 Mobile USB Charger Power Adapter Hi Speed T...",Warehouse A,55,48,2025-02-15 03:12:00,7
17180,ORD_17181,27959,"TAGG Verve NEO Smartwatch 1.69"" HD Display | 60+ Sports Modes | 10 Days Battery | 150+ Maximum Watch Face Library | Waterp...",Warehouse C,101,93,2025-02-15 13:30:00,8
17181,ORD_17182,5098,"Arata Natural Deep Hydration Combo Therapy with Hydrating Shampoo(75 Ml), Body Wash(75 Ml) & Conditioner(75 Ml) 225 ml",Warehouse B,91,79,2025-02-15 15:31:00,12
17182,ORD_17183,5101,Levodus 500mg Tablet,Warehouse C,26,18,2025-02-15 12:02:00,8
17183,ORD_17184,26475,Papaya Fruit Facial Kit - 5 Session,Warehouse C,39,31,2025-02-15 09:36:00,8
17184,ORD_17185,26482,Conaspas Plus 10mg/250mg Tablet,Warehouse B,34,23,2025-02-15 14:14:00,11
17185,ORD_17186,5185,Kufma Syrup,Warehouse B,63,54,2025-02-15 03:22:00,9
17186,ORD_17187,35217,Theocof DX Syrup,Warehouse A,82,73,2025-02-15 22:16:00,9
17187,ORD_17188,5188,Jaquline USA Lipstick Lip Locked 10 (Matte),Warehouse B,71,66,2025-02-15 10:09:00,5
17188,ORD_17189,1482,House of Aroma Violet Fragrance Oil 100 ml,Warehouse A,43,25,2025-02-15 11:12:00,18
17189,ORD_17190,26418,Belora Paris World Matte Vit C Popsicles - 011 Nudie Peach 4.2 gm,Warehouse A,30,12,2025-02-15 00:43:00,18
17190,ORD_17191,9951,"Extension Board with USB Ports, Hoteon 2500W Power Strip with QC3.0 Fasting Charger and 5V/3.1A/15.5W USB Ports, 4 Way Out...",Warehouse A,34,16,2025-02-15 20:23:00,18
17191,ORD_17192,33045,Acidshoonya Ras,Warehouse A,48,41,2025-02-15 21:31:00,7
17192,ORD_17193,27843,"Casecandy ® - Pack 1 – Samsung S23 Ultra Tempered Glass Screen Protector, UV Glass Full Adhesive [Liquid Technology][Finge...",Warehouse A,34,25,2025-02-15 09:24:00,9
17193,ORD_17194,27918,Mongra Saffron,Warehouse B,64,45,2025-02-15 18:47:00,19
17194,ORD_17195,19390,Bacotil 100mg Tablet,Warehouse B,52,44,2025-02-15 17:00:00,8
17195,ORD_17196,26486,GM 3041 Trio 2 Pin Flex Box 5 Mtr. with Indicator & International Socket,Warehouse A,61,55,2025-02-15 16:27:00,6
17196,ORD_17197,27917,Tough Lee Silicone Back Cover for OnePlus Nord 2 5G (Transparent),Warehouse A,22,16,2025-02-15 09:47:00,6
17197,ORD_17198,21776,Intimate Wipes - Pre-play,Warehouse B,118,99,2025-02-15 11:20:00,19
17198,ORD_17199,27895,milk_shake® SOS Roots Dark Brown 75ml,Warehouse B,56,41,2025-02-15 02:32:00,15
17199,ORD_17200,9840,"Organic Harvest Pink Tinted Lip Balm: Lily, Lip Balm for Women, Girls & Kids | Dry & Chapped Lips Care | 100% American Cer...",Warehouse A,97,91,2025-02-15 09:43:00,6
17200,ORD_17201,19426,Promet AM 5mg/50mg Tablet XL,Warehouse A,22,14,2025-02-15 14:58:00,8
17201,ORD_17202,5895,Imifenac AQ 75mg Injection,Warehouse C,89,76,2025-02-15 09:14:00,13
17202,ORD_17203,19445,Fenbest Plus 100 mg/500 mg/15 mg Tablet,Warehouse B,47,28,2025-02-15 16:37:00,19
17203,ORD_17204,35248,Skylon Antiseptic Solution,Warehouse A,98,88,2025-02-15 19:36:00,10
17204,ORD_17205,21790,Vedic Chyawanprash,Warehouse B,33,19,2025-02-15 08:52:00,14
17205,ORD_17206,19454,Sportivo Hair Styling Pomade Wax,Warehouse A,21,9,2025-02-15 19:00:00,12
17206,ORD_17207,5888,Spigen EZ Fit Tempered Glass Screen Protector for iPhone 14/13/13 Pro - 2 Pack (Sensor Protection),Warehouse A,94,77,2025-02-15 06:45:00,17
17207,ORD_17208,5084,"Boya by-MM1 Super-Cardioid Shotgun Microphone with Real Time Monitoring Compatible with iPhone/Android Smartphones, DSLR C...",Warehouse A,70,57,2025-02-15 16:13:00,13
17208,ORD_17209,1518,Esmozole 40mg Tablet,Warehouse A,39,32,2025-02-15 21:22:00,7
17209,ORD_17210,8600,Beauty People Quick Dry Nail Polish 502 Bliss Me 12 ml,Warehouse B,39,20,2025-02-15 13:21:00,19
17210,ORD_17211,26534,"ONUMTZ Newly Launched Smart Watch Charging Cable, Watch Holder Magnetic 24k Gold Plated 2 pin Cable, Compatible with T55, ...",Warehouse B,74,69,2025-02-15 21:58:00,5
17211,ORD_17212,33002,Priometh 2500mcg Injection,Warehouse B,98,87,2025-02-15 08:29:00,11
17212,ORD_17213,19509,Matlek Bluetooth in Ear Earbuds TWS | Deep Bass Earphones | 15 Hours Non Stop with Case Battery Headphones | Low Latency f...,Warehouse A,54,48,2025-02-15 13:18:00,6
17213,ORD_17214,5867,Santoor Handwash Classic 750ml (Pack of 2),Warehouse B,11,4,2025-02-15 08:59:00,7
17214,ORD_17215,9773,Rutodol 90mg/48mg/100mg Tablet,Warehouse A,49,33,2025-02-15 16:06:00,16
17215,ORD_17216,34513,V-Fex Oral Suspension Raspberry & Vanilla,Warehouse A,98,84,2025-02-15 04:41:00,14
17216,ORD_17217,34514,Nvlax 75 SR Tablet,Warehouse A,83,66,2025-02-15 00:08:00,17
17217,ORD_17218,19530,"L.A. COLORS Sweet 16 Color Eyeshadow Palette Shimmery Finish, Brave, 20g (Multicolor)",Warehouse A,92,85,2025-02-15 12:53:00,7
17218,ORD_17219,19370,"AmazonBasics USB Type-C to USB-A 2.0 Male Fast Charging Cable for Laptop - 3 Feet (0.9 Meters), Black",Warehouse B,104,96,2025-02-15 20:57:00,8
17219,ORD_17220,35100,"EDW Essenza Ignite Fleur Luxury Deodorant for Women, 150ml",Warehouse A,110,92,2025-02-15 20:16:00,18
17220,ORD_17221,7475,"Dyazo Height Adjustable, Angle Adjustable, Fully Foldable, Anti-Slip Tabletop Mobile Phone Stand/Holder Compatible for Viv...",Warehouse B,72,65,2025-02-15 06:20:00,7
17221,ORD_17222,36014,Megalax 10gm Syrup,Warehouse C,56,42,2025-02-15 23:12:00,14
17222,ORD_17223,25440,Lafz Kismet No Alcohol Body Spray - For Women 150 ml,Warehouse A,26,8,2025-02-15 19:17:00,18
17223,ORD_17224,6406,EGOTUDE Slim Fit Silicone Soft Logo Cut Matte Back Cover Case for iPhone 14 (Navy Blue),Warehouse B,98,86,2025-02-15 23:05:00,12
17224,ORD_17225,23435,Ulean 25mg Injection,Warehouse A,48,33,2025-02-15 01:08:00,15
17225,ORD_17226,7511,Apple USB-C to USB-C Charge Cable (2m) (No Lightning Connector),Warehouse A,30,13,2025-02-15 19:14:00,17
17226,ORD_17227,11215,Amazon Brand - Solimo Royal Enfield Classic 350 Water Resistant Bike Cover (Silver),Warehouse B,42,37,2025-02-15 05:59:00,5
17227,ORD_17228,17473,"HyperX Cloud Stinger 2 Core Essential PC Gaming Wired Headset, Lightweight Over-Ear Headset with mic, Swivel-to-Mute Funct...",Warehouse C,53,38,2025-02-15 01:27:00,15
17228,ORD_17229,709,"Sery Colorflirt Nail Paint Dreamy Plum, Wine 10 ml",Warehouse C,55,41,2025-02-15 06:26:00,14
17229,ORD_17230,7514,POPIO Tempered Glass Screen Protector Compatible for iPhone 13 / iPhone 13 Pro with Case Friendly Edge to Edge Coverage an...,Warehouse B,49,44,2025-02-15 01:26:00,5
17230,ORD_17231,7678,Ajmal Blu Dreams EDP And Mukhallat Al Wafa CP & Aretha EDP Pack of 3 20 ml,Warehouse B,71,53,2025-02-15 13:17:00,18
17231,ORD_17232,33357,"Noise Flair Bluetooth Wireless in Ear Earphones with Mic Dual Smart with Touch Controls, 35 Hour Playtime, Environmental C...",Warehouse A,23,5,2025-02-15 03:17:00,18
17232,ORD_17233,17205,POVI 10% SOLUTION,Warehouse C,95,78,2025-02-15 05:27:00,17
17233,ORD_17234,25525,Addox 200mg Tablet,Warehouse B,42,25,2025-02-15 13:34:00,17
17234,ORD_17235,17296,Gutenmox 250mg Capsule,Warehouse A,90,84,2025-02-15 10:58:00,6
17235,ORD_17236,4417,Neoflox 500mg Capsule,Warehouse C,28,17,2025-02-15 11:39:00,11
17236,ORD_17237,23315,SanDisk ® Ultra Curve USB 3.2 256GB 100MB/s R Black,Warehouse B,61,52,2025-02-15 05:21:00,9
17237,ORD_17238,29241,Parker Quink Flow Ballpoint Refill Fine Blue,Warehouse C,27,18,2025-02-15 20:17:00,9
17238,ORD_17239,23636,"Amazon Basics in-Ear Bluetooth 5.0 Neckband with Up to 30 Hours Playtime, with Mic, Magnetic Earbuds, Voice Assistant, Dua...",Warehouse A,99,83,2025-02-15 04:14:00,16
17239,ORD_17240,17581,"boAt Rockerz 550 Sunburn Edition with 50MM Drivers, 20 Hours Playback, Physical Noise Isolation and Soft Padded Earcups Ov...",Warehouse B,81,76,2025-02-15 06:48:00,5
17240,ORD_17241,4527,"LG 60 cm/24 inches Full HD IPS 1920 x 1080 Pixels LCD Monitor, Inbuilt Speaker, HDMI x 2, VGA Port, 75 Hz Refresh Rate, AM...",Warehouse A,65,54,2025-02-15 16:24:00,11
17241,ORD_17242,7554,Relax Lavender Face & Body Mist,Warehouse B,74,60,2025-02-15 08:25:00,14
17242,ORD_17243,4383,Reflakast LC 5mg/10mg Tablet,Warehouse B,40,32,2025-02-15 07:49:00,8
17243,ORD_17244,32208,Dot & Key Foot Cream (Sanitizer + Moisturizer) - Lavender & Peppermint 50 ml,Warehouse C,107,92,2025-02-15 11:14:00,15
17244,ORD_17245,29244,Aziecro 200mg Oral Suspension,Warehouse B,100,92,2025-02-15 22:51:00,8
17245,ORD_17246,4480,Oceans Deodorant for Men - Long Lasting & Fresh Aquatic Fragrance,Warehouse A,97,87,2025-02-15 08:07:00,10
17246,ORD_17247,6451,daily life forever 52 GOLD WATER – FGW001 Primer - 15 ml (gold) (Gold),Warehouse C,74,65,2025-02-15 06:23:00,9
17247,ORD_17248,17169,Ajmal Bastion EDP Woody Aromatic Perfume And Sacrifice II For Him Deodorant Fruity Aromatic Fragrance 300 ml,Warehouse A,55,38,2025-02-15 20:08:00,17
17248,ORD_17249,23627,StayHappi Cefixime+Ornidazole 200mg/500mg Tablet,Warehouse B,25,19,2025-02-15 17:15:00,6
17249,ORD_17250,17218,"3110 Combo Tripod with Selfi Remote and Collar Mic 1.5 Meter Long, Mobile Stand Holder, Fold-able, Portable Adjustable, Al...",Warehouse A,103,91,2025-02-15 03:04:00,12
17250,ORD_17251,2772,Spigen Liquid Air Back Cover Compatible for Google Pixel 6a (TPU | Matte Black),Warehouse A,111,95,2025-02-15 11:30:00,16
17251,ORD_17252,23348,Corsair Vengeance LPX 16GB (1x16GB) DDR4 3200MHZ UDIMM C16 Desktop RAM Memory Module,Warehouse C,98,90,2025-02-15 17:07:00,8
17252,ORD_17253,1340,Lorat 1mg Tablet,Warehouse B,53,47,2025-02-15 09:21:00,6
17253,ORD_17254,7647,"Brut Sport Style Deodorant Spray for Men, Long-Lasting Refreshing Body Deo Spray with Athletic Fragrance, Everyday Wear Im...",Warehouse C,26,19,2025-02-15 07:31:00,7
17254,ORD_17255,24947,Ceham 250mg Injection,Warehouse C,103,90,2025-02-15 20:14:00,13
17255,ORD_17256,33510,"Samsung 980 500GB Up to 3,500 MB/s PCIe 3.0 NVMe M.2 (2280) Internal Solid State Drive (SSD) (MZ-V8V500)",Warehouse C,86,71,2025-02-15 10:30:00,15
17256,ORD_17257,24402,Tetra A Forte 500mg Tablet,Warehouse A,54,40,2025-02-15 11:40:00,14
17257,ORD_17258,29843,The Skin Story SPF 50+ Sunscreen - Moringa 100 gm,Warehouse B,29,23,2025-02-15 03:07:00,6
17258,ORD_17259,445,Hadran-DSR Capsule,Warehouse C,43,37,2025-02-15 00:04:00,6
17259,ORD_17260,24956,OpenTech® Tempered Glass Screen Protector Compatible for Samsung Galaxy M32 / F22 / A32 / A31 Edge to Edge Coverage with E...,Warehouse A,106,87,2025-02-15 23:20:00,19
17260,ORD_17261,24427,Cloprez Tablet,Warehouse B,98,85,2025-02-15 14:11:00,13
17261,ORD_17262,7017,"ProElite Smart Deer Flip case Cover for Samsung Galaxy Tab A7 Lite 8.7"" SM-T220/T225, Wine Red",Warehouse A,60,47,2025-02-15 20:11:00,13
17262,ORD_17263,25185,Hair Logic Nutritive Shampoo 1's,Warehouse A,82,63,2025-02-15 20:34:00,19
17263,ORD_17264,36324,The Face Shop Water Fit Lip Tint - Rose Pink 5 Gm,Warehouse C,94,85,2025-02-15 18:18:00,9
17264,ORD_17265,36328,Esogen-DSR Caspule,Warehouse A,58,48,2025-02-15 00:20:00,10
17265,ORD_17266,16047,Protolet 20mg Tablet,Warehouse A,101,92,2025-02-15 20:20:00,9
17266,ORD_17267,25003,English Rose Deodorant - For Women,Warehouse B,22,8,2025-02-15 14:12:00,14
17267,ORD_17268,11851,Azafran Organics Soya Rich Triple Action Shampoo 100 gm,Warehouse B,78,73,2025-02-15 05:37:00,5
17268,ORD_17269,477,Rabclaz-D Tablet,Warehouse C,46,29,2025-02-15 00:08:00,17
17269,ORD_17270,11817,Feact 200 Softgel Capsule,Warehouse A,59,44,2025-02-15 06:45:00,15
17270,ORD_17271,16099,"Tizum 4G Fast LTE Wireless USB Single Band Dongle Stick with All SIM Network Support, Plug & Play Data Card with up to 150...",Warehouse B,18,3,2025-02-15 05:18:00,15
17271,ORD_17272,7064,Ilazine 10mg Tablet,Warehouse C,30,19,2025-02-15 13:30:00,11
17272,ORD_17273,453,"Noise Agile 2 Buzz Bluetooth Calling Smart Watch with 1.28"" TFT Display,Dual Button,in-Built Mic & Speaker,AI Voice Assist...",Warehouse B,22,13,2025-02-15 01:43:00,9
17273,ORD_17274,16117,Artis ARTIS Mini 2.0 USB Multimedia Speakers (Black),Warehouse B,26,21,2025-02-15 21:57:00,5
17274,ORD_17275,29820,"Soap Pocket - Foamy, Bath Essentials",Warehouse A,100,92,2025-02-15 12:44:00,8
17275,ORD_17276,16120,StBotanica Caffeine Under Eye Cream Roller 15 ml,Warehouse B,34,28,2025-02-15 20:47:00,6
17276,ORD_17277,7079,"Tizum External Hard Drive Case for 2.5-Inch Hard Drive, Premium Edition, HDD Case (Black)",Warehouse B,24,15,2025-02-15 18:53:00,9
17277,ORD_17278,24336,"LUNAGARIYA®,PU Leather Cover Holder Protective Case for AIRTEL Dishtv dth Remote Control,PU Leather Cover Holder",Warehouse A,31,24,2025-02-15 11:40:00,7
17278,ORD_17279,2896,Aziwan 250mg Tablet,Warehouse A,38,22,2025-02-15 22:40:00,16
17279,ORD_17280,24330,"Maybelline New York Color Sensational Creamy Matte Lipstick, 634 Bold Crimson, 3.9g and Maybelline New York Color Sensatio...",Warehouse C,26,16,2025-02-15 03:01:00,10
17280,ORD_17281,29803,Okareb D 10mg/20mg Tablet,Warehouse B,95,77,2025-02-15 09:08:00,18
17281,ORD_17282,462,Olivia Natural Glow combo of Panstick (Natural-03) + compact (Natural Beige - 02) + Pancake (almond dust -26),Warehouse C,36,19,2025-02-15 22:03:00,17
17282,ORD_17283,16175,Hair Serum - Anti-Dandruff,Warehouse B,61,55,2025-02-15 18:35:00,6
17283,ORD_17284,36289,MI Braided Type C 100cm Cable Red|Supports Upto 22.5 Fast Charging|Tangle Free Sturdy Built with Kevlar Protection|Support...,Warehouse C,37,22,2025-02-15 10:41:00,15
17284,ORD_17285,4364,Amazon Basics 4 Port Superspeed USB 3.0 Hub (Grey),Warehouse B,103,88,2025-02-15 04:33:00,15
17285,ORD_17286,25568,Dorgesic Plus 50mg/10mg Tablet,Warehouse A,50,44,2025-02-15 12:50:00,6
17286,ORD_17287,17276,Anglopar 125mg Drop,Warehouse B,28,10,2025-02-15 19:59:00,18
17287,ORD_17288,33390,EGOTUDE Soft Silicone Simple Slim Ultra Thin Back Cover Case for iPhone 7 (Black),Warehouse A,32,27,2025-02-15 09:08:00,5
17288,ORD_17289,7578,Consistent 500 GB Hard Disk for Desktop,Warehouse A,76,66,2025-02-15 07:04:00,10
17289,ORD_17290,20912,Muzle DP Tablet,Warehouse A,90,81,2025-02-15 01:48:00,9
17290,ORD_17291,17129,Milkshake Direct Color Blue 100 ml,Warehouse A,14,9,2025-02-15 10:06:00,5
17291,ORD_17292,17672,Beggie All-in-One Makeup Kit Set for Women's & Girl's for all Skin Type/Birthday Gift (Makeup Kit + Kitty Brush Set of 7 +...,Warehouse B,56,48,2025-02-15 13:58:00,8
17292,ORD_17293,17398,T.O.G.Air Cushion BB Cream Brightening Concealer Even Skin Pigment Natural Color,Warehouse B,107,97,2025-02-15 03:44:00,10
17293,ORD_17294,1777,Redgear Cloak Wired RGB Wired Over Ear Gaming Headphones with Mic for PC,Warehouse B,39,30,2025-02-15 17:52:00,9
17294,ORD_17295,10902,Tendovisc Tablet,Warehouse B,55,48,2025-02-15 14:16:00,7
17295,ORD_17296,17662,Insight Cosmetics Color Rich Lipstick - Flamenco Red 4.2 gm,Warehouse B,48,36,2025-02-15 00:57:00,12
17296,ORD_17297,17427,OpenTech® Tempered Glass Screen Protector Compatible for iPhone X/XS / 11 Pro Edge to Edge Coverage with Easy Installation...,Warehouse A,60,53,2025-02-15 03:00:00,7
17297,ORD_17298,11079,Beauty People Glamour On The Go Nail Paint Remover Padsapple 1's,Warehouse A,79,60,2025-02-15 00:32:00,19
17298,ORD_17299,17659,GTN Sorbitrate 0.5mg Tablet,Warehouse A,69,63,2025-02-15 17:43:00,6
17299,ORD_17300,17418,Amozo Ultra Hybrid Camera and Drop Protection Back Cover Case for iPhone 13 Pro Max (TPU + Polycarbonate | Crystal Transpa...,Warehouse A,25,15,2025-02-15 17:25:00,10
17300,ORD_17301,6497,Ramble® 3 in 1 Face Primer | Oil Free Primer | Long Lasting Highlighter Primer - 30 ml,Warehouse B,89,71,2025-02-15 19:36:00,18
17301,ORD_17302,23256,Excellence Creme Hair Color (72ml+100g) 3 Dark Brown+Color Protect Shampoo 175ml,Warehouse C,62,47,2025-02-15 08:39:00,15
17302,ORD_17303,17420,"Sun Shield - Bio Pink Lentils Matte Look Sunblock, SPF 40",Warehouse B,70,55,2025-02-15 10:21:00,15
17303,ORD_17304,29103,Willgo SP Tablet,Warehouse B,32,23,2025-02-15 19:24:00,9
17304,ORD_17305,23481,"Nokia 105 Plus Single SIM, Keypad Mobile Phone with Wireless FM Radio, Memory Card Slot and MP3 Player | Red",Warehouse A,108,89,2025-02-15 17:57:00,19
17305,ORD_17306,32174,Kanamol 125mg Oral Suspension,Warehouse C,67,53,2025-02-15 12:45:00,14
17306,ORD_17307,28932,Oflocin Syrup,Warehouse B,105,95,2025-02-15 23:59:00,10
17307,ORD_17308,23700,Softening Musk Moisturiser With Vitamin E,Warehouse B,117,98,2025-02-15 09:49:00,19
17308,ORD_17309,11103,Beauty People Brick Highlighter & Blush Shade 03 7 gm,Warehouse A,82,77,2025-02-15 05:22:00,5
17309,ORD_17310,23526,Nourishing Face Wash,Warehouse B,104,87,2025-02-15 08:20:00,17
17310,ORD_17311,25457,Smopod 50mg Dry Syrup,Warehouse B,35,26,2025-02-15 19:44:00,9
17311,ORD_17312,33977,Fendic Plus 50 mg/500 mg Tablet,Warehouse C,97,80,2025-02-15 05:10:00,17
17312,ORD_17313,4428,Moxynix D 250mg/250mg Capsule,Warehouse A,39,34,2025-02-15 13:18:00,5
17313,ORD_17314,4538,"HP 220 Silent Wireless Mouse, 2.4 GHz Dongle, 15 Month Life Battery, Compatible with Windows, Mac, Chromebook/PC/Laptop (3...",Warehouse A,99,92,2025-02-15 05:03:00,7
17314,ORD_17315,28961,Soothing Body Oil,Warehouse A,76,66,2025-02-15 14:43:00,10
17315,ORD_17316,1783,Floxwell 200mg Tablet,Warehouse C,91,78,2025-02-15 18:18:00,13
17316,ORD_17317,25442,Hair Oil - The Old Fashioned Beard Fragrance,Warehouse B,101,87,2025-02-15 23:36:00,14
17317,ORD_17318,35884,Ketogail 200mg Tablet,Warehouse C,80,62,2025-02-15 05:08:00,18
17318,ORD_17319,17614,"Lenovo 130 Wireless Compact Mouse, 1K DPI Optical sensor, 2.4GHz Wireless NanoUSB, 10m range, 3button(left,right,scroll) u...",Warehouse C,25,14,2025-02-15 20:50:00,11
17319,ORD_17320,10911,"mCaffeine Coffee De-Stress Gift Set With Coffee Body Scrub, Body Oil & Specially Handcrafted Massager for Relieving Stress...",Warehouse C,36,29,2025-02-15 18:38:00,7
17320,ORD_17321,33976,"Faber-Castell Dust-Free Erasers - Large, Pack of 20 (White)",Warehouse A,53,46,2025-02-15 07:58:00,7
17321,ORD_17322,17260,Naxace TH 100mg/4mg Tablet,Warehouse C,101,93,2025-02-15 13:32:00,8
17322,ORD_17323,7648,"Brustro Artists Watercolour Paper 300 GSM A4-25% Cotton, Cold Pressed, Contains 18 + 6 Sheets Free",Warehouse C,82,76,2025-02-15 01:10:00,6
17323,ORD_17324,29017,"Deospray For Men - Dive, No Alcohol",Warehouse C,92,87,2025-02-15 17:25:00,5
17324,ORD_17325,4498,Irobin 195mg/1.5mg Capsule,Warehouse B,48,39,2025-02-15 23:04:00,9
17325,ORD_17326,2759,Ameto G Forte 3mg/1000mg Tablet,Warehouse A,49,31,2025-02-15 01:54:00,18
17326,ORD_17327,29040,"Wet n Wild Ultimate Brow Kit, Eyebrow Kit to Shape, Define and Fill the Eyebrows, Kit with 1 Brow Wax, 2 Fixing Powders, 1...",Warehouse C,92,73,2025-02-15 21:06:00,19
17327,ORD_17328,10990,Bonjour Paris Coat Me Satin Matte Nail Polish - Pink 9 ml,Warehouse C,61,46,2025-02-15 06:03:00,15
17328,ORD_17329,2756,Cello TZ 500mg/600mg Tablet,Warehouse C,19,12,2025-02-15 07:04:00,7
17329,ORD_17330,7641,O'mumsie- Soothing Vapor Bubble Bath With Eucalyptus & Lavender| Plant Rich Formula Safe For Kids And Adults To Soothe And...,Warehouse B,21,8,2025-02-15 07:42:00,13
17330,ORD_17331,2144,Vatican's Trick-P Tablet,Warehouse C,74,69,2025-02-15 02:35:00,5
17331,ORD_17332,23613,"IFB 25 L Solo Microwave Oven (25PM2S, Silver)",Warehouse C,30,14,2025-02-15 14:55:00,16
17332,ORD_17333,17245,TheGiftKart Shockproof Crystal Clear Back Cover Case for Redmi 10A / 10A Sport | 360 Degree Protection | Protective Design...,Warehouse C,99,86,2025-02-15 18:43:00,13
17333,ORD_17334,23388,Thromcin 100mg Oral Suspension,Warehouse B,93,83,2025-02-15 13:14:00,10
17334,ORD_17335,25419,Woman - Pure Body Mist,Warehouse B,74,64,2025-02-15 05:14:00,10
17335,ORD_17336,25557,Aktirose 20mg Injection,Warehouse B,17,2,2025-02-15 17:50:00,15
17336,ORD_17337,17259,"Aroma® NB119 Star Bluetooth Wireless In Ear Neckband with Long Lasting Playtime 50 Hrs, Smart Voice Assistant, Bluetooth V...",Warehouse C,51,44,2025-02-15 16:20:00,7
17337,ORD_17338,17237,Lo-Ldl 10mg Tablet,Warehouse B,53,40,2025-02-15 00:44:00,13
17338,ORD_17339,23364,"Casio HL-100LB Portable Calculator, 10 Digit",Warehouse B,65,56,2025-02-15 11:55:00,9
17339,ORD_17340,25544,The Beauty Co. SPF 50 Sunscreen Lotion 100 ml,Warehouse C,33,26,2025-02-15 05:23:00,7
17340,ORD_17341,23575,"Makeup & More Makeup Foundation, With Green Tea Extract, Beige, Evens And Corrects Your Skin Tone, Can Be Used As Conceale...",Warehouse B,101,84,2025-02-15 14:32:00,17
17341,ORD_17342,23417,"Arata Natural Moisturising Body Lotionfor Dry Skin with Shea Butter, Cocoa Butter & Coconut Oil 75 ml",Warehouse C,57,42,2025-02-15 00:14:00,15
17342,ORD_17343,23358,"Deltoid Lite Face Masks In Pink Knit Fabric With Binding - 1S1014, Medium",Warehouse C,22,17,2025-02-15 10:05:00,5
17343,ORD_17344,754,Koszid 250mg Injection,Warehouse C,94,75,2025-02-15 07:45:00,19
17344,ORD_17345,23423,Papaya Fairness Scrub Gel - With Honey & Saffron,Warehouse A,46,40,2025-02-15 15:04:00,6
17345,ORD_17346,11153,Seira 10 Tablet,Warehouse C,86,74,2025-02-15 19:20:00,12
17346,ORD_17347,17561,Esy Breath Nasal Drop,Warehouse B,58,41,2025-02-15 05:19:00,17
17347,ORD_17348,7547,"EGOTUDE Frameless Hard Back Cover Case for iPhone 13 (Camera Protection, Blue, Polycarbonate)",Warehouse A,30,17,2025-02-15 06:46:00,13
17348,ORD_17349,32201,Tide Plus 20 Tablet,Warehouse B,73,66,2025-02-15 23:38:00,7
17349,ORD_17350,32263,"OnePlus 24 inch Full HD LCD Monitor LED Backlit IPS Panel with 3-Side Bezel Less, USB Type-C connectivity with 18W Chargin...",Warehouse C,15,8,2025-02-15 22:00:00,7
17350,ORD_17351,23300,Apple Pencil Tips - 4 Pack,Warehouse B,102,88,2025-02-15 04:00:00,14
17351,ORD_17352,25513,"AmazonBasics USB 2.0 Extension Cable - A-Male to A-Female for Personal Computer, Printer - 6.5 Feet (Black, 2 Meters)",Warehouse B,46,35,2025-02-15 05:55:00,11
17352,ORD_17353,10912,Kofcef D Syrup,Warehouse B,65,48,2025-02-15 06:51:00,17
17353,ORD_17354,17433,"FIRSTZON HD pore minimizer and pore blurring matte face make up primer, matte + poreless face make up base primer , stay u...",Warehouse C,91,80,2025-02-15 05:35:00,11
17354,ORD_17355,16208,"INDUS VALLEY Bio Organic Face Pack (Mulethi Powder, Sandalwood Face Pack, Orange Peel Powder and Multani Mitti Powder)Beau...",Warehouse A,84,70,2025-02-15 17:42:00,14
17355,ORD_17356,24198,Muniheal Oil,Warehouse A,94,85,2025-02-15 04:35:00,9
17356,ORD_17357,16339,Cifizem 50mg Dry Syrup,Warehouse B,106,91,2025-02-15 17:30:00,15
17357,ORD_17358,6576,Vildamax 50mg Tablet,Warehouse B,107,88,2025-02-15 22:04:00,19
17358,ORD_17359,15868,Gabett 300mg Tablet,Warehouse B,46,35,2025-02-15 07:28:00,11
17359,ORD_17360,16346,"Lakmé Eyeconic Lash Curling Mascara, Black, 9ml And Lakmé Lip Love Chapstick, Spf15, Cherry, 4.5 g",Warehouse A,24,13,2025-02-15 12:46:00,11
17360,ORD_17361,16351,"Duracell Ultra Alkaline AA Batteries, Pack of 6",Warehouse C,23,5,2025-02-15 01:45:00,18
17361,ORD_17362,33748,Nicotex 4mg Chewing Gums Mint Plus Sugar Free,Warehouse C,64,52,2025-02-15 17:25:00,12
17362,ORD_17363,29397,boAt Bassheads 100 Wired in Ear Earphones with Mic (Mint Orange),Warehouse C,10,2,2025-02-15 05:00:00,8
17363,ORD_17364,29399,"BabyMoon Cotton Crochet Mermaid New Born Baby Photography Shoot Props Costume (6-18 Months, Red) - Set of 3",Warehouse A,26,7,2025-02-15 15:55:00,19
17364,ORD_17365,25262,Vertiver Pure Essential Oil,Warehouse A,91,86,2025-02-15 20:46:00,5
17365,ORD_17366,23881,Donazil 10mg Tablet,Warehouse B,54,47,2025-02-15 10:03:00,7
17366,ORD_17367,29417,Konaz -CT Lotion,Warehouse C,77,63,2025-02-15 03:01:00,14
17367,ORD_17368,33843,Weldrol 4mg Tablet,Warehouse A,94,89,2025-02-15 06:04:00,5
17368,ORD_17369,25251,"MAYCREATE® 20 sheet Tatto Sticker for Kids,Kids Waterproof Temporary Tattoos for Birthday Parties,Group Activities,Cute Ca...",Warehouse C,55,45,2025-02-15 15:32:00,10
17369,ORD_17370,29425,mobistyle Soft Silicone Wristband smartwatch Strap Compatible only for Watch 2 Lite/GPS Watch (WATCH NOT INCLUDED),Warehouse A,15,10,2025-02-15 15:15:00,5
17370,ORD_17371,29428,Carmizyme Tablet,Warehouse A,69,52,2025-02-15 03:07:00,17
17371,ORD_17372,7368,Avcif 200mg Tablet DT,Warehouse B,44,30,2025-02-15 09:28:00,14
17372,ORD_17373,15873,United Colors of Benetton Colors Rose for Women Intenso Eau de Parfum 80ml,Warehouse A,46,34,2025-02-15 21:52:00,12
17373,ORD_17374,6952,Nature's Essence Lacto Bleach Natural Milk Bleach Without Activator 58 gm,Warehouse C,89,82,2025-02-15 15:38:00,7
17374,ORD_17375,36373,Fixon 1000mg Injection,Warehouse A,77,68,2025-02-15 16:39:00,9
17375,ORD_17376,6808,Rabder IT 20mg/150mg Capsule,Warehouse A,23,11,2025-02-15 10:34:00,12
17376,ORD_17377,33540,Necfix-Clav 200mg/125mg Tablet,Warehouse A,60,52,2025-02-15 18:42:00,8
17377,ORD_17378,29947,Metsonix 4mg Tablet,Warehouse C,24,19,2025-02-15 14:10:00,5
17378,ORD_17379,24546,Veloxan 1.5mg Capsule,Warehouse A,54,40,2025-02-15 03:47:00,14
17379,ORD_17380,6796,Flormar Silk Matte Liquid Lipstick 010 Tender Terra 4.5 gm,Warehouse A,11,2,2025-02-15 20:47:00,9
17380,ORD_17381,11923,Belora Paris Leave No Evidence Liquid Matte Lipstick Nudie Fun 4.5 gm,Warehouse A,103,85,2025-02-15 22:47:00,18
17381,ORD_17382,36353,"DOOMSDAY 3 Pieces Silicone Remote Cover, Remote Case for Television and Air Conditioner, Remote Control Protective Cover, ...",Warehouse C,81,66,2025-02-15 20:06:00,15
17382,ORD_17383,11905,Novamox 100 Rediuse Drop,Warehouse B,97,87,2025-02-15 06:22:00,10
17383,ORD_17384,36351,New Theo-Asthalin Syrup,Warehouse A,59,52,2025-02-15 23:08:00,7
17384,ORD_17385,29906,Trinetra 20W USB-C Type Silicone Charger Charger case Cover Looking Cartoon Lightning Compatible with 360 Degrees 18-20W D...,Warehouse B,106,91,2025-02-15 01:00:00,15
17385,ORD_17386,430,YellowInc Case Cover Compatible with OnePlus Nord Buds (Earbuds Not Included) (Black),Warehouse A,24,18,2025-02-15 22:34:00,6
17386,ORD_17387,24894,Dulcet DC-A50X 2 Channel Stereo Amplifier with Big LED Display/Bluetooth/MIC Input/USB/SD Card Slot/FM Radio/AUX Input/Rem...,Warehouse C,78,70,2025-02-15 15:21:00,8
17387,ORD_17388,24896,Equff-D Syrup,Warehouse C,24,10,2025-02-15 03:52:00,14
17388,ORD_17389,1874,U & I Titanic Series Uinb-3987 Bluetooth Wireless In Ear Earphones With Mic Black,Warehouse C,30,15,2025-02-15 01:34:00,15
17389,ORD_17390,24201,Cold Processed Hot Chocolate Handmade Soap,Warehouse C,49,36,2025-02-15 00:38:00,13
17390,ORD_17391,33386,Aziram KT 100mg Tablet,Warehouse C,106,89,2025-02-15 19:36:00,17
17391,ORD_17392,17100,Reopod 100mg Dry Syrup,Warehouse C,107,92,2025-02-15 18:08:00,15
17392,ORD_17393,6507,Mepara Oral Suspension,Warehouse C,74,56,2025-02-15 02:22:00,18
17393,ORD_17394,17073,"Vatika Long & Black Shampoo - Amla & Bhringraj, Power of 7 Natural Ingredients",Warehouse A,41,28,2025-02-15 16:08:00,13
17394,ORD_17395,23727,Nourishing Hair Oil - Anti Dandruff,Warehouse C,103,92,2025-02-15 22:10:00,11
17395,ORD_17396,17062,Heptacare Syrup,Warehouse B,106,87,2025-02-15 05:18:00,19
17396,ORD_17397,23742,POPIO Tempered Glass Screen Protector Compatible for Samsung Galaxy S10e with Edge to Edge Coverage and Easy Installation kit,Warehouse A,40,35,2025-02-15 10:14:00,5
17397,ORD_17398,4337,"Samsung Galaxy M12 (Black,6GB RAM, 128GB Storage) 6 Months Free Screen Replacement for Prime",Warehouse B,39,21,2025-02-15 18:54:00,18
17398,ORD_17399,16849,"Noise Fit Halo with Standard Strap, Bluetooth Calling Round Dial Smart Watch, 1.43"" AMOLED Display, Premium Metallic Buil...",Warehouse A,76,65,2025-02-15 09:15:00,11
17399,ORD_17400,32161,Neewer 2 Packs Dimmable 5600K USB LED Video Light with Adjustable Tripod Stand/Color Filters for Tabletop/Low Angle Shooti...,Warehouse C,21,11,2025-02-15 09:20:00,10
17400,ORD_17401,29322,Kar-B 3.125mg Tablet,Warehouse B,84,66,2025-02-15 09:33:00,18
17401,ORD_17402,17041,CEDO Redmi Note 11/Note11s (4G) Case Back Cover Shockproof Bumper Crystal Clear | 360 Degree Protection TPU+PC | Camera Pr...,Warehouse A,90,83,2025-02-15 23:02:00,7
17402,ORD_17403,7428,CTD 6.25 Tablet,Warehouse C,19,5,2025-02-15 07:40:00,14
17403,ORD_17404,666,Amazon Brand - Solimo Bumper for Samsung Galaxy Note 20 Ultra (Silicone_Clear),Warehouse A,80,73,2025-02-15 22:33:00,7
17404,ORD_17405,23767,Acne Clearing Gel,Warehouse B,93,82,2025-02-15 13:40:00,11
17405,ORD_17406,2106,"FACTOR NOTES Notebook: 90 GSM, B6, Ruled, 112 Pages Journal Diary (Make Today Magical)",Warehouse A,114,96,2025-02-15 18:22:00,18
17406,ORD_17407,16929,Cefimax-AZ 200mg/250mg Tablet,Warehouse C,91,83,2025-02-15 01:15:00,8
17407,ORD_17408,7349,Dytor Plus 10 Tablet,Warehouse C,37,32,2025-02-15 14:44:00,5
17408,ORD_17409,32139,Ajmal Wisal EDP Floral Musky Perfume And Sacred Love Deodorant Floral Musky Fragrance 250 ml,Warehouse B,53,35,2025-02-15 00:21:00,18
17409,ORD_17410,4262,Eugebra L 75mg/40mg Capsule SR,Warehouse A,14,3,2025-02-15 02:14:00,11
17410,ORD_17411,11448,TERABYTE HDMI to VGA 1080P HDMI Male to VGA Female Video Converter Adapter Cable for PC Laptop HDTV Projectors and More De...,Warehouse C,41,31,2025-02-15 18:28:00,10
17411,ORD_17412,7350,Mothercare Small Easy Pop Freezer Pots - Multicolor (Pack of 6),Warehouse B,95,85,2025-02-15 23:53:00,10
17412,ORD_17413,4265,Ajmal Wild Waters Edt Of 2 & Magnetize Deodorant Pack of 2 450 ml,Warehouse A,63,52,2025-02-15 13:37:00,11
17413,ORD_17414,25236,Ajmal Viola EDP Fruity Floral Perfume And Jannatul Firdaus Concentrated Perfume Oil Oriental 85 ml,Warehouse A,76,58,2025-02-15 21:54:00,18
17414,ORD_17415,6592,SUGAR Cosmetics Time To Shine Lip Gloss - 01 Penelope Peachstop 4.5 ML,Warehouse B,32,23,2025-02-15 06:27:00,9
17415,ORD_17416,32124,Prazolin 5 Tablet SR,Warehouse C,62,52,2025-02-15 21:48:00,10
17416,ORD_17417,4270,Nimone Cold Tablet,Warehouse C,72,64,2025-02-15 02:56:00,8
17417,ORD_17418,7361,"TheGiftKart 360 Degree Protection Shockproof Back Cover for Samsung Galaxy M32 4G / M32 Prime (PC, TPU | Black Bumper, Cry...",Warehouse A,80,73,2025-02-15 05:56:00,7
17418,ORD_17419,23894,Oladac 5mg Tablet,Warehouse C,33,21,2025-02-15 13:38:00,12
17419,ORD_17420,4278,Levop-M Kid Tablet,Warehouse C,66,52,2025-02-15 10:33:00,14
17420,ORD_17421,23888,Lavisartan H 40mg/12.5mg Tablet,Warehouse B,105,90,2025-02-15 19:33:00,15
17421,ORD_17422,24506,Dynotrek Protector 15.6 Inch Laptop Sleeve Case Cover with Charger Pouch Compatible for IdeaPad ThinkPad Pavilion Envy Wat...,Warehouse C,47,30,2025-02-15 18:53:00,17
17422,ORD_17423,6777,Azithral Stat 250mg Oral Suspension,Warehouse C,30,24,2025-02-15 15:22:00,6
17423,ORD_17424,15996,"Redmi 10A (Charcoal Black, 4GB RAM, 64GB Storage) | 2 Ghz Octa Core Helio G25 | 5000 mAh Battery | Finger Print Sensor | U...",Warehouse C,73,57,2025-02-15 16:11:00,16
17424,ORD_17425,25010,Zithrolen 200mg Oral Suspension,Warehouse B,69,61,2025-02-15 22:32:00,8
17425,ORD_17426,16229,Veoni Belle Beauty Blender Super Soft sponge for face makeup. Makeup blender sponge puff branded,Warehouse C,20,7,2025-02-15 05:46:00,13
17426,ORD_17427,16228,Aspan D 10mg/40mg Tablet,Warehouse C,115,98,2025-02-15 21:29:00,17
17427,ORD_17428,16226,Torpod 200mg Tablet DT,Warehouse C,94,79,2025-02-15 16:32:00,15
17428,ORD_17429,32016,Tan Removal Orange Face Wash,Warehouse B,21,8,2025-02-15 20:29:00,13
17429,ORD_17430,11761,Panpra-DSR Capsule,Warehouse B,44,27,2025-02-15 11:13:00,17
17430,ORD_17431,24292,Astromet G2 Tablet SR,Warehouse C,30,15,2025-02-15 16:12:00,15
17431,ORD_17432,33703,Rosuprime 20mg Tablet,Warehouse A,74,65,2025-02-15 21:02:00,9
17432,ORD_17433,24917,Livoric 250mg Tablet,Warehouse B,103,88,2025-02-15 01:51:00,15
17433,ORD_17434,1928,Passion Indulge FACE OIL - ALOE TREE 10 ml,Warehouse B,70,58,2025-02-15 04:30:00,12
17434,ORD_17435,4050,Rflox Ear Drop,Warehouse C,76,68,2025-02-15 22:59:00,8
17435,ORD_17436,24460,Imiz 2 mg/25 mg Tablet,Warehouse C,57,46,2025-02-15 15:23:00,11
17436,ORD_17437,24628,Marshall Emberton 20 Watt Wireless Bluetooth Portable Speaker (Black and Brass),Warehouse C,63,47,2025-02-15 10:02:00,16
17437,ORD_17438,2933,SONATA GOLD Series Mini Spy Magnet Camera WiFi Hidden Camera HD1080P Indoor Home Small Spy Cam Security Cameras Nanny Cam ...,Warehouse A,74,61,2025-02-15 06:59:00,13
17438,ORD_17439,15853,"Maybelline New York Colossal Kajal, Black, 0.35g and Maybelline New York Lasting Drama Gel Eyeliner, Blackest Black, 2.5g",Warehouse B,70,55,2025-02-15 03:18:00,15
17439,ORD_17440,4115,OpenTech® Tempered Glass Screen Protector Compatible for Xiaomi Redmi 10 / Redmi 10C / Redmi 10 Power with Edge to Edge Co...,Warehouse B,13,6,2025-02-15 16:43:00,7
17440,ORD_17441,4117,Streetwear Nail Enamel (Pretty Girl Collection) - I Mess 8 Ml,Warehouse C,11,6,2025-02-15 23:58:00,5
17441,ORD_17442,485,SUGAR Cosmetics Blend Trend Dual Eyeshadow Brush - 412 Flat + Round 17 gm,Warehouse C,55,38,2025-02-15 03:33:00,17
17442,ORD_17443,6712,"AILKIN USB-C 65W Warp Charger 10V/6.5A for OnePlus 8T/9/9 Pro Charger, Warp Charge 30 for OnePlus 7 Pro / 7T / 7T Pro/Nord...",Warehouse B,70,59,2025-02-15 20:30:00,11
17443,ORD_17444,11739,Ovral G Tablet,Warehouse A,35,25,2025-02-15 22:21:00,10
17444,ORD_17445,24269,Cefomed 50mg Syrup,Warehouse A,68,52,2025-02-15 12:25:00,16
17445,ORD_17446,16260,"COAL Clean Beauty , Vitamin C Clay Face Mask with Vitamin C and Mango Extracts 100 ml",Warehouse B,39,27,2025-02-15 18:16:00,12
17446,ORD_17447,11735,TP-Link AC600 600 Mbps WiFi Wireless Network USB Adapter for Desktop PC with 2.4GHz/5GHz High Gain Dual Band 5dBi Antenna ...,Warehouse A,30,16,2025-02-15 21:19:00,14
17447,ORD_17448,24260,"Tough Lee Tempered Glass Screen Guard Protector for Apple iPad Air 5 5th Generation 2022, Air 4 4th Gen 2020 10.9 inch, iP...",Warehouse B,105,91,2025-02-15 03:46:00,14
17448,ORD_17449,29731,S CREATION SCMEBE Writing Pad/Tablet/Tab Portable 8.5 inches LCD E-Writer Electronic Paperless Digital LCD Writing Pad Tab...,Warehouse B,72,58,2025-02-15 02:11:00,14
17449,ORD_17450,11726,"ELV Direct Tabletop Direct Laptop Stand, Ergonomic Aluminum Computer Stand, Laptop Riser, Ventilated Lapdesk Compatible fo...",Warehouse B,90,84,2025-02-15 12:22:00,6
17450,ORD_17451,29726,Tin 0.25mg Tablet CR,Warehouse B,110,96,2025-02-15 22:06:00,14
17451,ORD_17452,11721,Isaz D 30mg/40mg Capsule,Warehouse B,82,67,2025-02-15 06:16:00,15
17452,ORD_17453,25041,SÉRY Browfidence Eyebrow Duo Kit|Brow shaping and Filling with Vitamin E - Natural BED-01,Warehouse A,105,93,2025-02-15 20:39:00,12
17453,ORD_17454,6689,"Samsung Dolby Digital Bluetooth Soundbar (HW-T42E/XL, Black, 2.1 Channel)",Warehouse A,35,19,2025-02-15 14:43:00,16
17454,ORD_17455,16310,"MAYA BALLE® Camera Lens Protector Compatible for iPhone 13/iPhone 13 Mini, [Anti-Scratch] Premium Tempered Glass Film Alum...",Warehouse C,10,3,2025-02-15 12:22:00,7
17455,ORD_17456,15843,Azacort 6 Tablet,Warehouse A,23,5,2025-02-15 03:25:00,18
17456,ORD_17457,6926,Planokuf Syrup,Warehouse C,115,98,2025-02-15 05:24:00,17
17457,ORD_17458,15824,Rest 20mg Injection,Warehouse A,76,70,2025-02-15 22:42:00,6
17458,ORD_17459,6890,Levoron 500mg Tablet,Warehouse C,61,42,2025-02-15 17:22:00,19
17459,ORD_17460,6990,"Aroma® NB119 Badshah Bluetooth Wireless In Ear Neckband with Long Lasting Playtime 60 Hrs, Smart Voice Assistant, IPX4 Rat...",Warehouse A,81,70,2025-02-15 01:34:00,11
17460,ORD_17461,16024,BERINA COLLAGEN TREATMENT SPA 500 gm,Warehouse C,27,20,2025-02-15 03:59:00,7
17461,ORD_17462,11867,Hibiscus Flower Powder - Externally Very Useful As Hair Tonic,Warehouse C,105,95,2025-02-15 02:08:00,10
17462,ORD_17463,7006,"L'Oreal Paris Lash Paradise Mascara, Waterproof 7.6 Gm",Warehouse B,92,81,2025-02-15 16:21:00,11
17463,ORD_17464,11862,Sivanna Colors Contour Highlight & Eyeshadow Palette - HF365 05 10 gm,Warehouse C,46,33,2025-02-15 16:20:00,13
17464,ORD_17465,16034,Oral B Cross Action Toothbrush Heads Pack Of 4 Replacement Refills For Electric Rechargeable,Warehouse B,33,15,2025-02-15 18:31:00,18
17465,ORD_17466,11963,Zayn & Myza Arabica Coffee Face Mask 50 gm,Warehouse A,33,24,2025-02-15 08:45:00,9
17466,ORD_17467,6822,"BHARATGAURAV - Hair Accessories Combo of 30 Black Rubber Hair Band, Tic Tac 12, Banana Claw and Black Hair Claw for Women,...",Warehouse A,49,41,2025-02-15 06:55:00,8
17467,ORD_17468,24458,"Sony Wh-Ch510 Bluetooth Wireless On Ear Headphones Up-To 35Hrs Playtime Lightweight, Type-C, Play/Pause Control, 30Mm Driv...",Warehouse C,57,38,2025-02-15 14:58:00,19
17468,ORD_17469,6830,Gluconorm-G 4 Tablet PR,Warehouse B,20,11,2025-02-15 13:31:00,9
17469,ORD_17470,15716,Amozo Ultra Hybrid Transparent Drop and Camera Protection Back Cover Case for Samsung Galaxy S23 Ultra 5G (PolyCarbonarte)...,Warehouse C,69,56,2025-02-15 05:02:00,13
17470,ORD_17471,30055,"Wow Skin Science Ubtan Body Wash For Tan Removal And Glowing Skin - With Chickpea Flour, Almond, Safron & Turmeric Extract...",Warehouse A,88,80,2025-02-15 16:50:00,8
17471,ORD_17472,2040,Redmi Note 12 5G Mystique Blue 6GB RAM 128GB ROM | 1st Phone with 120Hz Super AMOLED and Snapdragon® 4 Gen 1 | 48MP AI Tri...,Warehouse B,22,3,2025-02-15 11:51:00,19
17472,ORD_17473,33562,Fenzy 10 Tablet,Warehouse A,48,34,2025-02-15 03:58:00,14
17473,ORD_17474,15733,Charm Avatar Deodorant & Body Spray Perfume For Men,Warehouse B,66,54,2025-02-15 06:01:00,12
17474,ORD_17475,11995,Unilastine 20mg Tablet,Warehouse A,84,76,2025-02-15 05:11:00,8
17475,ORD_17476,30046,GT Capsules,Warehouse B,79,66,2025-02-15 06:06:00,13
17476,ORD_17477,30044,Snapsert 50 Tablet,Warehouse C,84,67,2025-02-15 03:37:00,17
17477,ORD_17478,36412,"SHEAFFER ""K"" - Blue Fine Ballpoint Refill",Warehouse A,71,66,2025-02-15 20:39:00,5
17478,ORD_17479,33576,Onsitego 1 Year Extended Warranty for Small Home & Kitchen Appliances from Rs. 2001-2500 (Email Delivery - No Physical Kit),Warehouse B,51,34,2025-02-15 07:30:00,17
17479,ORD_17480,12019,"Fastrack New Reflex VOX 2.0 Dark Blue Smart Watch|BT Calling|1.8"" HD Display|TWS Connect|AI Voice|50+ Sports Modes|100+ Wa...",Warehouse A,89,84,2025-02-15 15:36:00,5
17480,ORD_17481,396,Narzine 5mg Tablet,Warehouse C,50,32,2025-02-15 10:14:00,18
17481,ORD_17482,24701,Azidxl 200mg Oral Suspension,Warehouse A,49,39,2025-02-15 03:36:00,10
17482,ORD_17483,2020,"BRUSTRO Metallic Brush Pens - Soft Brush Tip for Calligraphy, Hand Lettering, Colouring, Scrapbooking, Card Making - Set o...",Warehouse C,37,26,2025-02-15 04:03:00,11
17483,ORD_17484,24681,Robustrion Anti-Scratch & Smudge Proof Tempered Glass Screen Protector Guard for Redmi Pad 10.61 inch,Warehouse B,106,91,2025-02-15 14:47:00,15
17484,ORD_17485,33587,Himalayan Cherry Hand & Body Lotion,Warehouse A,23,13,2025-02-15 23:56:00,10
17485,ORD_17486,400,Spigen EZ Fit Tempered Glass Screen Protector Guard for Galaxy S23 (2 Pack),Warehouse C,24,13,2025-02-15 14:43:00,11
17486,ORD_17487,11998,LOHAYA Television Remote Compatible for VU LED LCD HD Tv Remote Control Model No :- EN2B27V,Warehouse A,18,3,2025-02-15 18:53:00,15
17487,ORD_17488,6915,OnePlus 108 cm (43 inches) Y Series Full HD Smart Android LED TV 43 Y1S (Black),Warehouse C,95,80,2025-02-15 15:34:00,15
17488,ORD_17489,24653,Mefesun P Oral Suspension,Warehouse B,29,12,2025-02-15 03:56:00,17
17489,ORD_17490,27155,"Model-P4 6 Way Swivel Tilt Wall Mount 32-55-inch Full Motion Cantilever for LED,LCD and Plasma TV's",Warehouse B,112,98,2025-02-15 23:44:00,14
17490,ORD_17491,19223,"CARECASE® Optical Bay 2nd Hard Drive Caddy, 9.5 mm CD/DVD Drive Slot for SSD and HDD",Warehouse B,27,8,2025-02-15 02:07:00,19
17491,ORD_17492,15244,Spigen Liquid Air Back Cover Case Compatible with iPhone 14 (TPU | Matte Black),Warehouse A,73,59,2025-02-15 13:47:00,14
17492,ORD_17493,14289,Duracell - 2032 3V Lithium Coin Battery - Long Lasting Battery - 2 Count,Warehouse C,97,80,2025-02-15 00:01:00,17
17493,ORD_17494,15620,Arata Natural Bath Essentials with Cleansing Shampoo(75 Ml) & Body Wash(75 Ml) 150 ml,Warehouse C,73,66,2025-02-15 02:58:00,7
17494,ORD_17495,14431,Tencol LA Syrup,Warehouse C,19,11,2025-02-15 15:52:00,8
17495,ORD_17496,13162,Kalmegh Herb Powder - Supports As Natural Liver Tonic,Warehouse B,53,45,2025-02-15 22:01:00,8
17496,ORD_17497,13163,Vega Foot File (PD - 18) 46 gm,Warehouse B,32,18,2025-02-15 18:58:00,14
17497,ORD_17498,13024,Amazon Basics Male to Female Stereo Audio Cable (Aux Extension Cable) with Gold Plated Connectors- 25 Feet (3.5mm) - Does ...,Warehouse C,12,6,2025-02-15 08:04:00,6
17498,ORD_17499,14036,Facial Serum - Anti-Ageing,Warehouse B,63,55,2025-02-15 00:17:00,8
17499,ORD_17500,14296,"Canon PIXMA G2012 Printer Mono/Colour, Print, Scan,Copy, High Volume Printing, 3.04 LCD Screen, 2 Additional Black Ink Bot...",Warehouse C,36,24,2025-02-15 13:59:00,12
17500,ORD_17501,36448,"False Eyelash Extension Kit,Eyelash Extension Supplies Include USB Air Conditioning Blower,Silicone Pad,Gel Pads,Mini Make...",Warehouse B,103,86,2025-02-15 17:42:00,17
17501,ORD_17502,31529,"TAAPSEE DC 12V 2A Power Supply Adapter, AC 100-240V to DC 12Volt Transformers, Switching Power Source 3528/5050 LED Strip ...",Warehouse B,92,83,2025-02-15 19:37:00,9
17502,ORD_17503,14647,"AILKIN USB C To Lightning Apple Certified (Mfi) Sync & Charge Cable For Iphone, Ipad And Ipod. Fast Charging Lightning Cab...",Warehouse B,87,79,2025-02-15 08:11:00,8
17503,ORD_17504,31671,Mosi-D Eye Drop,Warehouse A,86,76,2025-02-15 21:49:00,10
17504,ORD_17505,31817,Chloromide Eye Drop,Warehouse A,60,54,2025-02-15 18:41:00,6
17505,ORD_17506,12329,Raziweb 20mg Tablet,Warehouse C,82,71,2025-02-15 12:09:00,11
17506,ORD_17507,14470,Metacin Tablet,Warehouse C,75,61,2025-02-15 20:36:00,14
17507,ORD_17508,12736,Tenamagic-M 1000 Tablet ER,Warehouse A,17,7,2025-02-15 16:35:00,10
17508,ORD_17509,36782,Eufal 600mg Tablet,Warehouse C,99,86,2025-02-15 13:02:00,13
17509,ORD_17510,30529,AmazonBasics AAAA Everyday Alkaline Batteries for Stylus (8-Pack) - Appearance May Vary,Warehouse C,11,3,2025-02-15 15:04:00,8
17510,ORD_17511,61,Dynotrek Grade 14-15 Inch Laptop Sleeve Case Cover with Charger Pouch Compatible for Mackbook Tablet Exterior Waterproof S...,Warehouse C,57,50,2025-02-15 19:15:00,7
17511,ORD_17512,3608,VASUPUJYA BB FACE CREAM - PAPAYA COLOR,Warehouse A,78,71,2025-02-15 21:50:00,7
17512,ORD_17513,14558,"Ahuja Portable PA Neckband System NBA-20Dp Rechargeable With 1 Neckband Mic With USB And SD Card Input, Black, 340gms",Warehouse A,77,62,2025-02-15 01:44:00,15
17513,ORD_17514,12175,Provend Tablet,Warehouse C,56,42,2025-02-15 13:56:00,14
17514,ORD_17515,15641,Dynadol P 100mg/325mg Tablet,Warehouse B,44,29,2025-02-15 14:21:00,15
17515,ORD_17516,3686,After Shave Lotion Atomizer- Fresh Lime,Warehouse C,97,84,2025-02-15 05:37:00,13
17516,ORD_17517,14899,Leplenz-M Syrup,Warehouse B,91,72,2025-02-15 19:44:00,19
17517,ORD_17518,31447,Ideale Ultra Night,Warehouse B,19,4,2025-02-15 06:12:00,15
17518,ORD_17519,13421,"WRISTIO 3 1.85"" HD, Bluetooth Calling Smart Watch, 50+ Sports Modes, Rotating Crown, 15 days battery life, Split-screen, W...",Warehouse B,61,52,2025-02-15 19:44:00,9
17519,ORD_17520,3169,Myglamm Lit Nail Enamel - Grounded 7 Gm,Warehouse B,67,59,2025-02-15 19:24:00,8
17520,ORD_17521,13010,"TP-Link USB to Ethernet Adapter (UE306), Foldable USB 3.0 to Gigabit Ethernet LAN Network Adapter, Supports Nintendo Switc...",Warehouse B,68,59,2025-02-15 06:43:00,9
17521,ORD_17522,3821,Metcold Tablet,Warehouse A,48,39,2025-02-15 21:53:00,9
17522,ORD_17523,13720,"Plastic Foot File/Callus Remover - Green, BB1211GRN",Warehouse A,97,91,2025-02-15 17:28:00,6
17523,ORD_17524,30102,Zithobrex 500 Tablet,Warehouse C,98,84,2025-02-15 16:23:00,14
17524,ORD_17525,34972,Mcaffeine Naked & Raw Cappuccino Coffee Hair Mask 200 gm,Warehouse C,106,88,2025-02-15 17:22:00,18
17525,ORD_17526,31096,Rabicure 20mg Tablet,Warehouse B,33,15,2025-02-15 13:55:00,18
17526,ORD_17527,248,"Mi Xiaomi 22.5W Fast USB Type C Charger Combo|Compatible for Mobile,Power Banks|Fast Charging|(Adapter + USB to Type C Cab...",Warehouse A,94,82,2025-02-15 08:27:00,12
17527,ORD_17528,3578,Soulflower Hexagon Bath Set With Lavender 1300 gm,Warehouse B,76,64,2025-02-15 07:12:00,12
17528,ORD_17529,31735,Snazzy Bamboo Wood Foldable Portable Adjustable Height Multipurpose Laptop Table Lap Desk/Study Table/Writing Utility Tabl...,Warehouse B,91,74,2025-02-15 04:58:00,17
17529,ORD_17530,30585,Amozo Frameless Slim Design Translucent Matte Back Case Cover for iPhone 13 (Polycarbonate|Blue),Warehouse B,80,66,2025-02-15 02:08:00,14
17530,ORD_17531,14303,Macefxone IV 1000mg Injection,Warehouse B,47,39,2025-02-15 01:13:00,8
17531,ORD_17532,30593,Navneet Youva | Primed Canvas Board for Acrylic and Oil Colour Painting | 10x12 inch | Pack of 3,Warehouse C,32,15,2025-02-15 04:11:00,17
17532,ORD_17533,14175,"boAt Smart Watch Charging Cable Xtend, Storm Xplorer Smartwatches (Black)",Warehouse B,30,23,2025-02-15 22:39:00,7
17533,ORD_17534,3673,Seven Seas Eyeliner & Mascara 2 in 1,Warehouse A,95,85,2025-02-15 00:46:00,10
17534,ORD_17535,14028,"Bliss Of Earth Raw Organic African Cocoa Butter Raw For Body Lotion, Stretch Marks, Chocolate Making, Lip Balms, DIY Cream...",Warehouse B,84,72,2025-02-15 15:54:00,12
17535,ORD_17536,15650,"Western Digital 2TB WD Blue PC Hard Drive - 7200 RPM Class, SATA 6 Gb/s, 256 MB Cache, 3.5"" - WD20EZBX",Warehouse B,90,77,2025-02-15 08:10:00,13
17536,ORD_17537,31379,Revlon Outrageous Color Protection Conditioner 190 Ml,Warehouse C,92,86,2025-02-15 05:36:00,6
17537,ORD_17538,15486,Giamox CV LB 500mg/125mg Tablet,Warehouse A,85,67,2025-02-15 11:13:00,18
17538,ORD_17539,12784,Arodec 50mg Injection,Warehouse A,65,49,2025-02-15 12:24:00,16
17539,ORD_17540,244,"SanDisk iXpand USB 3.0 Flash Drive Flip 64GB, for iOS and Windows, Metalic",Warehouse C,92,86,2025-02-15 13:40:00,6
17540,ORD_17541,13191,Maryaj Pebble Shine EDP Floral Fruity Perfume And Ajmal Sacred Love Deodorant Floral Musky Fragrance 300 ml,Warehouse B,77,61,2025-02-15 21:51:00,16
17541,ORD_17542,36442,Koffset DX Syrup Sugar Free,Warehouse A,48,37,2025-02-15 22:49:00,11
17542,ORD_17543,30276,Tadablis-DX Tablet,Warehouse B,19,12,2025-02-15 15:15:00,7
17543,ORD_17544,12280,MISS DOLLMakeup Sponge Beauty Blender Puff + Beauty New Fit Me Matte-Pore-less Liquid Tube Foundation Natural With 36h Eye...,Warehouse C,44,31,2025-02-15 09:01:00,13
17544,ORD_17545,3666,"Silicone Rubber Earbuds Tips, Eartips, Earpads, Earplugs, for Replacement in Earphones and Bluetooth Medium Size (10 Pcs B...",Warehouse C,14,8,2025-02-15 16:47:00,6
17545,ORD_17546,12281,"Body Bath+Scrub - Orange, Peach Essence",Warehouse C,49,33,2025-02-15 11:47:00,16
17546,ORD_17547,36690,Organic Ashwagandha,Warehouse A,118,99,2025-02-15 13:23:00,19
17547,ORD_17548,311,Ajmal Aurum EDP Fruity Floral Perfume 75ml for Women and Wisal EDP Floral Musky Perfume 50ml for Women +1 Perfume Tester FREE,Warehouse A,103,88,2025-02-15 04:15:00,15
17548,ORD_17549,12997,TULMAN 50Pcs Transparent A4 Size Document Sleeves 150 Micron Thickness Leaf Waterproof Clear Sheet Protector 11 Holes Punc...,Warehouse B,113,99,2025-02-15 05:19:00,14
17549,ORD_17550,30277,"Pudaier Liquid Eyeshadow, Long Lasting, Waterproof, Smudge Proof Colour Number 03",Warehouse A,10,3,2025-02-15 15:47:00,7
17550,ORD_17551,13688,Allure Powder Brush - (104) 1's,Warehouse C,44,35,2025-02-15 17:21:00,9
17551,ORD_17552,31084,Bruzol-O Capsule,Warehouse A,109,93,2025-02-15 03:18:00,16
17552,ORD_17553,31604,"PTron Boom Ultima V2 Dual Driver, in Ear Gaming Wired Earphones with Mic, Volume Control, Passive Noise Cancelling Boom 3 ...",Warehouse B,35,25,2025-02-15 21:16:00,10
17553,ORD_17554,12179,Spigen Liquid Air Back Cover Case Compatible For Google Pixel 6a (TPU | Midnight Green),Warehouse B,12,1,2025-02-15 06:17:00,11
17554,ORD_17555,10436,Parawal 250mg Syrup,Warehouse A,67,50,2025-02-15 23:41:00,17
17555,ORD_17556,35561,"PERPAA® Power Stay Liquid Matte Lipstick - Waterproof Combo of 2(Long Hrs Stay) (Apple Red , Cherry Red, Pack of 2)",Warehouse B,96,91,2025-02-15 16:53:00,5
17556,ORD_17557,22617,"Spigen TPU Rugged Armor Back Cover, Compatible for Samsung Galaxy S21 FE 5G - Matte Black",Warehouse B,101,87,2025-02-15 06:19:00,14
17557,ORD_17558,26000,MI 80 cm (32 inches) HD Ready Smart Android LED TV 5A Pro | L32M7-EAIN (Black),Warehouse C,24,7,2025-02-15 00:52:00,17
17558,ORD_17559,22628,Nature's Essence Acne Magic Clear Skin Gel Face Wash 100 ml,Warehouse B,21,2,2025-02-15 08:36:00,19
17559,ORD_17560,8073,Ajmal CD 99 Mukhallat Concentrated Perfume Oil Floral Oriental And Blu Homme Deodorant Aquatic Woody Fragrance 214 ml,Warehouse B,35,26,2025-02-15 02:01:00,9
17560,ORD_17561,8065,"Xiran Mobile Phone Stand Holder, 04PCS Mobile Holder Stand, Wall Mounted Mobile Phone Holder, Mobile Phone Stand Holder (P...",Warehouse A,99,89,2025-02-15 18:47:00,10
17561,ORD_17562,10385,Revlon Colorstay Gel Envy Long Wear Nail Enamel - Lovestuck 11.6 Ml,Warehouse B,9,3,2025-02-15 01:11:00,6
17562,ORD_17563,15629,Onsitego 1 Year Extended Warranty for Small Home & Kitchen Appliances from Rs. 4001-5000 (Email Delivery - No Physical Kit),Warehouse B,47,32,2025-02-15 06:14:00,15
17563,ORD_17564,998,Flormar Diamonds Baked Eye Shadow D06 Golden Eyes 5 gm,Warehouse B,60,50,2025-02-15 18:25:00,10
17564,ORD_17565,32472,Mtaz Cream,Warehouse A,86,68,2025-02-15 02:53:00,18
17565,ORD_17566,26120,Homcet DP 5mg/500mg/5mg Tablet,Warehouse A,58,49,2025-02-15 20:55:00,9
17566,ORD_17567,28247,Glimiprime M 3 Tablet,Warehouse C,23,15,2025-02-15 13:23:00,8
17567,ORD_17568,18802,"Portronics Harmonics Twins S3 Smart TWS Bluetooth 5.2 Earbuds with 20 Hrs Playtime, 8 MM Drivers, Lightweight Earbuds(Black)",Warehouse C,21,14,2025-02-15 06:51:00,7
17568,ORD_17569,18789,Safe Sun Intensive Sunblock Spray SPF 50 Uva Index -16,Warehouse C,39,25,2025-02-15 14:02:00,14
17569,ORD_17570,18460,Faces Canada Belle De Luxe Nail Enamel Russian Maroon 63 9 Ml,Warehouse B,93,80,2025-02-15 06:03:00,13
17570,ORD_17571,10417,Acesac P Tablet,Warehouse A,62,53,2025-02-15 14:40:00,9
17571,ORD_17572,35554,Clotrin Mouth Paint,Warehouse A,97,85,2025-02-15 19:15:00,12
17572,ORD_17573,955,Woman - Urban Musk Eau De Toilette Deodorant,Warehouse A,93,75,2025-02-15 19:15:00,18
17573,ORD_17574,956,Glavira M 500mg/50mg Tablet,Warehouse C,34,17,2025-02-15 00:43:00,17
17574,ORD_17575,34239,"Mexa Keyboard Bag Compatible With Yamaha PSR-E363, E373, E473, E463, I455, I425, I400, I500 Keyboard & Casio CT-X700, X870...",Warehouse A,33,15,2025-02-15 19:49:00,18
17575,ORD_17576,18525,Ajmal Mukhallat Raaqi Concentrated Perfume Oil Floral Fruity And Avid Homme Deodorant Aquatic Woody Fragrance 210 ml,Warehouse C,21,11,2025-02-15 23:37:00,10
17576,ORD_17577,18621,Sunaina Bridal Collection Yellow Bindi for Women [SBCY105] (size-5) (Size 4mm),Warehouse C,91,75,2025-02-15 02:42:00,16
17577,ORD_17578,8140,"ZEBRONICS Zeb-Bro in Ear Wired Earphones with Mic, 3.5mm Audio Jack, 10mm Drivers, Phone/Tablet Compatible(Blue)",Warehouse C,19,5,2025-02-15 14:31:00,14
17578,ORD_17579,10362,Vomgee 4mg Tablet MD,Warehouse A,51,37,2025-02-15 19:30:00,14
17579,ORD_17580,35533,SELLORIA Boy's Black Analogue Stainless Steel Watch with Black Sunglass with Baseball Cap Black,Warehouse B,63,51,2025-02-15 05:44:00,12
17580,ORD_17581,18556,"Note Mattemoist Lipstick 316, Red, 4.5g",Warehouse A,83,66,2025-02-15 09:05:00,17
17581,ORD_17582,34278,Juniper Berry Oil Free Moisturiser,Warehouse B,39,26,2025-02-15 16:04:00,13
17582,ORD_17583,2259,"Camel Soft Pastels, 36 Shades (Multicolor)",Warehouse A,58,45,2025-02-15 17:26:00,13
17583,ORD_17584,965,Xeronac-P Tablet,Warehouse A,66,57,2025-02-15 17:13:00,9
17584,ORD_17585,6113,Wildcraft Shutter Bug Camera Backpack - Black,Warehouse C,68,62,2025-02-15 17:37:00,6
17585,ORD_17586,28262,Safekast-L Tablet,Warehouse B,19,14,2025-02-15 12:23:00,5
17586,ORD_17587,990,Hivir 100mg Tablet,Warehouse A,102,87,2025-02-15 05:40:00,15
17587,ORD_17588,33118,Clavoixi LB 500mg/125mg Tablet,Warehouse B,26,20,2025-02-15 11:42:00,6
17588,ORD_17589,22373,Vasaka Leaves Powder - Supports Healthy Respiratory Function & As Bronchodialator,Warehouse A,71,66,2025-02-15 02:48:00,5
17589,ORD_17590,30111,Refreshing Haldi Chandan Body Lotion,Warehouse A,55,40,2025-02-15 17:25:00,15
17590,ORD_17591,36753,Jwarshoonya Tablets,Warehouse B,53,42,2025-02-15 01:56:00,11
17591,ORD_17592,12734,Badam Tail - 100% Pure Almond Oil,Warehouse C,88,78,2025-02-15 07:50:00,10
17592,ORD_17593,14720,7SEVEN™ Bluetooth Voice Command Remote Compatible for oneplus Remote | 1+ Android TV Remote | one plus tv Remote with Netf...,Warehouse B,82,69,2025-02-15 01:24:00,13
17593,ORD_17594,10053,"ZEBRONICS Zeb-DUKE1 Wireless Bluetooth 5.0 Over Ear Headphone with Voice Assistant, AUX Port, Call Function, 34Hrs* Batter...",Warehouse C,69,62,2025-02-15 15:23:00,7
17594,ORD_17595,36427,Lady Bladder Control Pads - Normal,Warehouse A,14,6,2025-02-15 03:15:00,8
17595,ORD_17596,18740,REALCASE Designed for iPhone 14 Pro Back Cover Case | Stylish Frameless Matte Hard Skin | Soft TPU Shock Proof Bumper Back...,Warehouse B,41,27,2025-02-15 16:15:00,14
17596,ORD_17597,10287,Active Fresh Gel Toothpaste,Warehouse A,29,15,2025-02-15 12:13:00,14
17597,ORD_17598,18656,Belora Paris Serum No Acne Clean Skin (Serum Sans Acne) 30 ml,Warehouse C,31,26,2025-02-15 02:22:00,5
17598,ORD_17599,8206,Vyosef O 200mg Tablet,Warehouse B,62,57,2025-02-15 22:11:00,5
17599,ORD_17600,28324,Hand Soap - Lemon Extract,Warehouse C,106,92,2025-02-15 21:44:00,14
17600,ORD_17601,10266,Robustrion Hard Shell Case Cover for Apple MacBook Air 13 inch [2020 2019 2018 Release] M1 A2337 A2179 with Retina Display...,Warehouse C,65,60,2025-02-15 21:58:00,5
17601,ORD_17602,22374,"pTron Bassbuds Wave ENC Bluetooth 5.3 Truly Wireless in Ear Earbuds, 40Hrs Total Playtime, Movie Mode & Deep Bass, Low Lat...",Warehouse C,20,13,2025-02-15 11:17:00,7
17602,ORD_17603,18694,"Revolution Relove Supermatte Foundation F8.5 Full Coverage Foundation Makeup, Liquid Cream, Lightweight Long Lasting Cover...",Warehouse C,31,20,2025-02-15 14:41:00,11
17603,ORD_17604,10258,"NISUN Webcam Cover Slider,Ultra Thin Laptop Camera Cover Slider Blocker Compatible for Notebook Laptop PC & Smartphone Mob...",Warehouse C,88,73,2025-02-15 01:12:00,15
17604,ORD_17605,28264,Mofel K Eye Drop,Warehouse C,74,64,2025-02-15 03:17:00,10
17605,ORD_17606,8211,Onsitego 2 Year Extended Warranty for Small Household Appliances from Rs. 2001-2500 (Email Delivery - No Physical Kit),Warehouse C,71,57,2025-02-15 22:46:00,14
17606,ORD_17607,10238,2022 New Cleaner Kit for Keyboard Soft Brush 5 in 1 Multifunction Computer Cleaning Tools Kit with Keycap Puller (Red),Warehouse B,100,83,2025-02-15 22:51:00,17
17607,ORD_17608,10236,Synotin D Tablet,Warehouse B,68,52,2025-02-15 03:31:00,16
17608,ORD_17609,22364,Itraque 100 Capsule,Warehouse B,17,10,2025-02-15 23:59:00,7
17609,ORD_17610,22359,Sugarcrush Clutch for Women Hand Clutches for Girls Printed Box Clutch,Warehouse B,102,94,2025-02-15 03:13:00,8
17610,ORD_17611,10233,"Fashion Colour Non - Transfer Matt Waterproof Lipstick, 35 Peach Bloom 2.6 gm",Warehouse B,108,91,2025-02-15 17:09:00,17
17611,ORD_17612,18633,"boAt Stone 1208 Bluetooth Speaker with Upto 9 Hours Playback, RGB LEDs, True Wireless Feature, Carry Strap, IPX7 and Ergon...",Warehouse C,82,65,2025-02-15 05:18:00,17
17612,ORD_17613,10230,Flunus 150mg Capsule,Warehouse C,114,95,2025-02-15 02:25:00,19
17613,ORD_17614,26167,Chambor Gel Effectnail Lacquer Must Haves - 0317 30 ml,Warehouse B,30,21,2025-02-15 00:58:00,9
17614,ORD_17615,10222,Gliss Hair Repair Conditioner Color Protect & Shine,Warehouse A,47,30,2025-02-15 12:08:00,17
17615,ORD_17616,4921,Sparflex-P Tablet,Warehouse B,72,65,2025-02-15 09:05:00,7
17616,ORD_17617,18771,Tels AM 40mg/5mg Tablet,Warehouse A,52,34,2025-02-15 10:00:00,18
17617,ORD_17618,10214,"Maybelline New York Color Sensational Creamy Matte, 630 Flaming Fuchsia, 3.9g with FREE Color Sensational Creamy Matte 507...",Warehouse C,44,38,2025-02-15 11:07:00,6
17618,ORD_17619,26168,"GLink 2.0 GS-001 Multimedia Speaker with Aux Connectivity, USB Powered and Volume Control for PC/Laptops/Desktop/Mobile an...",Warehouse B,55,46,2025-02-15 01:03:00,9
17619,ORD_17620,13703,Pierre Cardin Paris - Natural Look Foundation 412-Fair,Warehouse B,92,78,2025-02-15 20:28:00,14
17620,ORD_17621,12558,Spnpod 50 Dry Syrup,Warehouse A,39,34,2025-02-15 05:53:00,5
17621,ORD_17622,18581,Serchcef-O Injection,Warehouse B,108,96,2025-02-15 10:13:00,12
17622,ORD_17623,14083,Ankita Black Carbon Rat tail Combs (937),Warehouse A,103,92,2025-02-15 19:24:00,11
17623,ORD_17624,15352,Artamin 250mg Capsule,Warehouse B,82,75,2025-02-15 14:06:00,7
17624,ORD_17625,13212,Cello Signature Creme Ivory Ball Pen | Blue Ball Pen | Pack of 1 | Best Ball Pen for Smooth Writing | Gifting Pens | Premi...,Warehouse B,58,47,2025-02-15 11:47:00,11
17625,ORD_17626,31462,Raypod O 200mg/200mg Tablet,Warehouse C,50,40,2025-02-15 02:32:00,10
17626,ORD_17627,14093,Passion Indulge MOISTURE - ALOE TREE 50 gm,Warehouse B,20,14,2025-02-15 00:26:00,6
17627,ORD_17628,31589,Daily Perfume Hand Cream Grapefruit,Warehouse A,16,3,2025-02-15 21:05:00,13
17628,ORD_17629,12578,(Renewed) JBL Tune 215BT Wireless Bluetooth In Ear Headphone with Mic (Blue),Warehouse A,85,75,2025-02-15 05:55:00,10
17629,ORD_17630,37079,"Ambrane Unbreakable 60W / 3A Fast Charging 1.5m Braided Type C Cable for Smartphones, Tablets, Laptops & other Type C devi...",Warehouse C,81,68,2025-02-15 06:42:00,13
17630,ORD_17631,14486,Gastric Gel Tablet,Warehouse C,40,29,2025-02-15 06:02:00,11
17631,ORD_17632,13242,"Red Square Professional 250 Ml Empty Spray Bottles Clean Squirt BottleTransprent Multi-uses Spray Bottles for Cleaning, Wa...",Warehouse C,18,9,2025-02-15 21:21:00,9
17632,ORD_17633,30243,Tooth Brush Cross Action Power - Soft (Battery Brush),Warehouse C,115,97,2025-02-15 14:44:00,18
17633,ORD_17634,12064,Kacelo P 100mg/325mg Tablet,Warehouse B,65,50,2025-02-15 14:12:00,15
17634,ORD_17635,12716,Nothing Phone 1 Charger Adapter 25 Watt Original Adaptor | Alternate for 45w & 33w (MAX 25 Watt) Compatible Charger | 1.5%...,Warehouse A,87,74,2025-02-15 01:45:00,13
17635,ORD_17636,3278,Uncle Tony Shaving Razor - Red,Warehouse A,60,51,2025-02-15 16:05:00,9
17636,ORD_17637,13643,Neomol 170 Anal Suppository,Warehouse A,33,27,2025-02-15 23:07:00,6
17637,ORD_17638,15462,Amozo Ultra Hybrid Defence Back Case Cover for iPhone 13 (Polycarbonate|Matte Black),Warehouse A,85,72,2025-02-15 13:03:00,13
17638,ORD_17639,14689,Cross 8521 Rolling Ball Pen Refill (Blue),Warehouse B,44,36,2025-02-15 08:04:00,8
17639,ORD_17640,13666,House of Aroma Kiwi Fragrance Oil 100 ml,Warehouse B,91,83,2025-02-15 05:35:00,8
17640,ORD_17641,14760,Nokia 105 Single SIM (Blue),Warehouse A,30,12,2025-02-15 15:54:00,18
17641,ORD_17642,14730,AEIDESS Tempered Glass Screen Protector Compatible for OnePlus 6T / OnePlus 7 with Edge to Edge Coverage and Easy Installa...,Warehouse A,27,12,2025-02-15 22:25:00,15
17642,ORD_17643,31018,Etowin PG 75mg/60mg Tablet,Warehouse A,82,63,2025-02-15 08:59:00,19
17643,ORD_17644,15679,Gogo 500mg/125mg Tablet,Warehouse A,89,81,2025-02-15 16:16:00,8
17644,ORD_17645,12312,"Amazon Basics USB Type-C to USB-A 2.0 Male Fast Charging Cable for Laptop - 9 Feet (2.7 Meters), Black",Warehouse A,15,3,2025-02-15 21:09:00,12
17645,ORD_17646,13263,"E-Zilla Ring Lights 10"" Portable LED Selfie Lights (26cm) for Camera, Phone, TIK Tok, YouTube Video Shooting. Makeup Ring ...",Warehouse B,20,4,2025-02-15 08:38:00,16
17646,ORD_17647,30822,Stanosafe 2mg Tablet,Warehouse C,17,1,2025-02-15 18:34:00,16
17647,ORD_17648,14216,"TECKO Watch S8 Ultra Bluetooth Calling Series 8 2inch Big AMOLED Display with All Sports Features & Health Tracker, Unisex...",Warehouse B,29,12,2025-02-15 05:18:00,17
17648,ORD_17649,36776,House of Aroma Champaka Fragrance Oil 10 ml,Warehouse A,52,35,2025-02-15 22:30:00,17
17649,ORD_17650,31798,"Amosfia Natural Concealer Makeup for Women Eye Dark Circles Concealer (NATURAL BEIGE, 6 ml)",Warehouse C,94,75,2025-02-15 08:15:00,19
17650,ORD_17651,36842,Flormar Full Color Nail Enamel FC46 Rose Pumps 8 ml,Warehouse B,66,51,2025-02-15 07:36:00,15
17651,ORD_17652,3015,Brahmi Powder - Supports As Sensory Organ Tonic Especially For Speech Disability,Warehouse C,96,90,2025-02-15 19:21:00,6
17652,ORD_17653,30945,Superdrug Spa Hydrating Face Sheet Mask 16 gm,Warehouse C,94,81,2025-02-15 13:01:00,13
17653,ORD_17654,14074,Ronemox CV 500mg/125mg Tablet,Warehouse A,44,33,2025-02-15 14:34:00,11
17654,ORD_17655,12170,Naturally Long Shikakai Shampoo,Warehouse A,108,94,2025-02-15 00:24:00,14
17655,ORD_17656,14079,Prolet Cute 3D Bulldog Fashion Character Silicone Case for Airpods Pro Headphones with Keychain (D-Red),Warehouse A,24,16,2025-02-15 07:12:00,8
17656,ORD_17657,31365,EGOTUDE Shock Proof Hard Back Soft Air Corner Bumper Anti-Scratch Cover Case for iPhone 12 & iPhone 12 Pro 6.1 inch (Trans...,Warehouse A,72,66,2025-02-15 17:00:00,6
17657,ORD_17658,31305,Prazowell-DSR Capsule,Warehouse A,97,90,2025-02-15 00:03:00,7
17658,ORD_17659,12563,Karpooradi Oil,Warehouse A,88,79,2025-02-15 05:47:00,9
17659,ORD_17660,31364,Mcaffeine Mulberry Silk Eye Mask 1's,Warehouse C,29,11,2025-02-15 09:56:00,18
17660,ORD_17661,30269,SanDisk Ultra CZ48 16GB USB 3.0 Pen Drive (Black),Warehouse C,30,24,2025-02-15 19:35:00,6
17661,ORD_17662,13371,Soflocin 200mg Tablet,Warehouse A,78,60,2025-02-15 17:23:00,18
17662,ORD_17663,31300,Eyecirque Under Eye Gel Serum,Warehouse B,46,34,2025-02-15 13:54:00,12
17663,ORD_17664,12577,Pilgrim Korean Beauty White Lotus Refreshing Face Mist & Toner | Toner for glowing skin | Alcohol-Free Mist & toner for op...,Warehouse B,38,28,2025-02-15 21:29:00,10
17664,ORD_17665,12984,TheGiftKart Shockproof Crystal Clear Back Cover Case for Samsung Galaxy A33 5G | 360 Degree Protection | Protective Design...,Warehouse A,94,88,2025-02-15 09:22:00,6
17665,ORD_17666,15431,Normadate 50mg Tablet,Warehouse A,74,63,2025-02-15 06:21:00,11
17666,ORD_17667,30805,Handwash - Mild,Warehouse C,46,36,2025-02-15 11:27:00,10
17667,ORD_17668,332,Azithcure 200mg Oral Suspension,Warehouse A,30,17,2025-02-15 03:47:00,13
17668,ORD_17669,3423,"Ultra Night Sanitary Pads For Women - XXXL+, Koala Soft",Warehouse C,60,51,2025-02-15 15:34:00,9
17669,ORD_17670,13596,Mamaearth Anti Mosquito Body Roll On 40 ml,Warehouse A,29,23,2025-02-15 00:45:00,6
17670,ORD_17671,14152,"HUDA GIRL BEAUTY Original Jaclyn Hill Makeup Eyeshadow - Long Lasting Waterproof Shades for Girls, Multicolor, Matte and S...",Warehouse C,79,69,2025-02-15 15:40:00,10
17671,ORD_17672,36514,Police Imperial Patchouli Mens EDT 100ml,Warehouse C,64,54,2025-02-15 18:24:00,10
17672,ORD_17673,30205,"Qianlink USB Type C to 3.5mm Headphone Jack, Upgrade 32bit Hi-Fi Sound USB Type C to Audio Adapter Cable Pixel 2/2XL/3/3X...",Warehouse B,19,5,2025-02-15 19:08:00,14
17673,ORD_17674,12233,"Huion H610Pro V2 Digital Drawing Tablet Graphic Pen Tablet 10"" x 6.25"", 8192 Pressure Sensitivity with Battery-Free Stylus...",Warehouse A,57,42,2025-02-15 17:45:00,15
17674,ORD_17675,12778,"JioFi Jio Phone Next 32 GB ROM, 2 GB RAM, Blue, Smartphone",Warehouse C,17,5,2025-02-15 06:01:00,12
17675,ORD_17676,116,Berina Hair Treatment Spa 250 gm,Warehouse A,45,27,2025-02-15 08:49:00,18
17676,ORD_17677,31465,"PRAUSH (Formerly Plume) Plush Matte Lipsticks - Super Light And Hydrating, Long Lasting, Rich Pigment, Smooth Soft Matte F...",Warehouse B,20,13,2025-02-15 18:49:00,7
17677,ORD_17678,14779,Medimade Revitalizing Conditioner With Coconut Milk (Pack of 2) 1's,Warehouse C,19,4,2025-02-15 22:51:00,15
17678,ORD_17679,30695,Flormar Kiss Me More Lip Tattoo 05 Blush 3.8 gm,Warehouse A,32,13,2025-02-15 12:27:00,19
17679,ORD_17680,3282,Nasone SP 100mg/325mg/10mg Tablet,Warehouse A,78,67,2025-02-15 01:36:00,11
17680,ORD_17681,14068,Gatiray 0.3% Eye Drop,Warehouse A,49,30,2025-02-15 10:48:00,19
17681,ORD_17682,30082,DGM-Drive Tablet,Warehouse A,23,17,2025-02-15 22:42:00,6
17682,ORD_17683,15426,Biomet GP 1mg/500mg Tablet SR,Warehouse B,11,1,2025-02-15 15:14:00,10
17683,ORD_17684,327,Ciroxine 125mg Dry Syrup,Warehouse B,51,40,2025-02-15 13:55:00,11
17684,ORD_17685,3496,"Boult Audio Z15 with 32Hrs Playtime, Pro+Calling HD Mic, Type-C Lightning Boult™ Fast Charging (10mins=100Mins), BoomX™ Te...",Warehouse B,96,91,2025-02-15 07:30:00,5
17685,ORD_17686,31218,Wottagirl! Fragrant Body Splash - Vanilla Twist,Warehouse C,77,63,2025-02-15 18:19:00,14
17686,ORD_17687,30483,Ajmal 2 Carbon And 2 Nightingale Deodorants Pack of 4 200 ml,Warehouse C,32,16,2025-02-15 12:10:00,16
17687,ORD_17688,3027,"Portronics My Buddy K Portable Laptop Stand with Adjustable Height, Foldable, OverHeating Protection for Laptops & MacBook...",Warehouse A,81,68,2025-02-15 01:59:00,13
17688,ORD_17689,31173,Ajmal Blu & Sacrifice II Him Deo & Aretha EDP Pack of 3 20 ml,Warehouse A,64,59,2025-02-15 13:13:00,5
17689,ORD_17690,13097,Iffcold Tablet,Warehouse C,79,61,2025-02-15 14:40:00,18
17690,ORD_17691,3514,Vogipax M 0.3 Tablet SR,Warehouse A,48,36,2025-02-15 22:31:00,12
17691,ORD_17692,12398,Dpine 5mg Tablet,Warehouse A,50,32,2025-02-15 12:44:00,18
17692,ORD_17693,30406,Breetel AT Tablet,Warehouse A,39,32,2025-02-15 01:34:00,7
17693,ORD_17694,36770,Candicute B Cream,Warehouse C,83,65,2025-02-15 01:13:00,18
17694,ORD_17695,12401,Ansicalm Plus 0.5mg/10mg Tablet,Warehouse A,53,48,2025-02-15 12:02:00,5
17695,ORD_17696,14271,"Fashion Colour Vivid Matte Lipstick, 22 Barbie Pink 3.8 gm",Warehouse B,51,45,2025-02-15 19:59:00,6
17696,ORD_17697,14599,MI Compact Bluetooth Speaker 2 with in-Built mic and up to 6hrs Battery (White),Warehouse B,37,21,2025-02-15 09:40:00,16
17697,ORD_17698,14249,Latest Universal Travel Adapter Worldwide Travel Adapter with Built in Dual USB Charger Ports (Universal Travel Adapter) (...,Warehouse C,23,6,2025-02-15 13:06:00,17
17698,ORD_17699,36624,Organic Cotton Pads - Medium,Warehouse C,108,97,2025-02-15 09:13:00,11
17699,ORD_17700,13833,Damage Repair Protein Conditioner,Warehouse A,97,83,2025-02-15 14:54:00,14
17700,ORD_17701,3367,"Rey Naturals® tea tree oil & Rosemary essential oils - Pure 100% Natural for Healthy Skin, Face, and Hair (15 ml + 15 ml)",Warehouse C,12,4,2025-02-15 19:31:00,8
17701,ORD_17702,12679,"REDTECH One Plus Latest Mobile USB Type C to 3.5 mm Jack Audio Connector, Noise Cancelling Headphones Jack Converter Audio...",Warehouse C,22,13,2025-02-15 10:51:00,9
17702,ORD_17703,14230,"Beard & Face Wash - No SLS, Sulphate, Parabens",Warehouse C,11,2,2025-02-15 14:25:00,9
17703,ORD_17704,31679,Bella Voste Sand Holo Nail Paints Vibrant Royal Blue - 412 10 ml,Warehouse A,112,94,2025-02-15 04:25:00,18
17704,ORD_17705,14587,Insight Cosmetics Non Transfer Matte Lipstick - Dagger 4.2 gm,Warehouse B,40,29,2025-02-15 11:20:00,11
17705,ORD_17706,15062,Glimmer Premium Nail Enamel Militarygreen 10 ml,Warehouse B,73,57,2025-02-15 23:06:00,16
17706,ORD_17707,31210,Handwash - Herbal,Warehouse A,92,75,2025-02-15 00:22:00,17
17707,ORD_17708,3339,Avertru 1% Dusting Powder,Warehouse A,90,72,2025-02-15 09:56:00,18
17708,ORD_17709,13812,Brivepsy 50mg Tablet,Warehouse A,72,55,2025-02-15 02:04:00,17
17709,ORD_17710,30386,Sidzox 8 Capsule,Warehouse B,61,46,2025-02-15 06:16:00,15
17710,ORD_17711,12368,"Veet Hair Removal Cream 100 g + Full Body Waxing Kit, 20s for Normal Skin",Warehouse A,75,62,2025-02-15 03:29:00,13
17711,ORD_17712,14263,HOBBACHI Smart Watch Fitness Band Smart Watch- Y68 D20 Water Proof Smart Watches SpO2 Full Touch Smartwatch with Workout M...,Warehouse B,47,36,2025-02-15 10:36:00,11
17712,ORD_17713,36586,"DIGITEK® (DRL-15C RGB) LED RGB Ring Light with Stand for YouTube, Photo-Shoot, Video Shoot, Live Stream, Makeup & More, Co...",Warehouse A,67,60,2025-02-15 22:44:00,7
17713,ORD_17714,14591,Ocyp T Syrup,Warehouse C,75,59,2025-02-15 17:44:00,16
17714,ORD_17715,36883,Tiscold Tablet,Warehouse B,77,61,2025-02-15 00:12:00,16
17715,ORD_17716,30878,Moxipil CV 500 mg/125 mg Tablet,Warehouse C,63,55,2025-02-15 07:59:00,8
17716,ORD_17717,13305,Metwin XL 50mg Tablet,Warehouse A,95,82,2025-02-15 15:32:00,13
17717,ORD_17718,31859,Pelmic-SP Tablet,Warehouse C,14,6,2025-02-15 01:55:00,8
17718,ORD_17719,12861,Spigen EZ Fit Optik Pro Tempered Glass Camera Lens Protector Guard for iPhone 14 Pro / 14 Pro Max (Gold) - 2 Pack,Warehouse B,61,53,2025-02-15 07:44:00,8
17719,ORD_17720,13460,Fastrack Reflex Play +|BT Calling|1.3” AMOLED Display Smartwatch with AOD|Premium Metallic Body|AI Voice Assistant|In-Buil...,Warehouse A,97,88,2025-02-15 07:51:00,9
17720,ORD_17721,13827,Sony TV - Remote Compatible for Sony LED Remote Control Works with Sony LED TV by Trend Trail Speed tech & Remote hi Remot...,Warehouse B,102,94,2025-02-15 08:40:00,8
17721,ORD_17722,36649,Conivog 0.3mg Tablet,Warehouse B,89,73,2025-02-15 14:39:00,16
17722,ORD_17723,36980,"Men Deserve - Hair Pomade for Men (100g) | Strong Hold and Wet Look | Paraben, Sulphate, and Petroleum Jelly Free | Enrich...",Warehouse C,106,89,2025-02-15 09:01:00,17
17723,ORD_17724,31411,Deep Radiance Serum With Vitamin C,Warehouse B,60,47,2025-02-15 23:21:00,13
17724,ORD_17725,12857,Pantosin 40mg Tablet,Warehouse B,38,33,2025-02-15 21:29:00,5
17725,ORD_17726,36582,"Bose SoundLink Flex Bluetooth Portable Speaker, Wireless Waterproof Speaker for Outdoor Travel - Stone Blue",Warehouse A,80,74,2025-02-15 19:44:00,6
17726,ORD_17727,12888,Caricin Tablet,Warehouse C,91,74,2025-02-15 20:24:00,17
17727,ORD_17728,14265,Teliscope 20mg Tablet,Warehouse C,15,8,2025-02-15 14:16:00,7
17728,ORD_17729,15008,Santuss Syrup,Warehouse B,78,72,2025-02-15 03:29:00,6
17729,ORD_17730,15006,"Glowy Multi Shades 18 Colours Nude Edition Eyeshadow Palette, Matte & Shimmery Finish",Warehouse C,104,95,2025-02-15 00:11:00,9
17730,ORD_17731,12124,7SEVEN® TCL Remote Control Smart TV RC802V Remote Compatible for TCL TV Remote Original 55EP680 40A325 49S6500 55P8S 55P8 ...,Warehouse B,34,18,2025-02-15 19:13:00,16
17731,ORD_17732,3735,Envie Charger NEXA ECR 30 Smart Charge Control Charger System for AA & AAA & 9V Rechargeable Batteries,Warehouse B,89,71,2025-02-15 04:31:00,18
17732,ORD_17733,31567,V CAN YS Wired In Ear Earphones with Ultra Bass & Dolby Sound 0.33mm Jack for All Samsung/Anroid/ iOS Devices - (White),Warehouse A,47,35,2025-02-15 00:15:00,12
17733,ORD_17734,3720,Amzaris 250mg Capsule,Warehouse C,87,79,2025-02-15 08:43:00,8
17734,ORD_17735,30119,Credtree T 60mg/4mg Tablet,Warehouse A,57,52,2025-02-15 01:47:00,5
17735,ORD_17736,3925,Zovimax CV 500mg/125mg Tablet,Warehouse A,93,84,2025-02-15 04:51:00,9
17736,ORD_17737,36767,"UN1QUE X3 Mini Portable Fan - Powerful Handheld Table Fan with Base, 3-Speed, Noise-Canceling Design, Lightweight, USB Rec...",Warehouse C,48,42,2025-02-15 01:21:00,6
17737,ORD_17738,3535,"EPOS Sennheiser PC 8 Over-Ear USB, Wired VOIP Headphone with Mic (Black)",Warehouse B,21,2,2025-02-15 21:20:00,19
17738,ORD_17739,31801,Axocold DX Suspension,Warehouse C,78,69,2025-02-15 18:55:00,9
17739,ORD_17740,3451,"DR VAKU® 20W iPhone Charger Type C Adapter for Phone 14/ 14 Plus/ 14 Pro/ 14 Pro Max, iPhone 13/13 Pro/13 Pro Max/13 Mini,...",Warehouse A,60,54,2025-02-15 00:09:00,6
17740,ORD_17741,37025,"Fashion Colour Professional Makeup Kit, 2480 - 1 191 gm",Warehouse B,56,43,2025-02-15 05:23:00,13
17741,ORD_17742,30509,Vegetable Glycerin,Warehouse C,104,87,2025-02-15 14:03:00,17
17742,ORD_17743,14988,"Noise_Colorfit Replacement USB Charging Cable for Noise ColorFit Pro 3 / Pro 2 / Pro 2 Oxy/Pulse/Ultra/Nav, Nav+ / Brio/No...",Warehouse C,32,14,2025-02-15 11:00:00,18
17743,ORD_17744,36835,Thiobit A 100mg/4mg Tablet,Warehouse B,60,47,2025-02-15 08:50:00,13
17744,ORD_17745,3483,Gevic OZ 200mg/500mg Tablet,Warehouse A,17,3,2025-02-15 19:30:00,14
17745,ORD_17746,13943,TheGiftKart Ultra-Hybrid Clear Back Case Cover for iPhone 14 Plus | Shockproof Design | Camera Protection Bump | Hard Back...,Warehouse B,28,21,2025-02-15 15:11:00,7
17746,ORD_17747,31159,Szith 500mg Tablet,Warehouse C,21,2,2025-02-15 02:10:00,19
17747,ORD_17748,30521,Onsitego 1 Year Extended Warranty for Small Household Appliances from Rs. 8001-9000 (Email Delivery - No Physical Kit),Warehouse B,31,19,2025-02-15 15:23:00,12
17748,ORD_17749,36469,Myodol Tablet,Warehouse B,110,94,2025-02-15 04:53:00,16
17749,ORD_17750,20,Lighten & Smooth Under Eye Gel,Warehouse C,37,32,2025-02-15 19:22:00,5
17750,ORD_17751,4854,Syska 4 Way Power Plug Adapter (White) (1),Warehouse C,37,27,2025-02-15 12:26:00,10
17751,ORD_17752,14891,Avidine-M Ointment,Warehouse B,86,81,2025-02-15 08:46:00,5
17752,ORD_17753,34298,Rislex Plus 3mg/2mg Tablet,Warehouse A,95,87,2025-02-15 22:00:00,8
17753,ORD_17754,18110,Reclimet OD 30 Tablet ER,Warehouse C,58,52,2025-02-15 01:29:00,6
17754,ORD_17755,18136,"Giorgio Armani Acqua Di Gioia Eau De Parfum, 100ml",Warehouse C,96,83,2025-02-15 22:37:00,13
17755,ORD_17756,18135,"Maybelline New York Super Stay Matte Ink Liquid Lipstick, 15 Lover, 5ml and Maybelline New York Colossal Kajal, Black, 0.35g",Warehouse B,84,71,2025-02-15 11:24:00,13
17756,ORD_17757,25852,"RJ11 Telephone Line Wire Patch Cable Compatible for Landline, Telephone (Black) (10 Meters)",Warehouse B,18,13,2025-02-15 17:35:00,5
17757,ORD_17758,18117,Revlon Colorstay Whipped Creme Makeup - Warm Golden 23.7 Ml,Warehouse B,86,76,2025-02-15 03:39:00,10
17758,ORD_17759,10639,Gemblue Biocare Shea Butter Body Scrub 500 ml,Warehouse C,105,91,2025-02-15 18:41:00,14
17759,ORD_17760,28686,"ZEBRONICS Zeb-HAA1520 (1.5 Meter) HDMI Cable Supports 3D, 4K, ARC & CEC Extension, Compatible with HDMI-Enabled TV, Blu-ra...",Warehouse A,12,7,2025-02-15 05:59:00,5
17760,ORD_17761,34164,Razer DeathAdder Essential Wired Gaming Mouse I Single-Color Green Lighting I 6400DPI Optical Sensor- Black - RZ01-0385010...,Warehouse B,96,77,2025-02-15 13:47:00,19
17761,ORD_17762,18107,Lower A 20mg Tablet,Warehouse A,27,15,2025-02-15 09:34:00,12
17762,ORD_17763,32363,(Renewed) Samsung SM-R180NZKAINU In-Ear Wireless Bluetooth Buds Live with Mic (Mystic Black),Warehouse B,21,13,2025-02-15 18:31:00,8
17763,ORD_17764,10649,Hymax 10mg Tablet,Warehouse C,57,47,2025-02-15 07:02:00,10
17764,ORD_17765,18097,Excid 40mg Injection,Warehouse C,27,17,2025-02-15 13:46:00,10
17765,ORD_17766,35682,Okacet AX 10mg Tablet,Warehouse C,94,84,2025-02-15 09:53:00,10
17766,ORD_17767,22878,Denset 2mg Injection,Warehouse C,94,87,2025-02-15 11:18:00,7
17767,ORD_17768,18137,Yoclav Dry Syrup,Warehouse B,70,56,2025-02-15 05:45:00,14
17768,ORD_17769,22869,G.B.H.C Soap,Warehouse C,71,53,2025-02-15 21:40:00,18
17769,ORD_17770,7948,Skin Lightening Gold Bleach For Radiant Skin,Warehouse B,32,15,2025-02-15 21:26:00,17
17770,ORD_17771,22865,Remulide Gel,Warehouse A,54,38,2025-02-15 05:40:00,16
17771,ORD_17772,18173,Beardhood Sunscreen SPF 50 PA++ Cream - Water & Sweat Resistant 50 gm,Warehouse C,8,2,2025-02-15 01:36:00,6
17772,ORD_17773,18180,Movin Plus Tablet,Warehouse C,92,73,2025-02-15 19:53:00,19
17773,ORD_17774,28652,"Winble Camera Protection Soft Silicone, TPU Protective Back Cover Case for OnePlus 9/One Plus 9 (Blue)",Warehouse A,50,44,2025-02-15 02:39:00,6
17774,ORD_17775,2674,Acne Clearing Face Wash,Warehouse C,68,50,2025-02-15 18:48:00,18
17775,ORD_17776,28639,Olcefone 100mg Tablet DT,Warehouse A,62,55,2025-02-15 08:17:00,7
17776,ORD_17777,28636,Q Press H 10 mg/12.5 mg Tablet,Warehouse C,35,27,2025-02-15 06:01:00,8
17777,ORD_17778,2671,Prolovas T 40mg/50mg Tablet,Warehouse A,101,83,2025-02-15 16:25:00,18
17778,ORD_17779,6234,Murivenna Thailam,Warehouse A,100,81,2025-02-15 03:22:00,19
17779,ORD_17780,32384,Tazlive MT 40mg/50mg Tablet,Warehouse A,29,13,2025-02-15 08:12:00,16
17780,ORD_17781,22843,Olosafe 0.1% Eye Drop,Warehouse C,15,10,2025-02-15 10:00:00,5
17781,ORD_17782,7907,Bevertz 8mg Tablet,Warehouse B,99,80,2025-02-15 04:10:00,19
17782,ORD_17783,18267,Paperkraftâ Expression| Hardâ  Cover Notebook | 15.8 Cm X 19.4 Cm | Unruled | 192 Pages,Warehouse B,62,47,2025-02-15 09:44:00,15
17783,ORD_17784,25717,"elevn ergo11e 2.4GHz Premium Wireless Optical Mouse for Laptop, Desktop, PC, MacBook,Black",Warehouse B,33,24,2025-02-15 04:18:00,9
17784,ORD_17785,18295,Wotlin Syrup,Warehouse C,44,36,2025-02-15 11:03:00,8
17785,ORD_17786,10537,Yorten Universal Clip Cell Phone Holder Multi-Joint Flexible Adjustment for Car Rear View Mirror Back Seat Video Stand Kit...,Warehouse C,96,77,2025-02-15 12:44:00,19
17786,ORD_17787,6211,Psythip 50mg Tablet,Warehouse B,98,90,2025-02-15 10:57:00,8
17787,ORD_17788,6213,Rabsar SR 30mg/20mg Capsule SR,Warehouse C,36,22,2025-02-15 10:35:00,14
17788,ORD_17789,25896,Apabol 25mg Injection,Warehouse C,118,99,2025-02-15 15:51:00,19
17789,ORD_17790,18299,Ordilan Trio Tablet,Warehouse C,104,90,2025-02-15 08:48:00,14
17790,ORD_17791,33223,Lacticare HC Lotion,Warehouse C,74,56,2025-02-15 06:15:00,18
17791,ORD_17792,7961,Fagel Instant Glow All Purpose Beauty Gel,Warehouse B,107,91,2025-02-15 13:34:00,16
17792,ORD_17793,25961,Fashion Colour Makeup Brush Cleanser 150 ml,Warehouse B,93,81,2025-02-15 02:43:00,12
17793,ORD_17794,10545,P-PLUS INTERNATIONAL Folding Pocket Mirror Round Compact Mirror Double-Sided Makeup Mirror (Random Style) (Pack of 1),Warehouse B,81,64,2025-02-15 18:17:00,17
17794,ORD_17795,28591,Nocon Syrup,Warehouse B,22,8,2025-02-15 21:42:00,14
17795,ORD_17796,22816,Doms Triangle Dust Free Fragrance Eraser Jar (50 Pcs),Warehouse C,82,68,2025-02-15 03:34:00,14
17796,ORD_17797,28562,Oxin 100mg Tablet,Warehouse A,104,89,2025-02-15 08:15:00,15
17797,ORD_17798,25971,CREATiON Jawline Exerciser Jaw Double Chin Reducer for Women and Men Face Shaper Tone Your Neck and Face Look Younger and ...,Warehouse A,79,64,2025-02-15 21:42:00,15
17798,ORD_17799,10667,Ajmal 2 Sacrifice II For Him And 2 Magnetize Deodorants Pack of 4 200 ml,Warehouse C,104,98,2025-02-15 04:22:00,6
17799,ORD_17800,35607,Clincin 150mg Capsule,Warehouse B,60,49,2025-02-15 09:40:00,11
17800,ORD_17801,18320,POPIO Tempered Glass Compatible for iPhone SE (2020) ; Apple iPhone SE (2022) with Edge to Edge Coverage and Easy Installa...,Warehouse C,11,5,2025-02-15 12:17:00,6
17801,ORD_17802,18332,"FEDUS 12V 1.5A DC Power Adapter, Powers Supply, SMPS for LCD Monitor, TV, LED Strip, CCTV, 12 Volt 1.5 Amp Power Adapter,A...",Warehouse B,64,45,2025-02-15 18:16:00,19
17802,ORD_17803,4721,Olmibid 20mg Tablet,Warehouse B,102,85,2025-02-15 02:20:00,17
17803,ORD_17804,25928,Wired Earphones for OnePlus Nord/One Plus Nord Earphone Original Like Wired Stereo Deep Bass Head Hands-free Headset Earbu...,Warehouse B,46,33,2025-02-15 18:17:00,13
17804,ORD_17805,28554,"Amazon Brand - Solimo Rhine Study/Laptop Table (Blue, Powder Coated,Engineered Wood)",Warehouse B,27,18,2025-02-15 02:23:00,9
17805,ORD_17806,10511,Flacox T Eye Drop,Warehouse A,98,92,2025-02-15 21:55:00,6
17806,ORD_17807,28538,Neuropentin 300mg Capsule,Warehouse C,109,94,2025-02-15 07:09:00,15
17807,ORD_17808,18361,Ronitop-D Tablet,Warehouse B,55,37,2025-02-15 01:40:00,18
17808,ORD_17809,18371,Clion 5 Tablet MD,Warehouse C,29,10,2025-02-15 20:41:00,19
17809,ORD_17810,10496,Nystan TF 250mg Tablet,Warehouse C,28,22,2025-02-15 05:30:00,6
17810,ORD_17811,8018,Tifcetri-Cold Tablet,Warehouse B,8,2,2025-02-15 07:06:00,6
17811,ORD_17812,22719,Sunaina Bridal Collection Dark Pink Bindis for Women [SBCDP102] (size-2) (Size 7mm),Warehouse B,19,2,2025-02-15 00:07:00,17
17812,ORD_17813,22702,"Love Earth Lip Tint & Cheek Tint Multipot Combo (Rose Pink & Coral) with Richness of Jojoba Oil and Vitamin E for Lips, Ey...",Warehouse A,76,64,2025-02-15 13:57:00,12
17813,ORD_17814,18392,Fruity Soap Enriched with Narural Lemon Extract,Warehouse C,76,68,2025-02-15 04:21:00,8
17814,ORD_17815,6180,Mebeford Tablet,Warehouse B,70,56,2025-02-15 18:55:00,14
17815,ORD_17816,34208,Ariban 400mg Tablet,Warehouse B,87,79,2025-02-15 17:14:00,8
17816,ORD_17817,9956,TheGiftKart Back Cover for Redmi 9 / Redmi 9 Activ/Poco C31 (Poly Carbonate | Black),Warehouse C,36,20,2025-02-15 17:54:00,16
17817,ORD_17818,26393,"EDYELL True Wireless Earbuds, C15 Over Ear Headphone with Mic,48Hrs Playtime Noise Cancelling EarHook Earphones Type-C Cha...",Warehouse A,52,33,2025-02-15 21:51:00,19
17818,ORD_17819,9517,"RMC USB Magnetic 2 Pin Charging Cable for T500, T55, W26, W26plus, P6 X16, HW22, HW18, T500Plus, X7 / X8Plus Smart Watch (...",Warehouse A,90,76,2025-02-15 09:49:00,14
17819,ORD_17820,9502,"Electronic Spices 2pcs 12v Brushless 3Inch DC Cooling Fan for Pc Case,CPU Cooler Black (80X80) mm",Warehouse A,107,88,2025-02-15 05:15:00,19
17820,ORD_17821,1439,"Cooler Master Cryofuze Thermal Paste - for Processor, GPU, Console, Laptop | 14 W/m-K Thermal Conductivity | Excellent Per...",Warehouse B,70,64,2025-02-15 03:34:00,6
17821,ORD_17822,5369,"POPIO Tempered Glass for Samsung Galaxy M51 / A71 / Note10 Lite (Transparent) Full Screen Coverage (except edges), Pack of 1",Warehouse C,23,15,2025-02-15 03:59:00,8
17822,ORD_17823,20028,"Just Herbs Javakusum Hair Oil for Men & Women, Controls Dandruff, 100% Natural, Certified Organic Ingredients - 100 ML",Warehouse A,70,64,2025-02-15 21:51:00,6
17823,ORD_17824,20025,Miss Claire Professional Makeup Everyday Foundation Natural Weightless Foundation 30ml Cream (FR - 05 Natural),Warehouse C,45,31,2025-02-15 20:49:00,14
17824,ORD_17825,5767,MANCODE Charcoal Face Sheet Mask 25 ml,Warehouse A,90,78,2025-02-15 11:12:00,12
17825,ORD_17826,20013,Artist's Den Brushes (Wash Brush Set of 3)(Wood),Warehouse B,112,99,2025-02-15 21:25:00,13
17826,ORD_17827,20209,Statwa 20mg Tablet,Warehouse B,62,52,2025-02-15 01:17:00,10
17827,ORD_17828,21400,Mix Berries Glitter Glow Mask For Instant Glow On Face,Warehouse A,94,86,2025-02-15 12:43:00,8
17828,ORD_17829,21401,"Crysendo Silicone Replacement Ear Tips for APL AirPods Pro & AirPods Pro 2 | Pain Reducing, Anti-Slip Eartips | Fits in Th...",Warehouse A,93,88,2025-02-15 04:35:00,5
17829,ORD_17830,19988,Brightening Lemon & Cherry Face Wash,Warehouse B,96,91,2025-02-15 23:26:00,5
17830,ORD_17831,19985,Esmox-CV 625 Tablet,Warehouse B,57,41,2025-02-15 11:10:00,16
17831,ORD_17832,5778,Levetas 750 Tablet,Warehouse B,70,60,2025-02-15 22:32:00,10
17832,ORD_17833,19983,Lightening Pigmentation Oil,Warehouse C,69,51,2025-02-15 21:56:00,18
17833,ORD_17834,9499,Antiseptic Cream,Warehouse C,50,32,2025-02-15 20:03:00,18
17834,ORD_17835,20116,Geolid 600mg Tablet,Warehouse A,12,6,2025-02-15 13:36:00,6
17835,ORD_17836,8787,Atropen P Eye Drop,Warehouse C,36,25,2025-02-15 17:37:00,11
17836,ORD_17837,2480,Nutriment De Tan Scrub All Skin Type 250 gm,Warehouse B,94,77,2025-02-15 07:52:00,17
17837,ORD_17838,34632,"Redmi Note 11 (Horizon Blue, 6GB RAM, 64GB Storage)|90Hz FHD+ AMOLED Display | Qualcomm® Snapdragon™ 680-6nm | 33W Charger...",Warehouse B,18,10,2025-02-15 02:22:00,8
17838,ORD_17839,1426,Daily Life Forever52 Ultra Definition Liquid Foundation Flf005 30 Ml,Warehouse C,78,62,2025-02-15 17:05:00,16
17839,ORD_17840,5387,DIMAZO Cleaning Pen for Ear pods Headphone Earbud & Phone Multifunction Cleaner Kit Soft Brush for Bluetooth Earphones cas...,Warehouse C,22,14,2025-02-15 08:19:00,8
17840,ORD_17841,9491,"Redragon GW800 1080P Webcam with Built-in Dual Microphone, 360-Degree Rotation - 2.0 USB Skype Computer Web Camera - 30 FP...",Warehouse B,92,82,2025-02-15 20:17:00,10
17841,ORD_17842,34642,Alexcef OF 200mg/200mg Tablet,Warehouse A,56,49,2025-02-15 14:47:00,7
17842,ORD_17843,32462,Rabiall-LS Capsule SR,Warehouse C,31,17,2025-02-15 17:48:00,14
17843,ORD_17844,26748,Lakme 9To5 Primer + Matte Perfect Cover Foundation W120 Warm Creme 25 Ml,Warehouse B,80,70,2025-02-15 18:45:00,10
17844,ORD_17845,1186,"Zayn & Myza Transfer - Proof Power Matte Lip Color, Red 6 ml",Warehouse C,43,31,2025-02-15 03:26:00,12
17845,ORD_17846,8803,Azistic 500 Tablet,Warehouse C,83,73,2025-02-15 05:11:00,10
17846,ORD_17847,26751,"Amazon Basics High Speed HDMI Cable (Gold-Plated, A Male to A Male) - Supports 4K @60Hz and Audio Return (6 Feet)",Warehouse A,45,26,2025-02-15 21:08:00,19
17847,ORD_17848,1187,"Google Pixel 6a (Charcoal, 128 GB) (6 GB RAM)",Warehouse B,116,97,2025-02-15 19:20:00,19
17848,ORD_17849,1192,Atorcia CP 10mg Tablet,Warehouse C,29,10,2025-02-15 18:25:00,19
17849,ORD_17850,5728,Amozid 250 Tablet,Warehouse C,47,41,2025-02-15 10:15:00,6
17850,ORD_17851,21370,Medlivo M Syrup,Warehouse B,80,63,2025-02-15 23:55:00,17
17851,ORD_17852,8886,Intaderm Plus Cream,Warehouse B,46,29,2025-02-15 04:32:00,17
17852,ORD_17853,20119,Crysendo 60mm / 6cm Cushion for Jabra Evolve 30/20/ 65 UC/ BIZ2400 Headphone | Replacement Memory Foam & Softer Protein Le...,Warehouse A,25,15,2025-02-15 00:46:00,10
17853,ORD_17854,9418,"HP Deskjet Ink Advantage 2776 AIO Printer, Copy, Scan, WiFi, Bluetooth, USB, Simple Setup Smart App, Ideal for Home.",Warehouse C,80,65,2025-02-15 01:42:00,15
17854,ORD_17855,20140,"Spigen USB-C to C 3.2 Gen 1 Cable Official E-Mark, 100W & 5Gbps Compatible with Macbook, iPad, Galaxy, OnePlus, Pixel (1m)...",Warehouse A,34,28,2025-02-15 14:18:00,6
17855,ORD_17856,20145,"IFB 7.0 Kg 5 Star Top Load Washing Machine Aqua Conserve (TL-RES 7.0KG AQUA, Light Grey, Hard Water Wash, Smart Sense)",Warehouse C,93,78,2025-02-15 06:31:00,15
17856,ORD_17857,20146,RAMGEE 5 MG TABLET,Warehouse A,72,57,2025-02-15 20:26:00,15
17857,ORD_17858,9457,"Maybelline New York Instant Age Rewind Concealer, Caramel 6 gm",Warehouse C,70,59,2025-02-15 07:00:00,11
17858,ORD_17859,20159,Essential Souls Pigmentation Oil 20 ml,Warehouse B,35,25,2025-02-15 23:31:00,10
17859,ORD_17860,21292,Titanium EDP Fresh Perfume For Men,Warehouse B,110,94,2025-02-15 08:55:00,16
17860,ORD_17861,27403,"Dyazo 3 Port 36 W Fast USB Car Charger Qc Charging Compatible for Qualcomm 3.0 iPhone 11/12 / Max/Mini, Samsung Galaxy, Pi...",Warehouse B,19,8,2025-02-15 13:14:00,11
17861,ORD_17862,27401,Amazon Brand - Solimo Silicone Back Cover for Samsung Galaxy M21 / M30s / M21 2021 Edition - Black,Warehouse A,35,28,2025-02-15 10:02:00,7
17862,ORD_17863,26768,SPYKART Rearview Mirror Phone Holder Rotatable and Retractable Car Phone Holder 360° Adjustable Phone Mount for All Car,Warehouse A,101,85,2025-02-15 04:47:00,16
17863,ORD_17864,2375,CEDO Bumper Back Cover for OnePlus Nord 2T 5G with Rotating Ring Holder & in-Built Kickstand (TPU+Plastic | Black),Warehouse B,80,74,2025-02-15 00:05:00,6
17864,ORD_17865,8838,New Recapro hair Vitalizing Serum (60ml),Warehouse C,114,97,2025-02-15 03:14:00,17
17865,ORD_17866,32763,"LAKMÉ Absolute Hydra Pro Gel Day Crème, 50g",Warehouse B,84,70,2025-02-15 04:48:00,14
17866,ORD_17867,8850,Natural Refreshing Face Wash,Warehouse A,20,10,2025-02-15 14:18:00,10
17867,ORD_17868,21303,"DIGITEK® (DTR 455 LT) (51 Inch) Tripod for Smartphones & Cameras with Mobile Holder and Carry Bag, Max Operating Height - ...",Warehouse C,78,65,2025-02-15 07:56:00,13
17868,ORD_17869,8821,Romilast FX Tablet,Warehouse B,101,94,2025-02-15 08:29:00,7
17869,ORD_17870,2378,Pilot V5 Liquid Ink Roller Ball Pen - 1Blue + 1Black + 1Red,Warehouse A,24,17,2025-02-15 18:48:00,7
17870,ORD_17871,1214,Nimeson 200mg Tablet,Warehouse C,36,19,2025-02-15 23:09:00,17
17871,ORD_17872,5442,Beauty People High Shine Nail Polish 1090 12 ml,Warehouse B,15,10,2025-02-15 20:52:00,5
17872,ORD_17873,20247,OnePlus 126 cm (50 inches) Y Series 4K Ultra HD Smart Android LED TV 50Y1S Pro (Black),Warehouse A,42,37,2025-02-15 22:23:00,5
17873,ORD_17874,21221,Soulflower Relax With Lavender Bath And Aroma Set 600 gm,Warehouse B,78,63,2025-02-15 06:51:00,15
17874,ORD_17875,5446,Shakti Drops - Immunity Booster,Warehouse B,102,84,2025-02-15 12:18:00,18
17875,ORD_17876,20265,"Fashion Colour Cover Up Concealer Stick, Shade 03 8.5 gm",Warehouse B,44,28,2025-02-15 07:44:00,16
17876,ORD_17877,35000,Cello ColourUp Celebration Kit Gift Pack |12 Wax Crayons Colour Set | 12 Oil Pastels | 15 Mini Sketch Pens | Kids Drawing ...,Warehouse B,87,70,2025-02-15 23:32:00,17
17877,ORD_17878,20274,"ASUS Vivobook 14, 14.0-inch (35.56 cms) HD, Intel Core i3-1005G1 10th Gen, Thin and Light Laptop (8GB/512GB SSD/Integrated...",Warehouse B,104,85,2025-02-15 07:24:00,19
17878,ORD_17879,34683,Itazen 200 Capsule,Warehouse B,41,28,2025-02-15 21:26:00,13
17879,ORD_17880,5735,ZYBUX iPhone 14 / iPhone 14 Plus Metal Rings Back Camera Lens Protector | Anti Scratch | HD Tempered Metal Glass Back Came...,Warehouse C,66,59,2025-02-15 06:46:00,7
17880,ORD_17881,34988,"Paradyes Semi-Permanent Ammonia, Cruelty Free & Vegan Ruby Wine Hair Color 120gm AND Paradyes Lighten Up! Bleach Pack 30 V...",Warehouse C,77,65,2025-02-15 14:22:00,12
17881,ORD_17882,8878,"Fashion Colour Vivid Matte Lipstick, 16 Coffee 3.8 gm",Warehouse B,59,43,2025-02-15 01:45:00,16
17882,ORD_17883,34980,Gold Face Oil,Warehouse B,61,49,2025-02-15 14:04:00,12
17883,ORD_17884,2193,Acelza-P Oral Suspension,Warehouse C,61,56,2025-02-15 16:12:00,5
17884,ORD_17885,30059,Telyes H 40mg/12.5mg Tablet,Warehouse C,32,20,2025-02-15 09:05:00,12
17885,ORD_17886,25713,Desq 5mg Tablet,Warehouse C,38,20,2025-02-15 19:10:00,18
17886,ORD_17887,28225,Jovees Hair Repair Conditioner - Argan Kernel Oil 250 ml,Warehouse C,104,97,2025-02-15 07:18:00,7
17887,ORD_17888,18878,OLSERTAIN H ACTIVE 12.5 MG/40 MG TABLET,Warehouse A,46,29,2025-02-15 07:56:00,17
17888,ORD_17889,28217,Beauty People Waterproof Liquid Sindoor (Red),Warehouse B,50,35,2025-02-15 05:45:00,15
17889,ORD_17890,10144,Migshant 5mg Tablet,Warehouse A,90,75,2025-02-15 11:06:00,15
17890,ORD_17891,18864,Nimist P 100mg/500mg Tablet,Warehouse A,71,59,2025-02-15 06:26:00,12
17891,ORD_17892,18859,"Zebronics ZEB-BT4444RUCF Made in India Wireless Bluetooth Multimedia Speaker With Supporting SD Card, USB, AUX, FM & Remot...",Warehouse A,85,73,2025-02-15 19:37:00,12
17892,ORD_17893,10153,Insta Glow Herbal Bleach,Warehouse A,71,63,2025-02-15 00:35:00,8
17893,ORD_17894,2613,1 Year OneAssist Extended Warranty Plan for Mixer Juicer Grinder (5000 to 7500) - Delivery via Email,Warehouse B,31,12,2025-02-15 16:17:00,19
17894,ORD_17895,35323,"Oblivion Multi-Purpose Wall Holder Stand for Charging Mobile Just Fit in Socket, Support All Charger and Hang (Red)",Warehouse C,43,24,2025-02-15 14:50:00,19
17895,ORD_17896,28234,Lexa Tablet,Warehouse C,28,21,2025-02-15 15:23:00,7
17896,ORD_17897,28241,"Face Pack - Youthful Nourishing & Revitalizing, Bio Pistachio",Warehouse B,85,80,2025-02-15 04:18:00,5
17897,ORD_17898,6019,"Spigen Essential Sand Blast Back Cover Compatible for Samsung Galaxy A33 5G (TPU, Matte Black)",Warehouse B,77,64,2025-02-15 12:34:00,13
17898,ORD_17899,34436,Revlon Flex Shampoo For Normal To Dry Hair 592 Ml,Warehouse B,24,7,2025-02-15 19:07:00,17
17899,ORD_17900,4953,Winble Back Cover for OnePlus Nord 2T 5G Back Cover Camera Protection Soft Silicone Protective Back Cover Designed for One...,Warehouse B,43,30,2025-02-15 22:35:00,13
17900,ORD_17901,1617,Nihimont LC 5mg/10mg Tablet,Warehouse A,22,3,2025-02-15 21:08:00,19
17901,ORD_17902,28212,Juarez JRZ16MS Microphone Boom Scissor Suspension Arm Stand,Warehouse C,69,51,2025-02-15 15:50:00,18
17902,ORD_17903,28204,Spigen Ultra Hybrid Matte Back Cover Case for iPhone 13 (TPU + Poly Carbonate | Frost Black),Warehouse B,97,86,2025-02-15 08:52:00,11
17903,ORD_17904,18898,Elpis Gold Eyeconic Long Lasting Kajal,Warehouse C,12,4,2025-02-15 14:01:00,8
17904,ORD_17905,22257,Rosze Gold 20 Capsule,Warehouse C,111,99,2025-02-15 16:13:00,12
17905,ORD_17906,18997,Nokia 6310 TA-1400 DS in Green,Warehouse C,55,44,2025-02-15 23:09:00,11
17906,ORD_17907,6040,Woolmar Plus 500 mg/37.5 mg Tablet,Warehouse A,75,68,2025-02-15 22:32:00,7
17907,ORD_17908,26216,Detab Plus Tablet,Warehouse C,60,47,2025-02-15 00:31:00,13
17908,ORD_17909,35415,Dazi 500mg Tablet,Warehouse B,51,37,2025-02-15 06:48:00,14
17909,ORD_17910,22224,Clyora-DX Syrup,Warehouse A,100,91,2025-02-15 15:20:00,9
17910,ORD_17911,1607,Uterone 100mg Capsule,Warehouse C,45,36,2025-02-15 04:36:00,9
17911,ORD_17912,22217,Maydine M 1 mg/500 mg Tablet SR,Warehouse A,51,42,2025-02-15 03:13:00,9
17912,ORD_17913,28179,Lakme 9To5 Weightless Mousse Foundation Toffee 25 Gm,Warehouse C,86,79,2025-02-15 18:35:00,7
17913,ORD_17914,10113,Fervay 1500mg Injection,Warehouse C,58,50,2025-02-15 02:03:00,8
17914,ORD_17915,4975,Volnaz P 0.25mg/10mg Tablet,Warehouse A,74,59,2025-02-15 15:04:00,15
17915,ORD_17916,26252,Omnec D 10mg/20mg Capsule,Warehouse C,35,24,2025-02-15 00:24:00,11
17916,ORD_17917,9976,CEDO Samsung Tab A7 Lite 8.7 Inch (2021) Tempered Glass | Screen Protector Tempered Glass for Samsung Galaxy Tab A7 Lite ...,Warehouse B,91,85,2025-02-15 14:29:00,6
17917,ORD_17918,34424,Gesicare TH 100mg/8mg Tablet,Warehouse A,24,5,2025-02-15 05:14:00,19
17918,ORD_17919,10106,Lacomb 400mg/325mg Tablet,Warehouse B,88,70,2025-02-15 03:21:00,18
17919,ORD_17920,22128,Spd Gel,Warehouse C,63,58,2025-02-15 06:43:00,5
17920,ORD_17921,5020,Mahafen-MR Tablet,Warehouse A,66,59,2025-02-15 08:57:00,7
17921,ORD_17922,19100,Foxpod CV Dry Syrup,Warehouse B,53,35,2025-02-15 08:17:00,18
17922,ORD_17923,10048,House of Aroma Fragrance Oil - Ylang 100 ml,Warehouse B,100,87,2025-02-15 23:18:00,13
17923,ORD_17924,19054,Rozon 20mg Tablet,Warehouse A,23,17,2025-02-15 16:05:00,6
17924,ORD_17925,28114,Faces Canada Ultime Pro Sun Defense Cc Powder Spf 30 Sand 04 8 Gm,Warehouse A,51,41,2025-02-15 21:23:00,10
17925,ORD_17926,19027,Soltop-S 3% Lotion,Warehouse A,44,25,2025-02-15 10:46:00,19
17926,ORD_17927,8441,Ajmal Avid Avid Blu Deodorant Spray (Pack of 3) 200 ml,Warehouse B,54,42,2025-02-15 03:50:00,12
17927,ORD_17928,10446,Texcef O Oral Suspension,Warehouse A,22,8,2025-02-15 22:06:00,14
17928,ORD_17929,28246,Yamnac-MR Tablet,Warehouse C,14,1,2025-02-15 05:00:00,13
17929,ORD_17930,10310,Clobalyf 5 Tablet MD,Warehouse C,82,70,2025-02-15 15:41:00,12
17930,ORD_17931,10319,"rts (2 Pack) High speed USB C to USB Adapter, USB-C Female to USB Male, USB Type C Female to USB OTG Adapter compatible fo...",Warehouse A,51,46,2025-02-15 06:22:00,5
17931,ORD_17932,23112,Amvalor Chrono 500 Tablet CR,Warehouse B,59,51,2025-02-15 03:57:00,8
17932,ORD_17933,19105,Dynotrek Vostro 15.6 Inch Laptop Sleeve Cover Pouch with Handle Compatible for Mackbook ThinkPad Tablet Chromebook Surface...,Warehouse C,64,50,2025-02-15 17:29:00,14
17933,ORD_17934,8404,Winble Silicone Camera Protection Soft Silicon Protective Back Cover Back Cover Back Cover for OnePlus Nord CE 2 Lite 5G D...,Warehouse B,32,27,2025-02-15 10:22:00,5
17934,ORD_17935,28069,Ytm 10 Pcs (5 Pair) for Samsung Level u Earbuds | Earbuds for Samsung Level U &U2 | Replacement Black Original Earbuds | P...,Warehouse C,23,7,2025-02-15 02:02:00,16
17935,ORD_17936,19136,"Love Earth Lip Tint & Cheek Tint Multipot-Be The Change With Richness Of Jojoba Oil And Vitamin E For Lips, Eyelids & Chee...",Warehouse A,81,71,2025-02-15 00:52:00,10
17936,ORD_17937,10017,JXL 1090 High Performance 3 Way 4 Inch Coaxial Car Speaker with Inbuilt PEI Car Tweeter and HOP Woofer 500W MAX Pair (Black),Warehouse A,109,95,2025-02-15 17:54:00,14
17937,ORD_17938,1578,Gel Toothpaste for Kids - Strawberry Flavor,Warehouse B,92,85,2025-02-15 17:27:00,7
17938,ORD_17939,1020,Dilantin 25mg Capsule,Warehouse C,17,1,2025-02-15 17:11:00,16
17939,ORD_17940,2300,TOUGH LEE Tempered Glass Screen Guard Protector for Samsung Galaxy M13 / M13 5G / Samsung Galaxy M33 5G / Samsung F23 5G (...,Warehouse C,96,84,2025-02-15 12:24:00,12
17940,ORD_17941,8422,Esodove D 30mg/40mg Capsule SR,Warehouse B,20,2,2025-02-15 08:55:00,18
17941,ORD_17942,10013,Pierre Cardin Paris - Lip Master Intense Velvet Color Lipgloss 603-Hollywood Red,Warehouse B,8,2,2025-02-15 01:48:00,6
17942,ORD_17943,35337,"Fashion Colour Soft Lip Mousse, 12 Toast Tea 8 gm",Warehouse A,105,86,2025-02-15 10:50:00,19
17943,ORD_17944,10011,Oresta 10mg Tablet,Warehouse A,115,97,2025-02-15 14:11:00,18
17944,ORD_17945,1047,CHITROSE TYA Fashion Makeup Kit (6171) Multicolor - (Pack of 1),Warehouse A,81,70,2025-02-15 17:53:00,11
17945,ORD_17946,19186,"Episkey 7-in-1 Electronic Cleaner Kit,Keyboard Cleaner,Laptop Cleaner Kit for Monitor, Cell Phone, Bluetooth,Headset, Leg...",Warehouse A,49,40,2025-02-15 09:48:00,9
17946,ORD_17947,21971,"ProTVSolutions iPhone 14 Charger,20W PD Super Quick Apple Charger [Apple MFi Certified] iPhone Charger Fast Charging Block...",Warehouse C,74,69,2025-02-15 09:58:00,5
17947,ORD_17948,22153,Ospical OP Tablet,Warehouse A,95,87,2025-02-15 04:41:00,8
17948,ORD_17949,8241,Cefoxy 50mg Dry Syrup,Warehouse B,73,59,2025-02-15 03:10:00,14
17949,ORD_17950,10100,Portronics MPORT 31C 4-in-1 USB Hub (Type C to 4 USB-A Ports) with Fast Data Transfer,Warehouse B,115,98,2025-02-15 16:46:00,17
17950,ORD_17951,33287,Dvn 80mg Tablet,Warehouse C,90,74,2025-02-15 07:43:00,16
17951,ORD_17952,28881,Otovert 16 Tablet,Warehouse C,18,2,2025-02-15 18:36:00,16
17952,ORD_17953,23163,"CableCreation Usb C To Micro B 3.0 (Gen 2/10G), 1Ft Usb 3.1 Type C Cable Braided For Macbook (Pro), Hdd External Hard Driv...",Warehouse C,48,30,2025-02-15 16:16:00,18
17953,ORD_17954,4576,Stbotanica Hyaluronic Acid Hydra Boost Foaming Face Wash 120 ml,Warehouse A,102,83,2025-02-15 12:25:00,19
17954,ORD_17955,28904,CEDO Clear Case for iPhone Xs Max | Soft Flexible Full Protection Shock Proof TPU Back Cover for iPhone Xs Max (Transparent),Warehouse C,90,85,2025-02-15 15:44:00,5
17955,ORD_17956,6336,Bathing Soap - Almond & Rose,Warehouse C,26,11,2025-02-15 10:17:00,15
17956,ORD_17957,34070,Mitqure Lotion,Warehouse C,102,87,2025-02-15 10:50:00,15
17957,ORD_17958,34063,Hawkdeals Mini Stainless Steel Foot Switch Pedal For Tattoo,Warehouse A,39,33,2025-02-15 16:04:00,6
17958,ORD_17959,25801,Odeon Turmeric & Yogurt Face And Body Scrub 300 ml,Warehouse C,68,63,2025-02-15 04:25:00,5
17959,ORD_17960,10879,Gear Vintage2 Anti Theft Faux Leather 18 cms Tan Laptop Backpack,Warehouse B,74,66,2025-02-15 21:40:00,8
17960,ORD_17961,10883,"Fashion Colour Professional Face & Body Highlighter, Shade 05 35 gm",Warehouse C,58,49,2025-02-15 21:58:00,9
17961,ORD_17962,23156,Amazon Brand - Solimo 2.4 A USB to Micro USB Extra Tough Braided Data Cable - 1.5 Meter,Warehouse C,21,10,2025-02-15 05:25:00,11
17962,ORD_17963,7892,Bathing Soap - Aloe Vera,Warehouse A,56,44,2025-02-15 00:34:00,12
17963,ORD_17964,17867,Ajmal ARTISAN - SMOKY MUSK DEODORANT PERFUME 150ML FOR MEN AND WOMEN ONLINE EXCLUSIVE,Warehouse A,54,43,2025-02-15 00:17:00,11
17964,ORD_17965,34097,Ajmal Mukhallat Raaqi Concentrated Perfume Oil Floral Fruity And Wisal Dhahab Deodorant Fruity Floral Fragrance 210 ml,Warehouse C,76,68,2025-02-15 20:35:00,8
17965,ORD_17966,23158,"iBall Decor 9-2.0 USB Powered Computer Multimedia Speakers with in-line Volume Controller, Black",Warehouse A,59,53,2025-02-15 14:16:00,6
17966,ORD_17967,10824,BESTOR® Portable Ruff 12 inches LCD Paperless Memo Digital Tablet Notepad Scribble Board/E-Writer/Writing/Drawing Pad/Digi...,Warehouse C,104,92,2025-02-15 07:17:00,12
17967,ORD_17968,10823,Recharge Marine Splash & Ocean Breeze Deodorant - Combo Pack,Warehouse A,50,44,2025-02-15 05:05:00,6
17968,ORD_17969,17791,Colorbar Bubble Away Sheet Mask - (Pack Of 3) 1's,Warehouse A,97,91,2025-02-15 06:06:00,6
17969,ORD_17970,2710,Leplenz-M Tablet,Warehouse C,14,4,2025-02-15 01:54:00,10
17970,ORD_17971,25735,TP-Link TL-WA855RE 300 Mbps Wi-Fi Range Extender (White),Warehouse C,102,94,2025-02-15 14:25:00,8
17971,ORD_17972,35761,"LAPSTER 3 Port HDMI 4 K 1.4V Version Switch Splitter with Pigtail Cable for Xbox One, PS3, 4, TV (Black)",Warehouse B,57,46,2025-02-15 07:28:00,11
17972,ORD_17973,28845,Acigrip P 40mg Tablet,Warehouse B,99,87,2025-02-15 20:21:00,12
17973,ORD_17974,17819,"Philips Audio TAH4205XTBK/00 Bluetooth 5.0, Bass Booster, Quick Charging Upto 29H Playtime, 32mm Driver, Compact Folding D...",Warehouse B,85,78,2025-02-15 20:20:00,7
17974,ORD_17975,810,Echoslide 120 Tablet,Warehouse A,63,57,2025-02-15 18:17:00,6
17975,ORD_17976,25693,Oboe Silicone Protective Full Wrap Remote Case Compatible with Oneplus Q Series/U Series / Y1S / Y1S Edge Smart LED TV Rem...,Warehouse A,80,64,2025-02-15 23:20:00,16
17976,ORD_17977,10801,"Blue Heaven Hypergel Nailpaint - Storm Lightening, 704 11 ml",Warehouse B,76,62,2025-02-15 19:55:00,14
17977,ORD_17978,811,Esotab-LS Capsule,Warehouse A,14,9,2025-02-15 18:42:00,5
17978,ORD_17979,17842,Autax 1000mg Injection,Warehouse B,41,22,2025-02-15 11:21:00,19
17979,ORD_17980,17851,Neoprate 500mg/5ml Injection,Warehouse B,65,59,2025-02-15 09:08:00,6
17980,ORD_17981,26261,Oudh Golab Middle Eastern Handmade Soap,Warehouse A,34,20,2025-02-15 21:57:00,14
17981,ORD_17982,25704,Herbal Face Pack With Fruit Extracts - Nourishes Skin & Tightens Pores,Warehouse B,87,72,2025-02-15 23:23:00,15
17982,ORD_17983,855,Fresh Comfort Women Deodorant - Long Lasting Freshness & 48h Protection,Warehouse C,87,72,2025-02-15 10:19:00,15
17983,ORD_17984,6334,English Lavender Perfumed Talc,Warehouse C,13,7,2025-02-15 08:06:00,6
17984,ORD_17985,22958,Costar-DS Dry Syrup,Warehouse C,34,24,2025-02-15 17:31:00,10
17985,ORD_17986,10733,Himaxime O 200mg/200mg Tablet,Warehouse C,63,54,2025-02-15 16:11:00,9
17986,ORD_17987,34126,Divine Restorative Night Creme,Warehouse C,103,98,2025-02-15 14:54:00,5
17987,ORD_17988,22665,Dotcoff M Syrup,Warehouse C,18,2,2025-02-15 09:38:00,16
17988,ORD_17989,22656,Bennett Khadi + Polyester Drax Laptops Bag Sleeve Case Cover Pouch for 15.6 inches 39cm Laptop Apple/Dell/Lenovo/ASUS/Hp/S...,Warehouse A,29,13,2025-02-15 16:48:00,16
17989,ORD_17990,2705,Crekuff LS Syrup,Warehouse A,46,36,2025-02-15 13:08:00,10
17990,ORD_17991,2179,"Doodle Hard Bound Notebook Diary l A5 l 80 GSM l Undated l 192 Ruled Pages(5.5X8.5 Inches), Ethinic Motif Diary for Girls,...",Warehouse A,85,69,2025-02-15 03:04:00,16
17991,ORD_17992,17876,Bentley Infinite Rush Edt 100ml,Warehouse C,98,92,2025-02-15 17:29:00,6
17992,ORD_17993,25749,Aspent 60mg Tablet,Warehouse C,91,84,2025-02-15 10:57:00,7
17993,ORD_17994,7832,"Mattlook Matte Crush Velvet Mousse Lipstick, Burgundy (10ml)",Warehouse A,48,30,2025-02-15 06:07:00,18
17994,ORD_17995,2182,DOMS Water Color Tube 12 Shades (Multicolour) (7768),Warehouse C,49,32,2025-02-15 01:00:00,17
17995,ORD_17996,6293,Miss Rose 6 Color Shimmery Highlighter Glow Palette 7003 - 037 27 gm,Warehouse B,62,45,2025-02-15 11:37:00,17
17996,ORD_17997,7843,Canon CL-57 Ink Cartridge (Color),Warehouse C,70,64,2025-02-15 09:51:00,6
17997,ORD_17998,10737,Deborah Milano 10 Days Long - 39 Geranium Red Nail Polish 11 ml,Warehouse C,20,9,2025-02-15 15:33:00,11
17998,ORD_17999,17691,Zabimox-CV 250mg/125mg Tablet,Warehouse B,44,38,2025-02-15 03:19:00,6
17999,ORD_18000,33258,Abitor 10mg Tablet,Warehouse A,11,4,2025-02-15 21:14:00,7
18000,ORD_18001,28758,"HP MPP 1.51 Stylus Pen Compatible for HP Spectre x360 13, Spectre x360 15 Convertable PC/Laptop with Microsoft Pen Protoco...",Warehouse B,79,72,2025-02-15 03:54:00,7
18001,ORD_18002,35698,"ESR Clear Case Compatible with iPhone 13 Case, Shockproof Thin Silicone Cover, Yellowing-Resistant Slim Transparent TPU Ph...",Warehouse A,19,10,2025-02-15 10:13:00,9
18002,ORD_18003,28773,"Boult Audio ProBass Curve-X Bluetooth Earphones with Fast Charging & 15H Battery Life, Extra Bass, IPX5 Water Resistant He...",Warehouse C,18,1,2025-02-15 22:36:00,17
18003,ORD_18004,22977,"Dyazo 6 Angle Foldable & Portable Laptop Riser Stand Made with Aluminum Alloy |Compatible for Dell, Mac Book Air/Pro, Leno...",Warehouse A,91,86,2025-02-15 15:44:00,5
18004,ORD_18005,28748,A-Ret 0.025% Gel,Warehouse B,68,60,2025-02-15 11:05:00,8
18005,ORD_18006,28749,Spantra Tea tree Shampoo 300 ml,Warehouse B,111,92,2025-02-15 16:53:00,19
18006,ORD_18007,28757,"PHILIPS Audio TAE1126 Wired in Ear Earphones with mic, 10 mm Driver, Powerful bass and Clear Sound, Black",Warehouse C,12,1,2025-02-15 22:15:00,11
18007,ORD_18008,22972,Rolosol-Plus Tablet,Warehouse A,110,91,2025-02-15 03:41:00,19
18008,ORD_18009,17984,"(Renewed) Dell Latitude Laptop E5480 Intel Core i5 7th Gen. - 7300u Processor, 8 GB Ram & 512 GB SSD, 14.1 inches Full HD ...",Warehouse A,61,53,2025-02-15 20:13:00,8
18009,ORD_18010,22998,Magome D 10mg/20mg Capsule,Warehouse C,91,82,2025-02-15 19:59:00,9
18010,ORD_18011,22993,Labfix O 200mg/200mg Tablet,Warehouse A,60,50,2025-02-15 04:46:00,10
18011,ORD_18012,17870,Febrikast F 10mg/120mg Tablet,Warehouse C,57,52,2025-02-15 01:59:00,5
18012,ORD_18013,22988,"ZEBRONICS Zeb-Thunder Wireless Bluetooth Over The Ear Headphone FM, mSD, 9 hrs Playback with Mic (Red)",Warehouse A,76,71,2025-02-15 21:36:00,5
18013,ORD_18014,3940,"Gizga Essentials USB WiFi Adapter for PC, 150 Mbps Wireless Network Adapter for Desktop - Nano Size WiFi Dongle Compatible...",Warehouse A,49,34,2025-02-14 00:34:00,15
18014,ORD_18015,3958,Vega Detangling Comb (HMC - 22) 35 gm,Warehouse C,96,80,2025-02-14 01:19:00,16
18015,ORD_18016,30018,Ancer L 5mg Tablet,Warehouse B,103,96,2025-02-14 19:57:00,7
18016,ORD_18017,36402,"Nivea Men Face Wash For Oily Skin, Oil Control For 12Hr Oil Control With 10X Vitamin C Effect, 50 G",Warehouse A,90,78,2025-02-14 21:03:00,12
18017,ORD_18018,12004,"Dyazo QC 12V Fast Car Charger Back Seat Charging 4 USB Ports Compatible for Qualcomm 3.0, Samsung Galaxy, Note, iPhone, Ne...",Warehouse B,48,39,2025-02-14 03:25:00,9
18018,ORD_18019,15805,TheGiftKart Sleek Back Cover Case for OnePlus 11 5G | Slim Fit Protective Design | Ultra Matte Finish | Camera Protection ...,Warehouse C,91,84,2025-02-14 12:15:00,7
18019,ORD_18020,12077,Allure Buffer Brush ( Stippling Brush C-25),Warehouse B,59,51,2025-02-14 04:49:00,8
18020,ORD_18021,30005,Lametec 200mg Tablet DT,Warehouse C,22,11,2025-02-14 15:19:00,11
18021,ORD_18022,30003,Tezaglit-M 500mg/20mg Tablet,Warehouse B,116,99,2025-02-14 02:13:00,17
18022,ORD_18023,30001,"PIDILITE Fevicryl Acrylic Colour (Golden Yellow, 500ml) for Art and Craft Paint, Canvas, Wood, Leather, Earthenware, Metal",Warehouse A,60,50,2025-02-14 12:13:00,10
18023,ORD_18024,407,Haxone 500mg Injection,Warehouse B,13,1,2025-02-14 12:26:00,12
18024,ORD_18025,2948,Vega Detangling Comb (HMC - 21) 45 gm,Warehouse C,67,50,2025-02-14 14:26:00,17
18025,ORD_18026,15861,Bronchosolvin Syrup,Warehouse A,28,10,2025-02-14 20:33:00,18
18026,ORD_18027,12037,Lafz Onion Seed Oil Shampoo 200 ml,Warehouse A,87,82,2025-02-14 16:53:00,5
18027,ORD_18028,29948,Macmon L Syrup,Warehouse A,93,85,2025-02-14 20:57:00,8
18028,ORD_18029,12044,Cargobid 500mg Tablet,Warehouse C,37,24,2025-02-14 10:01:00,13
18029,ORD_18030,30052,Samsung AKG-Tuned IC100 Type-C Wired in Ear Earphone with mic White,Warehouse C,56,48,2025-02-14 13:54:00,8
18030,ORD_18031,30054,INTACEPH 250 MG TABLET DT,Warehouse C,63,57,2025-02-14 12:26:00,6
18031,ORD_18032,15890,OFIXO Black Mesh Metal Desk Pen Pencil Organiser Cup Holder Office School Supplier UK,Warehouse C,86,67,2025-02-14 11:23:00,19
18032,ORD_18033,16092,Charcoal Peel-Off Mask,Warehouse A,36,24,2025-02-14 21:37:00,12
18033,ORD_18034,11824,"FACTOR NOTES Notebook: 90 GSM, B6, Ruled, 112 Pages Journal Diary (Little Things in Life)",Warehouse C,90,80,2025-02-14 20:52:00,10
18034,ORD_18035,446,Seblok 20mg Capsule,Warehouse A,82,71,2025-02-14 14:30:00,11
18035,ORD_18036,15605,"Miss Claire Full Coverage Makeup + Concealer #3, Beige, 6 g",Warehouse B,55,38,2025-02-14 03:31:00,17
18036,ORD_18037,11838,Jojoba Oil - Cold Pressed,Warehouse C,78,67,2025-02-14 16:24:00,11
18037,ORD_18038,2904,Deezo 6mg Tablet,Warehouse B,32,25,2025-02-14 12:09:00,7
18038,ORD_18039,4058,O P D Tablet,Warehouse B,28,20,2025-02-14 03:49:00,8
18039,ORD_18040,12115,Axid D 10mg/20mg Tablet,Warehouse B,43,35,2025-02-14 05:53:00,8
18040,ORD_18041,2954,"Mattlook CC Conceal N Cover Oil-Free SPF-15, Beige (45gm+2.5gm)",Warehouse C,46,34,2025-02-14 19:58:00,12
18041,ORD_18042,11634,Beard Comb,Warehouse B,82,65,2025-02-14 06:31:00,17
18042,ORD_18043,11961,Atitone Syrup,Warehouse B,45,26,2025-02-14 17:56:00,19
18043,ORD_18044,16514,SupCares Edge to Edge Tempered Glass for iPhone 11 and iPhone XR (6.1 Inch) with Easy Self Installation Kit | Black,Warehouse B,54,47,2025-02-14 04:22:00,7
18044,ORD_18045,11806,EREBEX 3D Temporary Tattoo Colorful Feathers Butterflies Birds Compass Totem Design Sticker Size 21x15CM - 1PC.,Warehouse C,58,42,2025-02-14 02:08:00,16
18045,ORD_18046,15997,Kumkumadi Face Cleanser,Warehouse C,72,55,2025-02-14 05:22:00,17
18046,ORD_18047,16123,Ajmal 2 Sacred Love Deo & Yearn EDP Pack of 3 20 ml,Warehouse B,47,29,2025-02-14 21:47:00,18
18047,ORD_18048,29816,Azafran Organics Everyday Gentle Face Scrub 100 gm,Warehouse B,13,3,2025-02-14 14:20:00,10
18048,ORD_18049,11809,"AirCase Office Messenger Sling Bag fits upto 15.6"" Laptop/Macbook, Detachable Shoulder Strap, Waterproof, Shockproof, Carr...",Warehouse C,54,45,2025-02-14 09:44:00,9
18049,ORD_18050,11723,SKA Fashions Madurai Thalampoo Violet Kumkum Powder Sindoor Bindi For Women And Girls Forehead Wedding Festivals Pack of 2,Warehouse C,97,87,2025-02-14 11:42:00,10
18050,ORD_18051,15532,Moska Tablet,Warehouse C,65,48,2025-02-14 17:43:00,17
18051,ORD_18052,15530,Replenishing Night Cream,Warehouse C,52,42,2025-02-14 01:22:00,10
18052,ORD_18053,29593,Gabasync-Total Tablet,Warehouse A,110,95,2025-02-14 22:45:00,15
18053,ORD_18054,16550,Trantas EM 250mg/250mg Tablet,Warehouse A,111,97,2025-02-14 10:21:00,14
18054,ORD_18055,30200,Ornibest 200mg/500mg Tablet,Warehouse C,116,98,2025-02-14 22:03:00,18
18055,ORD_18056,16523,Fashion Colour Strawberry Moisturiser 100 ml,Warehouse C,83,69,2025-02-14 16:01:00,14
18056,ORD_18057,16516,"Seagate Ultra Touch 1 TB External HDD USB-C USB 3.0, 1yr Mylio Create, 4 Months Adobe CC Photography Plan, and 3-Year Resc...",Warehouse A,24,13,2025-02-14 07:12:00,11
18057,ORD_18058,16513,"Duracell Specialty 1220 Lithium Coin Battery 3V, Pack of 5 (DL1220/CR1220) Designed for use in keyfobs, Scales, wearables ...",Warehouse B,37,21,2025-02-14 16:40:00,16
18058,ORD_18059,30097,Body Fragrance - Marcus,Warehouse A,65,57,2025-02-14 23:09:00,8
18059,ORD_18060,36193,Elzzi ® Liquid Silicone Cover Compatible for iPhone 14 Pro Max Case (6.7 inches) 3 Layer Microfiber Lining Covers Phone Ca...,Warehouse B,44,37,2025-02-14 03:37:00,7
18060,ORD_18061,4182,Classmate Octane Neon- 25 Blue Gel Pens | Smooth Writing Pens| Water-proof Ink For Smudge-free Writing| Preferred By Stude...,Warehouse A,17,8,2025-02-14 22:03:00,9
18061,ORD_18062,29650,Anti-Hair Fall Hair Cream,Warehouse C,87,73,2025-02-14 09:04:00,14
18062,ORD_18063,16453,Epilex 200mg Tablet,Warehouse C,50,31,2025-02-14 05:51:00,19
18063,ORD_18064,32049,Cinron-D Tablet,Warehouse A,115,96,2025-02-14 05:58:00,19
18064,ORD_18065,36219,Medimade Argan Oil Body Butter (Pack of 2) 1's,Warehouse B,28,21,2025-02-14 10:22:00,7
18065,ORD_18066,519,Gulfadryl Syrup,Warehouse B,93,76,2025-02-14 18:06:00,17
18066,ORD_18067,16357,Cefkia 500mg Injection,Warehouse B,110,91,2025-02-14 18:41:00,19
18067,ORD_18068,349,(Renewed) JBL C200SI Wired In Ear Headphone with Mic (Gun Metal),Warehouse C,94,81,2025-02-14 06:55:00,13
18068,ORD_18069,30167,Maryaj After Dark EDP Woody Aromatic Perfume And Ajmal Wisal Dhahab Deodorant Fruity Floral Fragrance 300 ml,Warehouse A,57,46,2025-02-14 01:42:00,11
18069,ORD_18070,16306,Jumbocef 500mg/500mg Injection,Warehouse B,53,38,2025-02-14 01:22:00,15
18070,ORD_18071,16109,Careprega 200mg Soft Gelatin Capsule,Warehouse B,94,84,2025-02-14 09:45:00,10
18071,ORD_18072,29838,"Gizga Essentials Multi-Purpose Height-Adjustable Laptop Table, Ergonomic Study Table, Portable, with Docking for Tablet, P...",Warehouse B,61,42,2025-02-14 21:15:00,19
18072,ORD_18073,15292,Ajmal Selfie Concentrated Perfume Oil Woody Aromatic And Aurum Femme Deodorant Fruity Floral Fragrance 210 ml,Warehouse C,39,34,2025-02-14 23:37:00,5
18073,ORD_18074,29879,"Samsung Galaxy A23 5G, Silver (8GB, 128GB Storage) with Offer",Warehouse B,52,42,2025-02-14 09:24:00,10
18074,ORD_18075,643,"Amazon Basics Mini Car Charger with Dual Output, Fast Charging (Type C 20W + Type A 3.0A) Compatible with All Smartphones(...",Warehouse B,51,38,2025-02-14 16:44:00,13
18075,ORD_18076,36342,Strawberry & Peach Lip Balm Combo,Warehouse C,85,74,2025-02-14 02:07:00,11
18076,ORD_18077,11894,Avocado Oil,Warehouse B,29,19,2025-02-14 22:41:00,10
18077,ORD_18078,29269,Ajmal Wild Waters Edt Of 2 & Persuade Deodorant Pack of 2 450 ml,Warehouse B,44,35,2025-02-14 17:09:00,9
18078,ORD_18079,17227,VW 80 cm (32 inches) Frameless Series HD Ready Android Smart LED TV VW32S (Black),Warehouse B,95,78,2025-02-14 10:33:00,17
18079,ORD_18080,11199,CEDO Samsung M31s Back Cover | Matte Soft Silicon Flexible | Camera Bump Protection | All Side Shock Proof Rubberised Back...,Warehouse B,84,69,2025-02-14 05:46:00,15
18080,ORD_18081,12297,Spigen Ultra Hybrid Back Cover Case for Samsung Galaxy S22 Ultra (TPU + Poly Carbonate | Crystal Clear),Warehouse B,20,5,2025-02-14 14:37:00,15
18081,ORD_18082,17219,"JUDEE Keyboard Cleaning Brush 7 in 1 Kit, Portable Keyboard Tools Including Screen Dust Brush, Airpod Cleaner Per with Key...",Warehouse C,40,27,2025-02-14 17:10:00,13
18082,ORD_18083,11204,"realme 9 5G SE (Starry Glow, 8GB RAM, 128GB Storage)",Warehouse C,73,60,2025-02-14 10:45:00,13
18083,ORD_18084,29237,Bio Active Skin Lightening Face Gel,Warehouse A,93,75,2025-02-14 15:46:00,18
18084,ORD_18085,15308,"Zebronics 300HB 4 Port USB 3.0 Hub with Hi-Speed Data Transfer, LED Indication, 15cm Cable, Backward Compatible, Multi Dev...",Warehouse A,71,53,2025-02-14 14:37:00,18
18085,ORD_18086,30299,Dzire 50mg Capsule,Warehouse C,28,14,2025-02-14 09:13:00,14
18086,ORD_18087,15314,Voage 5 Tablet,Warehouse B,66,58,2025-02-14 15:23:00,8
18087,ORD_18088,35968,Intalol 50mg Tablet,Warehouse B,23,9,2025-02-14 16:19:00,14
18088,ORD_18089,17152,Seaol CH 40mg/12.5mg Tablet,Warehouse B,58,39,2025-02-14 12:27:00,19
18089,ORD_18090,29252,Almond Cream Beauty Bathing Bar,Warehouse B,73,62,2025-02-14 19:09:00,11
18090,ORD_18091,2791,"TheGiftKart Back Cover for Samsung Galaxy A52 / A52s 5G (TPU, Poly Carbonate | Transparent, Black Bumper)",Warehouse C,27,10,2025-02-14 02:57:00,17
18091,ORD_18092,30288,"Samsung Galaxy Tab A8 10.5 inches Display, RAM 3 GB, ROM 32 GB Expandable, Wi-Fi Tablets, Gray, (SM-X200NZAAINU)",Warehouse B,19,3,2025-02-14 00:53:00,16
18092,ORD_18093,35976,Tin 0.5mg Tablet CR,Warehouse A,70,58,2025-02-14 06:45:00,12
18093,ORD_18094,17132,Aborvast 40mg Tablet,Warehouse B,42,23,2025-02-14 11:28:00,19
18094,ORD_18095,17120,TheGiftKart Shockproof Crystal Clear Back Cover Case for Google Pixel 6A | 360 Degree Protection | Protective Design | Tra...,Warehouse A,10,3,2025-02-14 16:23:00,7
18095,ORD_18096,29381,Woman - Spicy Love Eau De Toilette Deodorant,Warehouse A,34,29,2025-02-14 14:16:00,5
18096,ORD_18097,16914,Herbal Milk & Saffron Hand Cream,Warehouse B,37,19,2025-02-14 02:05:00,18
18097,ORD_18098,16900,"RESTONE Clear Magnetic Case for iPhone 12/12 Pro 6.1, Slim Fit Hard Back Soft Silicone TPU Bumper Cover, Cute Thin Shockpr...",Warehouse B,74,57,2025-02-14 15:09:00,17
18098,ORD_18099,16895,Aticlav 200mg/28.5mg Tablet,Warehouse A,108,93,2025-02-14 07:17:00,15
18099,ORD_18100,16715,Sery Focuseye Shadow Stick E1 Night 2.5 gm,Warehouse A,46,40,2025-02-14 22:30:00,6
18100,ORD_18101,36129,OpenTech® Tempered Glass Screen Protector Compatible for Oneplus 10T 5G with Edge to Edge Coverage and Easy Installation kit,Warehouse A,67,58,2025-02-14 03:30:00,9
18101,ORD_18102,36136,Alzero M Syrup,Warehouse B,59,45,2025-02-14 19:24:00,14
18102,ORD_18103,16688,"Fashion Colour Lip Crayon, Waterproof, Long Lasting, 27 Smitten 2.8 gm",Warehouse B,29,11,2025-02-14 18:54:00,18
18103,ORD_18104,11799,BeautifulMe Durable Moroccan Hammam Exfoliating Mitt Kessa Scrub Glove Preparation Shower Scrub Gloves Body Facial Tan Mas...,Warehouse A,82,69,2025-02-14 18:01:00,13
18104,ORD_18105,30207,Wayona MFI Certified USB C to Lightning Cable Short 0.25M Fast Charging PD 20W for iPhone 14 14 Pro 14 Plus 14 Pro Max 13 ...,Warehouse A,97,82,2025-02-14 22:19:00,15
18105,ORD_18106,29275,Dinofen SP Tablet,Warehouse C,79,71,2025-02-14 07:40:00,8
18106,ORD_18107,4362,Carzec 3.125 Tablet,Warehouse C,22,14,2025-02-14 22:08:00,8
18107,ORD_18108,36347,Belora Paris World Matte Vit C Popsicles - 013 Earthy Sudan 4.2 gm,Warehouse A,88,80,2025-02-14 00:30:00,8
18108,ORD_18109,2915,"Wayona 4 in 1 OTG Card Reader Four Ports : Lightning + Type C + Micro USB + USB Card Reader - Like Iflash, Idisk for iPhon...",Warehouse B,30,23,2025-02-14 14:15:00,7
18109,ORD_18110,15958,Rejuvenating UBTAN Essential Oil - Frankincense 10 ml,Warehouse C,94,78,2025-02-14 13:33:00,16
18110,ORD_18111,15932,Candid Mouth Paint,Warehouse C,34,25,2025-02-14 20:08:00,9
18111,ORD_18112,11933,CHITROSE Soft Bristle Kitty Makeup Brush Set with Storage Box (Pink) - (Set of 7),Warehouse C,101,90,2025-02-14 20:44:00,11
18112,ORD_18113,11935,Unique Empire Stainless Steel Cosmetic Makeup Mixing Makeup Plate (Set of 2),Warehouse C,79,64,2025-02-14 19:36:00,15
18113,ORD_18114,29941,Panty Liners - Designed For Sensitive Skin,Warehouse A,110,91,2025-02-14 19:33:00,19
18114,ORD_18115,16566,DIGITEK® (DSG 007F) 3 Axis Handheld Steady Gimbal PTZ Camera Mount for All Smart Phones with Face & Object Tracking Motio...,Warehouse B,69,54,2025-02-14 00:34:00,15
18115,ORD_18116,16587,Zopenta 6.25mg Tablet ER,Warehouse A,52,35,2025-02-14 20:27:00,17
18116,ORD_18117,36172,Klokmox CL 500mg/125mg Tablet,Warehouse C,84,75,2025-02-14 15:44:00,9
18117,ORD_18118,17112,SanDisk Ultra 128 GB USB 3.0 Pen Drive (Black),Warehouse C,91,74,2025-02-14 18:20:00,17
18118,ORD_18119,17080,Mirabelle Korea Argan Oil Ultra Facial Sheet Mask 25 Ml,Warehouse C,36,17,2025-02-14 07:03:00,19
18119,ORD_18120,677,Cezifix 200mg Tablet,Warehouse A,47,41,2025-02-14 19:31:00,6
18120,ORD_18121,29315,"Portronics Toad 101 Wired Optical Mouse with 1200 DPI, Plug & Play, Hi-Optical Tracking, 1.25M Cable Length, 30 Million Cl...",Warehouse B,24,14,2025-02-14 04:52:00,10
18121,ORD_18122,15367,Ponds Starlight Talc,Warehouse A,50,39,2025-02-14 22:26:00,11
18122,ORD_18123,32162,Global Mythical Bloom & Cosmic Charm Pack of 2 Eau De Parfum 100ML for Women Crafted by Ajmal,Warehouse A,73,67,2025-02-14 23:54:00,6
18123,ORD_18124,17040,Fujifilm Instax Mini Picture Format Film (20 Shots),Warehouse C,52,34,2025-02-14 21:01:00,18
18124,ORD_18125,12274,Amazon Brand - Solimo Back Cover Case for Mi A3 | Compatible for Mi A3 Back Cover Case | 360 Degree Protection | Soft and ...,Warehouse A,57,39,2025-02-14 20:31:00,18
18125,ORD_18126,664,Zapcase Thermoplastic Polyurethane Back Case Cover for iPhone 13 | Compatible for iPhone 13 Back Case Cover | Scratch-Resi...,Warehouse B,61,51,2025-02-14 13:16:00,10
18126,ORD_18127,17028,Tint’d Liquid Blush- Over the moon,Warehouse A,103,87,2025-02-14 23:40:00,16
18127,ORD_18128,12272,"AmazonBasics RJ45 Cat 7 High-Speed Gigabit Ethernet Patch Internet Cable for Printer, Server (10Gbps, 600MHz - Black, 3-Feet)",Warehouse B,63,44,2025-02-14 13:22:00,19
18128,ORD_18129,29349,Faces Canada Hi Shine Nail Enamel Hollywood - 54 9 Ml,Warehouse C,59,53,2025-02-14 11:27:00,6
18129,ORD_18130,36029,Azigaur 500mg Tablet,Warehouse C,83,73,2025-02-14 07:56:00,10
18130,ORD_18131,36033,Glicus M 80mg/500mg Tablet,Warehouse B,69,56,2025-02-14 02:59:00,13
18131,ORD_18132,32150,Prenerv M 750mcg/75mg Capsule,Warehouse B,73,64,2025-02-14 13:14:00,9
18132,ORD_18133,29362,"Western Digital WD Blue SN570 NVMe 500GB, Upto 3500MB/s, with Free 1 Month Adobe Creative Cloud Subscription, 5 Y Warrant...",Warehouse C,98,87,2025-02-14 16:53:00,11
18133,ORD_18134,31835,Rabrel-DSR Capsule,Warehouse A,28,10,2025-02-14 02:32:00,18
18134,ORD_18135,16128,Color Naturals Creme Riche Ultra Hair Color - Plum Red,Warehouse B,67,58,2025-02-14 23:44:00,9
18135,ORD_18136,10302,Genlide Plus 100 mg/500 mg Tablet,Warehouse A,109,96,2025-02-14 01:56:00,13
18136,ORD_18137,11796,Glycolic Concentrate,Warehouse B,100,83,2025-02-14 06:21:00,17
18137,ORD_18138,10375,"Oraimo 18W USB Wall Charger,3A Super Fast Charger Wall Adapter PE2.0&Quick Charge 3.0 Wall Charger Phone Adapter with 1m L...",Warehouse A,103,91,2025-02-14 07:11:00,12
18138,ORD_18139,4824,Norethi 10 CR Tablet,Warehouse A,49,41,2025-02-14 19:00:00,8
18139,ORD_18140,957,Lakme 9To5 Weightless Mousse Foundation Natural Sand 25 Gm,Warehouse C,43,33,2025-02-14 21:18:00,10
18140,ORD_18141,18485,Letazin FX 10mg/120mg Tablet,Warehouse A,102,88,2025-02-14 11:19:00,14
18141,ORD_18142,32430,Tretcee HQ Cream,Warehouse B,101,92,2025-02-14 09:56:00,9
18142,ORD_18143,10423,Soulflower Romantic Rose Bath And Aroma Set 600 gm,Warehouse A,83,70,2025-02-14 07:38:00,13
18143,ORD_18144,28467,Omidazzle Ultra soft Blender Makeup Sponge Set of 4 with box (Multicolor),Warehouse C,15,1,2025-02-14 20:13:00,14
18144,ORD_18145,18454,Mach3 Sensitive - Manual Shaving Razor Blades Cartridge,Warehouse B,68,53,2025-02-14 22:27:00,15
18145,ORD_18146,36654,Eliceph 250mg Capsule,Warehouse B,46,36,2025-02-14 21:23:00,10
18146,ORD_18147,18448,Etrocef 200 Tablet,Warehouse C,37,23,2025-02-14 05:53:00,14
18147,ORD_18148,30516,"L'Oreal Paris Women's Dermo-Expertise Gentle Lip and Eye Make-up Remover 125 ml with Extra Ayur Sunscreen, 50 ml",Warehouse A,13,1,2025-02-14 14:16:00,12
18148,ORD_18149,10439,Audio-Technica Ath-M20X Wired Over Ear Headphones Without Mic (Black),Warehouse A,85,73,2025-02-14 10:27:00,12
18149,ORD_18150,14970,Augmed 250 mg/125 mg Tablet,Warehouse C,103,98,2025-02-14 08:25:00,5
18150,ORD_18151,18555,Ezinoz Nasal Spray,Warehouse C,54,40,2025-02-14 06:21:00,14
18151,ORD_18152,18563,Skin Naturals - Light Complete Night Cream,Warehouse C,21,12,2025-02-14 04:50:00,9
18152,ORD_18153,10665,Zoline Eye Drop,Warehouse B,72,53,2025-02-14 16:49:00,19
18153,ORD_18154,35472,"Camlin Brush Pen 12 Shades, Bold - Assorted",Warehouse C,109,91,2025-02-14 01:54:00,18
18154,ORD_18155,18745,Flormar Full Color Nail Enamel FC13 Squashed Raspberry 8 ml,Warehouse C,73,55,2025-02-14 13:45:00,18
18155,ORD_18156,35478,Gleways PM 1mg/500mg/15mg Tablet SR,Warehouse B,35,16,2025-02-14 22:58:00,19
18156,ORD_18157,30576,"Samsung Galaxy M33 5G (Mystique Green, 6GB, 128GB Storage) | 6000mAh Battery | Upto 12GB RAM with RAM Plus | Travel Adapte...",Warehouse C,95,89,2025-02-14 09:57:00,6
18157,ORD_18158,28301,Tramajem 100mg/325mg Tablet,Warehouse C,65,55,2025-02-14 02:18:00,10
18158,ORD_18159,4895,Floracal Tablet,Warehouse B,24,10,2025-02-14 12:14:00,14
18159,ORD_18160,32486,Onapract 0.25mg Tablet,Warehouse C,70,52,2025-02-14 03:05:00,18
18160,ORD_18161,18696,Colorbar Lux Nail Lacquer Cbn1118 12 Ml,Warehouse A,54,37,2025-02-14 22:28:00,17
18161,ORD_18162,10272,Clofedac-AQ Injection,Warehouse B,98,91,2025-02-14 07:18:00,7
18162,ORD_18163,4887,Acer 80 cm (32 inches) I Series HD Ready Android Smart LED TV AR32AR2841HDFL (Black),Warehouse A,75,59,2025-02-14 04:10:00,16
18163,ORD_18164,32479,Style Shoes Brown Leather Card Holder Card case Money Purse Wallet-9164QL9-BB,Warehouse C,112,97,2025-02-14 12:39:00,15
18164,ORD_18165,32465,Vilatin DP 5mg/100mg Tablet,Warehouse B,98,91,2025-02-14 00:23:00,7
18165,ORD_18166,10389,Appime T 500mg/62.5mg Injection,Warehouse B,92,76,2025-02-14 07:49:00,16
18166,ORD_18167,36662,Nandika Beauty Hair Removal Wax - White Milky 600 ml,Warehouse A,91,84,2025-02-14 19:34:00,7
18167,ORD_18168,31999,"Issey Miyake L'Eau D'Issey Pure Nectar Eau De Parfum for her, 30ml",Warehouse B,27,18,2025-02-14 12:02:00,9
18168,ORD_18169,10364,Sevenaire MagCharge D1900 3-in-1 Wireless Charger [Dual Phone Charge] [15W Fast Charge] [Mag-Safe Compatible] for iPhone 1...,Warehouse A,107,96,2025-02-14 12:25:00,11
18169,ORD_18170,36504,"Fashion Colour Colour Correction Makeup Base Single Packing, FS29 3.5 gm",Warehouse A,37,24,2025-02-14 07:45:00,13
18170,ORD_18171,28995,Flutil 150mg Capsule,Warehouse C,30,19,2025-02-14 11:20:00,11
18171,ORD_18172,15243,Regimen Kit - 1 Razor + 2 Refills + 1 Satin Care Sensitive Skin Gel,Warehouse B,53,45,2025-02-14 22:26:00,8
18172,ORD_18173,10959,Capitrax Plus 500mg/250mg Tablet,Warehouse A,103,95,2025-02-14 19:08:00,8
18173,ORD_18174,29002,"EGOTUDE Ultra Hybrid Hard Back Transparent Cover Case for iPhone 13 (Black, Polycarbonate)",Warehouse A,41,29,2025-02-14 07:00:00,12
18174,ORD_18175,29004,"Arctic Hunter Sling Bag for Men,Chest Bag for Men Crossbody Bag for Men Stylish Shoulder Bag for Men Water&Scratch Resista...",Warehouse A,80,73,2025-02-14 13:58:00,7
18175,ORD_18176,10977,Tavak Oil,Warehouse A,17,3,2025-02-14 17:43:00,14
18176,ORD_18177,35845,"iMethod Wing Eyeliner Stamp 2 Packs Left and Right Dual Ended Liquid , The Easiest Way to Get Perfect Winged Cat Look, Wat...",Warehouse A,40,35,2025-02-14 00:38:00,5
18177,ORD_18178,29020,Ondonac Injection,Warehouse C,66,61,2025-02-14 03:22:00,5
18178,ORD_18179,29026,Clonapax 0.5mg Tablet,Warehouse A,21,15,2025-02-14 00:11:00,6
18179,ORD_18180,29034,Pubg Anti-Slip Thumb Sleeve Pack Of 6 Pair Yellow Finger Sleeve (Pack of 12),Warehouse C,82,69,2025-02-14 02:43:00,13
18180,ORD_18181,2753,Avocado Cold Pressed Oil,Warehouse C,61,51,2025-02-14 03:44:00,10
18181,ORD_18182,15216,Vega Lip Filler (PV - 23) 16 gm,Warehouse A,97,84,2025-02-14 09:24:00,13
18182,ORD_18183,29050,Rabenny 20 Tablet,Warehouse A,20,9,2025-02-14 21:13:00,11
18183,ORD_18184,4492,Fragrance Body Spray - High Street For Women,Warehouse A,27,20,2025-02-14 17:52:00,7
18184,ORD_18185,15224,Sonazep 0.5mg Tablet,Warehouse A,103,98,2025-02-14 15:51:00,5
18185,ORD_18186,17459,Lakme Color Crush Nailart M15 Purple 6 Ml,Warehouse C,103,87,2025-02-14 09:03:00,16
18186,ORD_18187,17449,Rabomac 20mg Tablet,Warehouse B,86,67,2025-02-14 15:00:00,19
18187,ORD_18188,29082,AlexVyan 24pcs Eyebrow Shaping Stencils Grooming Kit Makeup Shaper Set Template Tool Make up tools Maquiagem,Warehouse C,24,17,2025-02-14 12:08:00,7
18188,ORD_18189,36568,Sidpiles Tablets -  For Relief From Piles,Warehouse C,102,91,2025-02-14 03:20:00,11
18189,ORD_18190,12325,Mapime 1gm Injection,Warehouse B,66,54,2025-02-14 07:07:00,12
18190,ORD_18191,29100,Lenphor Nail Tint Pine Love 59 12 Ml,Warehouse B,29,20,2025-02-14 05:25:00,9
18191,ORD_18192,4660,"Sevenaire 20W USB Type-C PD Fast Charging Adapter for iPhone 14/13/12/11/X Series, iPad Pro",Warehouse C,60,45,2025-02-14 16:32:00,15
18192,ORD_18193,15075,Lulinea 1% Cream,Warehouse B,102,86,2025-02-14 08:22:00,16
18193,ORD_18194,28720,Moxiday 500mg Capsule,Warehouse A,52,46,2025-02-14 06:24:00,6
18194,ORD_18195,4846,Clopinox-A Capsule,Warehouse A,62,57,2025-02-14 22:48:00,5
18195,ORD_18196,35532,"The Body Shop Vegan Strawberry Soap, 100 G",Warehouse A,73,57,2025-02-14 01:33:00,16
18196,ORD_18197,28416,Matlek Bluetooth Earbuds | True Wireless in Ear Earphones with Deep Bass | 16 Hour Battery,Warehouse C,74,59,2025-02-14 13:06:00,15
18197,ORD_18198,12515,Esoloc D 30mg/40mg Capsule,Warehouse C,86,71,2025-02-14 07:15:00,15
18198,ORD_18199,2645,"Casio DJ-120D 150 Steps Check and Correct Desktop Calculator with Bigger Screen/Keys (12 Digit), Black",Warehouse C,53,47,2025-02-14 15:56:00,6
18199,ORD_18200,18577,Cefnic-O Tablet,Warehouse A,20,14,2025-02-14 04:11:00,6
18200,ORD_18201,18571,Stabglu TM Forte 1000mg/20mg Tablet,Warehouse C,95,83,2025-02-14 11:50:00,12
18201,ORD_18202,933,Ethamstat 250mg Tablet,Warehouse C,74,68,2025-02-14 16:36:00,6
18202,ORD_18203,28519,Beauty People Sheer Color Lipstick - Just - Peach - 401 3.8 gm,Warehouse C,56,41,2025-02-14 20:51:00,15
18203,ORD_18204,932,Swemox 250mg Capsule,Warehouse B,95,80,2025-02-14 06:24:00,15
18204,ORD_18205,14987,YAMAHA PSR-E373 61-Keys Portable Keyboard,Warehouse A,75,57,2025-02-14 17:43:00,18
18205,ORD_18206,30503,"TOSHIBA Canvio Basics 2TB Portable External HDD - USB 3.0 for PC Laptop Windows and Mac, 3 Years Warranty, External Hard D...",Warehouse C,73,67,2025-02-14 17:42:00,6
18206,ORD_18207,10538,Shampoo Colour Shade - 3.16 Burgundy,Warehouse C,78,61,2025-02-14 16:54:00,17
18207,ORD_18208,35603,DeBelle Gel Nail Lacquer Grey Glitteratti Silver Glitter Nail Polish 8 ml,Warehouse A,112,95,2025-02-14 21:12:00,17
18208,ORD_18209,912,Brentor 200mg Injection,Warehouse C,79,72,2025-02-14 13:43:00,7
18209,ORD_18210,3041,Herbal Sensitive pH balanced Liquid Handwash,Warehouse B,41,25,2025-02-14 12:33:00,16
18210,ORD_18211,18315,Tongue Cleaner - Copper 006,Warehouse A,59,41,2025-02-14 03:12:00,18
18211,ORD_18212,2666,MI 100 cm (40 inches) 5A Series Full HD Smart Android LED TV L40M7-EAIN (Black),Warehouse C,75,63,2025-02-14 02:29:00,12
18212,ORD_18213,18311,Astigo Compatible Sony TV Remote Control (Works with Most Sony LCD/LED TV) RM-L1370,Warehouse A,47,32,2025-02-14 03:58:00,15
18213,ORD_18214,10536,Namocef 1000mg Injection,Warehouse C,80,65,2025-02-14 00:25:00,15
18214,ORD_18215,18304,Coffee Energizing Face Scrub,Warehouse A,44,26,2025-02-14 16:21:00,18
18215,ORD_18216,17261,Mobinac O 50mg/10mg Tablet,Warehouse B,67,51,2025-02-14 07:02:00,16
18216,ORD_18217,17238,Flukem 150mg Tablet,Warehouse C,36,27,2025-02-14 21:25:00,9
18217,ORD_18218,14874,Loprin 75 Tablet,Warehouse B,33,21,2025-02-14 15:44:00,12
18218,ORD_18219,2864,Finemox CV Dry Syrup,Warehouse C,22,3,2025-02-14 22:50:00,19
18219,ORD_18220,11727,Raswin F 160mg/10mg Tablet,Warehouse C,43,27,2025-02-14 22:45:00,16
18220,ORD_18221,2966,Largyl O Tablet,Warehouse B,79,68,2025-02-14 17:04:00,11
18221,ORD_18222,30150,Glimip MP 2mg/500mg/15mg Tablet,Warehouse B,115,99,2025-02-14 09:58:00,16
18222,ORD_18223,353,Mycocin Syrup,Warehouse A,102,97,2025-02-14 16:14:00,5
18223,ORD_18224,11763,"LG 22Mp68Vq 22 Inch (55 Cm) LCD 1920 X 1080 Pixels IPS Monitor - Full Hd, with Vga, Hdmi, Dvi, Audio Out Ports (Black)",Warehouse C,50,44,2025-02-14 17:41:00,6
18224,ORD_18225,4109,Cefocef O 100mg Tablet,Warehouse C,92,84,2025-02-14 17:58:00,8
18225,ORD_18226,16204,Flexpod 200mg Tablet,Warehouse B,66,59,2025-02-14 14:26:00,7
18226,ORD_18227,16189,Moutiv-M Tablet,Warehouse A,30,17,2025-02-14 18:36:00,13
18227,ORD_18228,16179,Weird Wolf Mosquito Racket Bat with Lithium Battery (CE Certified) | USB Charging | Bright LED | All India Warranty (Purple),Warehouse A,112,97,2025-02-14 18:05:00,15
18228,ORD_18229,15574,TNW - The Natural Wash Baby Body Wash 150 ml,Warehouse B,24,15,2025-02-14 04:50:00,9
18229,ORD_18230,28505,Rifacure 450mg Capsule,Warehouse B,64,50,2025-02-14 15:03:00,14
18230,ORD_18231,14981,Gliminyle 1mg Tablet,Warehouse C,47,30,2025-02-14 19:02:00,17
18231,ORD_18232,28502,Nutriment Charcoal Scrub All Skin Type 250 gm,Warehouse B,41,29,2025-02-14 20:10:00,12
18232,ORD_18233,18198,Myglamm Lit - Ph Lip Balm - Orange Crush 2 Gm,Warehouse A,81,70,2025-02-14 21:24:00,11
18233,ORD_18234,10347,Gear Aspire 30L Water Restant Office Laptop Bag/Backpack for Men/Women/(Black),Warehouse C,38,27,2025-02-14 14:14:00,11
18234,ORD_18235,28478,Gufidol 100mg Injection,Warehouse C,110,94,2025-02-14 12:29:00,16
18235,ORD_18236,10450,Maxiflo 0.5% Eye Drop,Warehouse C,70,56,2025-02-14 02:11:00,14
18236,ORD_18237,32420,Nepcinac Eye Drop,Warehouse C,65,48,2025-02-14 02:53:00,17
18237,ORD_18238,30512,Nidase D Tablet,Warehouse B,40,21,2025-02-14 21:14:00,19
18238,ORD_18239,10544,"SWAPKART Gold Plated 3.5mm 2 Male to 1 Female Headphone Earphone Mic Audio Y Splitter Adapter Cable for PC Laptop (20cm, B...",Warehouse B,64,47,2025-02-14 01:35:00,17
18239,ORD_18240,18270,"Wecool Mr. Bass W001 Metallic in Ear Earphones with Rich Bass and Surround Sound, Wired Earphones with Volume Controller, ...",Warehouse C,10,4,2025-02-14 12:45:00,6
18240,ORD_18241,18257,Peppermint & Black Seed Lip Polish,Warehouse B,25,12,2025-02-14 11:58:00,13
18241,ORD_18242,18233,Bronset Syrup,Warehouse A,42,27,2025-02-14 00:28:00,15
18242,ORD_18243,18230,Nordart 5mg Tablet,Warehouse B,107,99,2025-02-14 05:52:00,8
18243,ORD_18244,28617,SEVAM Broadcast Mobile Phone Stand Multi-Angle Adjustable Desk Mount Holder 360 Rotate for Online Classes Live Streaming S...,Warehouse C,36,20,2025-02-14 21:56:00,16
18244,ORD_18245,28632,"Activated Charcoal Peel-Off Face Mask For Acne, Pimples & Dark Spots",Warehouse C,50,39,2025-02-14 12:21:00,11
18245,ORD_18246,35641,Ropclav-LB Tablet,Warehouse A,16,9,2025-02-14 04:52:00,7
18246,ORD_18247,28501,House of Aroma Believe Fragrance Oil 10 ml,Warehouse C,90,82,2025-02-14 07:25:00,8
18247,ORD_18248,32375,"Fashion Colour Pro Hd Eyeshadow Palette 18 Shades, Shade 02 14 gm",Warehouse A,101,82,2025-02-14 18:59:00,19
18248,ORD_18249,885,Ajmal Selfie Concentrated Perfume Oil Woody Aromatic And Maryaj Tuxedo EDP Spicy Woody Perfume 110 ml,Warehouse B,77,62,2025-02-14 08:10:00,15
18249,ORD_18250,10618,Gaviflox OZ 200mg/500mg Tablet,Warehouse A,80,62,2025-02-14 10:06:00,18
18250,ORD_18251,30458,ClubComfort Matte Me Ultra Smooth Liquid Lipstick (Maroon) 6 ML,Warehouse A,109,96,2025-02-14 09:02:00,13
18251,ORD_18252,18139,"Fashion Colour Lip Crayon, Waterproof, Long Lasting, 1 Pink Passion 2.8 gm",Warehouse B,41,22,2025-02-14 02:01:00,19
18252,ORD_18253,32368,Droxef LB 250mg Tablet,Warehouse A,33,24,2025-02-14 07:05:00,9
18253,ORD_18254,10659,"Duracell Rechargeable AA 2500mAh Batteries, 2 Pcs",Warehouse A,37,23,2025-02-14 12:46:00,14
18254,ORD_18255,18288,Tazomac PS 1000mg/125mg Injection,Warehouse A,33,17,2025-02-14 05:54:00,16
18255,ORD_18256,18289,Rabxo L 75mg/20mg Capsule SR,Warehouse B,104,92,2025-02-14 22:36:00,12
18256,ORD_18257,18302,Ciprocid 500mg Tablet,Warehouse A,90,81,2025-02-14 05:31:00,9
18257,ORD_18258,4762,Dell MS5120W-Black Pro Wireless Dual Connectivity Mouse (Bluetooth 5.0/Wireless 2.4G) with Programmable Button and 3Y Adva...,Warehouse C,82,66,2025-02-14 07:49:00,16
18258,ORD_18259,16686,LE-Citriz Tablet,Warehouse B,15,4,2025-02-14 04:30:00,11
18259,ORD_18260,20677,Leucovorin Injection,Warehouse A,29,15,2025-02-14 03:53:00,14
18260,ORD_18261,36503,Megcetam 500mg Tablet,Warehouse B,99,93,2025-02-14 16:19:00,6
18261,ORD_18262,27540,Cef 200 DT Tablet,Warehouse A,74,68,2025-02-14 12:55:00,6
18262,ORD_18263,12682,The Natural Wash Honey Milk Skin Softening Shower Gel 250 Ml,Warehouse A,101,87,2025-02-14 21:08:00,14
18263,ORD_18264,19890,Protect & Care After Shave Balm,Warehouse C,97,81,2025-02-14 01:08:00,16
18264,ORD_18265,27379,Beautiful Skin Capsules,Warehouse C,23,15,2025-02-14 11:19:00,8
18265,ORD_18266,19883,"Boult Audio Probass Qcharge Bluetooth Wireless in Ear Earphones with Mic with Fast Charging, 20H Battery Life, Ipx5 Water ...",Warehouse C,83,71,2025-02-14 14:52:00,12
18266,ORD_18267,9603,Pierre Cardin Paris - Studio Nails 82,Warehouse C,100,92,2025-02-14 09:59:00,8
18267,ORD_18268,32703,Fenic SN 50mg/10mg Tablet,Warehouse A,94,87,2025-02-14 00:35:00,7
18268,ORD_18269,5316,Gulabari Rose Glow Face Cleanser,Warehouse A,18,5,2025-02-14 16:48:00,13
18269,ORD_18270,27583,Hunky Dory 50ml Empty Clear Plastic Bottles Refillable Travel Size Cosmetic Containers Small Leak Proof Squeeze Bottles wi...,Warehouse C,66,57,2025-02-14 00:45:00,9
18270,ORD_18271,5313,Original BN4A Battery Compatible for Xiaomi Redmi Note 7 / Redmi Note 7s / Redmi Note 7 Pro - 4000mAh - 1 Year Warranty.,Warehouse C,29,18,2025-02-14 02:27:00,11
18271,ORD_18272,30796,"BROLAVIYA Overhead Video Tabletop Stand Phone Holder, Metal Long Lazy Arm and Bracket for All Mobiles Phone, for Streaming...",Warehouse C,64,57,2025-02-14 12:00:00,7
18272,ORD_18273,9427,Portronics Auto 14 2-in-1 Bluetooth Transmitter & Receiver Adaptor (Black),Warehouse C,18,12,2025-02-14 04:44:00,6
18273,ORD_18274,27576,Ayurvedic Sanai Powder,Warehouse C,35,22,2025-02-14 14:17:00,13
18274,ORD_18275,20215,Toys Factory CV3 HD High Definition Foyndation Oil-Free Pack of 1,Warehouse B,45,29,2025-02-14 00:57:00,16
18275,ORD_18276,18780,Professional Brush - Roller,Warehouse B,72,60,2025-02-14 05:30:00,12
18276,ORD_18277,30834,"R M ENTERPRISES Soft Bristle Makeup Brush Set With Pu Leather Case - Black, 24 Pieces, 24 In 1 Makeup Brush Black",Warehouse C,110,97,2025-02-14 09:12:00,13
18277,ORD_18278,30775,Onnerv Plus Injection,Warehouse B,41,35,2025-02-14 16:32:00,6
18278,ORD_18279,20540,Valtec 200mg Tablet,Warehouse B,52,39,2025-02-14 14:56:00,13
18279,ORD_18280,20663,"TheGiftKart Back Cover for Redmi Note 7 / 7S / Note 7 Pro (TPU, Poly Carbonate | Black, Transparent)",Warehouse A,51,44,2025-02-14 14:39:00,7
18280,ORD_18281,32529,Bilhist 20 Tablet,Warehouse B,78,63,2025-02-14 07:39:00,15
18281,ORD_18282,35391,Argan Oil & Lavender Aroma Smooth & Serene Shampoo,Warehouse B,49,31,2025-02-14 22:36:00,18
18282,ORD_18283,19028,Sperixime Oral Suspension Mango,Warehouse A,60,53,2025-02-14 17:30:00,7
18283,ORD_18284,19047,Adicef-O Oral Suspension,Warehouse B,93,83,2025-02-14 22:23:00,10
18284,ORD_18285,14806,"Super Clean Toothbrush - Medium Bristles, Colour May Vary",Warehouse B,28,20,2025-02-14 17:16:00,8
18285,ORD_18286,10059,FEDUS 3M Computer Power Cable Cord for Desktops PC and Printers/Monitor SMPS Power Cable IEC Mains Power Cable Black,Warehouse C,53,47,2025-02-14 01:43:00,6
18286,ORD_18287,20632,Anxozeal 20mg Tablet,Warehouse A,23,15,2025-02-14 12:15:00,8
18287,ORD_18288,32557,"mobistyle Rubber, Plastic, Metal iPhone 14/iPhone 13 Back Cover, Enhanced Metal Camera Guard Shockproof Back Cover Case Co...",Warehouse C,12,6,2025-02-14 08:31:00,6
18288,ORD_18289,27565,Tizflox 400 mg/600 mg Tablet,Warehouse B,46,40,2025-02-14 00:19:00,6
18289,ORD_18290,1210,Tamslar 0.5mg Tablet,Warehouse B,46,33,2025-02-14 16:27:00,13
18290,ORD_18291,14541,MET XL NT TABLET,Warehouse B,28,12,2025-02-14 12:11:00,16
18291,ORD_18292,36769,"Noise ColorFit Ultra SE Smart Watch with 1.75""(4.3cm) HD Display, Aluminium Alloy Body, 60 Sports Modes, Spo2, Lightweigh...",Warehouse B,97,82,2025-02-14 12:27:00,15
18292,ORD_18293,14542,Body Wash Luminous Oils Rejuvenating Shower Gel With 100% Natural Fig Oil & White Orchid Extracts,Warehouse A,91,75,2025-02-14 15:49:00,16
18293,ORD_18294,20093,Dloxin 500mg Tablet,Warehouse C,91,77,2025-02-14 00:16:00,14
18294,ORD_18295,5383,Raftor Plus 50mg/10mg Tablet,Warehouse A,12,7,2025-02-14 19:38:00,5
18295,ORD_18296,9498,Vomot 4mg Tablet MD,Warehouse C,64,47,2025-02-14 18:54:00,17
18296,ORD_18297,20045,Nimik Plus Suspension,Warehouse A,44,32,2025-02-14 01:53:00,12
18297,ORD_18298,32734,Fluiz 10 Tablet,Warehouse A,24,8,2025-02-14 02:46:00,16
18298,ORD_18299,36796,Colorbar Sun Genius Top Coat Cbn1000 12 Ml,Warehouse B,60,51,2025-02-14 12:22:00,9
18299,ORD_18300,35041,Metwon XR 25 Tablet,Warehouse B,50,43,2025-02-14 15:30:00,7
18300,ORD_18301,20046,Nicopenta Injection,Warehouse C,23,14,2025-02-14 02:38:00,9
18301,ORD_18302,30792,"QUANTIC Silicone Socks Silicone Full Size Socks, Moisturizing Socks Foot Anti Cracking Care Socks for Dry Feet Cracked Hee...",Warehouse C,30,20,2025-02-14 01:14:00,10
18302,ORD_18303,19914,Sotret 10mg Capsule,Warehouse A,48,35,2025-02-14 14:38:00,13
18303,ORD_18304,14620,"WeCool Bluetooth Extendable Selfie Sticks with Wireless Remote and Tripod Stand, 3-in-1 Multifunctional Selfie Stick with ...",Warehouse C,46,37,2025-02-14 00:09:00,9
18304,ORD_18305,35012,Kindnim 100mg Tablet,Warehouse A,95,89,2025-02-14 14:05:00,6
18305,ORD_18306,35148,Charcoal Anti Pollution Foaming Face wash,Warehouse A,69,55,2025-02-14 21:00:00,14
18306,ORD_18307,2515,Deborah Milano Velvet Kajal&Eyeliner - 02 Blue 1.5 gm,Warehouse A,43,35,2025-02-14 20:03:00,8
18307,ORD_18308,3600,Pansoft D Tablet,Warehouse B,16,8,2025-02-14 03:58:00,8
18308,ORD_18309,27635,Tixy Kid  Syrup,Warehouse B,57,40,2025-02-14 02:09:00,17
18309,ORD_18310,27357,Noxifenac 100mg/325mg Tablet,Warehouse C,85,73,2025-02-14 11:11:00,12
18310,ORD_18311,32670,3Pack USB C Female to Lightning Male Adapter for iPhone 12/11/8 X XR/XS/SE/7Plus/Pro Max Ipad Air Mini Type Compatible wit...,Warehouse A,76,68,2025-02-14 07:43:00,8
18311,ORD_18312,2504,Skin Lightening Oxygen Bleach - Rich Fairness,Warehouse B,80,68,2025-02-14 14:52:00,12
18312,ORD_18313,27651,Aminophylin Injection,Warehouse C,54,40,2025-02-14 18:41:00,14
18313,ORD_18314,27665,Atulya Lemon Soap 125 gm,Warehouse C,70,60,2025-02-14 21:24:00,10
18314,ORD_18315,19736,TheGiftKart Back Case Cover for Samsung Galaxy S21 FE 5G Back Case Cover | Tough Armor Bumper | Ring Holder & Kickstand i...,Warehouse A,58,45,2025-02-14 12:08:00,13
18315,ORD_18316,3545,Milagro Beauty 2 in 1 Dual End Cream Brush Large Angled Dense Plus Mini Small Fluffy Bristle Spot Concealing Precise Cover...,Warehouse B,50,38,2025-02-14 22:54:00,12
18316,ORD_18317,32663,"Parker Jotter Anti Microbial Stainless Steel Ball Pen - CION Coated (Ink - Blue), 1 Count(Pack of 1) (9000025835)",Warehouse A,82,66,2025-02-14 17:01:00,16
18317,ORD_18318,20627,Senna Leaves Powder - Supports Laxative & Intestinal Purgation Response,Warehouse A,24,14,2025-02-14 09:05:00,10
18318,ORD_18319,28066,Methoday 0.125mg Tablet,Warehouse C,95,83,2025-02-14 13:18:00,12
18319,ORD_18320,32566,Oakter Mini UPS for 9V WiFi Router Broadband Modem | Backup Upto 4 Hours | WiFi Router UPS Power Backup During Power Cuts...,Warehouse C,29,19,2025-02-14 09:30:00,10
18320,ORD_18321,10016,"Iba Halal Care Pure Lips Moisturizing Lipstick Shade - A65 Ruby Touch, 4g and Halal Care All Day Kohl Kajal - Jet Black, ...",Warehouse C,77,63,2025-02-14 10:24:00,14
18321,ORD_18322,10115,Narayana Oil,Warehouse A,53,37,2025-02-14 06:33:00,16
18322,ORD_18323,4968,"HP K300 Backlit Membrane Wired Gaming Keyboard with Mixed Color Lighting, 4 LED Indicators, Matte Finish Double Injection ...",Warehouse C,103,84,2025-02-14 11:44:00,19
18323,ORD_18324,242,Azitough 500mg Tablet,Warehouse C,61,49,2025-02-14 09:18:00,12
18324,ORD_18325,1013,"ADWITS 5 Pack 20x67x0.5mm Thermal Conductive Silicone Pads with 6.0 W/mk Thermal Conductivity, Soft Safe Simple to Apply f...",Warehouse C,39,31,2025-02-14 08:37:00,8
18325,ORD_18326,2419,Aegte Organics Lip and Cheek Tint Balm (Rosy Pink) 15 gm,Warehouse C,24,17,2025-02-14 18:07:00,7
18326,ORD_18327,18933,"Fashion Colour Face Highlighter Bronzer And Illumintor, Shade 04 7.5 gm",Warehouse A,110,97,2025-02-14 06:19:00,13
18327,ORD_18328,18950,Zatsa 125mg Injection,Warehouse C,21,8,2025-02-14 04:16:00,13
18328,ORD_18329,30622,"Neem, Tulsi & Tea Tree Oil Ubtan - Anti Acne Face Pack",Warehouse C,19,7,2025-02-14 06:45:00,12
18329,ORD_18330,27102,Gravflox 200mg Tablet,Warehouse A,101,90,2025-02-14 12:31:00,11
18330,ORD_18331,5536,Flexon MR Tablet,Warehouse A,100,91,2025-02-14 03:19:00,9
18331,ORD_18332,32838,"GISSY Alloy Steel Dresser Mount To My Wife Love You From Husband Compact Round Makeup Mirror For Birthday Gifts, Marriage ...",Warehouse C,19,10,2025-02-14 01:51:00,9
18332,ORD_18333,19250,"Handmade Grooming Comb With Stylish Handle - GHC1201, Colour May Vary",Warehouse A,42,36,2025-02-14 05:07:00,6
18333,ORD_18334,14414,VapoRub - Super Saver Pack,Warehouse C,31,21,2025-02-14 19:21:00,10
18334,ORD_18335,9958,Bilacad Tablet,Warehouse B,44,32,2025-02-14 21:31:00,12
18335,ORD_18336,3074,Cotton Cosmetic Balls,Warehouse B,37,20,2025-02-14 19:44:00,17
18336,ORD_18337,30841,Naxdu 20 Tablet,Warehouse A,57,50,2025-02-14 08:38:00,7
18337,ORD_18338,27169,"HealthBest Kidbest Lip Balm for Kids | Extra Nourishing | Soothing Lips | Tear, Paraben, SLS free | Watermelon Flavor | 7gm",Warehouse C,46,39,2025-02-14 23:02:00,7
18338,ORD_18339,36821,Fungirest 150mg Tablet,Warehouse B,112,98,2025-02-14 20:38:00,14
18339,ORD_18340,19252,Wintex 250mg Injection,Warehouse C,46,37,2025-02-14 20:06:00,9
18340,ORD_18341,19234,"Lenovo Tab P11 5G FHD (11 inch (27.94 cm), 6 GB, 128 GB, Wi-Fi+LTE, Calling), Storm Grey with Qualcomm Snapdragon Processo...",Warehouse A,20,5,2025-02-14 02:09:00,15
18341,ORD_18342,3525,Miss Rose Professsional Makeup Glow Powder Metalises 7001 - 010M 11 2.5 gm,Warehouse A,83,70,2025-02-14 01:24:00,13
18342,ORD_18343,14764,Flucon Tablets - Fights Allergy Naturally,Warehouse C,74,67,2025-02-14 15:13:00,7
18343,ORD_18344,19251,Wovamet 500mg/200mg Tablet,Warehouse C,66,54,2025-02-14 21:07:00,12
18344,ORD_18345,19230,Ava Line Art Tattoo Transparent White Ink Cups with Stands for Durability - Pack of 100 (Medium),Warehouse B,103,92,2025-02-14 07:18:00,11
18345,ORD_18346,27176,Cefbect 1000 mg/500 mg Injection,Warehouse B,24,6,2025-02-14 04:14:00,18
18346,ORD_18347,1279,Olmecot 40mg Tablet,Warehouse C,42,26,2025-02-14 06:27:00,16
18347,ORD_18348,1276,"Portronics Konnect Spydr 31 3-in-1 Multi Functional Cable with 3.0A Output, Tangle Resistant, 1.2M Length, Nylon Braided(Z...",Warehouse A,34,20,2025-02-14 09:56:00,14
18348,ORD_18349,17382,Amla Hair Care Powder - Pure Herb,Warehouse B,23,15,2025-02-14 06:52:00,8
18349,ORD_18350,32516,"ZEBRONICS Zeb-Storm Wired On Ear Headphone with 3.5mm Jack, Built in Microphone for Calling, 1.5 Meter Cable, Soft Ear Cus...",Warehouse A,63,53,2025-02-14 12:20:00,10
18350,ORD_18351,27062,"Zayn & Myza Blink It Kajal, Jet Black 0.35 gm",Warehouse A,72,67,2025-02-14 06:36:00,5
18351,ORD_18352,28160,Shampoo - Environmental Defence,Warehouse B,41,33,2025-02-14 07:53:00,8
18352,ORD_18353,35339,Linevax Tablet,Warehouse A,72,62,2025-02-14 21:57:00,10
18353,ORD_18354,10015,Imunoherb - Immunity Booster Capsules,Warehouse A,29,10,2025-02-14 08:51:00,19
18354,ORD_18355,30645,"Zayn & Myza Breathable Nail Enamel With Raspberry & Almond Oil, Berry Yogurt 6 ml",Warehouse B,107,99,2025-02-14 05:27:00,8
18355,ORD_18356,36710,Zayn & Myza Blink It - 24hr Lasting Mascara 8.5 ml,Warehouse B,105,88,2025-02-14 09:05:00,17
18356,ORD_18357,19170,"Dr. Sheth's Haldi & Hyaluronic Acid Face Serum For Intense Hydration, Plump & Bouncy Skin | For Normal, Dry & Oily Skin | ...",Warehouse C,60,55,2025-02-14 11:43:00,5
18357,ORD_18358,12588,"Crucial X6 1TB Portable SSD – Up to 800MB/s – USB 3.2 – External Solid State Drive, USB-C - CT1000X6SSD9",Warehouse A,51,44,2025-02-14 20:49:00,7
18358,ORD_18359,5046,Lyzo 100mg/5ml Dry Syrup,Warehouse A,105,96,2025-02-14 19:44:00,9
18359,ORD_18360,9213,MAONO AU-A03 Condenser Microphone Kit Podcast Mic with Boom Arm Microphone Stand (Black),Warehouse A,55,45,2025-02-14 01:05:00,10
18360,ORD_18361,19188,Lakme 9 To 5 Primer + Gloss Nail Color Berry Business 6 Ml,Warehouse C,78,67,2025-02-14 11:49:00,11
18361,ORD_18362,2424,Ajmal Nightingale And Magnetize For Men & Women And Silver Shade Deodorants Pack of 3 200 ml,Warehouse C,63,44,2025-02-14 03:43:00,19
18362,ORD_18363,28025,Schwarzkopf Gliss Hair Repair Shampoo Ultimate Oil Elixir 400 ml,Warehouse A,9,1,2025-02-14 11:45:00,8
18363,ORD_18364,30658,Amleod 2.5mg Tablet,Warehouse B,47,42,2025-02-14 19:41:00,5
18364,ORD_18365,18984,"Samsung Galaxy Tab A8 10.5 inches Display, RAM 3 GB, ROM 32 GB Expandable, Wi-Fi+LTE Tablets, Gray, (SM-X205NZAAINU)",Warehouse C,42,31,2025-02-14 11:44:00,11
18365,ORD_18366,1049,Tympalin C Ear Drop,Warehouse C,70,51,2025-02-14 06:32:00,19
18366,ORD_18367,5589,CEDO Redmi 9/9 Activ Back Cover | Matte Soft Silicon Flexible | Camera Bump Protection | All Side Shock Proof Rubberised B...,Warehouse A,94,84,2025-02-14 12:41:00,10
18367,ORD_18368,1016,House of Aroma Lily Of The Valley Fragrance Oil 10 ml,Warehouse A,58,52,2025-02-14 17:54:00,6
18368,ORD_18369,28257,House of Aroma Fragrance Oil - Alive 100 ml,Warehouse A,105,97,2025-02-14 02:39:00,8
18369,ORD_18370,14363,"Liv-On - Liver Tonic, 500mg",Warehouse C,16,6,2025-02-14 19:01:00,10
18370,ORD_18371,20774,Losaden 8mg/12.5mg Tablet,Warehouse C,86,67,2025-02-14 10:13:00,19
18371,ORD_18372,4938,"Khadi Essentials Swamini Body Butter - Resplendent Argan Oil, Juniper Berry & Kokum 100 gm",Warehouse C,30,11,2025-02-14 16:09:00,19
18372,ORD_18373,18836,Kufril D Syrup,Warehouse A,26,11,2025-02-14 05:20:00,15
18373,ORD_18374,20773,"Tiwkka Cute Cartoon Lightning Data Cable Case for 18-20W iPhone USB-C Power Adapter Charger, Cartoon 3D Design Protective ...",Warehouse A,37,21,2025-02-14 15:35:00,16
18374,ORD_18375,31721,Ampride M 2mg/500mg Tablet SR,Warehouse B,92,81,2025-02-14 17:31:00,11
18375,ORD_18376,27045,Daceflam SP Tablet,Warehouse A,54,37,2025-02-14 22:54:00,17
18376,ORD_18377,32859,Spigen EZ Fit Tempered Glass Screen Protector Guard for iPhone 14/13/13 Pro - 2 Pack,Warehouse B,88,80,2025-02-14 21:16:00,8
18377,ORD_18378,36688,Wilzide 1mg Tablet,Warehouse C,58,45,2025-02-14 09:54:00,13
18378,ORD_18379,35054,A Rex 50mg Injection,Warehouse B,11,5,2025-02-14 19:28:00,6
18379,ORD_18380,5389,Telmavas 80 Tablet,Warehouse A,20,5,2025-02-14 14:44:00,15
18380,ORD_18381,36144,"UBON Single Ear Bluetooth Headset with HD Mic, Business Class BT-160, Wireless Mono Earbuds for Calling & Music, Up to 10 ...",Warehouse C,33,16,2025-02-14 09:06:00,17
18381,ORD_18382,30235,Uniwalk Capsule,Warehouse B,92,86,2025-02-14 15:03:00,6
18382,ORD_18383,989,TP-Link Tapo 3MP (2304 × 1296) Ultra-High-Definition Video Smart Wi-Fi Security Camera | Alexa Enabled | 2-Way Audio| Nigh...,Warehouse B,79,60,2025-02-14 00:14:00,19
18383,ORD_18384,18153,"pTron Bassbuds Wave ENC Bluetooth 5.3 Wireless in Ear Earbuds, 40Hrs Total Playtime, Movie Mode & Deep Bass, Low Latency, ...",Warehouse A,51,33,2025-02-14 08:17:00,18
18384,ORD_18385,27580,Spigen Liquid Air Back Cover Case for iPhone 12 and iPhone 12 Pro (TPU | Matte Black),Warehouse A,96,78,2025-02-14 07:11:00,18
18385,ORD_18386,9688,HP GT52 Ink Bottle (Cyan),Warehouse B,82,73,2025-02-14 23:11:00,9
18386,ORD_18387,35223,Flormar Nail Enamel 246 Cream Silk 11 ml,Warehouse B,57,46,2025-02-14 21:06:00,11
18387,ORD_18388,9353,Autotron 1000mcg Injection,Warehouse A,62,45,2025-02-14 03:09:00,17
18388,ORD_18389,19521,Fashion Colour Cat Eye Waterproof Mascara 10 gm,Warehouse B,98,86,2025-02-14 01:09:00,12
18389,ORD_18390,9342,"Cosmic Byte GS430 Gaming Headphone, 7 Color RGB LED and Microphone for PC, PS5, Xbox, Mobiles, Tablets, Laptops (Red)",Warehouse A,98,80,2025-02-14 07:19:00,18
18390,ORD_18391,9779,Osteocip 500 mg/400 mg Tablet,Warehouse C,28,11,2025-02-14 14:20:00,17
18391,ORD_18392,9337,Litchi Shine Lip Care,Warehouse C,102,95,2025-02-14 16:17:00,7
18392,ORD_18393,27816,"Maybelline Dream Fresh Dewy BB Cream, Light/Medium, 30ml",Warehouse C,10,5,2025-02-14 07:05:00,5
18393,ORD_18394,27817,Aristocillin 125mg Dry Syrup,Warehouse A,64,57,2025-02-14 20:02:00,7
18394,ORD_18395,9798,Qlubra 2% Lubricant Eye Gel,Warehouse C,96,89,2025-02-14 05:05:00,7
18395,ORD_18396,9800,Vapdol 100mg Injection,Warehouse B,24,11,2025-02-14 15:52:00,13
18396,ORD_18397,19488,Wine Bleach,Warehouse B,36,26,2025-02-14 15:29:00,10
18397,ORD_18398,5475,Azysafe 1000mg Tablet,Warehouse A,113,95,2025-02-14 13:20:00,18
18398,ORD_18399,27264,"Samsung 24-Inch(59.8Cm) FHD, LED 1920x1080 Pixels, 1800R Curved Monitor, 1920x1080 Pixels, VA Panel, Slim Design, AMD Free...",Warehouse B,54,43,2025-02-14 19:44:00,11
18399,ORD_18400,30697,"Digitek (DWM-001 Wireless Microphone & Receiver with Type C, Compatible for Noise Cancellation Mic Suitable for Vlog You T...",Warehouse A,100,81,2025-02-14 23:12:00,19
18400,ORD_18401,12630,Westinghouse 80 cm (32 inches) HD Ready Smart Certified Android LED TV WH32SP12 (Black),Warehouse A,83,77,2025-02-14 13:06:00,6
18401,ORD_18402,20339,Zebronics ZEB-KM2100 Multimedia USB Keyboard Comes with 114 Keys Including 12 Dedicated Multimedia Keys & with Rupee Key,Warehouse C,15,6,2025-02-14 13:16:00,9
18402,ORD_18403,20333,Renata 2450N Cr 2450 3V Swiss Made Lithium Battery Coin Cell (Silver) Blister Pack of 2 Pieces,Warehouse A,47,35,2025-02-14 14:14:00,12
18403,ORD_18404,5189,Onsitego 2 Years Extended Warranty for Small Appliances (Rs.5001-10000) (Email Delivery - No Physical Kit),Warehouse B,11,4,2025-02-14 01:18:00,7
18404,ORD_18405,5458,TheGiftKart Back Cover for Redmi Note 10 Lite/Note 9 Pro/Pro Max/Poco M2 Pro (Poly Carbonate | Greyish Blue),Warehouse B,54,40,2025-02-14 17:32:00,14
18405,ORD_18406,3090,"Vemigon Hard PC Case Compatible with Apple Watch Series 8 and 7 45mm with 9H Tempered Glass Screen Protector, Full Coverag...",Warehouse A,58,50,2025-02-14 22:54:00,8
18406,ORD_18407,20273,VU 126 cm (50 inches) The GloLED Series 4K Smart LED Google TV 50GloLED (Grey),Warehouse B,72,56,2025-02-14 06:55:00,16
18407,ORD_18408,27684,Hola TF-600 CLI Caller ID Corded Wall Mountable Landline Phone for Intercom and EPABX Desk (Black),Warehouse A,96,77,2025-02-14 12:07:00,19
18408,ORD_18409,5246,OpenTech® Tempered Glass Screen Protector Compatible for Oneplus Nord 2T 5G with Edge to Edge Coverage and Easy Installati...,Warehouse C,68,50,2025-02-14 19:09:00,18
18409,ORD_18410,3606,Ajmal Aurum & Wisal & Wisal Dhahab & Sacred Love Deo & Ascend EDP Pack of 5 20 ml,Warehouse C,79,60,2025-02-14 08:41:00,19
18410,ORD_18411,20286,NISHTECH for Google Pixel 6A (2022) Crystal Clear Premium TPU Transparent Back case Cover,Warehouse B,107,90,2025-02-14 10:46:00,17
18411,ORD_18412,30234,AND EterlR EDP & DaintyG Mist Pack of 2 250 ml,Warehouse A,36,26,2025-02-14 14:09:00,10
18412,ORD_18413,597,Acipact R 200mg/20mg Capsule,Warehouse B,101,87,2025-02-14 20:00:00,14
18413,ORD_18414,27453,Rapicof-L Syrup,Warehouse B,9,2,2025-02-14 05:28:00,7
18414,ORD_18415,2827,"Logitech K480 Wireless Multi-Device Keyboard for Windows, Apple iOS Android Or Chrome, Wireless Bluetooth, Compact Space-S...",Warehouse A,17,1,2025-02-14 04:20:00,16
18415,ORD_18416,36145,Wellzith 500mg Tablet,Warehouse C,89,84,2025-02-14 11:06:00,5
18416,ORD_18417,16660,"Biotique Natural Makeup Diva Glimmer Sparkling Eyeshadow, Vanity Fair, 1.5g",Warehouse A,29,20,2025-02-14 07:58:00,9
18417,ORD_18418,15448,Zocin OR 200 mg/500 mg Tablet,Warehouse B,44,30,2025-02-14 01:00:00,14
18418,ORD_18419,573,Itopral 40mg/150mg Capsule,Warehouse B,85,68,2025-02-14 01:36:00,17
18419,ORD_18420,36155,Aspiptazo 1.125gm Injection,Warehouse B,18,9,2025-02-14 12:33:00,9
18420,ORD_18421,16624,Amazon Basics Male to Female Stereo Audio Cable (Aux Extension Cable) with Gold Plated Connectors- 6 Feet (3.5mm) - Does n...,Warehouse B,17,6,2025-02-14 02:43:00,11
18421,ORD_18422,333,Redgear MP44 Speed-Type Gaming Mousepad (Black and Red),Warehouse C,67,59,2025-02-14 19:02:00,8
18422,ORD_18423,11559,ERH India Plastic Digital LCD Table Desk Car Calendar Timer Dashboard Office Desk Stopwatch Digital Alarm Clock for Car Da...,Warehouse B,38,32,2025-02-14 09:21:00,6
18423,ORD_18424,15463,Jenmox-P Eye Drop,Warehouse A,89,84,2025-02-14 20:57:00,5
18424,ORD_18425,30208,Ziroxy 150mg Tablet,Warehouse C,62,51,2025-02-14 21:33:00,11
18425,ORD_18426,16603,"Lafz Transfer Proof & Smudge Proof Velvet Matte Lip Colour, Fuchsia Flare 5.5 ml",Warehouse B,32,13,2025-02-14 14:06:00,19
18426,ORD_18427,11497,Levizon M 5mg/10mg Tablet,Warehouse C,53,44,2025-02-14 05:19:00,9
18427,ORD_18428,29518,Abnik MR 100mg/325mg/250mg Tablet,Warehouse C,11,1,2025-02-14 00:21:00,10
18428,ORD_18429,618,VITSZEE CHEMICALS FERTILIZERS Gelatin Powder With Activated Charcoal Powder For Face Mask /Pack / Hair Removal / Peel Off ...,Warehouse C,104,96,2025-02-14 22:15:00,8
18429,ORD_18430,16886,Western Digital WD Purple 128GB Surveillance and Security Camera Memory Card for CCTV & WiFi Cameras (WDD0128G1P0C),Warehouse A,85,67,2025-02-14 15:06:00,18
18430,ORD_18431,4285,"Gizga Essentials 3-in-1 Phone Cleaner, Screen Cleaner for Laptop, Fingerprint-Proof Screen Cleaner Kit, Reusable, Phones, ...",Warehouse C,64,59,2025-02-14 08:07:00,5
18431,ORD_18432,36519,MG Enterprise Empty Makeup Powder Foundation Case Air Cushion Puff BB Cream Container 15g Gold,Warehouse B,92,75,2025-02-14 10:41:00,17
18432,ORD_18433,627,Bella Voste Luxe Cookies Shade 245 10 Ml,Warehouse B,49,35,2025-02-14 02:25:00,14
18433,ORD_18434,324,Rose Water - Premium,Warehouse B,47,38,2025-02-14 09:27:00,9
18434,ORD_18435,36078,"Omron MC 343 Flexible Tip Digital Thermometer With Quick Measurement of Oral, Underarm Temperature in Celsius & Fahrenhei...",Warehouse A,52,43,2025-02-14 00:00:00,9
18435,ORD_18436,16727,Ketam Injection,Warehouse A,101,93,2025-02-14 17:36:00,8
18436,ORD_18437,16805,Proffisy Mobile Stand iPad Stand Aluminium Mobile Phone Stand for Table Height Angle Adjustable Mobile Holder Phone Stand ...,Warehouse B,26,19,2025-02-14 13:11:00,7
18437,ORD_18438,11445,Fashion Colour TRANSPARENT NOURISHING MASCARA (8ml),Warehouse C,93,78,2025-02-14 10:49:00,15
18438,ORD_18439,4259,KYOSEI Tempered Glass Compatible with OnePlus 11R 5G with Anti-Explosion Edge-to-Edge Coverage Screen Protector Guard,Warehouse C,32,21,2025-02-14 00:04:00,11
18439,ORD_18440,19589,"PRAUSH (Formerly Plume) Say No Pore Mattifying Gel Primer for Crack Free Long Lasting Makeup, Oil Absorbing & Skin Perfect...",Warehouse A,76,58,2025-02-14 15:39:00,18
18440,ORD_18441,34982,Robustrion Hybrid Case Cover for Samsung Galaxy Tab S6 Lite Tablet Cover 10.4 inch SM-P610/P615 - Black,Warehouse A,20,6,2025-02-14 06:32:00,14
18441,ORD_18442,27323,Natural Cranberry Coffee Face Scrub,Warehouse A,28,16,2025-02-14 13:58:00,12
18442,ORD_18443,27319,"MegaStro® Laptop Stand for Desk with 7 Adjustable Angles, Aluminum Ergonomic Foldable Portable Compatible with All Brands ...",Warehouse B,9,4,2025-02-14 22:29:00,5
18443,ORD_18444,20467,Hifi 1000mg Injection,Warehouse A,50,42,2025-02-14 02:55:00,8
18444,ORD_18445,27214,Glycichek MV 1mg/500mg/0.2mg Tablet,Warehouse C,50,43,2025-02-14 13:43:00,7
18445,ORD_18446,27889,Brutzox Tablet,Warehouse A,72,53,2025-02-14 11:38:00,19
18446,ORD_18447,20472,Climpen DS 500mg/500mg Injection,Warehouse A,24,6,2025-02-14 15:55:00,18
18447,ORD_18448,19392,Ensor N 100mg/15mg Tablet,Warehouse B,41,32,2025-02-14 18:56:00,9
18448,ORD_18449,19384,Gynonys H.P 500mg Injection,Warehouse C,28,11,2025-02-14 05:34:00,17
18449,ORD_18450,35267,"Premium Digital Tampon - Heavy Flow, FDA Approved",Warehouse B,55,46,2025-02-14 06:18:00,9
18450,ORD_18451,20271,"mobistyle iPhone 14 Pro Max Cover,Luxury Electroplating TPU Case, Individual Camera Protection for Each Lens Back Cover fo...",Warehouse C,82,65,2025-02-14 19:26:00,17
18451,ORD_18452,5249,Rossmax GB101 Aneroid Blood Pressure Monitor (Black),Warehouse B,108,96,2025-02-14 09:57:00,12
18452,ORD_18453,34910,Tough Lee Back Camera Lens Protector Tempered Glass for Oneplus 10R 5G (Black) Pack of 1,Warehouse B,107,96,2025-02-14 21:24:00,11
18453,ORD_18454,27678,Batiste Plus Dry Hair Shampoo - Divine Dark 200 ml,Warehouse C,48,29,2025-02-14 06:51:00,19
18454,ORD_18455,20018,opentech tempered glass screen protector compatible for iphone xs max / 11 pro max with edge to edge full screen coverage ...,Warehouse B,83,72,2025-02-14 18:30:00,11
18455,ORD_18456,27483,Petals - Mandya Panty Liners,Warehouse C,81,67,2025-02-14 10:48:00,14
18456,ORD_18457,27486,Teniva 10mg Tablet,Warehouse C,46,41,2025-02-14 22:59:00,5
18457,ORD_18458,5358,Nimofev P 100mg/325mg Tablet,Warehouse C,57,39,2025-02-14 16:34:00,18
18458,ORD_18459,32722,Zolil Cream,Warehouse B,54,37,2025-02-14 00:33:00,17
18459,ORD_18460,5405,Yves Rocher Sebo Vegetal Rebalancing ++ Antioxidant Essence 30 ml,Warehouse A,8,2,2025-02-14 04:53:00,6
18460,ORD_18461,2472,"Physicians Formula Powder Palette Mineral Glow Pearls, Light Bronze, 0.28 oz.",Warehouse C,65,60,2025-02-14 12:37:00,5
18461,ORD_18462,9530,Sricef O 200mg/200mg Tablet,Warehouse C,18,7,2025-02-14 08:44:00,11
18462,ORD_18463,35088,POPIO Tempered Glass Screen Protector Compatible for iPhone 14 Pro Max with Edge to Edge Coverage and Easy Installation ki...,Warehouse B,28,12,2025-02-14 20:08:00,16
18463,ORD_18464,32713,Bellezza Beauty Blender With Breathable Storage Case (Pack of 2),Warehouse C,19,14,2025-02-14 20:53:00,5
18464,ORD_18465,9438,"Lava Flip, Red - Dual Sim Keypad Mobile with Unique Design, Notification LED and Number Talker",Warehouse A,75,63,2025-02-14 10:03:00,12
18465,ORD_18466,35022,"E-COSMOS Car Rear View Reverse Parking Camera with HD Night Vision 8 LED Waterproof 170 Degree Wide Angle, Black, Small",Warehouse A,88,73,2025-02-14 23:57:00,15
18466,ORD_18467,14559,TheGiftKart Crystal Clear Back Cover Case for OnePlus Nord 2 5G / OnePlus Nord 2 5G Pac-Man Edition | 360 Degree Protectio...,Warehouse C,24,18,2025-02-14 00:02:00,6
18467,ORD_18468,20034,Bella Vita Organic Basil Pure Essential Oil 15 ml,Warehouse A,95,90,2025-02-14 05:38:00,5
18468,ORD_18469,36786,StBotanica Coffee Moment Face Kit 1's,Warehouse C,47,29,2025-02-14 18:17:00,18
18469,ORD_18470,1088,Cheridryl Junior Syrup,Warehouse A,102,89,2025-02-14 01:08:00,13
18470,ORD_18471,27884,Nominth 400mg Tablet,Warehouse B,103,98,2025-02-14 20:11:00,5
18471,ORD_18472,5492,SupCares Edge to Edge Tempered Glass for Nothing Phone 1 (6.55 Inch) with Easy Self Installation Kit | Black,Warehouse B,83,68,2025-02-14 04:47:00,15
18472,ORD_18473,19586,"Skineace beauty 5 in 1 Waterproof Matte Lipstick Set Makeup Cosmetic Moisturize Long Lasting Colorful Lipstick, 7.5 g, Dar...",Warehouse B,80,64,2025-02-14 17:03:00,16
18473,ORD_18474,20318,Dololsac 50mg Capsule DR,Warehouse C,50,31,2025-02-14 22:20:00,19
18474,ORD_18475,19563,Pyrin-C Tablet,Warehouse B,36,31,2025-02-14 15:03:00,5
18475,ORD_18476,14475,Myglamm Iridescent Brightening Moisturising Cream 30 Ml,Warehouse B,110,91,2025-02-14 03:26:00,19
18476,ORD_18477,32623,ZARALA Carbon Fibre Back Cover Case for OnePlus 11R 5G Shockproof & Protective | Stunning Minimalist Design Back Case Cover,Warehouse A,13,2,2025-02-14 04:31:00,11
18477,ORD_18478,20395,R.K's Aroma Carrier Oil - Jojoba 50 ml,Warehouse A,73,60,2025-02-14 22:56:00,13
18478,ORD_18479,20486,"Gizga Essentials Power Extension Board 8 USB 4.2A Ports, 2 PD 20W Ports, 4 Universal Thermal Trip Electrical Multi Plug So...",Warehouse C,10,3,2025-02-14 17:15:00,7
18479,ORD_18480,20479,"Tabelito® Casual Laptop Bag 15.6inch (39.6 cm) , 25 LTR Office College School Bags Business Travel Backpack for Men Women ...",Warehouse B,44,30,2025-02-14 12:29:00,14
18480,ORD_18481,19340,Wecool Ultra Premium German Bayer TPU Transparent Back Cover for iPhone 13 Anti Yellow Technology Crystal Clear Transparen...,Warehouse C,64,58,2025-02-14 05:50:00,6
18481,ORD_18482,20482,ZOUL Type C to Type C Fast Charging Cable 65W 2M/6ft USB C Nylon Braided Cord Compatible with Macbook Oneplus 9 9R Samsung...,Warehouse B,29,13,2025-02-14 17:34:00,16
18482,ORD_18483,19328,TheGiftKart Ultra-Hybrid Crystal Clear Back Case Cover for Samsung Galaxy S23 ULTRA 5G | Shockproof Design | Camera Protec...,Warehouse A,29,14,2025-02-14 23:03:00,15
18483,ORD_18484,9312,Comet Busters Glitter Black Eyeliner Stickers (EYE122),Warehouse A,69,50,2025-02-14 03:26:00,19
18484,ORD_18485,9875,"ZEBRONICS Zeb-Buds C2 in Ear Type C Wired Earphones with Mic, Braided 1.2 Metre Cable, Metallic Design, 10mm Drivers, in L...",Warehouse B,9,4,2025-02-14 10:05:00,5
18485,ORD_18486,171,Osia Osia Almond Oil And Honey 125 gm,Warehouse A,39,21,2025-02-14 16:03:00,18
18486,ORD_18487,9913,Clindasure 300 Capsule,Warehouse B,59,46,2025-02-14 20:31:00,13
18487,ORD_18488,9915,Bennett™ Mystic 15.6 inch (39.6cm) Laptop Briefcase Shoulder Sling Office Business Professional Travel Messenger Bag for M...,Warehouse A,109,95,2025-02-14 04:36:00,14
18488,ORD_18489,27202,Vigorite 50mg Tablet,Warehouse B,26,20,2025-02-14 22:07:00,6
18489,ORD_18490,19281,Lakme Absolute Matte Revolution Lip Color 502 Burgundy Blast 3.5 Gm,Warehouse C,54,49,2025-02-14 10:40:00,5
18490,ORD_18491,19270,Tooth Paste - Herbal,Warehouse A,52,41,2025-02-14 07:29:00,11
18491,ORD_18492,20476,Vega Graduated Dressing Comb (HMSC - 42D) 60 gm,Warehouse B,57,41,2025-02-14 23:23:00,16
18492,ORD_18493,35268,SanDisk Cruzer Blade 64GB USB 2.0 Flash Drive,Warehouse C,35,25,2025-02-14 07:11:00,10
18493,ORD_18494,27837,Zone DP 250mg/50mg/325mg Tablet,Warehouse A,26,14,2025-02-14 14:13:00,12
18494,ORD_18495,2436,"mCaffeine Espresso Body De-Tan Kit with Free Handcrafted Bean Tray - Pack of Bathing Bar Soap, Body Scrub & Body Lotion 400 gm",Warehouse B,36,30,2025-02-14 09:35:00,6
18495,ORD_18496,1099,Davdro M 80mg/250mg Tablet,Warehouse A,97,82,2025-02-14 05:51:00,15
18496,ORD_18497,27857,Insight Cosmetics Long Wear Color Rich Lip Gloss - Magical Pop 4 ml,Warehouse C,17,12,2025-02-14 15:08:00,5
18497,ORD_18498,29106,"Guess Eau de Toilette, Night, 100ml",Warehouse A,90,81,2025-02-14 11:50:00,9
18498,ORD_18499,27905,Glimmer Premium Nail Enamel Killer Red 10 ml,Warehouse B,28,17,2025-02-14 09:26:00,11
18499,ORD_18500,29202,"Emilydeals for Samsung Active 2 Watch Charger, Replacement Charger Cable for Samsung Galaxy Watch Active 2 Smartwatch (Black)",Warehouse A,68,56,2025-02-14 01:09:00,12
18500,ORD_18501,26779,Nokia T21 Flip Case,Warehouse B,86,77,2025-02-14 06:06:00,9
18501,ORD_18502,13740,"AlexVyan Pack of 2 pcs Nose shaper for women for big nose with lifter and shaper for men,Nose up clip for small and nose c...",Warehouse A,46,37,2025-02-14 08:35:00,9
18502,ORD_18503,14268,Trivoglicad 2 Tablet SR,Warehouse C,71,53,2025-02-14 11:36:00,18
18503,ORD_18504,141,Ajmal 2 Sacred Love Deo & Neea EDP Pack of 3 20 ml,Warehouse A,108,93,2025-02-14 13:36:00,15
18504,ORD_18505,24604,Ebavib 10 Tablet,Warehouse A,82,69,2025-02-14 08:38:00,13
18505,ORD_18506,21184,Generic Compatible Lg ac Remote (Pack of 1),Warehouse B,48,37,2025-02-14 19:56:00,11
18506,ORD_18507,24602,Halopax 5mg Capsule,Warehouse A,35,18,2025-02-14 20:41:00,17
18507,ORD_18508,34713,Pack of 2 TP4056 Micro USB Lithium Battery Charging Converter with Overcharge Discharge Over-Current Protection Charging B...,Warehouse C,35,28,2025-02-14 20:00:00,7
18508,ORD_18509,21114,Miss Claire Eyelash Glue Dark Tone 5 Gm,Warehouse B,40,23,2025-02-14 06:54:00,17
18509,ORD_18510,6950,Oropraz 20mg Tablet,Warehouse B,80,66,2025-02-14 16:53:00,14
18510,ORD_18511,23127,Ranoxim CV 200mg/125mg Tablet,Warehouse B,102,93,2025-02-14 07:33:00,9
18511,ORD_18512,21125,Flormar Quartet Eye Shadow 401 Copper Dreams 12 gm,Warehouse B,112,93,2025-02-14 23:11:00,19
18512,ORD_18513,5710,Grapeseed Oil Smoothing Hair Serum - Leave-On,Warehouse B,18,12,2025-02-14 08:20:00,6
18513,ORD_18514,26828,"Fashion Colour Shimmer Brick And Blusher, Shade 04 8 gm",Warehouse B,91,81,2025-02-14 17:12:00,10
18514,ORD_18515,31456,RESONATE RouterUPS Pro CRU12V3A | for JioFiber | Mini UPS | UPS for WiFi Router | Compatible with Advanced 12V <3A FTTH | ...,Warehouse A,106,95,2025-02-14 14:25:00,11
18515,ORD_18516,8910,Arpidon 10mg Tablet,Warehouse B,93,76,2025-02-14 19:19:00,17
18516,ORD_18517,24583,Ontac 75mg Injection,Warehouse A,49,32,2025-02-14 22:02:00,17
18517,ORD_18518,23106,"Amazon Basics USB A to Lightning PVC Molded Nylon MFi Certified Charging Cable (Black, 1.2 meter)",Warehouse A,36,24,2025-02-14 18:55:00,12
18518,ORD_18519,2385,Matalert 50 Tablet,Warehouse C,63,53,2025-02-14 01:28:00,10
18519,ORD_18520,6963,BRUSTRO Professional Pigment Based Fineliner - Set of 8 (Black),Warehouse B,56,50,2025-02-14 17:29:00,6
18520,ORD_18521,24551,Painulide 100mg Tablet,Warehouse B,77,71,2025-02-14 10:44:00,6
18521,ORD_18522,2174,Telcrest 40mg Tablet,Warehouse B,64,59,2025-02-14 05:04:00,5
18522,ORD_18523,3205,"Laptop Table Mate Multi Purpose Foldable, Adjustable Strong Table with 6 Heights, 3 Angles Adjustable for Laptop, Study, K...",Warehouse B,42,36,2025-02-14 20:36:00,6
18523,ORD_18524,23356,Ajmal Blu & Aurum & Sacred Love & Silver Shade Deo & Aretha EDP Pack of 4 20 ml,Warehouse B,17,5,2025-02-14 08:36:00,12
18524,ORD_18525,13346,"boAt Rockerz 558 Sunburn Edition with 50MM Drivers, 20 Hours Playback, Physical Noise Isolation and Soft Padded Earcups Ov...",Warehouse C,53,45,2025-02-14 00:21:00,8
18525,ORD_18526,5727,Bphlo S 8mg Tablet,Warehouse C,22,3,2025-02-14 19:01:00,19
18526,ORD_18527,21173,CP PLUS 4MP Outdoor Smart Wi-fi PT Camera | 360° with Pan & Tilt | Two Way Talk | Night Vision| SD Card (Up to 128 GB) | A...,Warehouse A,89,80,2025-02-14 18:42:00,9
18527,ORD_18528,23357,Olsong Trio 40mg/5mg/12.5mg Tablet,Warehouse C,40,35,2025-02-14 16:16:00,5
18528,ORD_18529,36879,Adiflam Plus 400 mg/500 mg Tablet,Warehouse B,35,30,2025-02-14 04:47:00,5
18529,ORD_18530,21248,Bacstol Suspension,Warehouse C,102,93,2025-02-14 02:25:00,9
18530,ORD_18531,23266,Pilot V7 Roller Fine Ball Pen Pack of 10 (Blue Ink ),Warehouse A,81,69,2025-02-14 15:01:00,12
18531,ORD_18532,8852,Wildcraft Work Packs'18 21 Ltrs Black Laptop Backpack (Streak Plus),Warehouse A,46,40,2025-02-14 14:28:00,6
18532,ORD_18533,34763,Global Desi Dreamy Daze Eau De Parfum 100ML & Cosmic Dreamer Body Mist 200ML Pack of 2 for Women Crafted by Ajmal,Warehouse C,23,6,2025-02-14 05:05:00,17
18533,ORD_18534,14329,Samsung 108 cm (43 inches) Crystal 4K Neo Series Ultra HD Smart LED TV UA43AUE65AKXXL (Black),Warehouse C,48,41,2025-02-14 23:03:00,7
18534,ORD_18535,6821,Zayn & Myza Jade No Alcohol Body Spray For Men 150 ml,Warehouse A,26,15,2025-02-14 14:23:00,11
18535,ORD_18536,8944,Bravia 20 Tablet,Warehouse B,22,3,2025-02-14 12:12:00,19
18536,ORD_18537,7679,Yves Rocher Sensual Body Lotion Coconut 390 ml,Warehouse C,42,26,2025-02-14 16:25:00,16
18537,ORD_18538,13164,Miss Rose 2 In 1 Creamy Matte Lipstick Orchid 7102 - 001M 33 2.1 gm,Warehouse A,17,2,2025-02-14 04:08:00,15
18538,ORD_18539,21189,"QZ SATA to USB 3.1 Hard Disk External Enclosure Case for 3.5 inch/2.5 inch HDD/SSD, 3.5 inch Hard Disk Case, HDD Casing, B...",Warehouse B,86,71,2025-02-14 14:16:00,15
18539,ORD_18540,21193,"BROTHER DR-B021 Drum Cartridge, Gray, Standard",Warehouse A,48,33,2025-02-14 14:18:00,15
18540,ORD_18541,6794,Spigen Thin Fit Cover Case for Apple Watch SE2 / 6 / SE / 5/4 (44mm) Polycarbonate - Black (Watch not Included),Warehouse B,32,13,2025-02-14 17:19:00,19
18541,ORD_18542,30951,"Nokia T10 Android™ 12 Tablet with 8” HD Display, 8MP Rear Camera, AI face Unlock, All-Day Battery, WiFi + 4G Volte | 4 + 64GB",Warehouse B,63,56,2025-02-14 12:56:00,7
18542,ORD_18543,21205,Ofvista 100mg Tablet DT,Warehouse C,45,36,2025-02-14 14:21:00,9
18543,ORD_18544,7652,Tizum Double Padded TZ-HDD 2.5-inch External Hard Drive Case (Black),Warehouse B,114,95,2025-02-14 16:40:00,19
18544,ORD_18545,5737,"Fashion Colour Kiss Lip No Transfer Lipstick, 68 Purple Red 2.6 gm",Warehouse B,80,64,2025-02-14 01:40:00,16
18545,ORD_18546,1750,36H Liquid Waterproof Lash Eyeliner Pencil (Pack of 1),Warehouse B,71,59,2025-02-14 04:23:00,12
18546,ORD_18547,21220,Cool Zone-O 4mg/10mg Tablet,Warehouse A,48,34,2025-02-14 14:43:00,14
18547,ORD_18548,25857,Denosia Suspension,Warehouse B,21,10,2025-02-14 13:09:00,11
18548,ORD_18549,24498,"Aston Andia Compatible for Xiaomi MI Band 5 4 3 Nylon Band Strap, Replacement Sport Wristband Bracelet Universal, Fitness ...",Warehouse B,30,19,2025-02-14 01:38:00,11
18549,ORD_18550,23054,Jamriya Natural Baby Massage Oil 200 ml,Warehouse A,30,11,2025-02-14 03:02:00,19
18550,ORD_18551,6776,"XP-Pen StarG640 Ultra-Thin Graphic Drawing Tablet (6"" x 4"", 8192 Levels of Pressure Sensitivity, Battery-Free Stylus, Black)",Warehouse A,40,27,2025-02-14 02:05:00,13
18551,ORD_18552,21231,Worgel Oral Suspension,Warehouse B,97,80,2025-02-14 10:16:00,17
18552,ORD_18553,23033,Ramicon 5 Tablet,Warehouse A,76,65,2025-02-14 20:49:00,11
18553,ORD_18554,23378,Zaduhik Soft Bristles 10 Pcs Black Makeup Brushes Set with 1 Pink Beauty Blender - (Pack of 11),Warehouse B,34,17,2025-02-14 11:20:00,17
18554,ORD_18555,34672,"Engage One Soul Gender-free Perfume, Unisex, Long Lasting, Citrus and Spicy, Free Tester with pack, 100ml",Warehouse C,43,31,2025-02-14 08:58:00,12
18555,ORD_18556,31617,"MOBILITO 7.5 Foot Professional Metal Tripod Stand for Camera, Ringlight, Video Shooting, Photography, Mobile Phone, Live S...",Warehouse C,57,46,2025-02-14 19:11:00,11
18556,ORD_18557,1425,Sheer Zinc Dry Touch Sunscreen SPF50+,Warehouse C,111,96,2025-02-14 05:31:00,15
18557,ORD_18558,30961,"Amazon Basics 4 Port USB 2.0 HUB, with 1.5m Length Cable, 62.2 Grams",Warehouse A,81,62,2025-02-14 07:59:00,19
18558,ORD_18559,13826,"Nataraj Gelix Gel Pens - Pack of 5, Blue",Warehouse A,83,68,2025-02-14 04:06:00,15
18559,ORD_18560,134,Rado 10 mg/20 mg Tablet,Warehouse C,72,57,2025-02-14 01:56:00,15
18560,ORD_18561,6967,Ajmal Distraction & Magnetize & Persuade Deo & Prose EDP Pack of 3 20 ml,Warehouse B,85,77,2025-02-14 20:42:00,8
18561,ORD_18562,23071,"L'Oreal Paris Brow Artist Xpert, 107 Cool Brunette 0.2 Gm",Warehouse A,93,77,2025-02-14 02:08:00,16
18562,ORD_18563,24889,Telmikaa AMH Tablet,Warehouse B,109,95,2025-02-14 00:28:00,14
18563,ORD_18564,24249,Tnd 50mg Injection,Warehouse A,87,71,2025-02-14 13:00:00,16
18564,ORD_18565,8393,"Spigen Modern Fit Band Strap Compatible with Apple Watch Series 7 (45mm), Series 6|SE|5|4 (44mm), Series 3|2|1 (42mm)",Warehouse B,109,96,2025-02-14 23:26:00,13
18565,ORD_18566,2104,"Cosmic Byte C3070W Nebula 2.4G Wireless Gamepad for PC/PS3 supports Windows XP/7/8/10, Rubberized Texture",Warehouse B,22,8,2025-02-14 07:10:00,14
18566,ORD_18567,23621,ProDot (Gold Series) KB-297rs USB (Hindi Remington) Standard Keyboard (Color: Solid Black),Warehouse C,29,15,2025-02-14 02:00:00,14
18567,ORD_18568,8028,"Body Bath Loofah/Sponge/Scrubber - Dual Sided, Hangable - Pink, BH030",Warehouse C,94,85,2025-02-14 16:07:00,9
18568,ORD_18569,33433,"realme narzo 50 5G (Hyper Black, 4GB RAM+128GB Storage) Dimensity 810 5G Processor | 48MP Ultra HD Camera",Warehouse B,76,65,2025-02-14 12:02:00,11
18569,ORD_18570,7519,Classmate Invento Geometry Box | Self Centering Die-Cast Compass | Rust resistant instruments | Available in your favourit...,Warehouse C,88,71,2025-02-14 04:40:00,17
18570,ORD_18571,26358,Zoflo 400mg Tablet,Warehouse B,47,33,2025-02-14 04:48:00,14
18571,ORD_18572,7321,Essemm-Cold Tablet,Warehouse A,53,43,2025-02-14 20:24:00,10
18572,ORD_18573,33823,Moca Dry Syrup,Warehouse A,67,60,2025-02-14 20:16:00,7
18573,ORD_18574,21998,Myglamm Wandurlust Sand Matt Nail Paint Cherry Tart 11 Ml,Warehouse C,77,70,2025-02-14 15:30:00,7
18574,ORD_18575,6470,Insivace TH 100mg/4mg Tablet,Warehouse C,79,63,2025-02-14 04:59:00,16
18575,ORD_18576,3420,7 Meter Topway USB Power Strip Extension Cord with Spike Guard | Sleek Extension Board with 4 AC Power Socket 10A & 3 USB ...,Warehouse A,50,36,2025-02-14 17:33:00,14
18576,ORD_18577,22688,Vega Lip Liner (EV - 15) 8 gm,Warehouse A,88,75,2025-02-14 05:01:00,13
18577,ORD_18578,31338,"IZI ONE 5K Ultra HD 48MP Touch & WiFi Action Camera with Dual Screen, 170° Wide Angle EIS Stabilisation Waterproof Vlog Vi...",Warehouse C,70,53,2025-02-14 22:03:00,17
18578,ORD_18579,33073,Mulbactin 200mg Tablet,Warehouse B,88,71,2025-02-14 12:11:00,17
18579,ORD_18580,6599,"Fashion Colour Kiss Lip No Transfer Lipstick, 71 Soft Red 2.6 gm",Warehouse A,83,75,2025-02-14 01:37:00,8
18580,ORD_18581,8397,"Shatavari - Scanty Lactation, 500mg",Warehouse B,94,82,2025-02-14 06:18:00,12
18581,ORD_18582,23926,Omenis 20mg Capsule,Warehouse C,90,77,2025-02-14 03:54:00,13
18582,ORD_18583,26305,Freeskin Mint Shower Gel 400 ml,Warehouse B,63,53,2025-02-14 22:04:00,10
18583,ORD_18584,31156,Livofame M 5mg/10mg Tablet,Warehouse A,72,54,2025-02-14 03:16:00,18
18584,ORD_18585,31154,Nolia 200mg Tablet,Warehouse A,52,35,2025-02-14 21:02:00,17
18585,ORD_18586,31078,Organic Harvest Kumkumadi Cream 50 gm,Warehouse B,68,52,2025-02-14 08:26:00,16
18586,ORD_18587,6472,URBANMAC 5 Pieces Eyelashes with Eyelash Glue and Eyelash Curler (Black),Warehouse C,12,1,2025-02-14 17:51:00,11
18587,ORD_18588,2234,Vega Paddle Brush (E15 - PB) 196 gm,Warehouse C,38,33,2025-02-14 19:56:00,5
18588,ORD_18589,22051,Cardinid T 10mg/40mg Tablet,Warehouse A,24,11,2025-02-14 18:39:00,13
18589,ORD_18590,31081,DeBelle Gel Nail Lacquer Green Olivia Dark Olive Green Nail Polish 8 ml,Warehouse B,76,69,2025-02-14 13:40:00,7
18590,ORD_18591,33189,Wesley Office Laptop Bag Briefcase Notebook Professional Business 15.6 Inch Briefcase Messenger Sling Water Resistant Lapt...,Warehouse A,71,65,2025-02-14 04:16:00,6
18591,ORD_18592,34389,Panci D 30mg/40mg Capsule SR,Warehouse C,53,40,2025-02-14 05:23:00,13
18592,ORD_18593,33086,"Nokia C01 Plus 4G, 5.45” HD+ Screen, Selfie Camera with Front Flash | 32GB Storage (Blue)",Warehouse A,64,50,2025-02-14 02:40:00,14
18593,ORD_18594,34346,"Adbeni Girls Selection Combo Makeup Set of 12 Lipstick, Glossy Finish and 12 Nail Paint - Multicolor",Warehouse C,105,89,2025-02-14 14:35:00,16
18594,ORD_18595,8349,Diosglt 10 Tablet,Warehouse A,83,69,2025-02-14 09:04:00,14
18595,ORD_18596,22417,Trabzid IV Injection,Warehouse C,51,40,2025-02-14 06:50:00,11
18596,ORD_18597,25036,Silo-Dalcare 8 Capsule,Warehouse B,23,17,2025-02-14 18:14:00,6
18597,ORD_18598,8348,Oleptal DT 450 Tablet,Warehouse B,101,92,2025-02-14 13:57:00,9
18598,ORD_18599,22106,"Fashion Colour Terra Cotta Blusher, Shade 04 8 gm",Warehouse C,26,8,2025-02-14 05:32:00,18
18599,ORD_18600,1600,"Start Makers Synthetic Bristle Brush Kit with Travel Bag- Pink, Set of 10 Pieces",Warehouse C,41,35,2025-02-14 12:02:00,6
18600,ORD_18601,22124,Revlon Colorstay Full Cover Foundation - Natural Tan 30 ml,Warehouse A,15,4,2025-02-14 02:42:00,11
18601,ORD_18602,13594,Oxy - Infusion Face Wash,Warehouse B,111,96,2025-02-14 03:27:00,15
18602,ORD_18603,7360,Coloressence Mekup Water Proof Sindoor Set of 24 Pieces. Pride of Indian Women,Warehouse B,104,88,2025-02-14 03:52:00,16
18603,ORD_18604,34371,Lal Dant Manjan - Ayurvedic Toothpowder,Warehouse A,49,33,2025-02-14 11:16:00,16
18604,ORD_18605,2238,Oxinor P 100mg/325mg Tablet,Warehouse A,78,69,2025-02-14 20:33:00,9
18605,ORD_18606,3178,Sonacuf-BR Syrup,Warehouse C,30,24,2025-02-14 10:09:00,6
18606,ORD_18607,34225,Plum Green Tea Clear Face Mask 60 gm,Warehouse A,42,37,2025-02-14 18:08:00,5
18607,ORD_18608,6163,Men - After Shave Lotion Cool Wave,Warehouse B,83,69,2025-02-14 17:42:00,14
18608,ORD_18609,13938,Mushroom Head Make up Air Cushion Moisturizing Foundation Air-permeable Natural Brightening Makeup BB CC Cream,Warehouse B,21,3,2025-02-14 21:29:00,18
18609,ORD_18610,13247,Lakme Perfecting Liquid Foundation Natural Shell 27 Ml,Warehouse C,109,94,2025-02-14 19:48:00,15
18610,ORD_18611,13665,Jasmine Soap,Warehouse C,117,98,2025-02-14 05:16:00,19
18611,ORD_18612,6590,7SEVEN® Compatible for Mi tv Remote Control Original Suitable with Smart Android 4K LED Non Voice Command Xiaomi Redmi Rem...,Warehouse B,18,3,2025-02-14 11:08:00,15
18612,ORD_18613,25400,Spigen Ultra Hybrid Back Cover Case Compatible with iPhone 14 Pro (TPU + Poly Carbonate | Crystal Clear),Warehouse B,72,66,2025-02-14 10:29:00,6
18613,ORD_18614,22186,Zivex 10mg Tablet,Warehouse B,105,89,2025-02-14 19:17:00,16
18614,ORD_18615,23873,Jiogest H 250mg Injection,Warehouse C,68,51,2025-02-14 12:48:00,17
18615,ORD_18616,22203,"Amozo Liquid Silicon Smooth Shockproof, Camara Protection with Fabric Lining Inside Back Case Cover for OnePlus Nord (Sili...",Warehouse C,37,25,2025-02-14 00:51:00,12
18616,ORD_18617,6157,"C.A.L. Los Angeles Intense Matte Lipstick 36 Hrs Long Lasting With Waterproof/Smudge Proof, Tottaly Twig, 3.5g",Warehouse A,42,28,2025-02-14 05:51:00,14
18617,ORD_18618,22599,Sanceft-SB 1gm/0.5gm Injection,Warehouse A,103,96,2025-02-14 21:17:00,7
18618,ORD_18619,7378,Superdrug Calm Skin Facial Oil 30 ml,Warehouse A,29,10,2025-02-14 06:27:00,19
18619,ORD_18620,26202,GROWHOMIC Face Pack Brush and Face Cleaning Sponge Combo Facial Mask Brush Facemask Applicator Brush Cosmetic Foundation M...,Warehouse B,93,84,2025-02-14 06:11:00,9
18620,ORD_18621,5641,Deo Bath Soap - 99.9% Germ Protection,Warehouse B,15,10,2025-02-14 06:49:00,5
18621,ORD_18622,6895,Syrine - Disposable Razors for Women,Warehouse C,96,80,2025-02-14 01:43:00,16
18622,ORD_18623,22653,Karela Powder - Supports As Blood Purifier & De-toxifier,Warehouse A,25,20,2025-02-14 21:06:00,5
18623,ORD_18624,26646,Great Choice High HD Focus Spy Magnet Camera Full HD Mini Spy WiFi Magnetic Live Stream Night Vision IP Wireless 1080P Aud...,Warehouse A,63,48,2025-02-14 15:39:00,15
18624,ORD_18625,7633,"Oil - Massage, Rejuvenating",Warehouse C,22,10,2025-02-14 08:45:00,12
18625,ORD_18626,7049,Azafran Organics Illuminating Dewy Face Mist 100 ml,Warehouse A,31,24,2025-02-14 15:32:00,7
18626,ORD_18627,21429,The Beard Story Beard & Moustache Styling Wax 45 gm,Warehouse B,30,17,2025-02-14 00:36:00,13
18627,ORD_18628,24378,Plantas Tan Defence Organic Face Scrub 50 ml,Warehouse C,71,54,2025-02-14 05:17:00,17
18628,ORD_18629,6732,Nimdose P 100mg/325mg Tablet,Warehouse A,73,61,2025-02-14 12:53:00,12
18629,ORD_18630,26668,"Just Herbs Plant-based Retinol, Bakuchiol Anti-aging Night Face Cream For Fine Lines,Wrinkles and Dark spots,Suitable for ...",Warehouse B,24,15,2025-02-14 01:09:00,9
18630,ORD_18631,21440,Calendula Essential Moisture Emulsion,Warehouse C,51,46,2025-02-14 02:53:00,5
18631,ORD_18632,8841,Scentio Organic Bird's Nest and Gold Ultimate Mask 100 ml,Warehouse C,79,64,2025-02-14 14:57:00,15
18632,ORD_18633,33498,"SanDisk Ultra Dual Drive Luxe USB Type C Flash Drive (Silver, 128 GB, 5Y - SDDDC4-128G-I35)",Warehouse C,42,29,2025-02-14 19:31:00,13
18633,ORD_18634,7075,DeBelle Gel Nail Lacquer Matcha Cookie Parrot Green Nail Polish 8 ml,Warehouse C,68,60,2025-02-14 05:12:00,8
18634,ORD_18635,8745,"Nokia C01 Plus 4G, 5.45” HD+ Screen, Selfie Camera with Front Flash (Blue)",Warehouse B,49,38,2025-02-14 09:08:00,11
18635,ORD_18636,14210,Aadav Stainless Steel Cosmetic Makeup Mixing Palette with Spatula Tool (Silver),Warehouse C,108,97,2025-02-14 09:10:00,11
18636,ORD_18637,2060,Herbal Wine Grapefruit Lip Balm,Warehouse B,62,48,2025-02-14 15:46:00,14
18637,ORD_18638,26723,"ColorSoul Waterproof liquid Glossy eyeliner, Black 6ml",Warehouse B,86,72,2025-02-14 05:28:00,14
18638,ORD_18639,7877,"Amazon Basics Double Braided Nylon USB Type-C to Micro-B 2.0 Male Cable, 3 Feet (0.9 Meters) - Dark Grey",Warehouse B,32,21,2025-02-14 12:08:00,11
18639,ORD_18640,1443,Fisdom Jelly,Warehouse B,40,32,2025-02-14 00:09:00,8
18640,ORD_18641,8774,Fluro Quin 500mg Tablet,Warehouse A,79,71,2025-02-14 07:12:00,8
18641,ORD_18642,13475,DC 4 U Men,Warehouse B,43,31,2025-02-14 01:57:00,12
18642,ORD_18643,23456,"Blue Heaven Hypergel Nailpaint - Expresso Spark, 706 11 ml",Warehouse A,56,47,2025-02-14 20:08:00,9
18643,ORD_18644,34624,Fission Body Mist - For Woman,Warehouse A,52,42,2025-02-14 03:13:00,10
18644,ORD_18645,24354,Original HB434666RBC Battery Compatible with Huawei Airtel Vodafone Router 4G Hotspot Battery - 1500mAh - 1 Year Warranty,Warehouse B,64,53,2025-02-14 20:50:00,11
18645,ORD_18646,13453,TheGiftKart Back Cover Case for Samsung Galaxy M31 Prime / F41 / M31 (Shockproof | Hybrid TPU & PC | Transparent | Black B...,Warehouse B,51,40,2025-02-14 20:07:00,11
18646,ORD_18647,37000,SheOak Empty Makeup Powder Foundation Case Air Cushion Puff BB Cream Container 15g Gold,Warehouse C,64,50,2025-02-14 22:33:00,14
18647,ORD_18648,8763,Rosuvit 10 Tablet,Warehouse B,93,79,2025-02-14 07:54:00,14
18648,ORD_18649,2358,"HP Laserjet 136w Compact Monochrome Multifunction Printer with Direct Wi-Fi (Print, Scan, Copy)",Warehouse B,35,18,2025-02-14 20:08:00,17
18649,ORD_18650,1953,"Lenovo Tab M10 FHD Plus (3rd Gen) (10.61 inch (26.94 cm), 6 GB, 128 GB, Wi-Fi+LTE, Calling), Storm Grey with Qualcomm Snap...",Warehouse B,52,39,2025-02-14 01:46:00,13
18650,ORD_18651,7585,"Homava 40 X 60 Outdoor Portable Monocular Telescope for Outdoor Travel, Camping, Sighting | 15.0 x 5.2 x 4.2 cm | Black",Warehouse C,86,73,2025-02-14 18:45:00,13
18651,ORD_18652,7926,"Deospray For Men - Energy, No Alcohol",Warehouse C,24,16,2025-02-14 10:48:00,8
18652,ORD_18653,25680,"GO SHOPS Realme 65W Super Vooc Charge, Data Sync Fast Charging Type-C Cable Compatible for Realme XT, Realme XT 730G, Real...",Warehouse A,41,28,2025-02-14 04:50:00,13
18653,ORD_18654,22870,Spigen Thermoplastic Polyurethane Polycarbonate Rugged Armor Cover Case Designed for Samsung Galaxy Buds2 Pro (2022)|Galax...,Warehouse A,108,89,2025-02-14 07:52:00,19
18654,ORD_18655,6416,"Gizga Essentials Gadget Organizer Case, Portable Zippered Pouch For All Small Gadgets, HDD, Power Bank, USB Cables, Power ...",Warehouse B,32,25,2025-02-14 17:37:00,7
18655,ORD_18656,12887,Medimade Activated Charcoal Face Gel Scrub 100 gm,Warehouse C,34,25,2025-02-14 15:36:00,9
18656,ORD_18657,7626,Amozo Ultra Slim Camera Protection Back Case Cover for iPhone 13 (TPU|Blue),Warehouse C,105,92,2025-02-14 02:50:00,13
18657,ORD_18658,33512,Azigma 500mg Tablet,Warehouse B,38,32,2025-02-14 06:33:00,6
18658,ORD_18659,1801,AEIDESS Tempered Glass Screen Protector Compatible For iPhone 13 and for iPhone 13 Pro with Edge to Edge Coverage and Easy...,Warehouse B,99,80,2025-02-14 13:24:00,19
18659,ORD_18660,33671,Lipikind 20 Tablet,Warehouse B,110,94,2025-02-14 02:55:00,16
18660,ORD_18661,24278,TIZUM External Hard Drive Case for 2.5-Inch Hard Drive - Double Padded (Black),Warehouse A,81,73,2025-02-14 06:53:00,8
18661,ORD_18662,25784,AND Pretty Vogue Pack of 2 Body Mist 200ML each Long Lasting Scent Spray Gift for Women Perfume Crafted by Ajmal,Warehouse A,33,28,2025-02-14 21:46:00,5
18662,ORD_18663,36893,"Tattoo Gizmo Tripod Stand Armrest, Professional Tattoo Armrest Adjustable Height and Tilt Tattoo Equipment, Arm Leg Bar Re...",Warehouse A,110,97,2025-02-14 16:54:00,13
18663,ORD_18664,24965,Epson 6641 Black Ink Bottle - 70 ml,Warehouse C,24,14,2025-02-14 13:05:00,10
18664,ORD_18665,30977,Bonjour Paris Photo Match Crayon Concealer - Medium Beige 3.2 gm,Warehouse A,39,34,2025-02-14 09:58:00,5
18665,ORD_18666,23482,Wekcium-Plus Soft Gel Capsule,Warehouse A,63,45,2025-02-14 09:55:00,18
18666,ORD_18667,7098,HP Victus Gaming Latest AMD Ryzen 5 5600H Processor 16.1 inch(40.9 cm) FHD Gaming Laptop (8GB RAM/512GB SSD/4GB Radeon RX5...,Warehouse B,32,26,2025-02-14 10:37:00,6
18667,ORD_18668,22911,The Derma Co Anti-Acne Regimen Combo - 1% Salicylic Acid Gel Face Wash (100 ml) + 2% Salicylic Acid Serum (30 ml),Warehouse B,88,77,2025-02-14 18:19:00,11
18668,ORD_18669,33718,OpenTech® Tempered Glass Screen Protector Compatible for Samsung Galaxy S21 FE 5G with Edge to Edge Coverage and Easy Inst...,Warehouse C,85,77,2025-02-14 13:28:00,8
18669,ORD_18670,31193,Medimade Pink Rose Face Wash (Pack of 2) 1's,Warehouse B,38,19,2025-02-14 18:52:00,19
18670,ORD_18671,37006,"EDYELL TW2S Gaming Earbuds, Wireless in-Ear Earbuds Bluetooth5.1 Technology, IPX7 Waterproof, Ultra-Long Playtime, Less Th...",Warehouse A,71,53,2025-02-14 14:15:00,18
18671,ORD_18672,36901,"Ajmal 1 Wisal Dhahab, 1 Wisal, 1 Nightingale And 1 Persuade Deodorants Pack of 4 200 ml",Warehouse B,27,10,2025-02-14 18:27:00,17
18672,ORD_18673,26765,Atr EZ 10mg/10mg Tablet,Warehouse A,39,33,2025-02-14 01:25:00,6
18673,ORD_18674,36549,Pure Body Mist - For Man,Warehouse C,45,35,2025-02-14 14:24:00,10
18674,ORD_18675,7015,Trospa 80mg Tablet,Warehouse B,110,95,2025-02-14 01:29:00,15
18675,ORD_18676,13173,Sypride 100mg Tablet,Warehouse A,73,66,2025-02-14 18:54:00,7
18676,ORD_18677,14196,Samsung Galaxy F23 5G Charger PD [Compatible] with Samsung Galaxy F23 / Samsung Galaxy F23 5G Fast Charger Original Adapte...,Warehouse A,38,23,2025-02-14 02:05:00,15
18677,ORD_18678,21514,Itratek 200mg Capsule,Warehouse B,66,48,2025-02-14 14:25:00,18
18678,ORD_18679,33965,Crysendo Spiral Cable Protector | Triple Color (3 Pcs) 1.5 Meters | 35+ Available Colours | Cable Cord Charger Protector S...,Warehouse C,107,97,2025-02-14 20:51:00,10
18679,ORD_18680,31433,Burt's Bees Beeswax Lip Balm with Vitamin E & Peppermint 0.15 oz,Warehouse A,50,32,2025-02-14 07:20:00,18
18680,ORD_18681,8765,Betnevin 4mg Injection,Warehouse C,15,5,2025-02-14 06:27:00,10
18681,ORD_18682,25850,"Pocket Comb - HMC-19D, Colour May Vary",Warehouse A,45,40,2025-02-14 20:34:00,5
18682,ORD_18683,25791,AmazonBasics 50-Inch Lightweight Tripod with Bag,Warehouse A,61,44,2025-02-14 13:00:00,17
18683,ORD_18684,24327,Rabium 40 Tablet,Warehouse B,75,59,2025-02-14 20:14:00,16
18684,ORD_18685,34725,"Sanitary Pads - XL, Ultra Soft 50 pcs + Daily Liners - Clean & Fresh 20s Pack",Warehouse A,51,43,2025-02-14 11:39:00,8
18685,ORD_18686,7698,"Aziclear serum with Azelaic Acid, Vitamin C, and Ferulic Acid for reducing pigmentation, scars, and signs of aging, 25 ml",Warehouse A,97,87,2025-02-14 16:59:00,10
18686,ORD_18687,21071,Beauty People High Shine Nail Polish 1095 12 ml,Warehouse C,84,74,2025-02-14 05:14:00,10
18687,ORD_18688,25606,Eyetex Dazller Nail Glitter - DR10 (Hot Lava) 12 ml,Warehouse A,65,56,2025-02-14 07:33:00,9
18688,ORD_18689,34023,"ASUS Vivobook 14, Intel Core i3-1115G4 11th Gen, 14"" (35.56 cm) FHD, Thin and Light Laptop (8GB/512GB SSD/Office 2021/Wind...",Warehouse B,34,21,2025-02-14 19:56:00,13
18689,ORD_18690,3114,Tea Tree Anti Dandruff Shampoo - With Tea Tree & Ginger Oil,Warehouse B,8,1,2025-02-14 06:31:00,7
18690,ORD_18691,20946,Glimwin 2mg/500mg Tablet,Warehouse C,20,12,2025-02-14 10:51:00,8
18691,ORD_18692,24795,G maxx 2mg Tablet,Warehouse C,68,52,2025-02-14 05:11:00,16
18692,ORD_18693,14328,Pack of 6 Small Multicolor Bindi size 2.5mm (Heart shape box) Forehead Bindi for Girls & Women,Warehouse C,50,44,2025-02-14 06:01:00,6
18693,ORD_18694,2409,Predira 10mg Tablet,Warehouse B,60,54,2025-02-14 09:03:00,6
18694,ORD_18695,14354,D Risk 100mg/325mg/15mg Tablet,Warehouse B,66,53,2025-02-14 03:26:00,13
18695,ORD_18696,1776,"Active Clean Body Wash With Active Charcoal - Shower Gel For Body, Face & Hair",Warehouse B,70,53,2025-02-14 16:31:00,17
18696,ORD_18697,31226,Gemblue Biocare Neem Face and Body cream 500 ml,Warehouse B,49,34,2025-02-14 04:03:00,15
18697,ORD_18698,9080,"Sounce 3 Pack 20mm Watch Straps Compatible for Amazfit GTS 2 Mini, Amazfit Bip/ Bip U/ Bip U Pro/ Bip Lite, Bip S, Amazfit...",Warehouse B,23,4,2025-02-14 06:29:00,19
18698,ORD_18699,24761,C Grel 75mg Tablet,Warehouse B,112,99,2025-02-14 00:02:00,13
18699,ORD_18700,1765,Flunatrac 5mg Tablet,Warehouse C,59,51,2025-02-14 14:12:00,8
18700,ORD_18701,24725,Alizol-IP 40mg/150mg Capsule SR,Warehouse C,106,91,2025-02-14 21:01:00,15
18701,ORD_18702,26998,Kyocin 500mg Injection,Warehouse A,69,58,2025-02-14 23:29:00,11
18702,ORD_18703,12810,Amla Fruit Powder - Supports As Natural Vit C Supplement,Warehouse C,91,72,2025-02-14 13:32:00,19
18703,ORD_18704,20858,Wet N Wild Color Icon Kohl Liner Pencil- Pretty In Mink 1.4 gm,Warehouse A,16,5,2025-02-14 09:10:00,11
18704,ORD_18705,23183,Oriflame OnColour Cream Lipstick (Ginger Nude),Warehouse C,105,88,2025-02-14 19:57:00,17
18705,ORD_18706,9045,Sery Colorflirt Nail Paint Rustic Orange 10 ml,Warehouse A,49,33,2025-02-14 06:47:00,16
18706,ORD_18707,165,SeCro 3.5mm Female to 6.35mm Male Plug Stereo Audio Jack Converter (Golden) - Pack of 2,Warehouse C,92,75,2025-02-14 16:51:00,17
18707,ORD_18708,31467,"MNT Pure ALOE VERA Gel Transparent (500 Gram) For Hair, Skin, Body and Beard | Multipurpose Beauty Skin Gel For Young Face...",Warehouse A,98,85,2025-02-14 03:32:00,13
18708,ORD_18709,6857,Reequil Ceramide & Hyaluronic Acid Moisturiser 100 gm,Warehouse B,15,9,2025-02-14 17:46:00,6
18709,ORD_18710,5634,Rabesec-D Tablet,Warehouse A,88,72,2025-02-14 01:20:00,16
18710,ORD_18711,9028,Luxol 10gm Powder,Warehouse B,83,68,2025-02-14 04:43:00,15
18711,ORD_18712,13793,Fusion - Power Shaving Razor,Warehouse A,33,28,2025-02-14 21:30:00,5
18712,ORD_18713,24833,Almizol F Cream,Warehouse A,46,41,2025-02-14 01:10:00,5
18713,ORD_18714,25688,Bella Voste Matt Nail Paint Shade 304 10 Ml,Warehouse C,28,20,2025-02-14 16:49:00,8
18714,ORD_18715,5685,Apple iPhone 14 Pro Max (128 GB) - Space Black,Warehouse C,76,66,2025-02-14 09:50:00,10
18715,ORD_18716,31464,Rose Woman Deodorant,Warehouse C,111,92,2025-02-14 21:01:00,19
18716,ORD_18717,21508,CableCreation USB C to 3.5mm Headphone Audio Adapter 2-in-1 USB C Type-C to Hi-Res 3.5mm Audio with PD Fast Charging Adapt...,Warehouse A,94,83,2025-02-14 14:44:00,11
18717,ORD_18718,31608,IT Z 2% Cream,Warehouse A,18,4,2025-02-14 18:49:00,14
18718,ORD_18719,25540,Vomifresh O 4mg Tablet MD,Warehouse C,73,57,2025-02-14 05:11:00,16
18719,ORD_18720,24322,Azokid 0.1% Cream,Warehouse C,14,8,2025-02-14 14:47:00,6
18720,ORD_18721,14215,Papaya Face Wash,Warehouse A,80,67,2025-02-14 23:36:00,13
18721,ORD_18722,6260,Voglicon GM 1mg/500mg/0.2mg Tablet SR,Warehouse A,60,53,2025-02-14 23:01:00,7
18722,ORD_18723,26772,Nosicold LS Oral Drops,Warehouse C,81,73,2025-02-14 04:36:00,8
18723,ORD_18724,12826,ZF 400mg Tablet,Warehouse B,96,88,2025-02-14 16:20:00,8
18724,ORD_18725,1782,"PHILIPS Audio Tat1225 Bluetooth Truly Wireless in Ear Earbuds with Mic (TWS) with 18 Hours Playtime (6+12) Ipx4, Voice Ass...",Warehouse C,49,41,2025-02-14 09:34:00,8
18725,ORD_18726,30910,Allitofixime LB 200 Tablet DT,Warehouse A,33,25,2025-02-14 14:49:00,8
18726,ORD_18727,2046,Nedee 2.5mg/5mg/10mg Tablet,Warehouse A,40,31,2025-02-14 23:01:00,9
18727,ORD_18728,20963,Kesar Ubtan Face Pack - Removes Excessive Oil & Sebum,Warehouse B,20,9,2025-02-14 13:46:00,11
18728,ORD_18729,5679,Power 10 Formula Po Effector,Warehouse C,41,28,2025-02-14 10:46:00,13
18729,ORD_18730,13800,"ESR Hybrid Case Compatible with iPad Pro 11 Inch Case (2022/2021), iPad Pro 11 Inch Case with Pencil Holder, Detachable Ma...",Warehouse B,36,17,2025-02-14 07:59:00,19
18730,ORD_18731,20982,Ignalis-M 50/1000 Tablet ER,Warehouse C,104,96,2025-02-14 06:28:00,8
18731,ORD_18732,6838,The Moms Co. Foot Cream 50 gm,Warehouse B,22,14,2025-02-14 09:45:00,8
18732,ORD_18733,14316,Edclav-LB 625 Tablet,Warehouse A,11,6,2025-02-14 11:39:00,5
18733,ORD_18734,26909,Nishq 1 Tablet,Warehouse C,104,94,2025-02-14 23:51:00,10
18734,ORD_18735,6922,Hand Wash - Pure & Gentle,Warehouse A,108,90,2025-02-14 23:47:00,18
18735,ORD_18736,26908,"Cablecreation USB C to HDMI Cable for Home Office 6Feet, USB Type C to HDMI 4K@30Hz, Thunderbolt 3/4 Compatible With Galax...",Warehouse C,31,22,2025-02-14 14:42:00,9
18736,ORD_18737,21028,EGOTUDE Slim Fit Silicone Soft Logo Cut Matte Back Cover Case for iPhone 14 (Black),Warehouse A,91,75,2025-02-14 02:15:00,16
18737,ORD_18738,24465,Nature'S Cell Perfect Makeup Remover Bxl Cleansing Oil 200 Ml,Warehouse C,15,3,2025-02-14 23:17:00,12
18738,ORD_18739,26888,ICIDIL CD 120MG TABLET,Warehouse C,87,76,2025-02-14 19:24:00,11
18739,ORD_18740,34734,Beprazol 20mg Tablet,Warehouse C,32,19,2025-02-14 04:49:00,13
18740,ORD_18741,24825,"SanDisk Ultra Dual Drive Go 64GB USB 3.0 Type C Pen Drive for Mobile (Mint Green, 5Y)",Warehouse C,94,84,2025-02-14 17:00:00,10
18741,ORD_18742,32904,Metrazole D 30mg/40mg Capsule SR,Warehouse A,91,82,2025-02-14 17:39:00,9
18742,ORD_18743,6171,Elseve Extraordinary Oil Serum,Warehouse B,56,44,2025-02-14 22:05:00,12
18743,ORD_18744,9016,"Luxor 5 Subject Single Ruled Notebook - A4, 70 Gsm, 300 Pages",Warehouse B,89,81,2025-02-14 14:27:00,8
18744,ORD_18745,37075,Daily Life Forever52 Velvet Rose Matte Lipstick Rs016 2.5 gm,Warehouse A,94,83,2025-02-14 06:07:00,11
18745,ORD_18746,33781,M.G.R.J Soft TPU Front Protection Case Cover for Honor Magic Watch 2 46mm Smart Watch (Flexible|Silicone|Black),Warehouse A,33,23,2025-02-14 10:23:00,10
18746,ORD_18747,34488,Lubimoist Eye Drop,Warehouse C,92,85,2025-02-14 04:26:00,7
18747,ORD_18748,25907,Tilutel H 40mg/12.5mg Tablet,Warehouse C,88,82,2025-02-14 19:59:00,6
18748,ORD_18749,8570,Portronics POR 343 UFO USB Home Charger 6 Ports 8A Charging Station for Smartphones and Tablets - White,Warehouse A,88,70,2025-02-14 13:44:00,18
18749,ORD_18750,22775,Coldleft Plus Tablet,Warehouse B,98,92,2025-02-14 22:36:00,6
18750,ORD_18751,2075,SHREENOVA® ID116 Plus Bluetooth Fitness Smart Watch for Men Women and Kids Activity Tracker (Black),Warehouse C,96,83,2025-02-14 22:55:00,13
18751,ORD_18752,22774,"Blue Heaven Hypergel Nailpaint - Lava Red, 511 11 ml",Warehouse C,86,75,2025-02-14 16:28:00,11
18752,ORD_18753,7985,Gofenac-S Tablet,Warehouse A,87,76,2025-02-14 01:29:00,11
18753,ORD_18754,24086,Sisdent Toothpaste,Warehouse A,33,25,2025-02-14 02:53:00,8
18754,ORD_18755,25910,"GM 3061 EBook 4+4 Spike Adaptor with Individual Switch, Indicator, Safety Shutter, International Sockets & Surge Protector",Warehouse A,27,17,2025-02-14 01:45:00,10
18755,ORD_18756,34188,Reynolds TRIMAX BLACK - 5 COUNTI Lightweight Roller Pen With Comfortable Grip for Extra Smooth Writing I School and Office...,Warehouse A,95,83,2025-02-14 13:00:00,12
18756,ORD_18757,6458,Duracell Plus AAA Rechargeable Batteries (750 mAh) Pack of 4,Warehouse A,110,96,2025-02-14 23:14:00,14
18757,ORD_18758,25124,Bronclean Syrup,Warehouse C,31,19,2025-02-14 09:15:00,12
18758,ORD_18759,31051,Abzee 500mg Tablet,Warehouse C,88,69,2025-02-14 21:22:00,19
18759,ORD_18760,31371,Maxol 0.5% Eye Drop,Warehouse B,20,7,2025-02-14 19:24:00,13
18760,ORD_18761,31370,"Aloe Vera Bathing Soap - With Vitamin E For Soft, Glowing Skin, Refreshing Fragrance, Combo Pack",Warehouse B,23,16,2025-02-14 14:17:00,7
18761,ORD_18762,7254,"ENVIE® (ECR 20 MC+4xAA1000) Standard Rechargeable Battery Charger for AA & AAA Ni-mh/Ni-Cd, LED Indicator, 600MA Output Cu...",Warehouse A,83,68,2025-02-14 08:47:00,15
18762,ORD_18763,1906,"Samsung Galaxy M33 5G (Deep Ocean Blue, 8GB, 128GB Storage) | 6000mAh Battery | Upto 16GB RAM with RAM Plus | Travel Adapt...",Warehouse A,79,72,2025-02-14 18:54:00,7
18763,ORD_18764,31590,Glimmer Premium Nail Enamel Bottle Green 10 ml,Warehouse B,69,54,2025-02-14 17:22:00,15
18764,ORD_18765,13550,Glimisil-M2 Tablet SR,Warehouse A,58,39,2025-02-14 11:57:00,19
18765,ORD_18766,25923,Attentin 25mg Tablet,Warehouse A,83,67,2025-02-14 18:08:00,16
18766,ORD_18767,21804,Gabawan M 300mg/500mcg Tablet,Warehouse B,9,2,2025-02-14 19:26:00,7
18767,ORD_18768,33025,"WRIGHT USB to 3.5mm Jack Audio Adapter, External USB Stereo Sound Card with 3.5mm Headset and Microphone Jack for Windows,...",Warehouse C,88,72,2025-02-14 03:59:00,16
18768,ORD_18769,5913,"Maybelline New York Volume Express Colossal Mascara, Washable, Glam Black 10.7 Gm",Warehouse B,15,2,2025-02-14 21:12:00,13
18769,ORD_18770,34476,Wyaze 500mg Tablet,Warehouse B,92,79,2025-02-14 05:56:00,13
18770,ORD_18771,23521,Colorbar Creamy Nude - (006) 1 gm,Warehouse A,108,93,2025-02-14 03:54:00,15
18771,ORD_18772,20805,Boonkuf AM Syrup,Warehouse C,69,53,2025-02-14 02:11:00,16
18772,ORD_18773,21759,Global Desi Cosmic Charm Eau De Parfum 100ML & Rhytmic Soul Body Mist 200ML Pack of 2 for Women Crafted by Ajmal,Warehouse A,94,85,2025-02-14 00:57:00,9
18773,ORD_18774,13272,"MyGlamm Lip Volumizer Instant Mega Plumping Lip Gloss Pink- (Pink)-2.9 gm | Glossy Lip Gloss, Instant Plumping & Nourishin...",Warehouse C,72,56,2025-02-14 10:49:00,16
18774,ORD_18775,34434,CEDO Hard Plastic Case OnePlus Nord Ce 2 Lite (5G) | Rotating Ring Holder & Kickstand in-Built | Military Grade Armor | Bu...,Warehouse A,49,44,2025-02-14 02:09:00,5
18775,ORD_18776,21823,Nandocia 50 Injection,Warehouse B,96,88,2025-02-14 12:15:00,8
18776,ORD_18777,26458,Revlon Uniqone Multi Benefit Lotus Flower Leave In Conditoner Hair Treatment 150ml,Warehouse B,25,14,2025-02-14 21:09:00,11
18777,ORD_18778,22734,Cefonus 250mg Injection,Warehouse C,23,8,2025-02-14 12:15:00,15
18778,ORD_18779,6640,Etilive 1mg Tablet,Warehouse C,102,93,2025-02-14 20:06:00,9
18779,ORD_18780,13679,"Casio SA-46 32 Mini Keys Musical Keyboard with Piano tones, Black/Green",Warehouse C,45,32,2025-02-14 20:39:00,13
18780,ORD_18781,7274,Lakme Absolute Infinity Eye Shadow Palette Soft Nudes 12 Gm,Warehouse A,66,51,2025-02-14 02:44:00,15
18781,ORD_18782,8534,Avilpro 20mg Capsule,Warehouse A,87,80,2025-02-14 20:02:00,7
18782,ORD_18783,33932,Affix Auto-Align Technology Tempered Glass Screen Guard for iPhone 12 and for iPhone 12 Pro (6.1 Inch) | Easy Installation...,Warehouse A,43,32,2025-02-14 14:31:00,11
18783,ORD_18784,21837,Appride M 1mg/500mg Tablet SR,Warehouse A,67,53,2025-02-14 10:36:00,14
18784,ORD_18785,24003,Dell Orignal Battery M5Y1K Inspiron 5558 3458 3558 3551 5558 3451 5758 Vostro 3458 3558 14.6V 2600mAh,Warehouse A,67,52,2025-02-14 20:39:00,15
18785,ORD_18786,5920,"Waterman Ink Bottle, Green",Warehouse B,17,1,2025-02-14 07:16:00,16
18786,ORD_18787,31355,"BLUE HEAVEN 2X Intense Kajal (Black Shock, 0.35 g)",Warehouse C,104,89,2025-02-14 15:37:00,15
18787,ORD_18788,6621,Amkette iGrip Drive Compact Car Phone Holder with Quick Release Function | Strong and Durable | Silicone Base Clamp | Stic...,Warehouse C,65,55,2025-02-14 19:34:00,10
18788,ORD_18789,13261,Elzzi Crystal Clear Designed for iPhone 14 Case | Anti-Yellowing |Transparent Hard Back Cover | Shockproof Case |TPU + Pol...,Warehouse B,48,34,2025-02-14 23:33:00,14
18789,ORD_18790,13566,Anytime Moisturizing Cream,Warehouse A,35,19,2025-02-14 19:04:00,16
18790,ORD_18791,6469,Vega Longe Handle Bristle Bath Brush (BA - 1/7) 134 gm,Warehouse B,64,47,2025-02-14 17:06:00,17
18791,ORD_18792,8501,Comet Busters Fancy Black Bindis (BV138),Warehouse B,26,13,2025-02-14 09:57:00,13
18792,ORD_18793,22727,Teli AM 80mg Tablet,Warehouse B,58,50,2025-02-14 13:27:00,8
18793,ORD_18794,8493,Torcoxia BCD 60 Tablet,Warehouse A,20,13,2025-02-14 16:32:00,7
18794,ORD_18795,23973,Gemblue Biocare De Tan Face Wash 150 ml,Warehouse A,28,23,2025-02-14 02:16:00,5
18795,ORD_18796,23615,Ventirex-PD Plus Oral Drops,Warehouse B,110,98,2025-02-14 16:03:00,12
18796,ORD_18797,34054,Clored S Cream,Warehouse A,68,52,2025-02-14 12:14:00,16
18797,ORD_18798,25193,Amazon Brand - Solimo Back Cover for Apple iPhone 11 (Silicone_Transparent),Warehouse B,54,38,2025-02-14 06:42:00,16
18798,ORD_18799,21906,"PRO365 Adjustable Tablet Holder Stand Compatible with iPad, Tablets & Phone (White)",Warehouse C,43,33,2025-02-14 21:30:00,10
18799,ORD_18800,34441,Sivpro Suspension,Warehouse A,47,31,2025-02-14 02:57:00,16
18800,ORD_18801,26391,"Loofah/Sponge Scrubber/Body Bath - With hand band, Black, BH-032 BLK",Warehouse A,77,63,2025-02-14 10:15:00,14
18801,ORD_18802,13573,Tampons for Heavy Flow,Warehouse A,85,75,2025-02-14 08:55:00,10
18802,ORD_18803,31362,Bella Voste Liquid Dip Eyeliner Go Bold (03) 4 Ml,Warehouse A,35,29,2025-02-14 10:34:00,6
18803,ORD_18804,10804,Onsitego 1 Year Extended Warranty for Small Home & Kitchen Appliances from Rs. 1001-1500 (Email Delivery - No Physical Kit),Warehouse C,13,8,2025-02-14 18:40:00,5
18804,ORD_18805,28857,I One 200mg Capsule,Warehouse A,76,69,2025-02-14 06:23:00,7
18805,ORD_18806,802,Signature Gold Dark Vanilla & Oud Wood Perfume,Warehouse B,18,4,2025-02-14 19:27:00,14
18806,ORD_18807,793,Levonox 10mg Tablet,Warehouse A,24,10,2025-02-14 16:53:00,14
18807,ORD_18808,10765,M10 Wireless Earbuds Bluetooth 5.1 TWS 2200mAh Power Bank Charging Box in Ear Earphones True Stereo Sports Headphones Wate...,Warehouse B,13,4,2025-02-14 23:00:00,9
18808,ORD_18809,15117,StayHappi Metformin+Voglibose 500mg/0.3mg Tablet,Warehouse C,19,7,2025-02-14 09:25:00,12
18809,ORD_18810,819,"(Renewed) Infinity (JBL) Glide 120, in Ear Wireless Earphones with Mic, Deep Bass, Dual Equalizer, 12mm Drivers, Premium M...",Warehouse B,86,74,2025-02-14 13:34:00,12
18810,ORD_18811,30416,Teromox CV Dry Syrup,Warehouse B,96,78,2025-02-14 10:40:00,18
18811,ORD_18812,30415,"Face Mask for Kids,  Yellow & Red, 4-6 years",Warehouse C,58,46,2025-02-14 14:11:00,12
18812,ORD_18813,31785,"Lotus Herbals Safe Sun Silk Touch Mattifying Uv Screen Crème Spf 50| Pa+++, 75 g",Warehouse B,72,54,2025-02-14 04:48:00,18
18813,ORD_18814,4613,Nutriment Coffee Gel Scrub All Skin Type 250 gm,Warehouse B,78,67,2025-02-14 02:06:00,11
18814,ORD_18815,4525,Shower Cap - Bath Essentials,Warehouse B,22,4,2025-02-14 10:30:00,18
18815,ORD_18816,10957,Rhinarest Oral Drops,Warehouse B,24,8,2025-02-14 00:24:00,16
18816,ORD_18817,30305,Trusten O 100mg Tablet,Warehouse C,65,54,2025-02-14 18:41:00,11
18817,ORD_18818,3812,Acicheck D Capsule SR,Warehouse C,20,8,2025-02-14 08:42:00,12
18818,ORD_18819,4448,Monitra Syrup,Warehouse B,53,48,2025-02-14 12:48:00,5
18819,ORD_18820,31809,Wet N Wild Color Icon Bronzer - Palm Beach Ready 11 gm,Warehouse A,88,78,2025-02-14 19:21:00,10
18820,ORD_18821,4442,Face Wash - Bio Morning Nectar Flawless Prevents Dark Spots,Warehouse C,88,82,2025-02-14 00:30:00,6
18821,ORD_18822,36559,Allure Makeup Blender Sponge - Cut Drop Yellow 1's,Warehouse A,63,53,2025-02-14 06:43:00,10
18822,ORD_18823,29139,Opthodex Eye Drop,Warehouse A,56,51,2025-02-14 18:01:00,5
18823,ORD_18824,17322,"Reynolds JETTER CLASSIC, 4 CT, BLUE| Smooth Ball Pens | Long-lasting ball pens | Professional Ball pens with superior writ...",Warehouse A,24,17,2025-02-14 17:32:00,7
18824,ORD_18825,3820,Gald Syrup,Warehouse A,79,68,2025-02-14 05:28:00,11
18825,ORD_18826,11142,Rtn 60mg Injection,Warehouse C,77,62,2025-02-14 11:05:00,15
18826,ORD_18827,35926,Loxof 750mg Tablet,Warehouse B,54,49,2025-02-14 07:53:00,5
18827,ORD_18828,11147,"Adjustable Face Mask - Medium, Multi",Warehouse B,33,14,2025-02-14 13:48:00,19
18828,ORD_18829,17292,Storite PU Leather Pocket Size Stainless Steel Multi Business Visiting Wallet Debit Credit Card Holders for Men & Women (...,Warehouse B,77,68,2025-02-14 12:11:00,9
18829,ORD_18830,35932,Koact 1000 mg/200 mg Injection,Warehouse A,22,15,2025-02-14 01:16:00,7
18830,ORD_18831,17282,(Renewed) boAt Airdopes 441 Bluetooth Truly Wireless In Ear Earbuds with Mic (Sporty Blue),Warehouse B,100,86,2025-02-14 01:15:00,14
18831,ORD_18832,23643,Wrinkle Correcting Serum Mask With Hyaluronic Acid & Avocado Extract,Warehouse C,58,53,2025-02-14 22:22:00,5
18832,ORD_18833,17905,"Sunny Face Wash Gel Enriched With Aloevera, Neem & Tulsi For Cleansing, Prevents Pimple & Removes Extra Oil | Moisturizes,...",Warehouse A,73,56,2025-02-14 12:50:00,17
18833,ORD_18834,10763,Cilnicaid-T Tablet,Warehouse B,48,41,2025-02-14 22:01:00,7
18834,ORD_18835,15105,Bennett™ Mystic Unisex Adult Men's Laptop Bag 15.6 inch Side Shoulder Briefcase Satchel Messenger Business Bags for Men & ...,Warehouse A,85,72,2025-02-14 01:51:00,13
18835,ORD_18836,10950,Clovell 5mg Tablet,Warehouse C,68,49,2025-02-14 06:48:00,19
18836,ORD_18837,17740,"Samsung Guru Music 2 315 (GT-B315, Black) (SM-B315EZKDINS)",Warehouse B,98,90,2025-02-14 05:45:00,8
18837,ORD_18838,32281,Suon 10mg Tablet CR,Warehouse B,103,90,2025-02-14 15:28:00,13
18838,ORD_18839,10869,Canon CL-746s (Small) Ink Cartridge (Color),Warehouse C,21,8,2025-02-14 11:30:00,13
18839,ORD_18840,10873,"POCO M4 Pro (Cool Blue, 6GB RAM 64GB Storage)",Warehouse C,45,31,2025-02-14 07:08:00,14
18840,ORD_18841,32279,L'Oreal Men's Expert Hydra Energetic Anti-Fatigue Moisturiser (50 ml),Warehouse A,107,91,2025-02-14 22:33:00,16
18841,ORD_18842,17698,Allure Flat Blending Brush - (227s) 1's,Warehouse A,93,87,2025-02-14 17:50:00,6
18842,ORD_18843,282,TheGiftKart Rugged Shockproof Carbon Fibre Slim Armour Back Cover Case for OnePlus 6T / 7 (Black),Warehouse C,44,27,2025-02-14 12:50:00,17
18843,ORD_18844,17685,"Samsung Galaxy Tab S6 Lite 26.31 cm (10.4 inch), S-Pen in Box, Slim and Light,Dolby Atmos Sound, 4GB RAM, 128GB Storage | ...",Warehouse C,17,11,2025-02-14 09:57:00,6
18844,ORD_18845,10895,Picofin Tablet,Warehouse B,40,22,2025-02-14 19:49:00,18
18845,ORD_18846,2735,Sananac-CZ Tablet,Warehouse A,69,59,2025-02-14 22:41:00,10
18846,ORD_18847,17638,Shaving Cream - Cool,Warehouse B,56,37,2025-02-14 13:26:00,19
18847,ORD_18848,35828,Vencox 90 Tablet,Warehouse A,49,41,2025-02-14 17:35:00,8
18848,ORD_18849,4625,Faces Canada Ultimepro Hd Intense Matte Lips + Primer Scandalous 13 1.4 Gm,Warehouse B,31,13,2025-02-14 17:25:00,18
18849,ORD_18850,2744,Pocket Perfume - Alluring,Warehouse A,79,64,2025-02-14 13:13:00,15
18850,ORD_18851,28839,"JBL Clip 4, Wireless Ultra Portable Bluetooth Speaker, JBL Pro Sound, Integrated Carabiner, Vibrant Colors with Rugged Fab...",Warehouse A,47,37,2025-02-14 21:18:00,10
18851,ORD_18852,10793,Vigini Lubricating Cum Stimulation Gel 100 gm,Warehouse B,102,95,2025-02-14 08:01:00,7
18852,ORD_18853,3777,"Duracell Ultra Alkaline AA Battery, 4 Pcs",Warehouse A,102,93,2025-02-14 04:20:00,9
18853,ORD_18854,4653,"Amazon Basics HDMI Coupler,Black",Warehouse A,68,52,2025-02-14 04:29:00,16
18854,ORD_18855,28740,SINLOE USB Extension Cable Male to Female 5 Meter / 15 Feet,Warehouse A,73,64,2025-02-14 13:48:00,9
18855,ORD_18856,18001,Pachani Rasayana - Digestive Tonic,Warehouse B,21,5,2025-02-14 16:48:00,16
18856,ORD_18857,2696,Boujee Beauty Powder Brush B102 135 gm,Warehouse C,72,58,2025-02-14 00:44:00,14
18857,ORD_18858,10734,Domkair 30mg Syrup,Warehouse C,26,10,2025-02-14 08:16:00,16
18858,ORD_18859,12408,Zopral 1mg Tablet,Warehouse C,87,77,2025-02-14 15:04:00,10
18859,ORD_18860,10739,"SPIN CART Thermal Compound Paste Use in Coolers Heat Sink for CPU and Chipsets (Grey, 30 g)",Warehouse B,93,79,2025-02-14 03:43:00,14
18860,ORD_18861,23990,"Philips Hair Clipper (Corded) With 13 Length Settings, 41 mm Wide Cutter, Stainless Steel Blades And Trim-n-Flow Technolog...",Warehouse A,35,22,2025-02-14 05:28:00,13
18861,ORD_18862,8189,Fashion Straightener Strong,Warehouse A,99,81,2025-02-14 00:16:00,18
18862,ORD_18863,14111,Acebromax 100mg Capsule,Warehouse C,114,95,2025-02-14 20:04:00,19
18863,ORD_18864,6572,Allure Lip Brush - 330 1's,Warehouse C,87,69,2025-02-14 05:50:00,18
18864,ORD_18865,26018,"Maquter Fast Type-C Charger for Samsung Galaxy M11, M20, M30s, M30, M31, M31s, M40, M41, M51 || Hi Speed Travel Charger ||...",Warehouse C,29,21,2025-02-14 23:23:00,8
18865,ORD_18866,31106,Micobate-CN Cream,Warehouse C,72,65,2025-02-14 03:57:00,7
18866,ORD_18867,7503,Ogiflo 200 Tablet,Warehouse B,72,63,2025-02-14 08:21:00,9
18867,ORD_18868,7387,Diskettes (Vanilla Flavor),Warehouse B,69,50,2025-02-14 19:20:00,19
18868,ORD_18869,6149,Glimilet M Forte 2mg/1000mg Tablet,Warehouse B,14,6,2025-02-14 07:51:00,8
18869,ORD_18870,8262,"Hennahub Amla, Reetha, Shikakai, Bhringraj and Hibiscus Powder for Hair Growth & Hair Mask, 200g each (Combo Pack of 5)",Warehouse B,58,47,2025-02-14 16:24:00,11
18870,ORD_18871,8105,Tabac Beard Wax 40 gm,Warehouse A,38,29,2025-02-14 15:48:00,9
18871,ORD_18872,31318,Ajmal Carbon Carbon Sacred Love Deodorant Spray (Pack of 3) 200 ml,Warehouse C,69,59,2025-02-14 07:28:00,10
18872,ORD_18873,33170,Terbikyor 250mg Tablet,Warehouse C,34,20,2025-02-14 10:53:00,14
18873,ORD_18874,1626,Dinfla Gel,Warehouse B,58,53,2025-02-14 05:06:00,5
18874,ORD_18875,34337,"Bavcieu® 2 Pack Camera Lens Protector for iPhone 14 Pro 6.1"" ＆ iPhone 14 Pro Max 6.7"",Tempered Glass,9H Hardness,Ultra HD,...",Warehouse C,24,7,2025-02-14 17:34:00,17
18875,ORD_18876,22303,Levozak M 5mg/10mg Tablet,Warehouse B,27,20,2025-02-14 11:28:00,7
18876,ORD_18877,6143,Vizo 4 in 1 Eyeshadow Chunky Glitter - Mix Stack - (Silver + Golden + Pink + Black),Warehouse A,81,65,2025-02-14 03:00:00,16
18877,ORD_18878,22532,Atorberd 10 Gold Capsule,Warehouse A,108,91,2025-02-14 07:17:00,17
18878,ORD_18879,23822,Tussnil Syrup,Warehouse B,51,35,2025-02-14 05:07:00,16
18879,ORD_18880,6066,Adwiron Injection,Warehouse A,87,69,2025-02-14 21:19:00,18
18880,ORD_18881,6491,Revcef-CV 325 Tablet,Warehouse A,76,66,2025-02-14 21:53:00,10
18881,ORD_18882,7399,Saicef 100mg Tablet,Warehouse B,93,75,2025-02-14 02:59:00,18
18882,ORD_18883,33163,Ajmal Amber Magic EDP Spicy Aromatic Perfume 100ml for Men and Sacred Love EDP Floral Musky Perfume 50ml for Women +1 Perf...,Warehouse B,37,28,2025-02-14 16:28:00,9
18883,ORD_18884,25305,"realme 10 Pro 5G (Nebula Blue, 128 GB) (6 GB RAM)",Warehouse C,37,25,2025-02-14 09:06:00,12
18884,ORD_18885,33399,Okt Eye Drop,Warehouse B,73,67,2025-02-14 08:50:00,6
18885,ORD_18886,31293,Cefobac TD 500mg/600mg Tablet,Warehouse A,69,51,2025-02-14 05:16:00,18
18886,ORD_18887,1666,"iQOO Neo 7 5G (Interstellar Black, 12GB RAM, 256GB Storage) | Dimensity 8200, only 4nm Processor in The Segment| 50% Charg...",Warehouse A,37,27,2025-02-14 18:01:00,10
18887,ORD_18888,21952,Vbeta 8mg Tablet,Warehouse C,102,92,2025-02-14 02:59:00,10
18888,ORD_18889,7502,Jovees Hair Spa Masque - Argan Oil 200 gm,Warehouse B,43,30,2025-02-14 09:32:00,13
18889,ORD_18890,8228,"BlueRigger Digital Optical Audio Toslink Cable (3.3 Feet / 1 Meter) With 8 Channel (7.1) Audio Support (for Home Theatre, ...",Warehouse C,106,88,2025-02-14 22:26:00,18
18890,ORD_18891,25037,Natural Cranberry Coffee Body Scrub,Warehouse B,23,13,2025-02-14 14:59:00,10
18891,ORD_18892,6128,"Samsung Galaxy S20 FE 5G (Cloud Mint, 8GB RAM, 128GB Storage)",Warehouse C,47,41,2025-02-14 00:55:00,6
18892,ORD_18893,13027,"Amazon Basics USB Type-C to Micro-B 2.0 Cable for Tablet, Personal Computer, Laptop, Smartphone (0.9 Meters, White)",Warehouse B,114,98,2025-02-14 06:44:00,16
18893,ORD_18894,23669,Kanterbi 250mg Tablet,Warehouse A,59,46,2025-02-14 15:38:00,13
18894,ORD_18895,7480,Baxin 250 mg/250 mg Tablet,Warehouse A,101,90,2025-02-14 05:53:00,11
18895,ORD_18896,13042,ZaySoo 4 Pc Rainbow Color Designer Stone Round Bindis for Women and Girl Foredead,Warehouse B,105,93,2025-02-14 03:23:00,12
18896,ORD_18897,6068,MG Eva Foam Sheet 10 Different Color A4 Size 2mm Thickness,Warehouse C,48,34,2025-02-14 22:12:00,14
18897,ORD_18898,3402,techlife solutions Head Strap Camera Mount for GoPro Xiaoyi SJCAM and All Action Camera,Warehouse C,100,93,2025-02-14 12:18:00,7
18898,ORD_18899,6117,Nourishing Thickening Hair Conditioner With Argan Oil & Curry Leaf Extract,Warehouse A,90,75,2025-02-14 13:57:00,15
18899,ORD_18900,34292,Activated Charcoal Cream Conditioner - Charged With Menthol,Warehouse A,43,25,2025-02-14 04:24:00,18
18900,ORD_18901,1840,Cetvin M Syrup,Warehouse C,50,38,2025-02-14 08:02:00,12
18901,ORD_18902,23687,"Beetel B26 Corded Slim Landline Phone,Ringer Volume Control,Wall/Desk Mountable,Ringer On/Off Switch,Clear Call Quality,Co...",Warehouse C,67,52,2025-02-14 14:02:00,15
18902,ORD_18903,33128,"65W Charger for OnePlus Nord CE 2 5G Ultra Charger Original Adapter Like Qualcomm QC 4.0 Quick Charge, Rapid, Dash, VOOC, ...",Warehouse A,56,47,2025-02-14 00:14:00,9
18903,ORD_18904,6112,Juicy Berry Lip Balm,Warehouse C,52,45,2025-02-14 17:33:00,7
18904,ORD_18905,26063,Magikisses Lip Balm Peach It 4 Gm,Warehouse C,95,84,2025-02-14 19:25:00,11
18905,ORD_18906,8183,Opimed 100mg Injection,Warehouse A,95,80,2025-02-14 03:22:00,15
18906,ORD_18907,8208,Lather Shaving Cream - Musk,Warehouse B,60,52,2025-02-14 05:12:00,8
18907,ORD_18908,33888,Stomcare 40mg Tablet,Warehouse B,15,10,2025-02-14 10:14:00,5
18908,ORD_18909,23723,Bella Vita Organic Neroli Essential Oil 15 ml,Warehouse C,106,87,2025-02-14 14:32:00,19
18909,ORD_18910,31116,"Western Digital WD Green M.2 240GB, Up to 545MB/s, 2.5 Inch/7 mm, 3Y Warranty, Internal Solid State Drive (SSD) (WDS240G3G0B)",Warehouse A,86,67,2025-02-14 21:25:00,19
18910,ORD_18911,22384,"Lapster Type C to 3.5 mm Jack Audio Connector Converter, Noise Cancelling Headphones Jack Converter Audio Adapter for OneP...",Warehouse C,28,18,2025-02-14 23:42:00,10
18911,ORD_18912,33134,"AGARO HS1907 Hair Straightner,Kerating Infused Ceramic Coated Plates, Fast Heating, PTC Heating, Hair Straightening,Hair S...",Warehouse B,91,78,2025-02-14 19:53:00,13
18912,ORD_18913,2122,Zezone-S 500mg/500mg Injection,Warehouse B,83,67,2025-02-14 10:42:00,16
18913,ORD_18914,1843,"Casio HL-4A Portable Calculator, Extra Small Size",Warehouse C,17,9,2025-02-14 14:04:00,8
18914,ORD_18915,8186,"Brinton WellGrow Gold Hair Serum for Hair Care, Women, Men (30ML)",Warehouse C,91,84,2025-02-14 01:55:00,7
18915,ORD_18916,7462,Kriticef S 1000mg/500mg Injection,Warehouse C,8,3,2025-02-14 17:54:00,5
18916,ORD_18917,8201,Verpol 250 Oral Suspension,Warehouse B,23,14,2025-02-14 12:04:00,9
18917,ORD_18918,1646,Khadi Essentials Handmade Bath Soap - Jasmine Sugar 100 gm,Warehouse A,75,60,2025-02-14 22:41:00,15
18918,ORD_18919,23961,Oil - Mustard,Warehouse B,45,39,2025-02-14 00:51:00,6
18919,ORD_18920,21941,"Pentonic Multicolor Gel Pen With Hard Box Case | 0.6 mm-1.0 mm | Sleek Matt Finish, Featherlite feel | Waterproof Gel Ink,...",Warehouse B,18,11,2025-02-14 08:46:00,7
18920,ORD_18921,33467,Verilux® Universal Touch Stylus S Pen Replacement Stylus Pen Refill Tool Kit for Samsung Galaxy Note 10 / Note10+Plus / No...,Warehouse B,46,29,2025-02-14 14:19:00,17
18921,ORD_18922,23527,Atoraj F 10mg/160mg Tablet,Warehouse C,23,11,2025-02-14 00:11:00,12
18922,ORD_18923,26624,"DailyObjects Large Premium Vegan Leather Anti-Skid, Anti-Slip | Reversible Desk spread Turf Desk Mat/Laptop mat for Work f...",Warehouse C,49,31,2025-02-14 07:21:00,18
18923,ORD_18924,33340,"Astigo Compatible Remote Control for Mi Smart LED 4A (43""/32"")",Warehouse A,38,30,2025-02-14 22:03:00,8
18924,ORD_18925,25038,Rezole 20mg Tablet,Warehouse A,22,13,2025-02-14 19:21:00,9
18925,ORD_18926,32977,Hinderm 200mg Capsule,Warehouse A,85,72,2025-02-14 00:38:00,13
18926,ORD_18927,33341,House of Aroma Amber Rose Fragrance Oil 100 ml,Warehouse A,91,83,2025-02-14 13:14:00,8
18927,ORD_18928,2068,Nitrocin 5mg Injection,Warehouse B,85,73,2025-02-14 04:22:00,12
18928,ORD_18929,34555,Nervistrong Forte Injection,Warehouse B,64,55,2025-02-14 00:08:00,9
18929,ORD_18930,33731,Azimax 500mg Injection,Warehouse A,27,8,2025-02-14 19:14:00,19
18930,ORD_18931,2070,Neokast DX 400mg/10mg Tablet,Warehouse A,6,1,2025-02-14 08:55:00,5
18931,ORD_18932,6437,Dmp Tablet DT,Warehouse B,111,94,2025-02-14 05:04:00,17
18932,ORD_18933,13292,Flyway Round Empty Luxurious Portable Air Cushion Puff Box BB Cream Container Case Pink,Warehouse B,11,6,2025-02-14 14:53:00,5
18933,ORD_18934,24204,Tlm 40mg Tablet,Warehouse B,61,42,2025-02-14 03:27:00,19
18934,ORD_18935,23518,Ajmal Tempest Concentrated Perfume Oil Floral And Sacred Love Deodorant Floral Musky Fragrance 212 ml,Warehouse B,18,12,2025-02-14 09:25:00,6
18935,ORD_18936,26599,"Blue Heaven HD All In One Makeup Stick, Silk Matte - 101, Vanilla-Very Fair, 10gm",Warehouse C,39,24,2025-02-14 22:20:00,15
18936,ORD_18937,6456,Medimade Tea Tree Oil & Ginger Oil Body Wash (Pack of 2) 1's,Warehouse A,25,7,2025-02-14 14:50:00,18
18937,ORD_18938,2204,"NARGO Metal, Engineered Wood Smart Multipurpose Foldable and Portable Laptop Table with Cup Holder - Ergonomic & Rounded E...",Warehouse C,32,18,2025-02-14 09:49:00,14
18938,ORD_18939,21610,"ProElite Smart Flip Case Cover for Apple iPad 10th Generation 10.9 inch 2022 Translucent & Hard Back with Stylus Pen, Navy...",Warehouse B,33,15,2025-02-14 21:29:00,18
18939,ORD_18940,22408,"HP v236w 32GB USB 2.0 Pen Drive, Grey",Warehouse B,46,40,2025-02-14 13:16:00,6
18940,ORD_18941,33747,Duof 400mg Tablet,Warehouse A,59,45,2025-02-14 09:38:00,14
18941,ORD_18942,8641,"M.G.R.J® Charger Stand Compatible for Samsung Galaxy Watch 4/ Classic/Watch 3 41mm 45mm/Active 2 40mm 44mm,Non-Slip Silico...",Warehouse B,47,42,2025-02-14 21:09:00,5
18942,ORD_18943,2341,Dyloop 10 Tablet,Warehouse A,31,22,2025-02-14 02:50:00,9
18943,ORD_18944,8635,Gel,Warehouse B,21,15,2025-02-14 08:09:00,6
18944,ORD_18945,7172,L.A. Colors Day to Night 12 Color Eyeshadow - Sunrise 8 gm,Warehouse C,27,21,2025-02-14 04:09:00,6
18945,ORD_18946,22854,DXN-SB 250mg/125mg Injection,Warehouse B,91,80,2025-02-14 04:41:00,11
18946,ORD_18947,13505,Doms Art Apps Kit,Warehouse A,73,54,2025-02-14 17:18:00,19
18947,ORD_18948,25105,Atocard 10mg Tablet,Warehouse C,31,21,2025-02-14 21:52:00,10
18948,ORD_18949,7936,DeBelle Gel Nail Lacquer Lilac Bloom Soft Lilac Nail Polish 8 ml,Warehouse C,84,66,2025-02-14 00:25:00,18
18949,ORD_18950,21587,"Duracell Ultra Alkaline AAA Battery, 4 Pcs",Warehouse A,69,64,2025-02-14 16:21:00,5
18950,ORD_18951,7173,"DishanKart A3 120GSM Sketch Book/Artist Pad/Drawing Note Book 50 Sheets 100 Pages for Students, Artists for Painting, Acry...",Warehouse A,33,23,2025-02-14 03:26:00,10
18951,ORD_18952,21649,Rosulip 10 Tablet,Warehouse B,11,3,2025-02-14 00:37:00,8
18952,ORD_18953,25864,"Deborah Milano Dh La Cipria Compact, 30",Warehouse A,49,35,2025-02-14 22:33:00,14
18953,ORD_18954,24176,"Havells HD1903 1200 Watts Powerful Hair Dryer, 2 Heat (Hot & Warm) Settings, Overheat Protection, 2 Year Guarantee (Premiu...",Warehouse A,25,6,2025-02-14 01:46:00,19
18954,ORD_18955,5612,"CeraVe Hydrating Mineral Sunscreen SPF 50 Face Cream, 75ml",Warehouse C,15,7,2025-02-14 17:53:00,8
18955,ORD_18956,14139,"Lapster usb cable for honor band 5 charger, for honor band 4 charger, for Huawei Band 3 Pro(50cm)",Warehouse A,85,73,2025-02-14 05:35:00,12
18956,ORD_18957,23535,Redmi 10 Prime (Astral White 4GB RAM 64GB ROM |Helio G88 with extendable RAM Upto 2GB |FHD+ 90Hz Adaptive Sync Display),Warehouse A,92,81,2025-02-14 09:26:00,11
18957,ORD_18958,23553,"HP 150 Wireless USB Mouse with Ergonomic and ambidextrous Design, 1600 DPI Optical Tracking, 2.4 GHz Wireless connectivit...",Warehouse A,46,31,2025-02-14 21:54:00,15
18958,ORD_18959,13511,Zoul USB C 60W Fast Charging 3A 6ft/2M Long Type C Nylon Braided Data Cable Quick Charger Cable QC 3.0 for Samsung Galaxy ...,Warehouse C,71,56,2025-02-14 14:08:00,15
18959,ORD_18960,14136,K London 14 Inches Slim Tan Vegan Leather Men Women Unisex Laptop MacBook Shoulder Messenger Office Bag (1808-tan),Warehouse B,45,31,2025-02-14 18:52:00,14
18960,ORD_18961,13512,Clomont-FA Tablet SR,Warehouse A,68,51,2025-02-14 12:55:00,17
18961,ORD_18962,13092,Fashion Colour Intense White Revolving Kajal 0.35 gm,Warehouse B,44,35,2025-02-14 10:37:00,9
18962,ORD_18963,7560,Violip 40mg Tablet,Warehouse C,62,46,2025-02-14 10:04:00,16
18963,ORD_18964,1514,Piomed-M 30 Tablet ER,Warehouse C,101,84,2025-02-14 05:43:00,17
18964,ORD_18965,24137,"Tribit MaxSound Plus Portable Bluetooth Speaker,24W Wireless Speaker with Powerful Louder Sound, Exceptional XBass, IPX7 W...",Warehouse A,97,92,2025-02-14 03:20:00,5
18965,ORD_18966,21656,HUION HS610 Graphics Drawing Tablet Battery-Free Stylus Android Windows macOS with 10x6.25inch Working Area Pen Tablet (HS...,Warehouse B,49,42,2025-02-14 10:47:00,7
18966,ORD_18967,24113,"Gizga Essentials Hard Drive Case Shell, 2.5-inch, Portable Storage Organizer Bag for Earphone USB Cable Power Bank Mobile ...",Warehouse B,31,16,2025-02-14 04:01:00,15
18967,ORD_18968,21746,Palash Flower Powder - Supports Low Blood Uric Acid Levels & Proper Urinary Flow,Warehouse B,18,3,2025-02-14 03:39:00,15
18968,ORD_18969,21742,Pre Shave Gel Tube - Moisturiser,Warehouse A,25,17,2025-02-14 14:10:00,8
18969,ORD_18970,33015,Shower Gel - Lemongrass & Jojoba,Warehouse A,14,8,2025-02-14 02:25:00,6
18970,ORD_18971,22807,Himalaya Fairness Kesar Face Wash 150 ml,Warehouse A,47,28,2025-02-14 03:22:00,19
18971,ORD_18972,33768,Beauty People Liquid Illuminator 05 Old Is Gold 25 ml,Warehouse B,33,26,2025-02-14 03:31:00,7
18972,ORD_18973,33011,"Noise Flair Smart Bluetooth Wireless in Ear Earphones with Mic Dual with Touch Controls, 35 Hour Playtime, Environmental C...",Warehouse C,107,91,2025-02-14 15:10:00,16
18973,ORD_18974,21703,Detek 30mg Tablet,Warehouse C,87,81,2025-02-14 05:34:00,6
18974,ORD_18975,7550,Plantas Cell Renewal Organic Face Wash 100 ml,Warehouse B,90,75,2025-02-14 23:20:00,15
18975,ORD_18976,5871,Superdrug Charcoal Mask 75 ml,Warehouse A,79,60,2025-02-14 06:33:00,19
18976,ORD_18977,26542,Recolide SG Expectorant,Warehouse C,75,58,2025-02-14 06:38:00,17
18977,ORD_18978,26544,Vyture-G Tablet,Warehouse C,41,22,2025-02-14 05:14:00,19
18978,ORD_18979,34316,Cerecetam 400 Tablet,Warehouse A,73,56,2025-02-13 01:03:00,17
18979,ORD_18980,20281,Oflotec-OZ Suspension,Warehouse A,50,39,2025-02-13 11:56:00,11
18980,ORD_18981,26825,Mamaearth Naturally Matte Lip Serum - Matte Liquid Lipstick with Vitamin C & E For Upto 12 Hour Long Stay - 08 - Chocolate...,Warehouse B,108,94,2025-02-13 19:37:00,14
18981,ORD_18982,19937,Lla 10mg Tablet,Warehouse C,48,29,2025-02-13 01:29:00,19
18982,ORD_18983,26809,"Flash Acrylic Color (Gold Plus, 50ml)",Warehouse B,39,30,2025-02-13 15:12:00,9
18983,ORD_18984,20314,Duratuf 50mg Injection,Warehouse A,97,87,2025-02-13 19:09:00,10
18984,ORD_18985,26781,Diprox 40mg Tablet SR,Warehouse B,88,83,2025-02-13 10:16:00,5
18985,ORD_18986,20243,SIRI CREATIONS Silver Bindi Stamps for Kids (Chukke kaddi?) 11 Sticks,Warehouse B,79,68,2025-02-13 03:31:00,11
18986,ORD_18987,34320,Mpx-CV Dry Syrup,Warehouse A,16,1,2025-02-13 21:33:00,15
18987,ORD_18988,34322,Rustic Rituals Wooden Double-sided Bath Brush With Massager and Long Handle | Natural Bristles | Dry Brushing Removes Dead...,Warehouse A,63,50,2025-02-13 02:42:00,13
18988,ORD_18989,33826,"Godox SB-UBW80, 80 cm Octa Softbox for Speedlite",Warehouse B,20,4,2025-02-13 20:30:00,16
18989,ORD_18990,34333,"lenovo 65w ac adapter with usb type c connector (3 prong power cord) for Laptops, p51s - Black",Warehouse B,66,47,2025-02-13 20:30:00,19
18990,ORD_18991,20244,"Camin LCD Writing Tablet 8.5 Inch Screen, Kids Toy, LCD Writing pad, Writing Tablet Toys for 3+ Years (Black Color)",Warehouse C,69,63,2025-02-13 11:01:00,6
18991,ORD_18992,33898,Gratel 50mg Syrup,Warehouse A,68,62,2025-02-13 11:41:00,6
18992,ORD_18993,19948,Petals - Ladli Pad Kit,Warehouse A,53,41,2025-02-13 13:32:00,12
18993,ORD_18994,15383,TheGiftKart Flip Back Cover Case for Samsung Galaxy M04 / F04 / A04e | Dual-Color Leather Finish | Inbuilt Stand & Pockets...,Warehouse B,8,3,2025-02-13 21:03:00,5
18994,ORD_18995,15388,House Of Makeup Good On You Hydra Matte Lipstick - Pink Peony 3.5 gm,Warehouse A,81,74,2025-02-13 08:03:00,7
18995,ORD_18996,19954,Novatax O 200mg Tablet,Warehouse A,114,99,2025-02-13 17:14:00,15
18996,ORD_18997,19961,DEVCOMM Silicone Keyboard Skin Protector Keyguard Keyboard Dust Cover Keyboard Skin for Laptop 15.6 inches (3.93 x 11.99 x...,Warehouse C,68,53,2025-02-13 22:39:00,15
18997,ORD_18998,34201,Histadol 5mg/500mg/5mg Tablet,Warehouse B,86,77,2025-02-13 09:45:00,9
18998,ORD_18999,27184,Ireex-S Injection,Warehouse B,56,44,2025-02-13 00:49:00,12
18999,ORD_19000,20001,Rhumafast Gel,Warehouse A,61,54,2025-02-13 11:09:00,7
19000,ORD_19001,27166,"Kinsound USB C to 3.5 mm Jack Audio Headphone Adapter, 32bit Hi-Res Sound Quality Type C to 3.5mm Jack Adapter Compatible ...",Warehouse C,84,73,2025-02-13 12:39:00,11
19001,ORD_19002,15159,"MAYCREATE® Makeup Brush Bag with Belt Strap, 22 Slots Makeup Brush Bag Makeup Brush Storage Pouch for Makeup Artists (Brus...",Warehouse B,106,87,2025-02-13 07:54:00,19
19002,ORD_19003,19714,Deep Clean Germ Protection Liquid Handwash Refill Pouch,Warehouse C,77,61,2025-02-13 13:58:00,16
19003,ORD_19004,33154,"Wings Phantom 250 Wireless Earbuds, with 30 Hours Playtime, Bullet Charge, 40ms Low Latency, Bluetooth 5.2, 13mm Drivers, ...",Warehouse B,24,6,2025-02-13 07:03:00,18
19004,ORD_19005,16023,Glimmer Premium Nail Enamel Lilac Star 10 ml,Warehouse B,69,53,2025-02-13 07:56:00,16
19005,ORD_19006,34842,Cool Wind Eau De Toilette Deodorant,Warehouse C,64,46,2025-02-13 01:13:00,18
19006,ORD_19007,34210,"Helmet Chin Mount with Mobile Holder, Motorcycle Helmet Strap Compatible with GoPro and Mobile Phones (Pack of 1)",Warehouse B,38,33,2025-02-13 18:23:00,5
19007,ORD_19008,26469,Vega 2 Side Pumice Stone With Handle (PD - 24) 97 gm,Warehouse B,20,6,2025-02-13 08:16:00,14
19008,ORD_19009,34072,"Casio FX-100MS 2nd Gen Non-Programmable Scientific Calculator, 300 Functions and 2-line Display, Black",Warehouse B,80,61,2025-02-13 05:17:00,19
19009,ORD_19010,20132,Pentel Energel Roller Gel Pen Set - Pack of 8 (Blue),Warehouse B,21,7,2025-02-13 19:38:00,14
19010,ORD_19011,14921,Maxvalper 500mg Tablet ER,Warehouse B,65,46,2025-02-13 04:53:00,19
19011,ORD_19012,15735,"SeTrack GPS Tracker Device with Android and iOS Mobile App with Engine Lock and Anti Theft Alarm for Car, Bike, Truck and Bus",Warehouse C,24,8,2025-02-13 22:16:00,16
19012,ORD_19013,15728,CEDO Back Cover Redmi Note 9 Pro/Note 9 Pro Max/Note 10 Lite | Matte Soft Silicon Flexible | Camera Bump Protection | All ...,Warehouse A,22,12,2025-02-13 20:47:00,10
19013,ORD_19014,26489,Glycichek M 2mg/500mg Tablet,Warehouse A,50,44,2025-02-13 16:31:00,6
19014,ORD_19015,20381,Djc 50mg Capsule,Warehouse B,83,68,2025-02-13 08:51:00,15
19015,ORD_19016,27333,"Samsung 6.0 Kg Inverter 5 Star Fully-Automatic Front Loading Washing Machine (WW60R20GLMA/TL, White, Hygiene Steam)",Warehouse A,94,86,2025-02-13 23:01:00,8
19016,ORD_19017,15355,"BOBO BM10H Handlebar Mount Fully Waterproof Bike / Motorcycle / Scooter Mobile Phone Holder Mount, Ideal for Maps and GPS ...",Warehouse B,47,29,2025-02-13 20:50:00,18
19017,ORD_19018,33814,VARS ; LONDON instant glow shimmer blusher bronzer face brick highlighter palette | face blusher palette | combo pack high...,Warehouse B,24,8,2025-02-13 12:17:00,16
19018,ORD_19019,27144,Cgglu 500 Tablet,Warehouse B,101,89,2025-02-13 19:57:00,12
19019,ORD_19020,20032,Bricol 80mg Injection,Warehouse B,115,97,2025-02-13 11:05:00,18
19020,ORD_19021,15430,Sandalwood Essential Oil,Warehouse C,24,7,2025-02-13 06:39:00,17
19021,ORD_19022,33959,Onwon-MD Tablet,Warehouse A,19,1,2025-02-13 08:59:00,18
19022,ORD_19023,33963,Naturale Detoxifying Aloevera Bodywash,Warehouse C,25,9,2025-02-13 19:08:00,16
19023,ORD_19024,33968,"AYA Meilin Non Transfer Waterproof Matte Lipstick, Burgundy, 3.2 g",Warehouse A,42,23,2025-02-13 07:50:00,19
19024,ORD_19025,15440,Zyrocon 100mg Tablet,Warehouse A,106,90,2025-02-13 03:25:00,16
19025,ORD_19026,20061,Almond Soap,Warehouse B,75,68,2025-02-13 10:45:00,7
19026,ORD_19027,26957,Panty Liners - Intima Large,Warehouse A,62,57,2025-02-13 01:57:00,5
19027,ORD_19028,20066,Slazenger Gym Eau De Toilette Green For Men 50 ml,Warehouse C,54,48,2025-02-13 20:01:00,6
19028,ORD_19029,26965,"NewYouth Professional Ear Pads Cushions Replacement, Earpads Compatible with Audio Technica ATH-M40X M40h M50 M50X Headphones",Warehouse C,35,29,2025-02-13 14:05:00,6
19029,ORD_19030,15522,"Logitech H340 Stereo Wired Over Ear Headphones With Mic With Noise-Cancelling, Usb, Pc/Mac/Laptop - Black",Warehouse C,61,52,2025-02-13 05:24:00,9
19030,ORD_19031,27082,Insight Cosmetics 2X Cover Master Concealer - Golden Russet 6 ml,Warehouse C,76,65,2025-02-13 04:14:00,11
19031,ORD_19032,34024,"(Renewed) DELL Latitude 5490 Core i5 8th Gen Laptop, 16 GB RAM, 512GB SSD, Intel HD Graphics, 14 inch (36.83 cms) HD Scree...",Warehouse C,97,88,2025-02-13 22:25:00,9
19032,ORD_19033,34123,WOWSOME Silver Universal Conversion Plug - 3 Pin Socket Worldwide Adaptor UK/US/EU/AU To Indian (2pcs),Warehouse B,46,36,2025-02-13 23:47:00,10
19033,ORD_19034,20175,Portronics My Buddy K4 Portable Laptop Stand Support Upto 15 inch Laptops(Black),Warehouse A,80,68,2025-02-13 13:32:00,12
19034,ORD_19035,34039,"Generic Y-68 Water Proof Bluetoth Smart Watch Fitness Band for Boys, Girls, Men, Women & Kids | Sports Watch for All Smart...",Warehouse B,34,27,2025-02-13 23:27:00,7
19035,ORD_19036,20162,Colossal Pen Liner,Warehouse B,38,22,2025-02-13 16:43:00,16
19036,ORD_19037,15502,EGOTUDE Silicon Soft Case Camera Protect Microfiber Lining Cover for iPhone 13 (Blue),Warehouse A,53,44,2025-02-13 07:34:00,9
19037,ORD_19038,27052,Just Herbs Ayurvedic Anti-Dandruff Soya Protein Shampoo For Strong & Bouncy Hair For Men & Women- Sls & Paraben Free 35 Ml,Warehouse B,57,50,2025-02-13 13:27:00,7
19038,ORD_19039,27990,Zedan P 50mg Tablet,Warehouse A,66,58,2025-02-13 17:35:00,8
19039,ORD_19040,34949,"SanDisk Ultra USB 3.0 Flash Drive, CZ48 256GB, USB3.0, Black, Stylish Sleek Design, 5Y Warranty",Warehouse A,114,95,2025-02-13 15:15:00,19
19040,ORD_19041,27988,SUGAR Cosmetics Smudge Me Not Liquid Lipstick - 13 Wooed By Nude (Peach Nude) 4.5 ml,Warehouse A,90,76,2025-02-13 13:43:00,14
19041,ORD_19042,19352,Vega Dressing Comb (HMSC - 04) 41 gm,Warehouse B,75,60,2025-02-13 03:07:00,15
19042,ORD_19043,33201,"Portronics Key2 Combo Multimedia USB Wireless Keyboard and Mouse Set with 2.4 GHz Wireless Technology, Soft & Silent Butto...",Warehouse C,101,88,2025-02-13 14:35:00,13
19043,ORD_19044,28039,"PiBOX India, Micro HDMI to HDMI Cable, 4K 60Hz , 1.5 Meter 5 feet, Adapter Ethernet Audio Return Compatible for Raspberry ...",Warehouse A,94,86,2025-02-13 06:43:00,8
19044,ORD_19045,14879,Camther 150mg Injection,Warehouse B,74,56,2025-02-13 00:24:00,18
19045,ORD_19046,25847,ENVIE ECR-20 Charger for AA & AAA Rechargeable Batteries,Warehouse B,83,72,2025-02-13 09:15:00,11
19046,ORD_19047,16039,"Western Digital WD 1TB Elements Portable Hard Disk Drive, USB 3.0, Compatible with PC, PS4 and Xbox, External HDD (WDBHHG0...",Warehouse A,64,52,2025-02-13 23:47:00,12
19047,ORD_19048,34891,"The Skin Story Daily Repair Moisturising Cream, 50g",Warehouse A,101,92,2025-02-13 16:53:00,9
19048,ORD_19049,28018,Montero L Syrup,Warehouse A,97,80,2025-02-13 06:11:00,17
19049,ORD_19050,34882,Mecokard Plus Injection,Warehouse B,113,94,2025-02-13 07:42:00,19
19050,ORD_19051,20959,Faceclin-A Gel,Warehouse C,74,64,2025-02-13 23:10:00,10
19051,ORD_19052,19387,FIRST CLICK Art 12 Wells 301 Kidney/Oval Shaped Plastic Palette Size 17cms X 22cms,Warehouse C,72,66,2025-02-13 03:20:00,6
19052,ORD_19053,34868,Analtra Tablet DT,Warehouse C,13,3,2025-02-13 17:02:00,10
19053,ORD_19054,34864,Tolpidol D Tablet,Warehouse A,82,66,2025-02-13 09:50:00,16
19054,ORD_19055,25946,"LXCN® New Car Phone Holder Mount, Rearview Mirror Phone Holder for Car, 360°Rotatable and Retractable Car Phone Holder, Mu...",Warehouse C,110,95,2025-02-13 13:25:00,15
19055,ORD_19056,27793,Alwel 5mg Tablet,Warehouse B,102,86,2025-02-13 15:34:00,16
19056,ORD_19057,14991,Ajmal Titanium EDP Citrus Spicy Perfume 100ml for Men and Raindrops EDP Floral Chypre Perfume 50ml for Women +1 Perfume Te...,Warehouse A,41,31,2025-02-13 15:12:00,10
19057,ORD_19058,20845,Electvision Remote Control Compatible with Xiaomi Mi Smart Led Tv and Tv Stick with Netflix & Prime Video Hot Keys (Pairin...,Warehouse C,77,64,2025-02-13 23:35:00,13
19058,ORD_19059,15882,Faces Canada Ultime Pro Gel Lustre Nail Lacquer Blush Flush 42 9 Ml,Warehouse A,53,45,2025-02-13 19:29:00,8
19059,ORD_19060,27721,"Peter Jones Round Anti Glare Reading Glasses for Men Women, Computer Readers UV 400 Customise Prescription (AG003)",Warehouse B,57,39,2025-02-13 18:21:00,18
19060,ORD_19061,19605,Rosloy D 10 Tablet,Warehouse C,32,16,2025-02-13 14:03:00,16
19061,ORD_19062,33459,Wella Professionals ColorMotion+ Colour Protection Shampoo | 250 ml | Hair Cleanser for Coloured Hair | For Vibrant Shine...,Warehouse B,19,12,2025-02-13 09:51:00,7
19062,ORD_19063,26184,Cefodaz CV 200mg/125mg Tablet,Warehouse A,85,69,2025-02-13 17:24:00,16
19063,ORD_19064,34611,Moiz Cleansing Lotion (200 ml),Warehouse B,55,42,2025-02-13 21:35:00,13
19064,ORD_19065,34607,YellowInc Global Impex Breathe Silicone Case Cover Skin for OnePlus Buds Z2 2022 Headphones - Earbuds Not Included (Black),Warehouse B,88,74,2025-02-13 15:39:00,14
19065,ORD_19066,19630,Xiaten M 1000mg/20mg Tablet,Warehouse C,47,36,2025-02-13 06:33:00,11
19066,ORD_19067,34605,Maladin 100mg Tablet,Warehouse B,10,5,2025-02-13 10:05:00,5
19067,ORD_19068,26215,Morning Dew Perfumed Talc,Warehouse C,42,36,2025-02-13 13:48:00,6
19068,ORD_19069,26225,MYVN 5V/4A Compatible Vooc SuperFast Data Sync Charging Cable for Compatible for Oppo F9 F9 pro Oppo F11 Pro & All Oppo Sm...,Warehouse B,84,69,2025-02-13 07:37:00,15
19069,ORD_19070,27667,"Sery Stay On Matte Liquid Lipstick Show Stopper, Red (LSO - 16) 5 ml",Warehouse B,113,96,2025-02-13 10:44:00,17
19070,ORD_19071,33197,FLENGO; MADE FOR YOU Flawless Color Correcting Concealer Palette (Shade-2),Warehouse A,105,92,2025-02-13 20:46:00,13
19071,ORD_19072,16067,Derwent Precision Mechanical Pencil 0.7 mm Refill Set,Warehouse A,100,93,2025-02-13 16:46:00,7
19072,ORD_19073,34838,Ajmal Diza EDP Fruity Floral Perfume And Wisal Deodorant Floral Musky Fragrance 300 ml,Warehouse B,63,50,2025-02-13 17:40:00,13
19073,ORD_19074,28089,Alertin 5mg Tablet,Warehouse A,88,70,2025-02-13 05:22:00,18
19074,ORD_19075,20917,Khadi Essentials Skin Reviving Night Cream - Vitamin C & E with Hyaluronic Acid 30 ml,Warehouse A,62,52,2025-02-13 12:00:00,10
19075,ORD_19076,27986,Time Office Usb Type C Cable For Mantra Mfs100 Fingerprint Scanner (Black),Warehouse C,77,64,2025-02-13 10:41:00,13
19076,ORD_19077,20916,"Redmi Lithiumpolymer 10000 Mah Fast Charging Slim Power Bank (Black, 10W Fast Charging, Dual Ports)",Warehouse C,67,49,2025-02-13 23:32:00,18
19077,ORD_19078,25882,"Genie Glitter Backpack for Women - 3 compartments, Laptop Bags for Girls, Stylish and Trendy College Backpacks for Girls, ...",Warehouse A,94,76,2025-02-13 06:40:00,18
19078,ORD_19079,14930,Super Immuno Elderberry Immunity Booster Gummies For Kids,Warehouse A,64,54,2025-02-13 20:19:00,10
19079,ORD_19080,27945,Colorbar Lux Nail Lacquer Cbn587 12 Ml,Warehouse C,104,93,2025-02-13 18:08:00,11
19080,ORD_19081,33249,Goldclav 375 Tablet,Warehouse B,20,10,2025-02-13 14:15:00,10
19081,ORD_19082,16004,Kangaro Stapler HP 45 - Colour May Vary,Warehouse B,18,9,2025-02-13 07:10:00,9
19082,ORD_19083,25903,"Fashion Colour Crystal Gel Lipstick, 602 3.8 gm",Warehouse C,98,91,2025-02-13 06:55:00,7
19083,ORD_19084,33253,"GIZGA essentials (25cm x 21cm Gaming Mouse Pad, Laptop Desk Mat, Computer Mouse Pad with Smooth Mouse Control, Mercerized ...",Warehouse B,41,31,2025-02-13 16:39:00,10
19084,ORD_19085,33257,Riptan M 500mg/50mg Tablet,Warehouse A,67,58,2025-02-13 01:05:00,9
19085,ORD_19086,27907,Ampilox CV 1000 mg/200 mg Injection,Warehouse B,83,75,2025-02-13 02:53:00,8
19086,ORD_19087,20872,Storva Trio 20 Capsule,Warehouse B,41,24,2025-02-13 11:44:00,17
19087,ORD_19088,27901,Palette Deluxe Oil-Care Color Permanent - 1-0 Deep Natural Black,Warehouse C,96,82,2025-02-13 21:19:00,14
19088,ORD_19089,19482,VINSH ENTERPRISE Telescope 60X60 HD Vision Binoculars 10000M High Power for Outdoor Hunting Optical LLL Vision Binocular F...,Warehouse B,60,48,2025-02-13 02:39:00,12
19089,ORD_19090,14958,Revlon Colorstay Brow Fiber Filler Gel - Grey Brown 6.8 ml,Warehouse A,94,77,2025-02-13 05:22:00,17
19090,ORD_19091,25926,"Cosmic Byte Kilonova 3325IC RGB Wired Gaming Mouse with Pixart 3325 Sensor, Ultra Lightweight 73grams, Adjustable Weights,...",Warehouse B,29,19,2025-02-13 08:01:00,10
19091,ORD_19092,25937,Face Wash - Activated Bamboo Charcoal,Warehouse A,32,19,2025-02-13 07:00:00,13
19092,ORD_19093,14918,Nitican 150mg Tablet,Warehouse C,96,83,2025-02-13 12:28:00,13
19093,ORD_19094,25867,Arzur 15 Tablet,Warehouse B,83,67,2025-02-13 18:25:00,16
19094,ORD_19095,27616,Kufcol PC Syrup,Warehouse A,13,6,2025-02-13 13:55:00,7
19095,ORD_19096,25853,Soulflower Geranium Essential Oil 15 ml,Warehouse A,61,56,2025-02-13 16:04:00,5
19096,ORD_19097,16088,CEDO Samsung Tab A8 10.5 inch Flip Cover | Leather Finish | 360 Degree Rotate Flip Cover | Shockproof Style Back Cover Cas...,Warehouse A,39,26,2025-02-13 23:46:00,13
19097,ORD_19098,34952,Hisense 164 cm (65 inches) Tornado 2.0 Series 4K Ultra HD Smart LED Google TV 65A7H (Silver),Warehouse B,86,79,2025-02-13 06:53:00,7
19098,ORD_19099,20997,Amazon Brand - Solimo Silicone Back Cover for iPhone 12/12 Pro - Clear,Warehouse C,74,67,2025-02-13 17:15:00,7
19099,ORD_19100,28141,Razer DeathAdder Essential White Edition - 6400 DPI Ergonomic Wired Gaming Mouse - RZ01-03850200-R3M1,Warehouse A,19,11,2025-02-13 02:38:00,8
19100,ORD_19101,33184,Painrav P 100mg/500mg Tablet,Warehouse B,22,16,2025-02-13 22:17:00,6
19101,ORD_19102,16076,BROTHER BT5000C Ink Bottle (Cyan),Warehouse C,94,76,2025-02-13 03:18:00,18
19102,ORD_19103,34438,"Reusable Face Mask - 2 Ply, Cotton, Assorted Colour",Warehouse B,55,39,2025-02-13 08:55:00,16
19103,ORD_19104,34431,Aclopride P 100 mg/500 mg Tablet,Warehouse B,90,83,2025-02-13 13:55:00,7
19104,ORD_19105,29148,Omepic D 10mg/20mg Capsule,Warehouse B,70,53,2025-02-13 05:23:00,17
19105,ORD_19106,34439,Fashion Colour Makeup Fixer Tin 150 ml,Warehouse C,60,49,2025-02-13 15:48:00,11
19106,ORD_19107,32355,Evikos 20 Tablet,Warehouse C,26,8,2025-02-13 13:06:00,18
19107,ORD_19108,14353,"Portronics Mport 60 4-in-1 Multiport Type C/USB Hub with LAN Adapter RJ45 Port, 3 USB2.0 Port, Type C OTG Support, Plug & ...",Warehouse B,113,97,2025-02-13 12:00:00,16
19108,ORD_19109,21583,"POPIO Screen Guard Protector Compatible for Apple Watch Series 4, 5, 6, Watch SE & Watch SE 2022, 40mm (Transparent) with ...",Warehouse B,81,65,2025-02-13 05:41:00,16
19109,ORD_19110,18776,ADISA 35L Large Laptop Backpack Office Bag College Travel Back Pack with rain Cover (Green),Warehouse B,88,72,2025-02-13 20:08:00,16
19110,ORD_19111,21543,ZYNK CASE Back Cover for OnePlus 7T (Silicone_Black),Warehouse A,60,46,2025-02-13 09:36:00,14
19111,ORD_19112,16542,Inflachek-D Tablet,Warehouse C,80,74,2025-02-13 13:43:00,6
19112,ORD_19113,16539,Xadoo 100mg Tablet,Warehouse B,63,49,2025-02-13 00:37:00,14
19113,ORD_19114,25040,RENEE Lipstick FAB5 (Matte) & RENEE Lipstick FAB5 Nude (Matte),Warehouse C,64,58,2025-02-13 19:30:00,6
19114,ORD_19115,28912,OFIXO Durable Soft 1.50 Meter 150 cm Sewing Tailor Tape Body Measuring Measure Ruler Dressmaking,Warehouse B,53,37,2025-02-13 15:45:00,16
19115,ORD_19116,21507,Ramitan 5mg/50mg Tablet,Warehouse C,58,41,2025-02-13 10:51:00,17
19116,ORD_19117,25077,"Casio FX-991ES Plus-2nd Edition Scientific Calculator, Black",Warehouse B,87,70,2025-02-13 09:02:00,17
19117,ORD_19118,35605,Gluconorm PG 1 Tablet ER,Warehouse C,94,85,2025-02-13 01:44:00,9
19118,ORD_19119,35602,Tritastatin 20mg Tablet,Warehouse B,65,51,2025-02-13 00:23:00,14
19119,ORD_19120,35596,Natural Ayurvedic Oil Clear Aloe Vera Face Wash,Warehouse B,87,80,2025-02-13 02:34:00,7
19120,ORD_19121,32613,ABOUTTHEFIT Polycarbonate Smart Trifold Hard Back Flip Stand Case Cover for Tablets Compatible with Lenovo Tab M10 HD TB-X...,Warehouse C,93,77,2025-02-13 18:26:00,16
19121,ORD_19122,35585,Glimix 2 Tablet SR,Warehouse B,76,68,2025-02-13 09:05:00,8
19122,ORD_19123,28818,CASEOLOGY by Spigen Vault Back Cover Case for Samsung Galaxy S21 FE 5G (TPU | Matte Black | Texture),Warehouse C,57,44,2025-02-13 08:58:00,13
19123,ORD_19124,28797,"Makeup Mania 140 Pcs Large Waxing Strips, Non-Woven Hair Removal Plain Waxing Strips - Ivory 140 Pcs",Warehouse C,77,69,2025-02-13 09:16:00,8
19124,ORD_19125,32651,Vitamin C Facewash,Warehouse C,113,97,2025-02-13 06:32:00,16
19125,ORD_19126,21420,"HUMBLE Universal Waterproof Smartphone Protective Pouch for Pool, Beach for All Smartphones-Random Color",Warehouse B,86,72,2025-02-13 23:01:00,14
19126,ORD_19127,21585,Aqua Blast Perfume Spray,Warehouse C,84,72,2025-02-13 11:46:00,12
19127,ORD_19128,18756,"Toothpaste - Red Gel, Combo Pack",Warehouse B,22,17,2025-02-13 22:21:00,5
19128,ORD_19129,18687,Makeup Revolution Colour Play Dreamer Eyeshadow Palette 5.2 gm,Warehouse C,102,87,2025-02-13 02:31:00,15
19129,ORD_19130,21714,"Redmi 11 Prime (Peppy Purple, 6GB RAM, 128GB Storage) | Prime Design | High Performance Helio G99 | 50 MP AI Triple Cam | ...",Warehouse C,107,88,2025-02-13 20:09:00,19
19130,ORD_19131,32367,Ajmal Avid Carbon Wisal Deodorant Spray (Pack of 3) 200 ml,Warehouse B,55,39,2025-02-13 07:43:00,16
19131,ORD_19132,32360,"Fashion Colour Cover Up Concealer Stick, Shade 02 8.5 gm",Warehouse B,97,79,2025-02-13 15:53:00,18
19132,ORD_19133,18637,Hisense 139 cm (55 inches) Tornado 2.0 Series 4K Ultra HD Smart LED Google TV 55A7H (Silver),Warehouse A,19,7,2025-02-13 21:39:00,12
19133,ORD_19134,21685,RE' EQUIL Oil Free Mattifying Moisturiser - 50g,Warehouse B,19,13,2025-02-13 15:18:00,6
19134,ORD_19135,24816,Belkin Essential Series 3-Socket Surge Protector Universal Socket with 5ft Heavy Duty Cable (Grey),Warehouse C,17,1,2025-02-13 21:02:00,16
19135,ORD_19136,19667,Revostat FB Tablet,Warehouse C,82,77,2025-02-13 04:43:00,5
19136,ORD_19137,35791,A2B A 40 mg/5 mg Tablet,Warehouse A,85,70,2025-02-13 11:00:00,15
19137,ORD_19138,14206,Dr. Morepen ST01 Deluxe Stethoscope,Warehouse A,92,80,2025-02-13 04:05:00,12
19138,ORD_19139,29281,Angiblock 10mg Capsule,Warehouse B,82,65,2025-02-13 22:03:00,17
19139,ORD_19140,24654,Vega Eye Brush (PB - 14) 22 gm,Warehouse B,98,90,2025-02-13 05:20:00,8
19140,ORD_19141,29440,"Fashion Colour Kiss Lip No Transfer Lipstick, 87 2.6 gm",Warehouse C,73,54,2025-02-13 09:26:00,19
19141,ORD_19142,29432,OnePlus OTG Cable OTG Adapter USB 3.0 Compatible with All C Type Supported Mobile Smartphone and Other Devices (White & Red),Warehouse C,80,66,2025-02-13 11:31:00,14
19142,ORD_19143,18500,Twinblok-T 80 Tablet,Warehouse A,96,89,2025-02-13 00:04:00,7
19143,ORD_19144,16793,"OREI USA to India Converter Plug, World (USA, UK, China) Australia to India Plug Converter - Type D Adapter - 2 in 1 Canad...",Warehouse B,52,37,2025-02-13 13:09:00,15
19144,ORD_19145,29398,Rabelyl-DSR Capsule,Warehouse C,69,60,2025-02-13 11:42:00,9
19145,ORD_19146,29389,Lazox-SP Tablet,Warehouse A,68,59,2025-02-13 14:29:00,9
19146,ORD_19147,18514,Rosewood Essentail Oil - 100% Pure & Natural,Warehouse A,68,53,2025-02-13 06:57:00,15
19147,ORD_19148,16778,Torcoxia 90mg Tablet,Warehouse B,105,96,2025-02-13 07:06:00,9
19148,ORD_19149,35973,Robustrion Smart Trifold Hard Back Flip Stand Case Cover for Samsung Tab S6 Lite Cover 10.4 inch SM-P610/P615 - Black,Warehouse A,75,69,2025-02-13 17:09:00,6
19149,ORD_19150,18527,Scanil 5% Lotion,Warehouse A,50,39,2025-02-13 04:09:00,11
19150,ORD_19151,24581,Olive Oil Body Lotion,Warehouse B,21,8,2025-02-13 12:51:00,13
19151,ORD_19152,16771,"ELV Desktop Cell Phone Tabletop Stand Tablet Stand, Aluminum Stand Holder for Mobile Phone and Tablet (Up to 10.1 inch) - ...",Warehouse B,97,81,2025-02-13 16:27:00,16
19152,ORD_19153,35943,Daily Life Forever52 Eye Brow Brush Nx025 1's,Warehouse C,85,67,2025-02-13 06:18:00,18
19153,ORD_19154,24606,C Fresh L 5mg Tablet,Warehouse C,29,16,2025-02-13 12:05:00,13
19154,ORD_19155,29358,Amazon Basics 6 Foot Micro HDMI-A to HDMI-D (NOT Micro-USB) Cable (Black),Warehouse B,73,57,2025-02-13 04:37:00,16
19155,ORD_19156,24634,YellowInc Global Impex Breathe Silicone Cover For Oneplus Buds Z2 Headphones (2022) (Earbuds Not Included) (Dark Green),Warehouse B,106,98,2025-02-13 10:35:00,8
19156,ORD_19157,21856,Crucial MX500 500GB 6.35 cm (2.5-inch) SSD,Warehouse C,111,98,2025-02-13 20:23:00,13
19157,ORD_19158,29356,Lapster rj45 connector Coupler Cat7/Cat6/Cat5e Ethernet Network lan connector,Warehouse A,96,88,2025-02-13 16:29:00,8
19158,ORD_19159,24641,Spigen Full Coverage Tempered Glass Screen Guard Protector for Galaxy S20 FE 4G / 5G - 1 Pack,Warehouse B,38,26,2025-02-13 12:45:00,12
19159,ORD_19160,16761,Atril 5 Tablet,Warehouse B,114,98,2025-02-13 07:11:00,16
19160,ORD_19161,21833,Jyocef 250mg Injection,Warehouse B,21,7,2025-02-13 01:53:00,14
19161,ORD_19162,24847,Biomol H 12.5mg/20mg Tablet,Warehouse B,89,70,2025-02-13 10:16:00,19
19162,ORD_19163,32403,"HP 14s, Intel Celeron N4500, 8GB RAM/256GB SSD 14-inches/35.6 cm HD, Micro-Edge Display/Alexa Built-in/Windows 11/Intel UH...",Warehouse C,73,60,2025-02-13 00:52:00,13
19163,ORD_19164,15745,Windol Plus Tablet,Warehouse B,103,95,2025-02-13 19:47:00,8
19164,ORD_19165,27388,Patchouli Man EDT,Warehouse C,20,9,2025-02-13 15:13:00,11
19165,ORD_19166,26600,HUMBLE Phone Holder for Bike/Bicycle for Phones/Mobile (Up to 7 Inches) (Updated 2023),Warehouse B,59,41,2025-02-13 16:18:00,18
19166,ORD_19167,27361,Lynx 250 Capsule,Warehouse B,89,70,2025-02-13 09:17:00,19
19167,ORD_19168,19908,"Syvo S-3520A (60-Inch) (152.4cm) Aluminium Tripod, Universal Lightweight Tripod with Carry Bag for All Smart Phones, Gopr...",Warehouse A,29,15,2025-02-13 06:40:00,14
19168,ORD_19169,27348,"Aroma® NB119 Titanium Bluetooth Wireless In Ear Headset Neckband with Long Lasting Playtime 48 Hrs, Smart Voice Assistant,...",Warehouse C,66,47,2025-02-13 09:42:00,19
19169,ORD_19170,15649,Olmo CT 40mg/12.5mg Tablet,Warehouse B,41,35,2025-02-13 12:57:00,6
19170,ORD_19171,26666,Vaadi Herbals Shower Gel - Divine Honey & Sandal 300 ml,Warehouse A,52,34,2025-02-13 08:38:00,18
19171,ORD_19172,15336,Instaryl-P Syrup,Warehouse A,75,69,2025-02-13 20:35:00,6
19172,ORD_19173,20388,Rabicip D  Capsule SR,Warehouse B,48,34,2025-02-13 04:26:00,14
19173,ORD_19174,26528,Lenphor Nail Tint Party Girl 16 12 Ml,Warehouse B,88,82,2025-02-13 02:56:00,6
19174,ORD_19175,20535,Eveready 1015 Carbon Zinc AA Battery - 10 Pieces,Warehouse B,98,86,2025-02-13 18:50:00,12
19175,ORD_19176,27605,"Samsung Galaxy S22 5G (Phantom Black, 8GB, 128GB Storage) with No Cost EMI/Additional Exchange Offers",Warehouse A,91,80,2025-02-13 23:32:00,11
19176,ORD_19177,20542,Oxobid-OZ Tablet,Warehouse A,40,28,2025-02-13 04:23:00,12
19177,ORD_19178,15161,"Zpc Milanówek Cream Fudge Luxury,150g Pack of 2 (Made in Poland) 150g Pack of 2",Warehouse A,74,68,2025-02-13 11:39:00,6
19178,ORD_19179,15169,"Wecool 4-in 1 USB Hub (Type C to 4 USB-A Ports) with Fast Data Transfer, USB C Hub with USB 2.0 and 3.0 Ports, Compatible ...",Warehouse C,116,99,2025-02-13 18:08:00,17
19179,ORD_19180,33618,Kapodox 200mg Tablet DT,Warehouse B,93,86,2025-02-13 00:09:00,7
19180,ORD_19181,15183,"JB SUPER Bass Portable Wireless Bluetooth Speaker with inbuilt Phone Stand Built-in mic, TF Card Slot, USB Port - Multi Color",Warehouse C,51,41,2025-02-13 23:13:00,10
19181,ORD_19182,26390,MI 108 cm (43 inches) 5A Series Full HD Smart Android LED TV L43M7-EAIN (Black),Warehouse B,36,19,2025-02-13 11:57:00,17
19182,ORD_19183,26394,Calming Body Oil,Warehouse A,15,1,2025-02-13 21:40:00,14
19183,ORD_19184,15768,Solocis 8mg Tablet,Warehouse A,43,29,2025-02-13 04:30:00,14
19184,ORD_19185,15188,Octrix Original 33W Sonic Charge Fast Charger Adapter with Type C Cable Compatible for Xiaomi Redmi Note 9 Series Note 10...,Warehouse B,102,92,2025-02-13 08:39:00,10
19185,ORD_19186,15189,Zomed 5mg Tablet,Warehouse B,42,23,2025-02-13 17:16:00,19
19186,ORD_19187,20569,Biosoft Wax Strips Roll Essentials 100's,Warehouse B,35,26,2025-02-13 23:06:00,9
19187,ORD_19188,33624,TARANJAL Dress to Impress Tablet for Kids Writing Pad Slate for Kids Electronic LCD Writing Tablet for Kids 8.5 Inch New G...,Warehouse B,65,49,2025-02-13 18:48:00,16
19188,ORD_19189,33629,CEDO Tempered Glass for iPad Air/Air 2 / iPad Pro 9.7 (2016) | Screen Protector Tempered Glass for iPad Air/Air 2 / iPad P...,Warehouse C,47,34,2025-02-13 23:00:00,13
19189,ORD_19190,34444,Elegance Deodorizing Talc-For Men 250 g + Gold Deodorizing Talc-For Men 250 g,Warehouse A,55,46,2025-02-13 11:54:00,9
19190,ORD_19191,34442,Immune Yogue Junior - Natural Ayurvedic Immunity Booster for Kids,Warehouse B,39,25,2025-02-13 06:48:00,14
19191,ORD_19192,27539,Ofcinta 200mg Tablet,Warehouse C,42,25,2025-02-13 20:02:00,17
19192,ORD_19193,26586,Passion Indulge MOISTURE - PEARL LIGHT 50 gm,Warehouse B,98,79,2025-02-13 00:16:00,19
19193,ORD_19194,32407,Battle Cry Mens Liquid Foundation for better coverage | Skin correcter for men | 30ml (Medium),Warehouse B,76,70,2025-02-13 22:53:00,6
19194,ORD_19195,26550,Telmitic 80mg Tablet,Warehouse A,62,45,2025-02-13 14:02:00,17
19195,ORD_19196,14285,Rbtin 16mg Tablet,Warehouse A,45,36,2025-02-13 00:57:00,9
19196,ORD_19197,29092,"Brustro Artists Wiro Bound Sketch Book, A4 Size, 120 Pages, 160 GSM (Acid Free)",Warehouse A,62,53,2025-02-13 08:17:00,9
19197,ORD_19198,29077,Eklo-SP Tablet,Warehouse C,37,19,2025-02-13 12:00:00,18
19198,ORD_19199,24874,SaleOn Pack of 1 Desk Lamp Study Lamp USB Lamp Touch Switch On-Off 3 Level Led Light for Laptop and Power Bank Eye Protect...,Warehouse A,16,4,2025-02-13 20:55:00,12
19199,ORD_19200,16641,"ESR Armorite Screen Protector Compatible with Apple Watch Ultra (2022, 49 mm), Tempered-Glass Protector with Stainless-Ste...",Warehouse B,101,95,2025-02-13 06:34:00,6
19200,ORD_19201,35675,"Coco Soul Cold Pressed Natural Virgin Coconut Oil, from the makers of Parachute 1250ml",Warehouse C,103,97,2025-02-13 11:58:00,6
19201,ORD_19202,32448,H Cort 100mg Injection,Warehouse A,34,19,2025-02-13 12:23:00,15
19202,ORD_19203,14295,TheGiftKart Flexible Shockproof Crystal Clear TPU Back Cover Case with Cushioned Edges for Ultimate Protection for Samsung...,Warehouse B,22,6,2025-02-13 20:57:00,16
19203,ORD_19204,14311,"OREI India to European Plug Adapter (Schuko) - Type E/F Plug Converter India to Germany - 2 in 1 - Perfect for Laptop, Cam...",Warehouse B,6,1,2025-02-13 09:27:00,5
19204,ORD_19205,24898,I AM EYECONIC 3D GLITTER MAUVE OVER 4 gm,Warehouse C,11,4,2025-02-13 16:21:00,7
19205,ORD_19206,18713,"Spigen USB C Car Charger, 45W Dual Port Car Charger Fast Charge (PD Charging 27W + Quick Charge 18W) Type C Car Adapter fo...",Warehouse C,62,55,2025-02-13 01:19:00,7
19206,ORD_19207,32489,Nexdec 25mg Injection,Warehouse A,13,8,2025-02-13 21:59:00,5
19207,ORD_19208,29049,Wycef 1000mg Injection,Warehouse B,34,24,2025-02-13 15:42:00,10
19208,ORD_19209,21618,"Trayodashanga Guggulu, 300 mg",Warehouse A,83,78,2025-02-13 02:38:00,5
19209,ORD_19210,29018,Vaidik 50mg/325mg/10mg Tablet,Warehouse B,107,98,2025-02-13 01:24:00,9
19210,ORD_19211,33153,Olee 20mg Tablet,Warehouse C,55,41,2025-02-13 18:41:00,14
19211,ORD_19212,34957,"Kangaro No.10-1M Staples Pack, 20 Packs",Warehouse A,34,28,2025-02-13 19:12:00,6
19212,ORD_19213,18477,Oil - Rose Essential,Warehouse A,95,78,2025-02-13 15:45:00,17
19213,ORD_19214,27512,"iPhone Original 20W PD Adapter Compatible for i-Phone 14/14 Plus/ 14 Pro/ 14 Pro Max, i-Phone 13/13 Pro/13 Pro Max/13 Min...",Warehouse C,37,29,2025-02-13 10:46:00,8
19214,ORD_19215,15254,Motorola T101 Cordless Landline Phone (Black),Warehouse B,48,30,2025-02-13 08:25:00,18
19215,ORD_19216,15696,Jioglim 2mg Tablet,Warehouse C,91,78,2025-02-13 01:14:00,13
19216,ORD_19217,20512,"Fashion Colour Terra Cotta Blusher, Shade 02 16 gm",Warehouse B,88,72,2025-02-13 00:00:00,16
19217,ORD_19218,33700,"Noise ColorFit Pulse Grand Smart Watch with 1.69"" HD Display, 60 Sports Modes, 150 Watch Faces, Spo2 Monitoring, Call Noti...",Warehouse B,63,58,2025-02-13 12:13:00,5
19218,ORD_19219,26539,WOW IMAGINE Shock Proof Clear Back Cover Case Mobile Cover for 1+ Oneplus Nord 2 5G | OnePlus Nord 2 5G Pac-Man Edition (H...,Warehouse A,28,21,2025-02-13 01:49:00,7
19219,ORD_19220,27436,Brother DCP-L2520D Multi-Function Monochrome Laser Printer with Auto-Duplex Printing,Warehouse C,30,24,2025-02-13 18:24:00,6
19220,ORD_19221,15282,"Hetvi trend ARLICODECK™ Double Sided Adhesive Tape, Transparent Strong Adhesive Traceless Tape Removable Washable and Reus...",Warehouse C,15,4,2025-02-13 16:17:00,11
19221,ORD_19222,27419,Newlike Silicone Bumper Thin Back Cover for Samsung Galaxy A33 5G (Transparent ),Warehouse B,98,91,2025-02-13 16:56:00,7
19222,ORD_19223,20652,MANCODE Hair Vitalizer 200 ml,Warehouse A,38,30,2025-02-13 05:29:00,8
19223,ORD_19224,22026,Merlion Naturals Organic Hibiscus Petals Powder 227 gm,Warehouse A,58,50,2025-02-13 11:56:00,8
19224,ORD_19225,33564,"HP 14s, 11th Gen Intel Core i3-1115G4, 8GB RAM/256GB SSD 14-inch(35.6 cm) Micro-Edge, Anti-Glare, FHD Laptop/Alexa Built-i...",Warehouse B,73,56,2025-02-13 00:53:00,17
19225,ORD_19226,23221,Podxetil  100 Oral Suspension Orange,Warehouse B,32,16,2025-02-13 01:08:00,16
19226,ORD_19227,13583,"BESTOR® USB C Hub HDMI Adapter, 6 in 1 Multiport Dock for MacBook pro to HDMI 4k,2 USB 3.0 Ports SD/TF Card Reader 55W PD,...",Warehouse C,76,70,2025-02-13 22:37:00,6
19227,ORD_19228,30732,FABTEC 4.3 Dashboard TFT LCD Screen Rear View Monitor with 8 LED Night Vision Car Reverse Camera,Warehouse B,70,55,2025-02-13 03:30:00,15
19228,ORD_19229,36831,"truke Yoga Mystic Wireless in Ear Earphones with mic, 50H of Playtime, Digital Display, ENC, Silicon Design, USB-C Fast Ch...",Warehouse C,94,82,2025-02-13 01:39:00,12
19229,ORD_19230,23541,"100% Natural Multani Mitti Stone Form (Fullers Earth/Calcium Bentonite Clay) For Face Pack And Hair, Pack- 1Kg",Warehouse A,19,6,2025-02-13 05:53:00,13
19230,ORD_19231,36810,Amazon Brand - Solimo Back Cover Case for POCO M2 / Mi Redmi 9 Prime / POCO M2 Reloaded | Compatible for POCO M2 / Mi Redm...,Warehouse B,83,74,2025-02-13 20:36:00,9
19231,ORD_19232,17750,Lakme 9 To 5 Primer + Gloss Nail Color Red Alert 6 Ml,Warehouse A,97,85,2025-02-13 08:10:00,12
19232,ORD_19233,31377,Miss Rose Liquid Smooth Matte Long Lasting Shine Lipgloss (Red),Warehouse A,53,35,2025-02-13 20:52:00,18
19233,ORD_19234,30708,Zegerd 20mg Oral Suspension,Warehouse C,67,48,2025-02-13 14:49:00,19
19234,ORD_19235,30694,Hello Zone Exclusive Dotted Matte Finish Soft Rubberised Back Case Cover for Nokia 3310 (2017) - Black,Warehouse C,31,21,2025-02-13 19:49:00,10
19235,ORD_19236,30687,"Maliao Matte Mousse Liquid Mousse Foundation Mousse Liquid long lasting water proof, 30 g",Warehouse A,90,71,2025-02-13 10:16:00,19
19236,ORD_19237,30678,Ciproked NF Cream,Warehouse A,94,81,2025-02-13 01:34:00,13
19237,ORD_19238,30650,Norban 400mg Tablet,Warehouse A,91,74,2025-02-13 04:33:00,17
19238,ORD_19239,30627,Whiteglow Skin Whitening & Brightening Massage Creme,Warehouse A,117,98,2025-02-13 06:11:00,19
19239,ORD_19240,31461,Arifix-OZ Dry Syrup,Warehouse B,92,73,2025-02-13 20:59:00,19
19240,ORD_19241,22576,Alatro Tablet,Warehouse B,99,86,2025-02-13 17:29:00,13
19241,ORD_19242,36731,Hub Woman Eau De Toilette Deodorant,Warehouse C,29,12,2025-02-13 05:28:00,17
19242,ORD_19243,23616,"Kadence rosewood Guitar Frontier Series, Electric Acoustic Black Guitar With EQ, Die Cast Keys, Set Of Strings, Strap, Pic...",Warehouse B,57,40,2025-02-13 06:00:00,17
19243,ORD_19244,23525,GIZGA Essentials Universal Silicone Keyboard Protector Skin for 15.6-Inches Laptop (5 X 6 X 3 Inches),Warehouse B,112,94,2025-02-13 22:36:00,18
19244,ORD_19245,22791,Hair Fruits Long & Silky Conditioning Shampoo,Warehouse A,86,73,2025-02-13 07:58:00,13
19245,ORD_19246,13561,"Amazon Basics USB 3.0 Extension Cable for Personal Computer, Printer - A-Male to A-Female - 6.5 Feet (2 Meters), Black",Warehouse A,71,55,2025-02-13 00:35:00,16
19246,ORD_19247,31243,Allure Foundation Brush - (102) 1's,Warehouse C,70,57,2025-02-13 06:57:00,13
19247,ORD_19248,36927,Femicare 200mg Soft Gelatin Capsule,Warehouse B,98,80,2025-02-13 06:04:00,18
19248,ORD_19249,30832,"REESO M1 Smart Watch for Men ID-116 Bluetooth Smartwatch Wireless Fitness Band for Boys, Girls, Men, Women & Kids | Sports...",Warehouse A,98,87,2025-02-13 18:23:00,11
19249,ORD_19250,30803,Skoda 200 Tablet,Warehouse B,34,26,2025-02-13 14:44:00,8
19250,ORD_19251,23280,Ansquare Dry Syrup,Warehouse C,79,60,2025-02-13 06:30:00,19
19251,ORD_19252,13503,Universal a.c. Remote Baba 1001 (Pack of 1),Warehouse A,48,33,2025-02-13 17:24:00,15
19252,ORD_19253,30794,Ngret 20mg Capsule,Warehouse A,41,24,2025-02-13 22:24:00,17
19253,ORD_19254,23314,Berina A29 Medium Chocolate Hair Color Cream 60 gm,Warehouse C,80,71,2025-02-13 05:08:00,9
19254,ORD_19255,23505,"Samsung Galaxy M33 5G (Deep Ocean Blue, 6GB, 128GB Storage) | 6000mAh Battery | Upto 12GB RAM with RAM Plus | Travel Adapt...",Warehouse A,31,12,2025-02-13 22:26:00,19
19255,ORD_19256,30909,Ajmal Aurum Sacred Love Deodorant Spray (Pack of 4) 200 ml,Warehouse A,56,48,2025-02-13 21:39:00,8
19256,ORD_19257,17679,"Kanget USB OTG for iPhone/iPad, Compatible with iOS 13 and Later, USB Female Support Connect USB Flash Drive, Keyboard, Mo...",Warehouse B,37,23,2025-02-13 21:37:00,14
19257,ORD_19258,17405,Gentacon 0.3% Eye/Ear Drops,Warehouse B,55,38,2025-02-13 19:07:00,17
19258,ORD_19259,17595,Olteem 2.5mg Tablet,Warehouse C,70,63,2025-02-13 14:30:00,7
19259,ORD_19260,17598,"OREI India to UK Adapter, UAE, Hong Kong, Dubai Adapter - 2 in 1 - Perfect for Laptop, Camera Charger - Type G Travel Adap...",Warehouse B,100,91,2025-02-13 17:04:00,9
19260,ORD_19261,17602,Amikafine 500mg Injection,Warehouse A,73,62,2025-02-13 02:01:00,11
19261,ORD_19262,23187,de'smat Silver Spiritual Forehead Teeka Tilak Applicator/Stamp Tool Puja for Daily Usage and Occasionally for Men and Wome...,Warehouse C,78,62,2025-02-13 03:09:00,16
19262,ORD_19263,17413,Mysole 6 Tablet,Warehouse A,85,78,2025-02-13 16:30:00,7
19263,ORD_19264,23192,Cpg 150mg Tablet,Warehouse A,83,70,2025-02-13 11:15:00,13
19264,ORD_19265,17407,Replacement 22mm Watch Straps Compatible with Samsung Galaxy Watch 46mm/Huawei Watch GT 2/Samsung Gear S3 Classic/Samsung ...,Warehouse A,70,60,2025-02-13 13:41:00,10
19265,ORD_19266,17406,Desolate 10mg Tablet,Warehouse B,62,43,2025-02-13 08:06:00,19
19266,ORD_19267,23122,"Anti Dandruff Shampoo - With Lemon & Methi, For Dandruff Free Hair",Warehouse C,61,54,2025-02-13 19:41:00,7
19267,ORD_19268,13433,B S Natural Sarai (Set Of11) Pure Mud Baked Mud,Warehouse B,67,52,2025-02-13 23:13:00,15
19268,ORD_19269,30987,HP 250 G8 Laptop (11th Gen Intel Core i3-11th Gen /8GB DDR4 Ram / 512GB SSD/Windows 11/39.62 cm (15.6 inch) HD/Intel UHD G...,Warehouse A,64,46,2025-02-13 11:37:00,18
19269,ORD_19270,13426,"Naturally Soft Sanitary Napkin Extra Long, 275mm",Warehouse C,100,83,2025-02-13 09:29:00,17
19270,ORD_19271,31087,Pre Shave Foam - Classic Menthol,Warehouse B,19,7,2025-02-13 15:48:00,12
19271,ORD_19272,22936,Spasmogil 20 mg/500 mg Tablet,Warehouse B,65,53,2025-02-13 11:32:00,12
19272,ORD_19273,17512,TheGiftKart Crystal Clear Back Cover Case for Google Pixel 6A | 360 Degree Protection | Shock Proof Design | Transparent B...,Warehouse A,88,69,2025-02-13 23:44:00,19
19273,ORD_19274,22935,Redgear Blaze 7 Colour Backlit Wired Gaming Keyboard with Full Aluminium Body Windows Key Lock,Warehouse A,31,24,2025-02-13 13:53:00,7
19274,ORD_19275,17463,"TP-Link USB Bluetooth Adapter for PC, 5.0 Bluetooth Dongle Receiver (UB500) Supports Windows 11/10/8.1/7 for Desktop, Lapt...",Warehouse B,91,83,2025-02-13 01:19:00,8
19275,ORD_19276,23020,TheGiftKart Translucent Hybrid Protective Hard Back Case Cover for Redmi 10 / Redmi 10 Power | Smoked Matte Back | 360 Deg...,Warehouse A,73,54,2025-02-13 09:32:00,19
19276,ORD_19277,31026,"ProElite Deer Flip case Cover for Lenovo Tab M10 FHD Plus 10.3"" X606V / TB-X606F / TB-X606X , Wine Red (Fits 1st & 2nd Gen)",Warehouse C,80,67,2025-02-13 07:14:00,13
19277,ORD_19278,13402,LOHAYA AC Remote Compatible with O General Split/Window AC Remote Control [Double Set-Swing] [ Compatible for O General AC...,Warehouse C,89,79,2025-02-13 12:10:00,10
19278,ORD_19279,22924,Menervin P 1500mcg/75mg Capsule,Warehouse A,43,31,2025-02-13 00:27:00,12
19279,ORD_19280,17450,Lakme True Wear Nail Color Reds & Maroons 404 9 Ml,Warehouse A,96,80,2025-02-13 21:03:00,16
19280,ORD_19281,13412,Cip TZ 500 mg/600 mg Tablet,Warehouse A,53,45,2025-02-13 01:51:00,8
19281,ORD_19282,22905,Drotanac-M Tablet,Warehouse A,91,83,2025-02-13 23:41:00,8
19282,ORD_19283,23061,Rushikanti Multani Mitti With Cucumber,Warehouse A,46,34,2025-02-13 05:39:00,12
19283,ORD_19284,23079,Tolaz 15mg Tablet,Warehouse A,106,94,2025-02-13 14:25:00,12
19284,ORD_19285,22889,Apple iPhone 12 (128GB) - Black,Warehouse A,75,63,2025-02-13 19:04:00,12
19285,ORD_19286,23105,Mahoushadha Granules,Warehouse A,33,26,2025-02-13 18:41:00,7
19286,ORD_19287,22744,Ajmal 2 Blu & 2 Aurum Deo & Neea EDP Pack of 5 20 ml,Warehouse A,90,73,2025-02-13 11:54:00,17
19287,ORD_19288,13518,Erywell 10mg/10mg/2.5mg Tablet,Warehouse B,44,27,2025-02-13 05:22:00,17
19288,ORD_19289,20644,Miss Rose 24 Color Glitter Eyeshadow Palette 7001 - 062 MT01 24 gm,Warehouse A,41,34,2025-02-13 15:01:00,7
19289,ORD_19290,36184,Soap Case - Ivy Big,Warehouse C,22,16,2025-02-13 13:08:00,6
19290,ORD_19291,29847,Uva/Uvb Lotion Sunflower Matte 100 Ml,Warehouse A,108,89,2025-02-13 08:01:00,19
19291,ORD_19292,24255,Ylang Ylang Shampoo - SLS & Paraben Free,Warehouse A,74,60,2025-02-13 19:36:00,14
19292,ORD_19293,29654,"DR. MOREPEN USA Scissor Set for Offices, Crafts, Kitchen, Tailoring and Hair Cutting (Black)",Warehouse C,49,32,2025-02-13 06:05:00,17
19293,ORD_19294,21929,Flugl 200mg Tablet,Warehouse A,111,95,2025-02-13 14:23:00,16
19294,ORD_19295,31967,Bonjour Paris Metallic Eye Pencil cum Eye Shadow - Waterproof Quick Silver 1.8 gm,Warehouse B,52,45,2025-02-13 10:25:00,7
19295,ORD_19296,32061,Samsung Level U2 Original in Ear Wireless Stereo Headset with Mic (Blue),Warehouse C,21,2,2025-02-13 11:12:00,19
19296,ORD_19297,22028,Anti-Dandruff Natural Ayurvedic Neem Shampoo,Warehouse B,99,82,2025-02-13 01:32:00,17
19297,ORD_19298,21986,House of Beauty Tree Tea Oil 30 ml,Warehouse A,25,8,2025-02-13 00:18:00,17
19298,ORD_19299,22068,Metsilone 8mg Tablet,Warehouse A,67,54,2025-02-13 12:08:00,13
19299,ORD_19300,13976,Beardo Hair Serum (Pack of 2) | serum for men | Serum for hair smoothing | Argan Oil & Almod Oil | Adds Shine | Daily use|...,Warehouse A,83,78,2025-02-13 12:30:00,5
19300,ORD_19301,14045,TheGiftKart Flip Back Cover Case for Samsung Galaxy A23 4G / A23 5G | Genuine Leather Finish | Designer Button | Inbuilt P...,Warehouse C,79,65,2025-02-13 09:13:00,14
19301,ORD_19302,18340,"QOCXRRIN IN-876 USB LED Mini Tube Light, Portable with High Brightness Cool Day Light for Small Rooms, Petty Shops, Car In...",Warehouse A,36,21,2025-02-13 04:34:00,15
19302,ORD_19303,14062,CZARTECH Tempered Glass Screen Guard for iPhone 13 | iPhone 14 | iPhone 13 Pro with Cleaning Kit (Pack of 1),Warehouse A,63,52,2025-02-13 17:57:00,11
19303,ORD_19304,24314,Rafenac Capsule SR,Warehouse A,43,24,2025-02-13 12:23:00,19
19304,ORD_19305,24491,Plum NaturStudio All-Day-Wear Kohl Kajal with FREE Sharpener - Gemstone Green (FSGG) 1.2 gm,Warehouse A,89,74,2025-02-13 12:02:00,15
19305,ORD_19306,22000,Generic Women's & Girl's Makeup Brushes - Colour : Pink - Set of 5,Warehouse B,85,67,2025-02-13 05:06:00,18
19306,ORD_19307,24323,Ajmal Majmua And Jannatul Firdaus & Neea EDP Of Pack of 3 20 ml,Warehouse B,94,83,2025-02-13 04:08:00,11
19307,ORD_19308,24434,Vetob-LP Eye Drop,Warehouse C,47,32,2025-02-13 16:01:00,15
19308,ORD_19309,36147,"Dunhill Desire Blue Ocean Eau De Toilete for him, 100ml",Warehouse B,71,65,2025-02-13 23:54:00,6
19309,ORD_19310,18447,7SEVEN® Infrared Non Voice oneplus Remote | 1+ Android TV Remote | Replacement of Original one plus smart tv Remote with N...,Warehouse C,23,4,2025-02-13 02:14:00,19
19310,ORD_19311,32069,"TP-Link Archer C80 AC1900 Dual Band Wireless, Wi-Fi Speed Up to 1300 Mbps/5 GHz + 600 Mbps/2.4 GHz, Full Gigabit, High-Per...",Warehouse A,27,18,2025-02-13 18:46:00,9
19311,ORD_19312,29174,Rabecon D 30 mg/20 mg Capsule,Warehouse B,38,19,2025-02-13 11:03:00,19
19312,ORD_19313,32134,Phycam 0.5mg Tablet SR,Warehouse B,49,37,2025-02-13 10:37:00,12
19313,ORD_19314,21924,Widcef 1.5gm Injection,Warehouse B,85,75,2025-02-13 14:48:00,10
19314,ORD_19315,18386,Levoflus Tablet,Warehouse A,113,96,2025-02-13 14:32:00,17
19315,ORD_19316,30780,"Portronics Toad II Wireless Optical Mouse with Dual Connectivity 2.4 Ghz & Bluetooth 5.0, Rechargeable Battery, Adjustable...",Warehouse C,42,23,2025-02-13 20:54:00,19
19316,ORD_19317,24344,"Fair and Handsome Laser 12 Advanced Whitening+ Multi Benefit Cream, 60g",Warehouse B,23,6,2025-02-13 00:41:00,17
19317,ORD_19318,31284,Kodak A4 Photo Paper 210x297mm 200gsm High Glossy Water Resistant Instant Dry For All Inkjet Printers – Set of 3 (60 Sheets),Warehouse A,21,4,2025-02-13 01:47:00,17
19318,ORD_19319,23343,Amikalon 500 Injection,Warehouse C,109,98,2025-02-13 11:22:00,11
19319,ORD_19320,36890,Fedus Clear HD Screen Guard Scratch Protector for 15.6 Inch Laptop,Warehouse C,16,1,2025-02-13 09:17:00,15
19320,ORD_19321,30743,Nourish & Replenish Shampoo,Warehouse B,63,45,2025-02-13 19:23:00,18
19321,ORD_19322,36876,"Fashion Colour Two Way Pancake, Shade 01 10 gm",Warehouse B,96,81,2025-02-13 03:29:00,15
19322,ORD_19323,24154,Girls CC Cream for Face Makeup Air Cushion BB Cream Women’s Face Powder Foundation Mushroom Head Facial Long Lasting Conce...,Warehouse C,41,28,2025-02-13 06:40:00,13
19323,ORD_19324,27051,Glimmer Ne Cranberry 5Ml Btl M 21 ml,Warehouse B,94,75,2025-02-13 05:39:00,19
19324,ORD_19325,29703,Prolet Classic Bumper Case Cover for Samsung Galaxy Watch 4 44mm TPU Plated Full Screen Protector (Transparent),Warehouse A,9,3,2025-02-13 02:51:00,6
19325,ORD_19326,21937,Fragrance Body Spray - Cool Blue,Warehouse C,22,14,2025-02-13 19:41:00,8
19326,ORD_19327,14138,Oil Pastels - 50 Shades,Warehouse A,59,44,2025-02-13 16:16:00,15
19327,ORD_19328,22054,"LG 224 L 4 Star Inverter Direct-Cool Single Door Refrigerator (GL-D241ASCY, Scarlet Charm, Base stand with Drawer, Total c...",Warehouse C,33,17,2025-02-13 09:05:00,16
19328,ORD_19329,29853,Marktus AM Syrup,Warehouse B,62,43,2025-02-13 20:34:00,19
19329,ORD_19330,29657,"Selfie Stick, All in One Professional 63'' Selfie Stick with Large Reinforced Tripod Stand, Bluetooth Selfie Stick with Wi...",Warehouse B,53,44,2025-02-13 17:19:00,9
19330,ORD_19331,36050,NOTE MINERAL FOUNDATION 403 -35ML 35 ml,Warehouse A,45,26,2025-02-13 09:59:00,19
19331,ORD_19332,32109,TheGiftKart Tough Armor Bumper Back Cover Case for Redmi 10A / 10A Sport | Ring Holder & Kickstand in-Built | 360 Degree P...,Warehouse A,15,10,2025-02-13 09:28:00,5
19332,ORD_19333,29751,Retrax 500mg Injection,Warehouse A,57,41,2025-02-13 09:04:00,16
19333,ORD_19334,36156,Sanitary Pads-Secure Dry XL With Wings,Warehouse A,61,52,2025-02-13 21:08:00,9
19334,ORD_19335,14000,Esredep 10mg Tablet,Warehouse A,71,61,2025-02-13 13:47:00,10
19335,ORD_19336,24252,SWAPKART Spiral Charger Cable Protector Data Cable Saver Charging Cord Protective Cable Cover Headphone MacBook Laptop Ear...,Warehouse B,51,34,2025-02-13 01:12:00,17
19336,ORD_19337,32089,Jubiglim M4 Forte Tablet PR,Warehouse A,28,15,2025-02-13 07:54:00,13
19337,ORD_19338,22083,Medimade Revitalizing Conditioner With Coconut Milk 300 ml,Warehouse B,92,80,2025-02-13 21:09:00,12
19338,ORD_19339,16893,Mixderm G M Cream,Warehouse B,60,53,2025-02-13 06:02:00,7
19339,ORD_19340,18261,"LUNAGARIYA®, Protective Cover for LG AC Remote Control -1,PU Leather Cover Holder (Before Placing Order,Please Check The P...",Warehouse A,13,7,2025-02-13 04:19:00,6
19340,ORD_19341,14119,Cetriliv M Tablet,Warehouse C,12,1,2025-02-13 18:47:00,11
19341,ORD_19342,14064,9 to 5 Flawless Matte Complexion Compact,Warehouse A,18,8,2025-02-13 11:44:00,10
19342,ORD_19343,32152,"Blue Heaven Intense Matte Lipstick, Chocolate Swirl,307, 4 gm",Warehouse B,70,59,2025-02-13 16:44:00,11
19343,ORD_19344,31993,"Pampers All round Protection Pants, Medium size baby diapers (MD) 152 Count, Anti Rash diapers, Lotion with Aloe Vera",Warehouse A,60,42,2025-02-13 22:58:00,18
19344,ORD_19345,29537,THANU'S CRAFT Multicolor Bindi Book Mini Small size Bindis Kumkum Forehead sticker Tikli Multi bindi booklet for Girls (94...,Warehouse C,72,60,2025-02-13 00:19:00,12
19345,ORD_19346,24238,MB Herbals Activated Coconut Shell Charcoal Powder 100 gram | Ultrafine | Used for formulation for face packs & soaps,Warehouse C,95,89,2025-02-13 21:58:00,6
19346,ORD_19347,31484,"theBalm Meet Matte Hughes Long Lasting Liquid Lipstick, Sincere, 7.4ml",Warehouse A,18,11,2025-02-13 15:00:00,7
19347,ORD_19348,30941,Riatech 3.5mm Audio Jack To Headphone Microphone Splitter Converter Adaptor (Specially Design For Mobile And Tablet Only),Warehouse C,79,64,2025-02-13 22:19:00,15
19348,ORD_19349,32610,Aptimust Oral Drops,Warehouse B,47,32,2025-02-13 20:31:00,15
19349,ORD_19350,31638,boAt Bass Heads 225 in-Ear Wired Headphones with Mic (Forest Green),Warehouse B,72,64,2025-02-13 11:04:00,8
19350,ORD_19351,13761,Beauty People Sundowner Stunner Shadow Palette - 16 Colors Sundowner Stunner 18 gm,Warehouse C,20,12,2025-02-13 14:04:00,8
19351,ORD_19352,30499,Dynotrek Vostro 13-13.3 Inch Laptop Sleeve Case Cover Pouch with Handle Compatible for MacBook Pro ThinkPad Tablet Chromeb...,Warehouse B,54,48,2025-02-13 21:28:00,6
19352,ORD_19353,17200,"Zipline Synthetic Leather Executive SMALL messenger bag for upto 13"" Laptop/Tablet for men women with multiple compartment...",Warehouse C,22,15,2025-02-13 18:37:00,7
19353,ORD_19354,17910,Krosimo-D Capsule SR,Warehouse C,38,19,2025-02-13 13:01:00,19
19354,ORD_19355,36528,Coxiblu 120mg Tablet,Warehouse A,103,87,2025-02-13 03:11:00,16
19355,ORD_19356,22477,Fixset 200 DT Tablet,Warehouse B,81,73,2025-02-13 05:46:00,8
19356,ORD_19357,17915,The Cozy Couch - Techbooth latest & trending Adjustable Multi-Angle Laptop stand with Detachable mouse pad - inbuilt Mobil...,Warehouse B,22,3,2025-02-13 09:53:00,19
19357,ORD_19358,22476,Insight Cosmetics Instant Glow Liquid Illuminator - Rose Gold 18 ml,Warehouse C,30,23,2025-02-13 19:26:00,7
19358,ORD_19359,22469,"Fashion Colour Nude Makeover 2 In 1 Face Powder, Shade 03 20 gm",Warehouse A,83,74,2025-02-13 08:31:00,9
19359,ORD_19360,17256,Coxking Plus 60mg/325mg Tablet,Warehouse B,40,32,2025-02-13 18:29:00,8
19360,ORD_19361,36494,SUGAR Cosmetics Contour De Force Mini Bronzer - 03 Caramel Captain (Chestnut Brown) 4 gm,Warehouse C,18,7,2025-02-13 11:10:00,11
19361,ORD_19362,13764,Sounce Mi Band 3 / 3i USB Adapter Power Charger Charging Cable Dock Charger Compatible for Xiaomi Mi Band 3 /3i Smart Brac...,Warehouse B,28,20,2025-02-13 18:55:00,8
19362,ORD_19363,23798,CROSSVOLT Tough Rugged Cover Case Compatible with Airpod 3rd Gen(2021),Warehouse B,93,88,2025-02-13 10:40:00,5
19363,ORD_19364,30387,Nomarks - Ayurvedic Antimarks Facewash For Oily Skin,Warehouse B,70,60,2025-02-13 10:07:00,10
19364,ORD_19365,22421,Baby Oil,Warehouse A,45,37,2025-02-13 20:19:00,8
19365,ORD_19366,23809,EREBEX Temporary Tattoo For Girls Men Women 3D Hand Sticker Size 19x12CM - 1PC,Warehouse C,56,45,2025-02-13 23:58:00,11
19366,ORD_19367,30380,Duvabel 10mg Tablet,Warehouse C,31,17,2025-02-13 19:08:00,14
19367,ORD_19368,17147,Chambor Gel Effectnail Lacquer Bling It On - 0318 30 ml,Warehouse C,22,9,2025-02-13 03:35:00,13
19368,ORD_19369,30508,"Maybelline New York Hypercurl Mascara, Curls Lashes, Highly Pigmented Colour, Long-lasting, Washable, Black 9.2ml",Warehouse B,98,83,2025-02-13 20:38:00,15
19369,ORD_19370,36547,Cetrizen M 2.5mg/5mg Tablet,Warehouse B,48,30,2025-02-13 12:31:00,18
19370,ORD_19371,30511,Fashion Colour Primer + Concealer 2 In 1 8.8 gm,Warehouse A,39,21,2025-02-13 22:08:00,18
19371,ORD_19372,30519,"Tukzer 3.5"" LED Selfie Ring Light with Phone Holder |Flexible Arm Desk Mount Clamp for Live Stream, Makeup, Online Meeting...",Warehouse C,65,59,2025-02-13 11:28:00,6
19372,ORD_19373,23655,"ASUS TUF Gaming VP5700 46.14 cm Backpack (Black), with Water Repellent Fabric, Suitable for up to 43.18 cm Laptop",Warehouse A,31,25,2025-02-13 11:14:00,6
19373,ORD_19374,22558,Torimate 50 Tablet,Warehouse C,46,36,2025-02-13 18:38:00,10
19374,ORD_19375,22557,"OFFENBERG Foldable Laptop Table with Cup Holder, Study Table, Bed Table, Breakfast Table, Foldable & Portable.->> (Wood)",Warehouse C,86,81,2025-02-13 00:02:00,5
19375,ORD_19376,31521,Green Tea Pack - Insta Radiance,Warehouse A,14,4,2025-02-13 10:26:00,10
19376,ORD_19377,18482,Pentel Mechanical Pencil Graphgear500 - 0.5mm - PG515,Warehouse A,28,9,2025-02-13 09:49:00,19
19377,ORD_19378,15070,Ulcipil 20mg Tablet,Warehouse A,52,42,2025-02-13 18:35:00,10
19378,ORD_19379,30957,"De-Tangling Comb - 1 Row, 1266",Warehouse B,52,36,2025-02-13 21:18:00,16
19379,ORD_19380,27741,Oxydex Tablet,Warehouse A,62,56,2025-02-13 02:29:00,6
19380,ORD_19381,20638,Retcil 5mg Tablet,Warehouse B,59,45,2025-02-13 01:39:00,14
19381,ORD_19382,15138,COLORESSENCE AQUA MAKEUP BASE - Ivory,Warehouse B,66,55,2025-02-13 03:05:00,11
19382,ORD_19383,20636,EDP 2,Warehouse B,59,46,2025-02-13 10:05:00,13
19383,ORD_19384,34539,"Layer'r Wottagirl Classic Collection Fantasy Fragrant Body Splash, 135ml",Warehouse A,60,51,2025-02-13 00:23:00,9
19384,ORD_19385,27623,SGJET 4 Universal Socket 3 Switch Multi Plug Extension Board/Extension Cord,Warehouse B,69,54,2025-02-13 17:51:00,15
19385,ORD_19386,20608,"Famous Quality® SD Card Reader, 3-in-1 USB 3.0, USB C, Micro USB Card Reader SD, Micro SDHC, Micro SDXC Memory Card Reader...",Warehouse C,69,61,2025-02-13 13:31:00,8
19386,ORD_19387,26142,Yves Rocher Relaxing Body Lotion Olive Petit Grain 200 ml,Warehouse C,61,50,2025-02-13 13:17:00,11
19387,ORD_19388,34668,Emmevoiz P 10mg/10mg/2.5mg Tablet,Warehouse B,104,96,2025-02-13 13:42:00,8
19388,ORD_19389,26118,"Maybelline New York Baby Lips Color Changing Lip Balm, Peach Bloom 1.8 Gm",Warehouse B,13,4,2025-02-13 17:20:00,9
19389,ORD_19390,34711,"Lotus Makeup Natural Kajal, Black, 4g (2LO0181)",Warehouse C,80,71,2025-02-13 20:43:00,9
19390,ORD_19391,25979,Activ Beaute Brightening Rich Night Cream 25 gm,Warehouse B,65,52,2025-02-13 15:21:00,13
19391,ORD_19392,15951,Hemont L 5mg/10mg Tablet,Warehouse C,68,55,2025-02-13 12:39:00,13
19392,ORD_19393,34748,"OnePlus Nord CE 2 Lite 5G (Blue Tide, 8GB RAM, 128GB Storage)",Warehouse B,69,54,2025-02-13 13:27:00,15
19393,ORD_19394,19541,mCaffeine Naked & Raw Moisturizing Coffee Body Lotion 200 ml,Warehouse A,81,73,2025-02-13 13:27:00,8
19394,ORD_19395,15934,"Boult Audio Bass Buds Q2 Lightweight Stereo Wired Over Ear Headphones Set with Mic with Deep Bass, Comfortable Ear Cushion...",Warehouse B,27,9,2025-02-13 09:05:00,18
19395,ORD_19396,15036,Adnim P 50mg/125mg Suspension,Warehouse B,48,39,2025-02-13 12:04:00,9
19396,ORD_19397,20813,"AmazonBasics Extension Board with 4 Sockets, 6A, 1.5m ISI Certified Cable, Individual Switch, 240 Volt, Grey",Warehouse C,103,86,2025-02-13 18:37:00,17
19397,ORD_19398,33373,Shvit Cold-AF Syrup,Warehouse B,92,76,2025-02-13 14:59:00,16
19398,ORD_19399,33380,Stbotanica Anti Oxidant Boost Over Night Mask 50 gm,Warehouse A,80,69,2025-02-13 05:58:00,11
19399,ORD_19400,15903,TheGiftKart Ultra-Hybrid Crystal Clear Back Case Cover for iPhone 14 PRO Back Cover Case | Slim Fit Shockproof Design | Ca...,Warehouse B,91,80,2025-02-13 01:09:00,11
19400,ORD_19401,15899,Fine Par-DS Oral Suspension,Warehouse B,38,27,2025-02-13 20:11:00,11
19401,ORD_19402,33408,Fayozen 1000mg Injection,Warehouse C,20,4,2025-02-13 23:50:00,16
19402,ORD_19403,26058,Comb - Lice & Nit,Warehouse C,28,18,2025-02-13 01:49:00,10
19403,ORD_19404,26060,Azinis 500mg Tablet,Warehouse B,37,20,2025-02-13 07:37:00,17
19404,ORD_19405,26094,"Cosmic Byte CB-EP-06 in-Ear Earphones with Inbuilt and Detachable Dual Microphone, Lightweight, Hi-Fidelity Drivers (Blac...",Warehouse A,66,55,2025-02-13 17:11:00,11
19405,ORD_19406,33416,Blown EC 0.5mg/10mg Tablet,Warehouse A,50,33,2025-02-13 17:23:00,17
19406,ORD_19407,17830,boAt Stone 200 3W Portable Bluetooth Speakers (Black),Warehouse C,108,91,2025-02-13 09:50:00,17
19407,ORD_19408,23662,Hasayan Rose Body Wash,Warehouse B,46,31,2025-02-13 21:53:00,15
19408,ORD_19409,17831,Organics - SoyaÂ RichÂ TripleÂ ActionÂ Conditiner,Warehouse C,83,67,2025-02-13 19:19:00,16
19409,ORD_19410,23664,Eternally Hot For Women,Warehouse C,40,24,2025-02-13 15:19:00,16
19410,ORD_19411,22274,Wecool BT1 ENC Earbuds with Magnetic Charging Case IPX5 Wireless Earphones with Digital Battery Indicator for Crisp Sound ...,Warehouse C,38,26,2025-02-13 18:55:00,12
19411,ORD_19412,31705,Color Naturals Creme Riche Ultra Hair Color - Raspberry Red,Warehouse A,26,13,2025-02-13 16:48:00,13
19412,ORD_19413,31722,Ds-Lini Gel,Warehouse A,100,93,2025-02-13 04:08:00,7
19413,ORD_19414,36437,Palette Intensive Colour Cream Long Lasting Intensity 9-0 Extra Light Blonde,Warehouse B,57,41,2025-02-13 15:33:00,16
19414,ORD_19415,22354,Tea Tree Face Toner,Warehouse C,92,73,2025-02-13 22:47:00,19
19415,ORD_19416,30328,Amitral 500mg Injection,Warehouse A,36,24,2025-02-13 20:34:00,12
19416,ORD_19417,30311,Azyzoc 250mg Tablet,Warehouse C,54,41,2025-02-13 17:33:00,13
19417,ORD_19418,30310,"URBN 10000 mAh Lithium_Polymer 22.5W Super Fast Charging Ultra Compact Power Bank with Quick Charge & Power Delivery, Type...",Warehouse C,53,46,2025-02-13 08:16:00,7
19418,ORD_19419,36404,Arias by Lara Dutta Exfoliating Face Scrub - Pumpkin seed Oil & Walnut Shell 100 gm,Warehouse C,51,37,2025-02-13 12:24:00,14
19419,ORD_19420,30303,Telmlet AM 40mg/5mg Tablet,Warehouse A,107,96,2025-02-13 14:37:00,11
19420,ORD_19421,36387,"Samsung Galaxy Watch4 Classic LTE (4.6cm, Black)",Warehouse C,73,56,2025-02-13 12:52:00,17
19421,ORD_19422,31759,Vellflox 200mg Tablet,Warehouse B,114,95,2025-02-13 12:38:00,19
19422,ORD_19423,31763,Nature's Essence Glowing Gold Facial Kit 60 gm,Warehouse A,64,55,2025-02-13 09:01:00,9
19423,ORD_19424,30265,Rabedrus LS 75mg/20mg Capsule,Warehouse C,67,55,2025-02-13 20:51:00,12
19424,ORD_19425,18092,B-Lanso 30mg Capsule,Warehouse C,31,22,2025-02-13 08:19:00,9
19425,ORD_19426,18095,"Maybelline New York Baby Lips Lip Balm, Pink Lolita 4 gm",Warehouse C,43,30,2025-02-13 17:29:00,13
19426,ORD_19427,36333,Brispam 0.25mg Tablet MD,Warehouse C,21,3,2025-02-13 18:11:00,18
19427,ORD_19428,17810,Spigen Ultra Hybrid Back Cover Case Compatible with iPhone 14 Pro max (TPU + Poly Carbonate | Crystal Clear),Warehouse A,98,89,2025-02-13 21:59:00,9
19428,ORD_19429,22151,Bella Voste Gold-Foil Nail Paints Shade 331 10 Ml,Warehouse A,57,52,2025-02-13 17:26:00,5
19429,ORD_19430,13447,Verozin 15mg/20mg Tablet,Warehouse B,108,99,2025-02-13 08:27:00,9
19430,ORD_19431,23126,Cello Signature Origin Ball Pen | Premium Metal Ball Pen | Pack of 1 | Ball Pen Blue | Easy Twist Mechanism |Best Pen for ...,Warehouse C,81,63,2025-02-13 16:33:00,18
19431,ORD_19432,30974,Zifcef SB 250mg/125mg Injection,Warehouse B,28,17,2025-02-13 02:42:00,11
19432,ORD_19433,23128,Hydrocet 5mg Tablet,Warehouse A,100,86,2025-02-13 09:56:00,14
19433,ORD_19434,31181,Beauty People Sheer Color Lipstick - Just - Natural - 404 3.8 gm,Warehouse B,113,97,2025-02-13 11:41:00,16
19434,ORD_19435,31186,"Elv FPStyli-2Gen-JETBLKIN Fine Point 2nd Gen Stainless Steel Stylus Pen for Tablets, Smartphones, Amazon Kindle (Jet Black)",Warehouse A,97,82,2025-02-13 01:27:00,15
19435,ORD_19436,17431,Cefom 250mg Tablet,Warehouse C,109,99,2025-02-13 14:56:00,10
19436,ORD_19437,30203,Volkpod Dry Syrup,Warehouse A,42,37,2025-02-13 13:06:00,5
19437,ORD_19438,24139,"SKYVIK Signi Pro 2 in 1 (Wide+Macro) Clip on Mobile Camera Lens Kit for iPhone, Samsung and Other Smartphones.",Warehouse C,94,81,2025-02-13 02:11:00,13
19438,ORD_19439,30201,Macox 300mg Capsule,Warehouse C,26,7,2025-02-13 05:58:00,19
19439,ORD_19440,17246,HIFFIN E27 Studio Single Holder Umbrella Lighting Kit for Photography Umbrella White + Studio Light Stand 9 FT + Umbrella ...,Warehouse C,50,34,2025-02-13 11:26:00,16
19440,ORD_19441,13693,Designerz hub Back Cover for Samsung Galaxy M21/M21 2021 Edition/M30s (Silicone | Black),Warehouse C,93,74,2025-02-13 17:57:00,19
19441,ORD_19442,30547,"Rapidotzz Band Straps - 3 Pcs (Unisex) | Removable Straps ONLY for Amazfit Huami Bip, Amazfit Bip Lite, Noise, Firebolt, b...",Warehouse B,85,78,2025-02-13 21:58:00,7
19442,ORD_19443,36676,bArrett USB Fast Charger 2.4Amp for Samsung Galaxy J1/J2/J3/J4/J5/J6/J7/A3/A4/A5/A6+/A7/A8/A9/On 5/On 6/On 7/ On 8 Prime P...,Warehouse A,62,43,2025-02-13 11:45:00,19
19443,ORD_19444,22527,Amlogift 5mg Tablet,Warehouse A,70,57,2025-02-13 07:15:00,13
19444,ORD_19445,30534,HASMI SURMI kajal,Warehouse C,38,22,2025-02-13 22:42:00,16
19445,ORD_19446,17220,TP-link 300Mbps Wireless N Speed N300 TL-WR840N Wi-Fi Single Band Router | Access Point Mode | Range Extender mode | WISP ...,Warehouse A,98,81,2025-02-13 13:27:00,17
19446,ORD_19447,23741,Rhinobest M Syrup,Warehouse C,48,36,2025-02-13 10:53:00,12
19447,ORD_19448,18020,Medcart 6mg Oral Suspension,Warehouse C,60,55,2025-02-13 21:53:00,5
19448,ORD_19449,23839,"Fashion Colour Non - Transfer Matt Waterproof Lipstick, 70 Chili 2.6 gm",Warehouse C,33,16,2025-02-13 08:35:00,17
19449,ORD_19450,23842,"boAt Stone 250 Portable Wireless Speaker with 5W RMS Immersive Audio, RGB LEDs, Up to 8HRS Playtime, IPX7 Water Resistanc...",Warehouse C,59,48,2025-02-13 18:09:00,11
19450,ORD_19451,17048,Klox 500mg Capsule,Warehouse B,9,1,2025-02-13 18:46:00,8
19451,ORD_19452,30168,Monzer LC 5mg/10mg Tablet,Warehouse C,40,28,2025-02-13 15:20:00,12
19452,ORD_19453,29942,"ProElite Deer Flip case Cover for Realme Pad X 11 inch Tablet, Wine Red",Warehouse B,79,60,2025-02-13 10:59:00,19
19453,ORD_19454,24044,"Nycil Neem and Pudina Prickly Heat Powder - 150 g (Cool Herbal, Free Nycil Cool Herbal 50gm Worth Rupees 40)",Warehouse B,56,45,2025-02-13 20:31:00,11
19454,ORD_19455,18176,"Parker Vector Standard Roller Ball Pen and Ball Pen - Blue Body, 2 Count (Pack of 1) (9000017309)",Warehouse A,73,67,2025-02-13 02:45:00,6
19455,ORD_19456,31869,Tel-Cad 80 Tablet,Warehouse A,40,24,2025-02-13 02:35:00,16
19456,ORD_19457,24083,Esam LT 50 mg/2.5 mg Tablet,Warehouse A,105,92,2025-02-13 12:45:00,13
19457,ORD_19458,36288,Cefatax 1000mg Injection,Warehouse A,73,64,2025-02-13 03:36:00,9
19458,ORD_19459,24090,Glimigen-MV1 Tablet,Warehouse B,15,1,2025-02-13 06:59:00,14
19459,ORD_19460,36281,"AmazonBasics laptopsss Sleeve Case Cover Pouch 15.6-inches laptopss for Men and Women | Slim Profile Neoprene, Soft Puffy ...",Warehouse B,57,51,2025-02-13 18:09:00,6
19460,ORD_19461,24102,Ajmal Zeal EDP Aquatic Woody Perfume And Evoke Silver Edition Him Deodorant Spicy Floral Fragrance 300 ml,Warehouse C,41,28,2025-02-13 12:18:00,13
19461,ORD_19462,36280,"S.A.V.I Full Arm Hand Temporary Tattoo For Men Girls Women Sticker Size 48x17cm - 1pc. (24), Multicolor, 7 g",Warehouse A,53,35,2025-02-13 18:45:00,18
19462,ORD_19463,22196,Ajmal Wisal & Wisal Dhahab & Sacred Love & Silver Shade Deo & Aretha EDP Pack of 5 820 ml,Warehouse A,73,61,2025-02-13 09:27:00,12
19463,ORD_19464,16982,Godrej Magic Ready-To-Mix Body Wash Combi Pack | Lavender Fragrance | Makes 200ml | 1 Empty Bottle & 1 Refill,Warehouse B,56,37,2025-02-13 18:15:00,19
19464,ORD_19465,30002,Lactiol Syrup,Warehouse A,88,73,2025-02-13 22:49:00,15
19465,ORD_19466,29153,HyperX Cloud Stinger Wired Over Ear Gamming Headphones with Mic Black,Warehouse C,55,48,2025-02-13 12:58:00,7
19466,ORD_19467,25187,Anabel-CT Gel,Warehouse B,71,57,2025-02-13 15:55:00,14
19467,ORD_19468,32344,Nimucil 50mg Suspension,Warehouse B,80,71,2025-02-13 04:17:00,9
19468,ORD_19469,4677,Levoz 500mg Tablet,Warehouse B,55,45,2025-02-13 01:23:00,10
19469,ORD_19470,9953,TP-Link Archer AX23 AX1800 Dual-Band Wi-Fi 6 Router (1800 Mbps Speed Gigabit Wireless | Beamforming OFDMA | Next-Gen Platf...,Warehouse A,44,38,2025-02-13 04:58:00,6
19470,ORD_19471,9090,Simzopox 400mg Tablet,Warehouse B,55,45,2025-02-13 09:34:00,10
19471,ORD_19472,883,iPhone Original 20W PD2.0 Charger with 6 Months Warranty Fast Certified Type-C Charger Adapter Compatible for Apple iPhone...,Warehouse C,65,48,2025-02-13 07:13:00,17
19472,ORD_19473,10611,Kast-L Syrup,Warehouse A,72,67,2025-02-13 13:01:00,5
19473,ORD_19474,219,Abhayarishta,Warehouse C,45,35,2025-02-13 11:32:00,10
19474,ORD_19475,7935,Action Pro Adjustable Chest Harness Strap Mount Phone Holder J Hook Quick Conversion Block Head Adapter Long Thumb Screw C...,Warehouse B,84,76,2025-02-13 00:09:00,8
19475,ORD_19476,8482,Beauty People Velvet Matte Nail Polish Matte - Me - Plum - 1003 9.9 ml,Warehouse C,42,36,2025-02-13 20:45:00,6
19476,ORD_19477,8529,Ajmal Avid & Blu Deo & Prose EDP Pack of 3 20 ml,Warehouse C,49,43,2025-02-13 04:37:00,6
19477,ORD_19478,3646,AmigozZ Compressed Facial Face mask tablets DIY Facial Paper Spa Skin Care - Pack of 50 pcs,Warehouse A,93,76,2025-02-13 13:18:00,17
19478,ORD_19479,4711,MYVN Warp charging cable compatible for OnePlus 7 Pro / 7T / 7T Pro and Dash charge for OnePlus 3 / 3T / 5 / 5T / 6 / 6T / 7,Warehouse A,105,87,2025-02-13 16:42:00,18
19479,ORD_19480,8475,Faber-Castell Fine Textliner - Pack of 5 (Assorted),Warehouse C,90,77,2025-02-13 01:53:00,13
19480,ORD_19481,78,"Sounce Earphone Case Cover Compatible with Boat Airdopes 131, Soft Silicone Skin Case Cover Shock-Absorbing Protective Cas...",Warehouse C,25,7,2025-02-13 07:57:00,18
19481,ORD_19482,7950,"PunnkFunnk D116 Fitness Smart Band Activity Tracker Smartwatch with Sleep Monitor, Step Tracking, Heart Rate Sensor for Me...",Warehouse B,89,75,2025-02-13 02:41:00,14
19482,ORD_19483,5957,"DEVEDITZ TYA 6155 MAKEUP KIT(1),HELLO KITTY MAKEUP BRUSH SET PINK(1), BLENDER PUFF(2), EYELINER(1), 5 IN1 LIPSTICK(1) PACK...",Warehouse A,66,53,2025-02-13 11:11:00,13
19483,ORD_19484,12462,Inoxate 200mg Tablet,Warehouse C,39,25,2025-02-13 00:09:00,14
19484,ORD_19485,7955,Plum Chamomile & White Tea Skin Revival Face Wash 75 ml,Warehouse A,45,37,2025-02-13 04:50:00,8
19485,ORD_19486,9980,Evomate 60mg Tablet,Warehouse B,83,70,2025-02-13 20:35:00,13
19486,ORD_19487,906,AmazonBasics 3 Feet High Speed HDMI Male to Female 2.0 Extension Cable,Warehouse A,36,21,2025-02-13 15:35:00,15
19487,ORD_19488,5036,Lakme Color Crush Nail Art F4 6 Ml,Warehouse A,89,72,2025-02-13 02:42:00,17
19488,ORD_19489,909,"Medimix Ayurvedic Brightening Body Lotion for All Skin Types, with Lavender, Almond Milk and Kumkumadi Oil, Unisex, Vegan,...",Warehouse A,63,49,2025-02-13 14:13:00,14
19489,ORD_19490,6257,Odedom 10mg/20mg Capsule,Warehouse C,32,13,2025-02-13 17:03:00,19
19490,ORD_19491,3080,"TP-Link Archer C60 AC1350 Dual Band Wireless, Wi-Fi Speed Up to 867 Mbps/5 GHz + 450 Mbps/2.4 GHz, Supports Parental Contr...",Warehouse A,34,19,2025-02-13 08:49:00,15
19491,ORD_19492,7803,"SOOPII ""Grade-A Quality DM01 Pro Dual Support Desktop Mobile Phone + Tablet Tabletop Stand, Mobile Holder, Adjustable & Fo...",Warehouse C,35,27,2025-02-13 18:05:00,8
19492,ORD_19493,12608,"ZEBRONICS AC32FHD LED Curved 75Hz 80Cm (32"") (81.28 Cm) 1920x1080 Pixels FHD Resolution Monitor with HDMI + VGA Dual Inpu...",Warehouse B,92,87,2025-02-13 16:41:00,5
19493,ORD_19494,7808,Ajmal Jannatul Firdaus & Majmuah Of CP & Aretha EDP Pack of 3 20 ml,Warehouse B,98,86,2025-02-13 06:31:00,12
19494,ORD_19495,5119,Nuvas F 160mg/10mg Tablet,Warehouse A,77,70,2025-02-13 09:13:00,7
19495,ORD_19496,9887,Moxer 500 Capsule,Warehouse A,111,99,2025-02-13 02:09:00,12
19496,ORD_19497,216,Rosuast Gold 75mg/10mg/75mg Capsule,Warehouse B,39,29,2025-02-13 16:08:00,10
19497,ORD_19498,6255,"ZEBRONICS DC Aquaman Edition Sound Bomb 7 TWS Earbuds with 40H* Backup, Rapid Charge, 50ms Gaming Mode, ENC mic, Voice Ass...",Warehouse C,26,17,2025-02-13 20:19:00,9
19498,ORD_19499,10776,Orange Essential Oil - 100% Pure & Natural,Warehouse A,99,80,2025-02-13 05:10:00,19
19499,ORD_19500,10660,"Squalo BassPlugs 151 Wireless in Ear Bluetooth Neckband with Mic, 30 Hours Playtime, IPX5 Water & Sweat Resistant,Type-C C...",Warehouse C,18,7,2025-02-13 09:00:00,11
19500,ORD_19501,7048,Lakme 9 To 5 Complexion Care Cc Cream Almond 30 Gm,Warehouse A,105,88,2025-02-13 05:31:00,17
19501,ORD_19502,9412,Chymosin Forte Tablet,Warehouse C,62,50,2025-02-13 08:48:00,12
19502,ORD_19503,9316,"Maybelline New York Lipstick, Matte Finish, Non-Sticky and Non-Drying, Sensational Liquid Matte, 21 Nude Nuance, 7ml",Warehouse A,55,39,2025-02-13 15:02:00,16
19503,ORD_19504,2963,"SWAPKART Fast Charging Cable and Data Sync USB Cable Compatible for iPhone 6/6S/7/7+/8/8+/10/11, 12, 13 Pro max iPad Air/M...",Warehouse B,97,90,2025-02-13 16:10:00,7
19504,ORD_19505,5648,Faber-Castell Kinder Scissors(Assorted),Warehouse C,29,22,2025-02-13 09:20:00,7
19505,ORD_19506,9200,SaleOn Water Resistance Portable Gadget Organizer Case Bag Pouch with Zipper Lock Bag for Travel Electric Gadget for Cable...,Warehouse B,89,78,2025-02-13 08:16:00,11
19506,ORD_19507,6578,"ZEBRONICS ZEB-JUKE BAR 7400 PRO 5.1 channel soundbar with 6.5” subwoofer, 180W RMS, Dual rear satellites, HDMI (ARC), Opti...",Warehouse A,39,21,2025-02-13 16:53:00,18
19507,ORD_19508,11573,"FORFOR® Intense Matte Lipstick Waterproof Long Last Matte Lipstick (Pack of 3, Blossom Pink, Highlight Nude, Red Wave)",Warehouse A,59,45,2025-02-13 14:48:00,14
19508,ORD_19509,6976,Ajmal 2 Wisal Dhahab Deo & Prose EDP Pack of 3 20 ml,Warehouse B,68,58,2025-02-13 08:32:00,10
19509,ORD_19510,9363,Age Miracle Eye Cream,Warehouse B,51,44,2025-02-13 22:56:00,7
19510,ORD_19511,8913,Dothic 25mg Tablet,Warehouse A,65,47,2025-02-13 14:36:00,18
19511,ORD_19512,12158,"Zebronics ZEB-BT701RUCF Wireless Bluetooth Multimedia Speaker With Supporting AC3 Audio, SD Card, USB, AUX, FM & Remote Co...",Warehouse C,82,66,2025-02-13 01:39:00,16
19512,ORD_19513,9263,Vitacomf Plus Injection,Warehouse C,17,7,2025-02-13 16:18:00,10
19513,ORD_19514,7266,"NOYMI True Wireless Bluetooth 5.1 in Ear Earbuds with Mic, 30 Hours Playtime, Bluetooth Earphones with 13MM Drivers,IPX4 R...",Warehouse A,32,23,2025-02-13 03:21:00,9
19514,ORD_19515,7268,Parker Frontier Stainless Steel GT Roller Ball Pen,Warehouse A,100,85,2025-02-13 03:07:00,15
19515,ORD_19516,502,"Safari Quill Laptop Backpack 26 Ltrs Water Resistant Fabric - Black, L (QUILL19CBBLK)",Warehouse A,68,54,2025-02-13 21:21:00,14
19516,ORD_19517,9380,Cefamid 1000mg Injection,Warehouse C,66,59,2025-02-13 06:05:00,7
19517,ORD_19518,5667,Herbal Green Tea Soap,Warehouse C,32,25,2025-02-13 23:40:00,7
19518,ORD_19519,12860,Sat Isabgol,Warehouse C,105,93,2025-02-13 19:41:00,12
19519,ORD_19520,12103,"Post-it Super Sticky Notes, 2X Sticking Power, 3 in x 3 in, 5 Pads/Pack, 90 Sheets/Pad (neon Colour)",Warehouse B,26,17,2025-02-13 23:19:00,9
19520,ORD_19521,4037,"Zebronics Companion 110 Wireless Keyboard and Mouse Set with Bluetooth multiconnect, 2.4GHz Receiver, 2 Months* Backup, 16...",Warehouse A,52,45,2025-02-13 02:41:00,7
19521,ORD_19522,12159,"ARCTIC MX-4 (incl. Spatula, 4 g) - Premium Performance Thermal Paste for All Processors (CPU, GPU - PC, PS4, Xbox), Very h...",Warehouse C,23,10,2025-02-13 15:08:00,13
19522,ORD_19523,1634,Lakme Perfect Radiance Compact Golden sand 03 8 Gm,Warehouse B,37,26,2025-02-13 11:14:00,11
19523,ORD_19524,3855,"BenQ Gw2485Tc 24 Inch (60.6 Cm) 1920 x 1080 Pixels, Fhd IPS Monitor, USB Type-C, Coding Mode, Noise Cancellation Mic, Ultr...",Warehouse B,107,89,2025-02-13 23:59:00,18
19524,ORD_19525,4706,Peranu 650mg Tablet,Warehouse C,65,60,2025-02-13 06:29:00,5
19525,ORD_19526,3768,"MATTSPY Smart Watches ID116 Bluetooth Smart Wireless Fitness Band for Boys, Girls, Men, Women & Kids | Sports Gym Watch fo...",Warehouse A,39,20,2025-02-13 01:19:00,19
19526,ORD_19527,6307,Capirab L 75mg/20mg Capsule SR,Warehouse B,68,57,2025-02-13 15:42:00,11
19527,ORD_19528,12152,"Stbotanica Vitamin C, E & Hyaluronic Acid Brightening Eye Mask, Nourishes, Brightens & Hydrates Under Eye 30 gm",Warehouse B,94,83,2025-02-13 03:17:00,11
19528,ORD_19529,8274,Bare Anatomy Dandruff Remover Hair Tonic | Dandruff Reduction Upto 100% in 30 Days | Scalp Sebum Reduction by 90% In 15 Da...,Warehouse C,82,77,2025-02-13 16:56:00,5
19529,ORD_19530,8272,VLCC Natural Sciences Pro Radiance D-White Complex Brightening Face Wash 100 ml,Warehouse C,40,28,2025-02-13 15:44:00,12
19530,ORD_19531,8184,"Makeup Revolution Soph Highlighter Palette, 16g Highly-pigmented Powder Highlighter with Ultra-Finish and Easy-to-blend Fo...",Warehouse A,82,69,2025-02-13 17:23:00,13
19531,ORD_19532,10128,Leafnim P 100mg/325mg Tablet,Warehouse A,20,3,2025-02-13 12:21:00,17
19532,ORD_19533,10524,Oftem 200mg Tablet,Warehouse B,89,73,2025-02-13 04:10:00,16
19533,ORD_19534,10304,"Blaupunkt BTW100 Truly Wireless Bluetooth in Ear Earbuds with Mic, ENC CRISPR TECH I HD Sound I 80ms Low Latency I 40H Pla...",Warehouse B,52,43,2025-02-13 08:38:00,9
19534,ORD_19535,8269,LAIQA Premium Cosyfluff Night Pads (XL) 10's,Warehouse B,29,12,2025-02-13 01:51:00,17
19535,ORD_19536,10294,Tuf Q Tablet,Warehouse B,79,72,2025-02-13 07:37:00,7
19536,ORD_19537,10281,ClubBeauty Home And Salon Use Beard Shaper for Men/Beard Shaper Black Tool kit With Comb,Warehouse B,41,34,2025-02-13 18:43:00,7
19537,ORD_19538,10279,T.O.G. 2 Pieces Transparent Flower Jelly Lipstick Magic Color Temperature Changing Long Lasting Waterproof Lip Stick with ...,Warehouse B,82,71,2025-02-13 16:50:00,11
19538,ORD_19539,4940,Hydrafresh Anti-Shine Gel,Warehouse C,52,44,2025-02-13 03:47:00,8
19539,ORD_19540,10162,K-Win 10mg Injection,Warehouse A,30,13,2025-02-13 05:17:00,17
19540,ORD_19541,8255,Tusli Plus Ras,Warehouse A,98,91,2025-02-13 18:45:00,7
19541,ORD_19542,8245,Citrus Blast Orange Lemon Soap Free Body Wash,Warehouse C,34,15,2025-02-13 12:44:00,19
19542,ORD_19543,1629,Opti Care Smooth Straight Professional Ultra Smoothing Conditioner,Warehouse C,89,72,2025-02-13 05:38:00,17
19543,ORD_19544,10174,SKOFRI 4 Pcs Silicone Spatula Set Small Beauty Spatula Mini Makeup Spatula Silicone Mini Jar Spatula for Makeup Lotion Fou...,Warehouse B,102,96,2025-02-13 19:10:00,6
19544,ORD_19545,4912,Amazeo 50 Tablet,Warehouse C,50,44,2025-02-13 04:01:00,6
19545,ORD_19546,2276,Carloc 6.25 Tablet,Warehouse A,35,23,2025-02-13 01:25:00,12
19546,ORD_19547,6139,Bactofight 500mg/125mg Tablet,Warehouse A,29,19,2025-02-13 19:37:00,10
19547,ORD_19548,4836,Spoxin 200mg Tablet,Warehouse A,91,76,2025-02-13 03:22:00,15
19548,ORD_19549,5023,Respik Plus 3mg Tablet,Warehouse C,83,72,2025-02-13 04:54:00,11
19549,ORD_19550,6194,Allure Professional Facepack Brush-001 1's,Warehouse B,36,30,2025-02-13 19:30:00,6
19550,ORD_19551,8403,"ENVOUS Phone Camera Lens 3 in 1 Phone Lens Kit, 198 Fisheye Lens + 120 Super Wide-Angle Lens + 20x Macro Lens for iPhone S...",Warehouse A,46,41,2025-02-13 01:53:00,5
19551,ORD_19552,8402,Eyetex Dazller Classique Compact Powder- 8005 Sunset 9 gm,Warehouse A,76,59,2025-02-13 01:36:00,17
19552,ORD_19553,10044,Belora Paris Paint & Pout- Lip & Cheek - Peacock Purple 3 ml,Warehouse A,85,77,2025-02-13 06:02:00,8
19553,ORD_19554,10471,Innoxin-OZ Tablet,Warehouse A,49,31,2025-02-13 01:31:00,18
19554,ORD_19555,10464,Cetnez AM 5mg/75mg Tablet,Warehouse A,60,45,2025-02-13 16:13:00,15
19555,ORD_19556,255,MANCODE Charcoal Scrub 100 gm,Warehouse B,84,74,2025-02-13 11:55:00,10
19556,ORD_19557,6014,"Mattlook Face Finity All Day Flowless, Vitamin E Aloe Essence, Meastro Fusion Makeup Foundation, SPF15, Fair (100gm)",Warehouse B,104,95,2025-02-13 06:12:00,9
19557,ORD_19558,10333,Lavender Cleansing Milk,Warehouse A,11,4,2025-02-13 21:40:00,7
19558,ORD_19559,821,NBP 2.5mg Tablet,Warehouse C,30,24,2025-02-13 06:57:00,6
19559,ORD_19560,1610,Sertapox 50mg Tablet,Warehouse B,23,11,2025-02-13 15:56:00,12
19560,ORD_19561,10774,"Nothing Phone (1) 5G (Black, 256 GB) (8 GB RAM)",Warehouse B,15,1,2025-02-13 10:43:00,14
19561,ORD_19562,12611,Nipodin 10mg Tablet,Warehouse A,103,95,2025-02-13 11:42:00,8
19562,ORD_19563,4623,Manish Malhotra Sandalwood Spf 25 Gel 50 Gm,Warehouse C,42,23,2025-02-13 18:24:00,19
19563,ORD_19564,9903,Natadrops,Warehouse A,74,63,2025-02-13 00:08:00,11
19564,ORD_19565,1741,Serecon-D Tablet,Warehouse C,68,56,2025-02-13 06:44:00,12
19565,ORD_19566,8541,"Logitech MK275 USB Wireless Keyboard and Mouse Set for Windows, 2.4 GHz Wireless, Compact Wireless Mouse, 8 Multimedia & S...",Warehouse A,108,93,2025-02-13 05:58:00,15
19566,ORD_19567,7878,"B2B Copier Paper, A4, 70 GSM, 500 Sheet",Warehouse B,12,1,2025-02-13 18:14:00,11
19567,ORD_19568,10729,JONFLOX 50 MG SYRUP,Warehouse B,45,39,2025-02-13 08:50:00,6
19568,ORD_19569,10722,Almond Shampoo - With Almond-Vita Complex & Milk Extracts,Warehouse C,86,68,2025-02-13 10:11:00,18
19569,ORD_19570,4638,Lafz Caffeine Foaming Face Wash With Built - In Face Brush 100 ml,Warehouse A,21,15,2025-02-13 13:24:00,6
19570,ORD_19571,13116,"ForSure® Absolute Shine Liquid Glitter Eyeliner, Intense Color, Long Lasting, Glossy Texture (7 ml each) (Royal Blue)",Warehouse B,72,58,2025-02-13 10:20:00,14
19571,ORD_19572,5918,"Nokia 8210 4G Volte keypad Phone with Dual SIM, Big Display, inbuilt MP3 Player & Wireless FM Radio | Sand",Warehouse B,103,92,2025-02-13 12:15:00,11
19572,ORD_19573,8535,"Maybelline New York Fit Me Mono Blush , 50 Revolution |16 HR Long Lasting Wear",Warehouse B,67,54,2025-02-13 17:50:00,13
19573,ORD_19574,3757,Ajmal Distraction & Nightingale Deo & Aretha EDP Pack of 3 20 ml,Warehouse C,53,47,2025-02-13 19:55:00,6
19574,ORD_19575,1732,Selzone 1000mg Injection,Warehouse B,74,63,2025-02-13 20:35:00,11
19575,ORD_19576,10682,House Of Makeup Nail Lacquer - Gooey Caramel 12 ml,Warehouse A,63,45,2025-02-13 21:32:00,18
19576,ORD_19577,12971,Global Desi SoulT EDP & MagicM Mist Pack of 2 250 ml,Warehouse B,61,53,2025-02-13 09:20:00,8
19577,ORD_19578,10671,Cytula Syrup,Warehouse A,67,54,2025-02-13 16:02:00,13
19578,ORD_19579,10670,"Zebronics 19.5 inch Monitor(49.5CM) with Anti Glare, HD, Slim Design and Wall Mount",Warehouse A,81,75,2025-02-13 14:33:00,6
19579,ORD_19580,6206,"CableCreation USB C to HDMI Cable 4k 6FT HDR, USB Type C to HDMI Cord, Black",Warehouse B,60,51,2025-02-13 17:26:00,9
19580,ORD_19581,910,Pazat D 30mg/40mg Capsule,Warehouse B,91,77,2025-02-13 18:13:00,14
19581,ORD_19582,8408,Terdoxy AB 100mg Capsule,Warehouse C,108,92,2025-02-13 00:22:00,16
19582,ORD_19583,4862,ME-ON Sweet Beauty Compact (Shade 02 - Marble),Warehouse C,68,57,2025-02-13 14:51:00,11
19583,ORD_19584,1662,Daknos SP 50mg/325mg/15mg Tablet,Warehouse B,107,97,2025-02-13 19:28:00,10
19584,ORD_19585,6033,"Amazon Brand - Solimo Fast Charging Braided Micro USB Data Cable, Suitable For All Supported Mobile Phones (2 Meter, Black)",Warehouse A,68,59,2025-02-13 04:02:00,9
19585,ORD_19586,13044,Feron 20mg Injection,Warehouse A,34,19,2025-02-13 21:15:00,15
19586,ORD_19587,8295,Oatmeal & Kokum Butter Smoothing Scrub,Warehouse B,92,87,2025-02-13 08:41:00,5
19587,ORD_19588,4847,Brepenta 40mg Tablet,Warehouse C,70,54,2025-02-13 03:03:00,16
19588,ORD_19589,3706,Nizbro 200mg Tablet SR,Warehouse B,27,12,2025-02-13 22:09:00,15
19589,ORD_19590,11934,Zapcase Back Cover Case Compatible for Mi A2 Cases & Covers (Carbon Fibre Rugged Armour Black Colour),Warehouse C,25,7,2025-02-13 21:34:00,18
19590,ORD_19591,138,SBWC Stylish Slim Lice Narrow Comb Fine Tooth Dust Lice Clean Remove Plastic Lice Hair Combs Perfect For Lice Nits Eggs Bu...,Warehouse A,52,40,2025-02-13 05:02:00,12
19591,ORD_19592,8070,"Tukzer USB C to USB Adapter, Thunderbolt 3/Type-C to USB 3.0 Adapter for Laptops, OTG Adapter for Android Phone (TZ-D2)",Warehouse B,60,42,2025-02-13 12:46:00,18
19592,ORD_19593,7307,Nature Boost Anti Germ Mouthwash,Warehouse B,87,81,2025-02-13 01:54:00,6
19593,ORD_19594,11672,Bio Nut Morning Nectar Scrub 50 Gm,Warehouse B,24,7,2025-02-13 01:33:00,17
19594,ORD_19595,3179,iPhone Fast Charger Original 20W Charger Compatible with Apple iPhone for 13/13 Mini/13Pro/13 Pro Max I-Phone 12/12 Pro/12...,Warehouse A,109,95,2025-02-13 12:54:00,14
19595,ORD_19596,2047,Udilox 150 Tablet,Warehouse B,25,17,2025-02-13 17:37:00,8
19596,ORD_19597,9115,"JioFi Next 32 GB, 2 GB RAM, Blue Smartphone",Warehouse B,51,37,2025-02-13 07:04:00,14
19597,ORD_19598,7093,Antiseptic Liquid 250 ml + Laundry Sanitizer- Fresh Linen 480 ml,Warehouse A,83,74,2025-02-13 01:15:00,9
19598,ORD_19599,3950,Velocid Plus Tablet,Warehouse C,95,78,2025-02-13 16:03:00,17
19599,ORD_19600,5618,"Blaupunkt BTW07 ANC Moksha-30Db Bluetooth Truly Wireless In Ear Earbuds with Mic, Flip Top Rotatory Design, 40H Playtime, ...",Warehouse A,73,67,2025-02-13 03:43:00,6
19600,ORD_19601,1193,Herbal Plus Shampoo,Warehouse C,22,6,2025-02-13 01:09:00,16
19601,ORD_19602,3110,The Natural Wash Intimate Secure Wash With Tea Tree And Sea Buckthorn Oil 100 Ml,Warehouse B,78,71,2025-02-13 10:58:00,7
19602,ORD_19603,5398,Eukof D Syrup,Warehouse A,52,37,2025-02-13 22:15:00,15
19603,ORD_19604,7072,"Talc - Golden Beauty, Moon Drop",Warehouse B,72,64,2025-02-13 09:33:00,8
19604,ORD_19605,11432,"Amazon Brand - Solimo Soft & Flexible Back Cover for Samsung Galaxy Note 20 Mobile [TPU, Transparent]",Warehouse C,46,39,2025-02-13 19:53:00,7
19605,ORD_19606,11422,"pTron Solero T241 2.4A Type-C Data & Charging USB Cable, Made in India, 480Mbps Data Sync, Durable 1-Meter Long USB Cable ...",Warehouse B,38,32,2025-02-13 09:49:00,6
19606,ORD_19607,12238,Berina A2 Dark Brown Hair Color Cream 60 gm,Warehouse A,20,5,2025-02-13 15:18:00,15
19607,ORD_19608,5511,Surakta - For Pimples & Acne-Free Skin,Warehouse A,79,73,2025-02-13 01:14:00,6
19608,ORD_19609,6884,"Hammer Bash 2.0 Over The Ear Wireless Bluetooth Headphones with Mic, Deep Bass, Foldable Headphones, Upto 8 Hours Playtim...",Warehouse A,75,68,2025-02-13 08:28:00,7
19609,ORD_19610,626,"Zebronics Zeb-Sound Bomb N1 True Wireless In Ear Earbuds with ENC, Gaming Mode (up to 50ms), up to 18H Playback, Bluetooth...",Warehouse B,16,2,2025-02-13 13:25:00,14
19610,ORD_19611,12045,Telmimer 40mg Tablet,Warehouse C,59,50,2025-02-13 00:20:00,9
19611,ORD_19612,4282,"DR VAKU® 25W charger travel Adapter with PD 3.0 | 25 watt Type C Fast Charging | BIS Certified, Charger for Samsung Galaxy...",Warehouse B,112,93,2025-02-13 02:11:00,19
19612,ORD_19613,6731,Ultramol RF 650mg Tablet,Warehouse A,102,89,2025-02-13 05:52:00,13
19613,ORD_19614,6720,Spigen Liquid Air Back Cover Case for Samsung Galaxy S22 Ultra (TPU | Matte Black),Warehouse A,92,84,2025-02-13 15:37:00,8
19614,ORD_19615,5503,Vega Powder Brush (Small) (MBP - 09) 50 gm,Warehouse B,116,98,2025-02-13 17:20:00,18
19615,ORD_19616,2021,"BEAUTE BLANC Fruit Vinegar Gel Hair Color, Natural Black Color Dye for Men, Women (500ml x 2)",Warehouse A,40,30,2025-02-13 11:52:00,10
19616,ORD_19617,3107,Provo 200mg Tablet,Warehouse A,41,28,2025-02-13 22:39:00,13
19617,ORD_19618,12787,Bentley Infinite Rush Edt 60ml,Warehouse A,81,67,2025-02-13 16:44:00,14
19618,ORD_19619,1356,Aditel CT 40mg/12.5mg Tablet,Warehouse A,51,38,2025-02-13 20:27:00,13
19619,ORD_19620,5416,Fluxtop DSR  Capsule,Warehouse A,104,92,2025-02-13 19:19:00,12
19620,ORD_19621,599,Mirabelle Korea Cucumber Fairness Facial Mask 25 Ml,Warehouse A,48,30,2025-02-13 19:30:00,18
19621,ORD_19622,8848,Bella Voste Sugar Baby Nail Paints Shade 361 10 Ml,Warehouse A,57,40,2025-02-13 19:02:00,17
19622,ORD_19623,3999,Apsara Long Point Sharpeners - Pack of 20,Warehouse B,26,9,2025-02-13 23:29:00,17
19623,ORD_19624,11816,Kepdox 200mg Tablet,Warehouse B,98,81,2025-02-13 22:58:00,17
19624,ORD_19625,9417,NAGARAKU Eyelash Extensions Individual Lashes 0.12mm C curl 15mm 16 Rows Soft Natural Matte Black Professional Mega Volume...,Warehouse B,33,21,2025-02-13 16:49:00,12
19625,ORD_19626,35803,Broadicilin 125mg Syrup,Warehouse C,100,89,2025-02-13 02:32:00,11
19626,ORD_19627,7319,"Kerrato Hair Fibres For Thinning Hair (Natursl Black) Natural, 11.5g - Conceals Hair Loss In 10 Seconds - Natural Hair Thi...",Warehouse C,86,69,2025-02-13 21:27:00,17
19627,ORD_19628,4018,Beauty People Natural HD Matte Lip Crayon Wicked - 106 4 gm,Warehouse B,14,2,2025-02-13 00:11:00,12
19628,ORD_19629,13254,Lip Butter - Black Currant,Warehouse A,62,46,2025-02-13 16:22:00,16
19629,ORD_19630,11821,"COOLCOLD USB Mobile Charger, USB Charging Station with Turbo Charging Auto Detect Technology Safety Guaranteed 10-Port Sma...",Warehouse B,51,38,2025-02-13 11:24:00,13
19630,ORD_19631,6746,Axocare 1000mg Injection,Warehouse B,37,22,2025-02-13 16:23:00,15
19631,ORD_19632,3864,L.A. Colors Jumbo Eye Pencil - Sea Shell 3.8 gm,Warehouse B,39,30,2025-02-13 06:45:00,9
19632,ORD_19633,417,"Acer Nitro QG271 27 Inch (68.58 Cm) 1920 x 1080 Pixels, Full HD Gaming LCD Monitor with LED Back Light Technology I VA Pan...",Warehouse B,68,57,2025-02-13 03:15:00,11
19633,ORD_19634,6833,"Moroccan Argan Hair Serum  - Nourishing, Conditioning",Warehouse A,53,48,2025-02-13 23:47:00,5
19634,ORD_19635,9031,"OnePlus 10R 5G (Forest Green, 8GB RAM, 128GB Storage, 80W SuperVOOC)",Warehouse B,109,95,2025-02-13 23:21:00,14
19635,ORD_19636,1206,"NoWide Back Cover Case for Redmi 10A, Silicone Shockproof Phone Case, Ultra Safety with Soft Feel (Pack of 1)",Warehouse C,117,98,2025-02-13 18:53:00,19
19636,ORD_19637,2934,AOF 200mg Tablet,Warehouse B,84,67,2025-02-13 06:25:00,17
19637,ORD_19638,3988,Rpee DSR Capsule,Warehouse C,64,53,2025-02-13 23:40:00,11
19638,ORD_19639,3504,Toothpaste - Strong Teeth & Healthy Gums,Warehouse A,102,92,2025-02-13 03:48:00,10
19639,ORD_19640,413,Bonjour Paris Photo Match Mousse Foundation - Deep Ochre 30 ml,Warehouse B,93,79,2025-02-13 21:55:00,14
19640,ORD_19641,12794,Radigan Tablet,Warehouse A,86,73,2025-02-13 07:36:00,13
19641,ORD_19642,3549,Orei HD-102 4K HDMI Splitter 1in2 Out - 1 Port to 2 Display Duplicate/Mirror - Ver 1.4 Certified for Full HD 1080P & 3D Su...,Warehouse B,63,57,2025-02-13 09:41:00,6
19642,ORD_19643,5698,Axdil DX Syrup,Warehouse C,76,63,2025-02-13 08:35:00,13
19643,ORD_19644,2421,"Digitek DTR 520 BH (60 Inch)(152cm) Professional Aluminum Tripod Cum Monopod with Swivel Pan Head, for DSLR Camera | Maxim...",Warehouse B,50,34,2025-02-13 00:21:00,16
19644,ORD_19645,9240,FOLX FS21 DOUBLE Loop Band Soft Silicone Sport Wristband Compatible with Smart Watch i-Watch Bands Silicone Strap Wristban...,Warehouse A,90,83,2025-02-13 04:58:00,7
19645,ORD_19646,491,Ofbest 200mg Tablet,Warehouse A,57,50,2025-02-13 23:30:00,7
19646,ORD_19647,2007,Pure White Mineral Clay Anti Pollution Purity Face Wash Foam,Warehouse B,76,63,2025-02-13 19:32:00,13
19647,ORD_19648,3122,"Ambrane 10000mAh Slim Power Bank, 20W Fast Charging, Dual Output, Type C PD (Input & Output), Quick Charge, Li-Polymer, Mu...",Warehouse A,69,61,2025-02-13 21:23:00,8
19648,ORD_19649,4128,Ultracycline 100mg Capsule,Warehouse B,76,57,2025-02-13 21:45:00,19
19649,ORD_19650,9165,BB & CC Cream Face Makeup Waterproof Foundation Cream Mushroom Head 3 in 1 Air Cushion 20 G.,Warehouse A,111,94,2025-02-13 15:46:00,17
19650,ORD_19651,6707,Volcanic Green Clay Face Wash - Mini,Warehouse C,16,5,2025-02-13 23:03:00,11
19651,ORD_19652,4000,Robustrion Smart Trifold Hard Back Flip Stand Case Cover for Xiaomi Mi Pad 5 Cover 11 inch - Black,Warehouse B,91,84,2025-02-13 13:22:00,7
19652,ORD_19653,7111,Vertiva 16mg Tablet,Warehouse C,76,65,2025-02-13 12:32:00,11
19653,ORD_19654,3985,MeeTo Makeup Foundation Blend Blush Brush With Sponge Puff Combo Pack of 2,Warehouse C,52,33,2025-02-13 12:27:00,19
19654,ORD_19655,11460,Eyetex Dazller Nail Glitter - DM4 (Syrup) 12 ml,Warehouse B,61,52,2025-02-13 10:21:00,9
19655,ORD_19656,170,Organic Extra Virgin Olive Oil - Pure Coldpressed Oil For Hair,Warehouse A,92,73,2025-02-13 06:42:00,19
19656,ORD_19657,11538,Vega Graduated Dressing Comb (HMC - 77D) 33 gm,Warehouse B,112,96,2025-02-13 20:10:00,16
19657,ORD_19658,3237,Razer Viper Mini Ultralight Gaming USB Mouse- Classic Black|Fastest Gaming Switches-8500 DPI Optical Sensor - Chroma RGB U...,Warehouse B,98,90,2025-02-13 01:45:00,8
19658,ORD_19659,3886,Cat Care Compatible with Oppo Reno 8 5G Luxury Square Plating Phone Case Solid Color Soft Silicone Back Cover for Oppo Ren...,Warehouse B,23,4,2025-02-13 22:17:00,19
19659,ORD_19660,4052,Defbir 6 Tablet,Warehouse C,50,38,2025-02-13 21:55:00,12
19660,ORD_19661,5713,"boAt LTG 500 Apple MFI Certified for iPhone, iPad and iPod 2Mtr Data Cable(Metallic Silver)",Warehouse A,99,86,2025-02-13 21:49:00,13
19661,ORD_19662,7180,Obimet Tablet,Warehouse A,58,41,2025-02-13 22:11:00,17
19662,ORD_19663,4174,"UN1QUE PH03 Car Mobile Holder AC Vent Car Mount, Auto Locking Stylish Design Compatible with All Smartphones, Car Phone Ho...",Warehouse C,29,14,2025-02-13 19:14:00,15
19663,ORD_19664,1965,Lenphor Gleaminator 35 Ml,Warehouse B,72,64,2025-02-13 11:49:00,8
19664,ORD_19665,7181,Moxletic-LB 625 Tablet,Warehouse A,49,37,2025-02-13 22:54:00,12
19665,ORD_19666,7186,Belora Paris World Matte Lipstick Vitamin C Popsicles - Transferproof I Vegan I Super Pigmented | Paraben free I Longstay ...,Warehouse C,105,97,2025-02-13 08:03:00,8
19666,ORD_19667,11685,Micromax X513+ Mauve,Warehouse A,93,88,2025-02-13 07:07:00,5
19667,ORD_19668,6671,Flormar Deluxe Cashmere Lipstick Stylo DC39 Love Mocha 3 gm,Warehouse B,83,66,2025-02-13 03:02:00,17
19668,ORD_19669,365,Ajmal Selfie Concentrated Perfume Oil Woody Aromatic And Blu Homme Deodorant Aquatic Woody Fragrance 210 ml,Warehouse B,86,80,2025-02-13 22:50:00,6
19669,ORD_19670,342,ZARALA Super Frosted Shield Pro Back Silicone Soft Mobile Case Compatible with Samsung Galaxy S23 Ultra 5G Dotted Slim-Fit...,Warehouse B,20,12,2025-02-13 06:00:00,8
19670,ORD_19671,7195,"COLOR DIVA Matte Mini Long Lasting Pocket Lipstick Set (multicolor, 24 g)",Warehouse C,20,7,2025-02-13 22:29:00,13
19671,ORD_19672,4151,"Seagate One Touch 4TB External HDD with Password Protection – Light Blue, for Windows and Mac, with 3 yr Data Recovery Ser...",Warehouse A,67,56,2025-02-13 07:09:00,11
19672,ORD_19673,13288,Rabidix 20mg Tablet,Warehouse B,35,18,2025-02-13 05:41:00,17
19673,ORD_19674,4141,"MARS Makeup Kit 24 eye shadow,2 blusher,2 compact powder,4 lipgloss,1 eyepencil",Warehouse C,47,36,2025-02-13 07:12:00,11
19674,ORD_19675,9295,Thiorex 100mg/4mg Tablet,Warehouse B,41,29,2025-02-13 13:26:00,12
19675,ORD_19676,12855,Pre Shave Cream - Lime,Warehouse C,101,87,2025-02-13 22:34:00,14
19676,ORD_19677,7292,Rizact 10mg Tablet MD,Warehouse B,19,4,2025-02-13 05:01:00,15
19677,ORD_19678,9167,Meconem Gold Injection,Warehouse A,28,14,2025-02-13 03:26:00,14
19678,ORD_19679,11719,Blemishes & Acne Control Sheet Mask (Pack of 6),Warehouse A,59,44,2025-02-13 05:32:00,15
19679,ORD_19680,7042,"KRISONS Thunder Speaker, Multimedia Home Theatre, Floor Standing Speaker, LED Display with Bluetooth, FM, USB, Micro SD Ca...",Warehouse A,45,35,2025-02-13 02:51:00,10
19680,ORD_19681,3254,"Amazon Basics USB 2.0 Cable - A-Male to B-Male - for Personal Computer, Printer- 6 Feet (1.8 Meters), Black",Warehouse B,45,29,2025-02-13 03:28:00,16
19681,ORD_19682,3546,I OD 40mg Injection,Warehouse B,93,85,2025-02-13 18:38:00,8
19682,ORD_19683,12211,Aldrofem 80mg/250mg Tablet,Warehouse C,34,24,2025-02-13 21:36:00,10
19683,ORD_19684,6797,Glycinorm-M 40 Tablet,Warehouse A,91,78,2025-02-13 11:05:00,13
19684,ORD_19685,4177,AND EterlR EDP & PrettyV Mist Pack of 2 250 ml,Warehouse A,53,45,2025-02-13 18:53:00,8
19685,ORD_19686,1964,Aclonac-RZ Capsule SR,Warehouse C,112,98,2025-02-13 21:47:00,14
19686,ORD_19687,12232,Ketostar Anti Dandruff Lotion,Warehouse A,46,37,2025-02-13 12:40:00,9
19687,ORD_19688,1916,Zoetryp D Tablet,Warehouse B,53,44,2025-02-13 16:33:00,9
19688,ORD_19689,9290,Collagen Under Eye Cream,Warehouse A,66,61,2025-02-13 00:38:00,5
19689,ORD_19690,5752,"EMBOX Rotary Extension Boards with USB Port with Universal Sockets and USB (2.4 A) Charging Ports (QC 3.0) with Indicator,...",Warehouse B,41,25,2025-02-13 10:20:00,16
19690,ORD_19691,2416,Mantra MIS100V2 Single IRIS Scanner Corded Portable Scanner with RD Service,Warehouse A,109,90,2025-02-13 11:49:00,19
19691,ORD_19692,9058,SUGAR Cosmetics Citrus Got Real Daily Moisturizer 60 gm,Warehouse A,105,86,2025-02-13 17:33:00,19
19692,ORD_19693,12011,"insta360 X3 Action Camera, 1/2"" Sensor, 5.7K 360 Capture, Optical Zoom 3X, 72 MP 360 Photo, 4K Single Lens Mode, Black",Warehouse C,97,79,2025-02-13 02:21:00,18
19693,ORD_19694,3941,Pepper Spray Self Defence Chilli for Woman Safety-110 ML Black+Yellow PK-2,Warehouse B,86,74,2025-02-13 07:32:00,12
19694,ORD_19695,11764,Febilt-S 5 Injection,Warehouse A,21,13,2025-02-13 11:59:00,8
19695,ORD_19696,1404,"Wet n Wild Lipstick, Mocha (Matte)",Warehouse B,107,89,2025-02-13 18:13:00,18
19696,ORD_19697,3520,Amazon Basics 20 ltrs Casual/Travel/College Backpack for 15.6-inch Laptop | Water Resistant Fabric,Warehouse A,95,81,2025-02-13 08:50:00,14
19697,ORD_19698,4232,Amlovas 2.5 Tablet,Warehouse A,40,22,2025-02-13 10:04:00,18
19698,ORD_19699,5654,Miss Claire Waterproof Extra Soft Kohl Pencil (Gold Cap) 0.35 Gm,Warehouse C,107,98,2025-02-13 01:13:00,9
19699,ORD_19700,4179,"Logitech G304 Lightspeed Wireless Gaming Mouse, Hero Sensor, 12,000 DPI, Lightweight, 6 Programmable Buttons, 250h Battery...",Warehouse C,16,9,2025-02-13 22:04:00,7
19700,ORD_19701,3884,Cosmic Byte Equinox Mousepad Speed Edition (L) (32x27x0.3cms),Warehouse C,43,34,2025-02-13 07:55:00,9
19701,ORD_19702,1978,Charcoal Shampoo,Warehouse B,90,77,2025-02-13 12:19:00,13
19702,ORD_19703,11622,Rabepea 20mg Injection,Warehouse A,49,30,2025-02-13 08:55:00,19
19703,ORD_19704,11694,Otcip 500mg Tablet,Warehouse C,60,51,2025-02-13 05:24:00,9
19704,ORD_19705,2958,"ZEBRONICS Astra 10 Portable Wireless BT v5.0 Speaker, 10W RMS Power, 15* Hours Backup, 2.25"" Drive Size, up to 6.4"" Mobile...",Warehouse C,84,79,2025-02-13 17:31:00,5
19705,ORD_19706,4187,LINLO Tempered Glass Screen Protector Compatible for OnePlus Nord CE 2 Lite 5G with Edge to Edge Coverage and Easy Install...,Warehouse B,95,86,2025-02-13 13:42:00,9
19706,ORD_19707,9229,Sparkling White Toothpaste,Warehouse A,25,13,2025-02-13 17:10:00,12
19707,ORD_19708,11874,"Honor MagicBook X14, 11th Gen Intel Core i5-1135G7, 14-inch (35.56 cm) FHD IPS Anti-Glare Thin and Light Laptop (8GB/512GB...",Warehouse A,68,63,2025-02-13 09:42:00,5
19708,ORD_19709,2912,Belzid T 250mg/31.25mg Injection,Warehouse A,51,41,2025-02-13 19:13:00,10
19709,ORD_19710,9007,Larbin Oral Drops,Warehouse C,25,15,2025-02-13 03:01:00,10
19710,ORD_19711,11837,Beardo Thin Hair Thickening Sulphate Free Shampoo 200 ml,Warehouse B,10,4,2025-02-13 04:51:00,6
19711,ORD_19712,11890,NOTE PERFECTING PEN 04 3 ml,Warehouse A,74,68,2025-02-13 07:23:00,6
19712,ORD_19713,1914,Spy Camera Mini Pocket Button Hidden Spy Video Camera with Motion Detection 1280x480p HD Recording (Black) (Gold) (Black),Warehouse A,70,64,2025-02-13 18:35:00,6
19713,ORD_19714,2452,Superdrug Coffee Mask 75 ml,Warehouse A,69,55,2025-02-13 13:43:00,14
19714,ORD_19715,4196,Epizole-DM 10mg/20mg Capsule,Warehouse C,78,71,2025-02-13 23:57:00,7
19715,ORD_19716,11585,DOMS Fusion X-tra Super Dark Pencils (Set of 2 Packets - 20 Pencils),Warehouse B,88,78,2025-02-13 15:15:00,10
19716,ORD_19717,233,Miss Claire Glimmersticks For Eyes - Silky Silver E-04 1.8 Gm,Warehouse B,57,39,2025-02-13 21:31:00,18
19717,ORD_19718,12727,CASON (DEVICE OF C)-Professional 8 X 40 HD Binoculars Powerful Lens 8X Zoom Portable Binocular Telescope with Pouch Outdoo...,Warehouse C,64,57,2025-02-13 18:11:00,7
19718,ORD_19719,12484,Nomxime-D 200mg/500mg Tablet,Warehouse A,95,83,2025-02-13 10:56:00,12
19719,ORD_19720,25213,Lineday 600 Tablet,Warehouse B,59,47,2025-02-13 03:23:00,12
19720,ORD_19721,35497,Ocef CV 250 mg/62.5 mg Tablet,Warehouse B,58,48,2025-02-13 06:51:00,10
19721,ORD_19722,21374,Original Eau De Toilette Deodorant - For Man,Warehouse C,79,61,2025-02-13 23:25:00,18
19722,ORD_19723,28705,"Pilgrim 24K Gold Face Mask For Glowing Skin | 24K Gold Face Pack For Glowing Skin, Skin Hydrating, Boosts Collagen And Res...",Warehouse A,57,43,2025-02-13 13:59:00,14
19723,ORD_19724,35469,Rhinofit Nasal Spray,Warehouse C,84,76,2025-02-13 18:58:00,8
19724,ORD_19725,25278,SYGA 4 Pairs Replacement Ear Cushion Pads Soft Comfortable Earpads Cushion Cover for Earphone Headphones Mobile Accessorie...,Warehouse A,99,90,2025-02-13 16:12:00,9
19725,ORD_19726,25284,Safeflox OZ Oral Suspension,Warehouse A,99,86,2025-02-13 15:54:00,13
19726,ORD_19727,35464,Passion Indulge FACIAL KIT - PEARL BLACK 7 STAR 1's,Warehouse C,105,95,2025-02-13 05:23:00,10
19727,ORD_19728,25297,Razowar-DSR Capsule,Warehouse B,59,54,2025-02-13 14:19:00,5
19728,ORD_19729,14497,JetLife Mobile Holder Pouch/Bag/Mount LITE for All Scooters Scooty Activa Jupiter EV's | Universal Size (Black),Warehouse A,106,97,2025-02-13 10:31:00,9
19729,ORD_19730,21349,"TABLE MAGIC Multipurpose Laptop Table Mat Finish Top Work at Home Study Table (TM Regular- Black, Alloy Steel)",Warehouse C,107,93,2025-02-13 11:39:00,14
19730,ORD_19731,25304,Vacsef 500mg/500mg Injection,Warehouse A,23,7,2025-02-13 16:18:00,16
19731,ORD_19732,16432,Xoten F 160mg/10mg Tablet,Warehouse A,77,64,2025-02-13 11:49:00,13
19732,ORD_19733,32745,Acne Control Face Wash - With Neem & Charcoal,Warehouse A,49,37,2025-02-13 13:53:00,12
19733,ORD_19734,35428,Ajmal Avid Carbon Sacredlove Deodorant Spray (Pack of 3) 200 ml,Warehouse C,20,12,2025-02-13 00:35:00,8
19734,ORD_19735,21321,"Safety Protection FF2400, FFP2 PM2.5 Particulate Mask/Respirator - White",Warehouse A,32,17,2025-02-13 04:08:00,15
19735,ORD_19736,21317,Sansui 140 cm (55 inches) 4K Ultra HD Certified Android LED TV JSW55ASUHD (Mystique Black),Warehouse B,77,69,2025-02-13 20:24:00,8
19736,ORD_19737,28678,Curetrax 250mg Injection,Warehouse C,59,41,2025-02-13 00:37:00,18
19737,ORD_19738,14527,Aloe Vera Kanti - Body Cleanser Soap,Warehouse A,64,58,2025-02-13 15:45:00,6
19738,ORD_19739,32754,Hicipro M 500mg/300mg Tablet,Warehouse B,32,20,2025-02-13 13:38:00,12
19739,ORD_19740,16396,Quadmox DM Eye Drop,Warehouse C,93,87,2025-02-13 11:44:00,6
19740,ORD_19741,35192,"HP Deskjet Ink Advantage 2335 All-in-One Printer, Scanner and Copier for Home for Home for Dependable Printing and scannin...",Warehouse B,109,98,2025-02-13 14:11:00,11
19741,ORD_19742,19081,"Storite 2.5 inch USB 3.0 External Hard Drive Enclosure, SATA to USB3.0 Transparent Portable Hard Disk Adapter for HDD and ...",Warehouse B,97,79,2025-02-13 19:04:00,18
19742,ORD_19743,28479,Daily Life Forever52 Curling Mascara Hm001 18 Ml,Warehouse C,91,77,2025-02-13 09:46:00,14
19743,ORD_19744,35028,Flix Micro Usb Cable For Smartphone (Black),Warehouse B,22,9,2025-02-13 02:20:00,13
19744,ORD_19745,25679,"Tough Lee (Pack of 2 Tempered Glass Screen Guard Protector for Apple iPhone 14 / Apple iPhone 13, Apple iPhone 13 Pro (Wil...",Warehouse C,41,29,2025-02-13 23:19:00,12
19745,ORD_19746,28285,Bella Voste Eyeshadow Soft Sketch 12 2.6 gm,Warehouse C,39,33,2025-02-13 05:38:00,6
19746,ORD_19747,28728,"TINY DEAL Organic Cotton Eyebrow Threading Thread for Eyebrow-Shaping, Removing Facial hair and Smoothening Facial Skin 8 ...",Warehouse B,35,21,2025-02-13 13:42:00,14
19747,ORD_19748,32755,Lofu 40mg Tablet,Warehouse B,57,49,2025-02-13 10:33:00,8
19748,ORD_19749,9799,"Fashion Colour Kiss Lip No Transfer Lipstick, 52 Pale Purple 2.6 gm",Warehouse A,98,83,2025-02-13 07:03:00,15
19749,ORD_19750,32682,Aziwo 500mg Tablet,Warehouse A,97,82,2025-02-13 20:28:00,15
19750,ORD_19751,3568,Apple 5W USB Power Adapter (for iPhone),Warehouse C,53,44,2025-02-13 05:53:00,9
19751,ORD_19752,37136,Novatax 1gm Injection,Warehouse A,26,9,2025-02-13 14:39:00,17
19752,ORD_19753,31118,Etolyte 90 Tablet,Warehouse B,36,23,2025-02-13 07:09:00,13
19753,ORD_19754,16386,Srvmor 50mg/400mg Tablet,Warehouse C,78,66,2025-02-13 20:16:00,12
19754,ORD_19755,25357,Actodom-DSR Capsule,Warehouse A,35,22,2025-02-13 18:55:00,13
19755,ORD_19756,18952,"Sound TECH LCD Writing Tablet for Kids Writing pad for Study, Drawing Tablet, Slate Board, 8.5 inch- E-Note Pad, Remove Bu...",Warehouse B,22,13,2025-02-13 13:29:00,9
19756,ORD_19757,18981,"Lapster 5 pin mini usb cable, usb b cable,camera cable usb2.0 for External HDDS/Card Readers/Camera etc.",Warehouse B,24,15,2025-02-13 11:36:00,9
19757,ORD_19758,18988,Flormar Waterproof Lipliner 202 Soft Pink Brown 1.14 gm,Warehouse C,110,98,2025-02-13 04:28:00,12
19758,ORD_19759,14574,(Renewed) Lenovo ThinkPad X260 High Performance 12.5 inch IPS Panel 1.5kg Laptop (Core i5 6300U/8 GB DDR4 RAM/256 GB SSD/W...,Warehouse C,89,75,2025-02-13 21:14:00,14
19759,ORD_19760,35330,Coderan  50 mg/50 mg Tablet,Warehouse A,96,77,2025-02-13 07:49:00,19
19760,ORD_19761,25361,Body Wash & Shower Gel - Cool,Warehouse B,40,23,2025-02-13 07:02:00,17
19761,ORD_19762,35313,Kodak XD Series 49mm 2 Layers UV Filter (Black),Warehouse C,87,69,2025-02-13 02:06:00,18
19762,ORD_19763,32810,"Fashion Colour Lip Liner, Waterproof, Long Lasting, 5 Goji Berry 0.35 gm",Warehouse A,63,49,2025-02-13 02:12:00,14
19763,ORD_19764,35297,Beardo Perfume - Godfather 100 ml,Warehouse B,15,6,2025-02-13 18:59:00,9
19764,ORD_19765,32816,Truly Essential Essential Oil - Orange 15 ml,Warehouse C,99,83,2025-02-13 03:52:00,16
19765,ORD_19766,25406,Excellence Creme Hair Color 172 g + Color Protect Shampoo 175 ml,Warehouse B,45,32,2025-02-13 20:40:00,13
19766,ORD_19767,35281,Navneet Youva | Spiral Long Book For Students And Executives | Spiral Bound With Safety Lock | A4 Size - 21 X 29.7 Cm | Si...,Warehouse A,37,27,2025-02-13 20:36:00,10
19767,ORD_19768,16311,Azidin 100mg Oral Suspension,Warehouse A,42,33,2025-02-13 06:54:00,9
19768,ORD_19769,14622,Amlip 5 Tablet,Warehouse C,38,21,2025-02-13 23:03:00,17
19769,ORD_19770,28508,Ezego Oral Solution Orange,Warehouse A,85,80,2025-02-13 09:03:00,5
19770,ORD_19771,19056,Skin Naturals - Moisturizing Serum-In-Lotion,Warehouse C,57,51,2025-02-13 05:44:00,6
19771,ORD_19772,21222,"ZEBRONICS Zeb-Vita Plus Mini 16 w Soundbar Supporting LED Display, USB, SD Card, AUX, FM, TWS & Call Function. (Blue)",Warehouse B,29,10,2025-02-13 19:10:00,19
19772,ORD_19773,25441,"AmazonBasics Truly Wireless in Ear Earbuds with ENC Quad Mic, IPX5 Water Resistant, Bluetooth 5.3, Up to 28 Hours Playtime...",Warehouse B,27,21,2025-02-13 04:33:00,6
19773,ORD_19774,35211,Dapafor 10mg Tablet,Warehouse C,103,84,2025-02-13 13:56:00,19
19774,ORD_19775,28494,Comet Busters Beautiful Silver Crystal Bindi (10 mm) (BIN452),Warehouse C,22,14,2025-02-13 07:54:00,8
19775,ORD_19776,25356,Emivin 4mg Tablet,Warehouse B,52,41,2025-02-13 11:04:00,11
19776,ORD_19777,25708,"Shudh Online Pure Aswagandhada Powder, Ashwagandha root, Asvagandha, Aswaghanda, Aswagandha",Warehouse B,91,75,2025-02-13 11:51:00,16
19777,ORD_19778,34996,Esocip 40mg Injection,Warehouse B,96,90,2025-02-13 15:15:00,6
19778,ORD_19779,34993,Cilrace 5mg Tablet,Warehouse C,65,53,2025-02-13 01:15:00,12
19779,ORD_19780,35086,Sariva Syrup,Warehouse C,82,71,2025-02-13 09:25:00,11
19780,ORD_19781,28408,"CarFrill Multi Retractable 3.0A Fast Charger Cord, Multiple Charging Cable 4Ft/1.2m 3-in-1 USB Charge Cord with Phone/Type...",Warehouse B,35,16,2025-02-13 22:55:00,19
19781,ORD_19782,28407,Secure Cottony XL Sanitary Napkins,Warehouse B,81,75,2025-02-13 15:17:00,6
19782,ORD_19783,19169,"Fashion Colour Eyebrow Pencil, EB03 1.3 gm",Warehouse C,80,69,2025-02-13 09:50:00,11
19783,ORD_19784,28389,"Intellilens Navigator Blue Cut Computer Glasses for Eye Protection | Unisex, UV ProtectionZero Power, Anti Glare & Blue Li...",Warehouse B,70,51,2025-02-13 07:44:00,19
19784,ORD_19785,16207,"Dell Pro Slim Backpack 15 - PO1520PS - Fits Most laptops up to 38.1 cm (15 inches, Black)",Warehouse A,36,29,2025-02-13 04:59:00,7
19785,ORD_19786,21119,Ayurvedic Soap 125 gm (Pack of 6) + Glycerine Soap 125 g Pack of 6,Warehouse B,20,1,2025-02-13 21:20:00,19
19786,ORD_19787,19180,Poppy Seed Natural Handmade Herbal Soap,Warehouse A,25,7,2025-02-13 02:43:00,18
19787,ORD_19788,35538,"OnePlus Nord CE 2 Lite 5G (Blue Tide, 6GB RAM, 128GB Storage)",Warehouse A,63,55,2025-02-13 08:32:00,8
19788,ORD_19789,18849,Esipro Lite 0.25mg/10mg Tablet,Warehouse C,82,69,2025-02-13 23:20:00,13
19789,ORD_19790,34958,Liverab 20mg Injection,Warehouse B,49,42,2025-02-13 15:27:00,7
19790,ORD_19791,24678,Cefiheal 200mg Tablet DT,Warehouse B,29,11,2025-02-13 18:37:00,18
19791,ORD_19792,24690,Micromax X778 Blue,Warehouse B,73,65,2025-02-13 12:05:00,8
19792,ORD_19793,35886,"Tecno Spark 8 Pro (Turquoise Cyan, 4GB RAM,64GB Storage) | 48MP Triple Camera | 33W Fast Charger",Warehouse A,42,30,2025-02-13 23:36:00,12
19793,ORD_19794,29272,Brevipil 25 Tablet,Warehouse C,53,48,2025-02-13 03:26:00,5
19794,ORD_19795,16741,Musk Deo Spray For Men,Warehouse A,20,5,2025-02-13 07:14:00,15
19795,ORD_19796,16716,"Just Herbs Ayurvedic Liquid Lipstick Kit Set of 5 with Long Lasting, Hydrating & Lightweight Lip Colour, Full Size - Parab...",Warehouse B,95,87,2025-02-13 23:39:00,8
19796,ORD_19797,35869,Traditional Tattoo ink cups for tattoo Ink pack of (100pcs) Medium,Warehouse A,18,7,2025-02-13 22:54:00,11
19797,ORD_19798,21807,"Verilux® Pendrive 128GB 4 in 1 Flash Drive with Light-ning, Micro USB, USB A, Type-C Interface Mini Hangable PenDrive for ...",Warehouse B,97,89,2025-02-13 03:15:00,8
19798,ORD_19799,21805,Aromatherapy Body Oil - Pure Lavender & Almond,Warehouse A,54,36,2025-02-13 15:06:00,18
19799,ORD_19800,14236,NISHTECH (BLACK HD tempered glass for Redmi 10 / Redmi 10C / Redmi 10 Power - Full Edge to Edge Screen Coverage,Warehouse C,55,43,2025-02-13 14:10:00,12
19800,ORD_19801,14237,Volume Million Lashes Mascara - Washable,Warehouse B,96,82,2025-02-13 14:23:00,14
19801,ORD_19802,14238,Qubo Smart WiFi Wireless Video Doorbell (White) from Hero Group | Instant Visitor Video Call | Intruder Alarm System | Eas...,Warehouse C,48,40,2025-02-13 15:49:00,8
19802,ORD_19803,29227,Rabewak 20mg Tablet,Warehouse C,15,6,2025-02-13 06:55:00,9
19803,ORD_19804,29218,"Body Cream - Smoothes, Softens & Protects",Warehouse B,43,28,2025-02-13 09:02:00,15
19804,ORD_19805,24756,Vega D'zyner Mini Nail File (NFS - 01) 9 gm,Warehouse C,57,41,2025-02-13 12:24:00,16
19805,ORD_19806,28421,Prizeno 1% Cream,Warehouse C,98,87,2025-02-13 02:52:00,11
19806,ORD_19807,25573,Flormar Contour Palette 03 Medium Deep 10 gm,Warehouse C,24,10,2025-02-13 14:41:00,14
19807,ORD_19808,35055,Arata Natural Happy Hair Duo For Women & Men With Cleansing Shampoo & Conditioner 600 ml,Warehouse A,16,9,2025-02-13 23:56:00,7
19808,ORD_19809,14830,"Caseous Leather Flip Magnetic Closure Card Slots Cover Case Back for Samsung Galaxy Tab A 8.0 inch (2019) SM-T290, SM-T295...",Warehouse B,18,3,2025-02-13 08:02:00,15
19809,ORD_19810,33062,Scentio Whitening Milk Plus Organic Bright & White Facial Foam 100 ml,Warehouse C,86,73,2025-02-13 21:49:00,13
19810,ORD_19811,28244,Hexim Dry Syrup,Warehouse C,31,12,2025-02-13 06:34:00,19
19811,ORD_19812,28238,WildHorn Leather Laptop Messenger Bag for Laptop/MacBook up to 15 inch| Padded Laptop Compartment |Office Bag I 365 Days W...,Warehouse A,108,90,2025-02-13 06:36:00,18
19812,ORD_19813,19259,Under The Ocean Bath Salt,Warehouse A,26,20,2025-02-13 08:12:00,6
19813,ORD_19814,14803,Odime 250mg Injection,Warehouse C,19,7,2025-02-13 18:34:00,12
19814,ORD_19815,16125,The Man Company Privilege Active Deodorant for Men| Premium Body Spray | Long-Lasting Fragrance | Perfect Deo For Everyday...,Warehouse B,19,13,2025-02-13 20:59:00,6
19815,ORD_19816,14808,Halodryl 1.5mg/2mg Tablet,Warehouse B,71,63,2025-02-13 01:35:00,8
19816,ORD_19817,19278,Rbther Injection,Warehouse C,27,16,2025-02-13 23:23:00,11
19817,ORD_19818,25748,"Lenovo Yoga Slim 7 Pro Intel Evo Core i5-11320H 14""(35.6cm) 2.8K Laptop(16GB/512GB SSD/Win11/MSO 2021/90Hz/3Yr Brand Warra...",Warehouse B,102,91,2025-02-13 12:07:00,11
19818,ORD_19819,19283,Medimade Rose Geranium Enriched Moisturizing Body Lotion (Pack of 2) 1's,Warehouse A,100,95,2025-02-13 12:40:00,5
19819,ORD_19820,21020,Medimade Coconut & Vanilla Moisturising Cream 200 gm,Warehouse A,50,33,2025-02-13 03:27:00,17
19820,ORD_19821,14733,Cello Signature Carbon Ball Pen | Blue Ball Pen | Pack of 1 | Premium Ball Pens | Best Ball Pen for Smooth Writing | Gifti...,Warehouse A,75,63,2025-02-13 05:12:00,12
19821,ORD_19822,25542,Nails On Board Handmade Press On Gel Nails- Holographic Lemon Yellow X Small 50 gm,Warehouse C,27,13,2025-02-13 10:21:00,14
19822,ORD_19823,28352,"Lenovo Tab M7 3rd Gen (7 inch(17.7cm), 2 GB, 32 GB, Wi-fi Only), Iron Grey",Warehouse A,37,29,2025-02-13 05:36:00,8
19823,ORD_19824,28365,"Smartwatch Charger for 2 Pin (Boat Wave Call & Boat Wave Lite Smartwatch) 0.2 m Magnetic Charging Cable, Black",Warehouse B,20,11,2025-02-13 10:28:00,9
19824,ORD_19825,28427,Ibibull T 325mg/37.5mg Tablet,Warehouse C,49,39,2025-02-13 06:02:00,10
19825,ORD_19826,32912,Glimmer Nail Polish Sunday Red 5 ml,Warehouse A,69,63,2025-02-13 19:55:00,6
19826,ORD_19827,16251,Beetel C51 Corded Landline Phone (Black),Warehouse B,49,38,2025-02-13 01:10:00,11
19827,ORD_19828,14666,Majestique Women Makeup Puff With Handle Latex Dry Wet Dual-purpose Face Sponge Foundation Blender For Lady Cosmetic Makeu...,Warehouse B,70,64,2025-02-13 20:18:00,6
19828,ORD_19829,16247,Face Wash - Acne Clear,Warehouse C,46,33,2025-02-13 19:08:00,13
19829,ORD_19830,25523,Essential Oil - Lavender,Warehouse A,102,91,2025-02-13 00:05:00,11
19830,ORD_19831,16245,Boatstorm (2022) Watch Charger Magnetic 2 pin USB All Types smartwatch (Smart Watch Charger for 2 Pin),Warehouse A,70,59,2025-02-13 03:56:00,11
19831,ORD_19832,35142,"Ambrane 12W Fast Car Charger, Dual USB Output, Multi-Layer Protection, Fast Charging, Compatible with All Cars, Without Ca...",Warehouse A,70,58,2025-02-13 19:26:00,12
19832,ORD_19833,25534,SKYVIK TRUHOLD StickOn Magnetic Mount Mobile or Remote Holder for Car-Bike-Scooter-Home-Kitchen-Office-Desk-(Rectangular S...,Warehouse C,104,90,2025-02-13 08:42:00,14
19833,ORD_19834,14684,Acer 80 cm (32 inches) N Series HD Ready TV AR32NSV53HD (Black),Warehouse B,52,44,2025-02-13 09:19:00,8
19834,ORD_19835,9801,Aldecef 100mg Tablet DT,Warehouse A,6,1,2025-02-13 02:06:00,5
19835,ORD_19836,21102,Kavcef XL 250mg/31.25mg Injection,Warehouse C,72,56,2025-02-13 12:53:00,16
19836,ORD_19837,4445,"Deborah Milano Red, Copper Blazer",Warehouse C,78,60,2025-02-13 02:58:00,18
19837,ORD_19838,723,Vega Luxury Fine Massager Bath Brush (BA - 1/1N) 155 gm,Warehouse A,36,26,2025-02-13 13:28:00,10
19838,ORD_19839,8669,Detoxie Keratin Repair & Shine Restore Strengthening Hair Mask 100 gm,Warehouse A,43,35,2025-02-13 17:04:00,8
19839,ORD_19840,11115,Anti-Dandruff Shampoo - Silky Black,Warehouse B,80,71,2025-02-13 18:41:00,9
19840,ORD_19841,4447,Tiglaz 20mg Tablet,Warehouse B,37,22,2025-02-13 06:23:00,15
19841,ORD_19842,12663,"boAt Stone Grenade Pro with 5W RMS, Upto 7 Hours Playback, Integrated Controls, Rugged Built and IPX6 Bookshelf Speaker (C...",Warehouse B,108,93,2025-02-13 22:23:00,15
19842,ORD_19843,7588,Clopinox 75mg Tablet,Warehouse B,87,82,2025-02-13 14:58:00,5
19843,ORD_19844,7594,Compatible with LG Split AC Remote (Works for Split AC only),Warehouse B,90,72,2025-02-13 07:24:00,18
19844,ORD_19845,8638,Ridol OZ 50mg/5ml/125mg/5ml Suspension,Warehouse C,32,19,2025-02-13 01:58:00,13
19845,ORD_19846,8637,Colorbar Just Smoky Pencil Kajal Jsp006 1.2 Gm,Warehouse A,70,62,2025-02-13 00:38:00,8
19846,ORD_19847,9692,Acer ED320QR 31.5 Inch Full HD (1920x1080 Pixels) VA Panel Curved Gaming LCD Monitor with LED Backlight with 165Hz Refresh...,Warehouse B,85,70,2025-02-13 09:05:00,15
19847,ORD_19848,12677,Dell 40Whr 14.8V 4 Cell Battery for M5Y1K 453-BBBR HD4J0 GR437 W6D4J 451-BBUD,Warehouse C,43,38,2025-02-13 13:58:00,5
19848,ORD_19849,308,Exermet GM Forte 2 Tablet PR,Warehouse C,46,32,2025-02-13 16:33:00,14
19849,ORD_19850,10791,Mamaearth Green Tea Face Toner With Green Tea & Collagen For Open Pores - 100 ml,Warehouse B,78,70,2025-02-13 11:47:00,8
19850,ORD_19851,8759,Trivastal LA Tablet SR,Warehouse C,73,65,2025-02-13 23:57:00,8
19851,ORD_19852,1430,Opnav D 10mg/20mg Capsule,Warehouse A,63,52,2025-02-13 00:55:00,11
19852,ORD_19853,1432,Fogg Fantastic Deo Absolute 150 Ml,Warehouse A,85,68,2025-02-13 11:26:00,17
19853,ORD_19854,11367,"Innisfree Green Tea Foam Cleanser | Face wash for Men & Women | For Dull & Dry Skin, 150 ml",Warehouse B,79,67,2025-02-13 09:24:00,12
19854,ORD_19855,6570,"BenQ GW2780 27 inch (68 cm) 1920 x 1080 Pixels IPS Full HD Ultra-Slim Bezel Monitor- Eye Care, Anti-Glare, Brightness Inte...",Warehouse B,58,49,2025-02-13 23:32:00,9
19855,ORD_19856,317,"StudBoy Natural Oud Perfume/Parfum, Unisex, 50ml (without box)",Warehouse B,31,12,2025-02-13 09:53:00,19
19856,ORD_19857,1184,GINNI CLEA Cleansing Makeup Remover Wipes (pack of 8) (30 wipes per pack) (LEMON),Warehouse A,32,14,2025-02-13 08:48:00,18
19857,ORD_19858,1434,Passion Indulge HAIR Proteinz Spa (small) 100 gm,Warehouse C,107,98,2025-02-13 19:58:00,9
19858,ORD_19859,2110,"Khadi Essentials Onion Shampoo for Hair Growth & Hair Fall Control with Black Seed Oil, Sulphate & Paraben Free Hair Clean...",Warehouse A,60,53,2025-02-13 06:12:00,7
19859,ORD_19860,6554,(Renewed) boAt Airdopes 381 Bluetooth Truly Wireless In Ear Earbuds With Mic (Active Black),Warehouse C,85,78,2025-02-13 03:10:00,7
19860,ORD_19861,5765,House of Aroma Tea Tree Essential Oil 10 ml,Warehouse B,14,9,2025-02-13 09:22:00,5
19861,ORD_19862,11270,Fexopill 180 Tablet,Warehouse B,48,35,2025-02-13 11:38:00,13
19862,ORD_19863,2362,Liquorice Day Cream,Warehouse A,23,6,2025-02-13 06:20:00,17
19863,ORD_19864,9555,Molkuf A Syrup Sugar Free,Warehouse B,33,19,2025-02-13 02:06:00,14
19864,ORD_19865,5264,Diclomera Injection,Warehouse B,51,36,2025-02-13 13:10:00,15
19865,ORD_19866,8708,Bio Henna - Fresh Powder Hair Colour For Dark Hair,Warehouse C,19,12,2025-02-13 08:26:00,7
19866,ORD_19867,693,Emkay LC 5mg/10mg Tablet,Warehouse A,58,41,2025-02-13 16:34:00,17
19867,ORD_19868,12319,Glycirid MF 2 mg/500 mg Tablet,Warehouse A,96,86,2025-02-13 16:27:00,10
19868,ORD_19869,10428,Bio Colour - Dark Brown,Warehouse C,83,69,2025-02-13 23:20:00,14
19869,ORD_19870,4986,"IKALL N7 7 Inch Display WiFi Only Tablet (2GB RAM +16GB Storage, Android 6.0) (Black)",Warehouse C,12,4,2025-02-13 05:15:00,8
19870,ORD_19871,13056,Eau De Toilette - Homme Green,Warehouse B,42,37,2025-02-13 06:48:00,5
19871,ORD_19872,253,Milani Matte Color Statement Lipstick Matte Beauty 3.97 gm,Warehouse B,32,24,2025-02-13 18:18:00,8
19872,ORD_19873,1684,JEBISON Smart Standard Multi-Purpose Laptop Table with Dock Stand/Study Table/Bed Table/Foldable and Portable/Ergonomic & ...,Warehouse C,43,24,2025-02-13 07:09:00,19
19873,ORD_19874,8335,CEDO Xiaomi 11i (5G) / 11i HyperCharge (5G) Case Back Cover Shockproof Bumper Crystal Clear | 360 Degree Protection TPU+PC...,Warehouse A,39,24,2025-02-13 01:30:00,15
19874,ORD_19875,3152,Xiaomi 11 Lite NE 5G (Jazz Blue 8GB RAM 128 GB Storage) | Slimmest (6.81mm) & Lightest (158g) 5G Smartphone | 10-bit AMOLE...,Warehouse B,94,80,2025-02-13 15:51:00,14
19875,ORD_19876,10409,Metal Lazy Stand Bracket Mobile Phone Stand | Flexible | Portable - Foldable | 360 Degree | Gooseneck Long Arm Clip Mobile...,Warehouse B,81,62,2025-02-13 22:10:00,19
19876,ORD_19877,6028,"Kent CamEye HomeCam 360 | CCTV WiFi Security IP Camera | Full HD 1080p, Night Vision | 360° with Pan & Tilt, 2-Way Audio |...",Warehouse B,115,97,2025-02-13 01:44:00,18
19877,ORD_19878,249,"SYSKA SSK-PW-0302A-WGY Power Wheel with Surge Protection , Strong ABS Material Body, 4 Meter Long (White-Grey)",Warehouse A,55,42,2025-02-13 04:46:00,13
19878,ORD_19879,10383,Makeup Revolution Fast Base Stick Foundation F9 6.2 gm,Warehouse B,82,73,2025-02-13 20:04:00,9
19879,ORD_19880,9871,Ambrane Type-C to Micro USB OTG Adapter for 3A Fast Charging and Data Sync- Compatible with All Type-C Enabled Devices Blue,Warehouse A,71,62,2025-02-13 14:40:00,9
19880,ORD_19881,4611,Divacon 500mg Tablet,Warehouse C,73,58,2025-02-13 09:44:00,15
19881,ORD_19882,4286,Azilip 250mg Tablet,Warehouse B,21,13,2025-02-13 23:01:00,8
19882,ORD_19883,12315,Revolution Pro Supreme Matte Lip Pigment-Imagine 2.5 ml,Warehouse B,62,57,2025-02-13 11:01:00,5
19883,ORD_19884,2352,EDT Spray - Original For Men,Warehouse C,88,73,2025-02-13 12:46:00,15
19884,ORD_19885,12300,Bend 200mg Tablet,Warehouse A,66,56,2025-02-13 09:15:00,10
19885,ORD_19886,13205,"Portronics Breeze Plus POR-545 20W Bluetooth 5.0 Portable Stereo Speaker with TWS, Aux in, Water Resistant, 2000mAh Batter...",Warehouse C,34,21,2025-02-13 08:08:00,13
19886,ORD_19887,1147,"Narciso Rodriguez for Her Fleur Musc Eau De Parfum, 50ml",Warehouse C,104,90,2025-02-13 02:53:00,14
19887,ORD_19888,6462,"Blue Heaven Hypergel Nailpaint - Mocha Magic, 708 11 ml",Warehouse B,60,45,2025-02-13 04:35:00,15
19888,ORD_19889,4411,Fungicort Cream,Warehouse B,72,60,2025-02-13 06:02:00,12
19889,ORD_19890,2137,Elc-FM Tablet,Warehouse A,36,18,2025-02-13 07:13:00,18
19890,ORD_19891,2508,ACM Watch Strap Nylon Loop compatible with Fire-Boltt Supernova Bsw083 Smartwatch Sports Hook Band Orange,Warehouse C,102,92,2025-02-13 03:14:00,10
19891,ORD_19892,1141,"Dyazo Ergonomic PU Vegan Leather Mouse Pad, Non-Slip, Anti-Skid, Reversible use, Dual Color, Splash-Proof Suitable for Gam...",Warehouse B,106,90,2025-02-13 11:35:00,16
19892,ORD_19893,13200,Mecotaz-P Tablet SR,Warehouse B,28,20,2025-02-13 02:26:00,8
19893,ORD_19894,3006,"Osaka­® 10"" (25.4 cm) Professional LED Ring Light with Tripod Stand for Mobile Phones & Camera, 3 Color Temperature Mode D...",Warehouse C,71,59,2025-02-13 05:59:00,12
19894,ORD_19895,7551,Arelol 50mg Tablet SR,Warehouse C,90,72,2025-02-13 04:08:00,18
19895,ORD_19896,5784,PROFESSIONAL 6 COLOR CHANGING MAGIC COLOR LIP OIL LIP BALM fruity,Warehouse C,32,16,2025-02-13 11:54:00,16
19896,ORD_19897,6568,Wel Decort 6mg Tablet,Warehouse C,94,80,2025-02-13 19:07:00,14
19897,ORD_19898,7629,De-Tan SPF 50 Sun Screen Gel Creme,Warehouse A,84,71,2025-02-13 06:15:00,13
19898,ORD_19899,4508,Thyromed 125mcg Tablet,Warehouse C,102,91,2025-02-13 07:47:00,11
19899,ORD_19900,7767,Alprotic 200mg/87mg Tablet CR,Warehouse A,59,49,2025-02-13 01:10:00,10
19900,ORD_19901,807,Roop Nikhar Red Color Bindi Set of 4 Pcs,Warehouse B,48,41,2025-02-13 18:32:00,7
19901,ORD_19902,2559,"elago Silicone Full Body Protection Hang Case, Compatible for Samsung Galaxy Buds 2 2021, Galaxy Buds Pro 2021, Galaxy Bud...",Warehouse C,90,83,2025-02-13 23:09:00,7
19902,ORD_19903,7777,mCaffeine Naked Detox Hydrating Green Tea Body Gel Lotion 200 ml,Warehouse B,45,29,2025-02-13 07:12:00,16
19903,ORD_19904,3433,FLU-C 400mg Tablet,Warehouse C,46,31,2025-02-13 06:08:00,15
19904,ORD_19905,6351,JetLife Premium Mobile Holder/Pouch-Bag for All Scooters Scooty Activa Jupiter EV's | Universal X1 Model (Grey),Warehouse B,61,44,2025-02-13 22:20:00,17
19905,ORD_19906,10925,"Natural Vetiver Bath Scrubber, Colour May Vary",Warehouse B,50,38,2025-02-13 02:12:00,12
19906,ORD_19907,1785,Asomex R 2.5mg/2.5mg Tablet,Warehouse C,84,65,2025-02-13 01:28:00,19
19907,ORD_19908,12334,(Renewed) New Jbl Tune 130Nc Bluetooth Truly Wireless In Ear Earbuds With Mic Active Noise Cancellation Massive 40Hrs Play...,Warehouse C,21,8,2025-02-13 03:06:00,13
19908,ORD_19909,7625,Shishu Taila - For Healthy Skin & Stronger Bones,Warehouse A,19,11,2025-02-13 01:58:00,8
19909,ORD_19910,4497,Oraimo 18W USB & Type-C Dual Output Super Fast Charger Wall Adapter PE2.0&Quick Charge 3.0 & Power Delivery 3.0 Compatible...,Warehouse A,58,47,2025-02-13 03:25:00,11
19910,ORD_19911,2998,"Pilot Frixion Clicker Roller Pen (Blue), (9000019529)",Warehouse C,46,36,2025-02-13 06:45:00,10
19911,ORD_19912,3797,Scofix OZ 200mg/500mg Tablet,Warehouse B,29,10,2025-02-13 22:40:00,19
19912,ORD_19913,11003,Otxone 1000mg Injection,Warehouse B,97,83,2025-02-13 09:35:00,14
19913,ORD_19914,12378,Deca Ndr 25mg Injection,Warehouse C,32,14,2025-02-13 20:55:00,18
19914,ORD_19915,4510,ELectroBot USB 2.0 Easycap Dc60 TV DVD VHS Video Adapter Capture Card Supports Windows Xp/7/Vista 32,Warehouse B,36,17,2025-02-13 03:48:00,19
19915,ORD_19916,4512,Miss Rose Skin Perfector Brick Highlighter 7003 - 126N 01 13 gm,Warehouse B,43,32,2025-02-13 07:48:00,11
19916,ORD_19917,13171,House of Aroma Ylang Essential Oil 10 ml,Warehouse C,106,94,2025-02-13 08:31:00,12
19917,ORD_19918,7650,TheGiftKart Back Cover For Samsung Galaxy M51 ( Poly Carbonate ; Polymer|Greyish Blue ),Warehouse B,22,4,2025-02-13 10:07:00,18
19918,ORD_19919,7651,Sitaxa M 50mg/850mg Tablet,Warehouse C,57,46,2025-02-13 21:47:00,11
19919,ORD_19920,13166,Alcold 5 mg/120 mg Tablet,Warehouse B,107,88,2025-02-13 02:31:00,19
19920,ORD_19921,5177,Light Complete Serum Cream With SPF 40/PA +++,Warehouse A,73,54,2025-02-13 22:17:00,19
19921,ORD_19922,12347,"Tygot 10"" Portable LED Ring Light with 3 Color Modes Dimmable Lighting | for YouTube | Photo-Shoot | Video Shoot | Live St...",Warehouse B,56,40,2025-02-13 18:37:00,16
19922,ORD_19923,769,Mucobrex Oral Drops,Warehouse C,43,29,2025-02-13 11:59:00,14
19923,ORD_19924,8608,Daily Life Forever52 Precise Eye Liner Brush Nx030 1's,Warehouse B,30,14,2025-02-13 18:02:00,16
19924,ORD_19925,4523,Azad 250mg Tablet,Warehouse C,84,77,2025-02-13 05:13:00,7
19925,ORD_19926,6373,Aloe Vera & Green Tea Daily Body Lotion,Warehouse C,34,17,2025-02-13 18:49:00,17
19926,ORD_19927,6370,ENVIE® (9v Infinite) Ni-Mh 300mAh Capacity Ready to Use Rechargeable Battery,Warehouse C,63,53,2025-02-13 14:43:00,10
19927,ORD_19928,213,(Renewed) HP 840g3 Elitebook Ultralight 1.48 KG (6th Gen Intel Core i5 - 6300U /8 GB/512 GB SSD/Windows 10 Pro/Silver /14 ...,Warehouse C,19,6,2025-02-13 02:55:00,13
19928,ORD_19929,4610,Spasrid Oral Drops,Warehouse C,90,75,2025-02-13 20:46:00,15
19929,ORD_19930,7762,Isv 4mg Tablet MD,Warehouse C,15,6,2025-02-13 23:21:00,9
19930,ORD_19931,1525,"Fashion Colour Terra Cotta Blusher, Shade 01 8 gm",Warehouse A,95,89,2025-02-13 08:45:00,6
19931,ORD_19932,9560,Myglamm Stay Defined Liquid Eyeliner Brow Powder - Nutmeg & Espresso 2.8 Gm,Warehouse B,68,49,2025-02-13 19:16:00,19
19932,ORD_19933,2794,Face Srcub,Warehouse C,71,59,2025-02-13 05:52:00,12
19933,ORD_19934,11244,Amlokas AT 5mg/50mg Tablet,Warehouse B,63,56,2025-02-13 23:36:00,7
19934,ORD_19935,12684,Medimade Shea Body Butter (Pack of 2) 1's,Warehouse A,43,24,2025-02-13 12:45:00,19
19935,ORD_19936,1468,MI Braided Type C 100cm Cable Black|Supports Upto 22.5 Fast Charging|Tangle Free Sturdy Built with Kevlar Protection|Suppo...,Warehouse C,107,93,2025-02-13 03:11:00,14
19936,ORD_19937,11026,Zerokuff Dmr Syrup,Warehouse A,70,64,2025-02-13 14:40:00,6
19937,ORD_19938,11023,"Epson 003 Ink Bottle (Cyan), Compatible with :L3110 /L3101/ L3150 / L4150 / L4160 / L6160 / L6170 / L6190 Printer Models",Warehouse A,35,20,2025-02-13 07:59:00,15
19938,ORD_19939,2162,Lolept 3gm Granules,Warehouse C,112,93,2025-02-13 22:47:00,19
19939,ORD_19940,285,"Amazon Basics 10000mAH Lithium Polymer Power Bank | 3 Charging Cables Included | Four Way Output (Micro USB, Type C, iPhon...",Warehouse A,106,91,2025-02-13 18:57:00,15
19940,ORD_19941,10899,Robustrion Tempered Glass Screen Protector Guard for Lenovo Tab M10 FHD Plus 10.6 inch 3rd Gen Generation Tablet,Warehouse A,33,27,2025-02-13 03:35:00,6
19941,ORD_19942,1524,"Fashion Colour Lip Crayon, Waterproof, Long Lasting, 8 Tango Red 2.8 gm",Warehouse B,46,40,2025-02-13 19:08:00,6
19942,ORD_19943,2166,Doubledicestore Tempered Glass Screen Protector Compatible for redmi Note 8 pro with Edge to Edge Full Coverage 9H and Eas...,Warehouse B,45,28,2025-02-13 07:11:00,17
19943,ORD_19944,7718,Televo 500mg Tablet,Warehouse B,80,68,2025-02-13 13:49:00,12
19944,ORD_19945,780,Gold Edition - Eau De Toilette For Man,Warehouse C,48,41,2025-02-13 13:26:00,7
19945,ORD_19946,7730,Penogab NT 75mg/10mg Tablet,Warehouse C,86,76,2025-02-13 17:32:00,10
19946,ORD_19947,4578,"Beauty Glazed 6Pcs Matte Liquid Lipstick Set +1 Lip Balm +1 Clear Gloss Kit, Plumping Quick Dry, No Smudge, Hard Transfer,...",Warehouse C,20,15,2025-02-13 04:16:00,5
19947,ORD_19948,1768,Dr.Wash Washing soap bar 200g (4),Warehouse C,13,4,2025-02-13 23:11:00,9
19948,ORD_19949,7734,Fastac SP 50mg/325mg/10mg Tablet,Warehouse C,74,69,2025-02-13 04:55:00,5
19949,ORD_19950,6341,Hisense 126 cm (50 inches) Bezelless Series 4K Ultra HD Smart LED Google TV 50A6H (Black),Warehouse C,79,74,2025-02-13 09:09:00,5
19950,ORD_19951,7746,"MINIMART Aluminum Tabletop Laptop Stand Ergonomic Foldable Portable Laptop Stand Holder Compatible for MacBook, HP, Dell, ...",Warehouse C,50,33,2025-02-13 06:44:00,17
19951,ORD_19952,8582,Bace P 100mg/325mg Tablet,Warehouse B,75,65,2025-02-13 09:05:00,10
19952,ORD_19953,108,Color Fever Eye Bomb Metallic Eye Pencil cum Eye Shadow Water Proof - Navy Blue 1.8 gm,Warehouse C,7,2,2025-02-13 21:16:00,5
19953,ORD_19954,5209,MARS Illuminati Base with primer & highlighter look (Gold Beam),Warehouse B,81,62,2025-02-13 03:51:00,19
19954,ORD_19955,5141,Bio Renew Coconut Milk Shampoo,Warehouse C,49,37,2025-02-13 16:47:00,12
19955,ORD_19956,7756,"Portronics UFO PRO POR-1094 6Ports, 60W Charging Station with PD + QC Output (Black)",Warehouse C,111,94,2025-02-13 05:40:00,17
19956,ORD_19957,35307,Chyawan Yogue Sugar Free Chyawanprash With Immunity Booster,Warehouse B,44,32,2025-02-12 20:09:00,12
19957,ORD_19958,25374,Chillrab Tablet,Warehouse C,60,44,2025-02-12 20:10:00,16
19958,ORD_19959,21277,Picolex Tablet,Warehouse C,46,31,2025-02-12 04:32:00,15
19959,ORD_19960,35304,Sagrach Makeup Mirror | Magnifying Mirror Makeup | Double Side Magnification | Tabletop Vanity Hand Mirrors Stand | 5X and...,Warehouse C,30,17,2025-02-12 17:56:00,13
19960,ORD_19961,1050,"Zayn & Myza Pollution Defense CC With SPF 30 Compact, Warm Beige 9 gm",Warehouse C,39,32,2025-02-12 09:28:00,7
19961,ORD_19962,25360,"Tukzer Wrist Rest Pad, Mouse Wrist Cushion Support for Office Upgrade Enlarge Gel Memory Foam Set Keyboard for Computer, L...",Warehouse A,40,29,2025-02-12 05:45:00,11
19962,ORD_19963,25387,Geometil 5mg Tablet,Warehouse B,29,21,2025-02-12 08:53:00,8
19963,ORD_19964,6479,"Bioderma Atoderm Intensive Ultra-soothing Baume - Moisturizer for Very dry Sensitive to Atopic Skin, 200ml",Warehouse C,23,6,2025-02-12 23:56:00,17
19964,ORD_19965,21258,HIKER Universal Dashboard Mount Car Mobile Phone Holder for Dashboard & Windshield with 360 Rotating Adjustable Long Arm &...,Warehouse A,31,14,2025-02-12 16:14:00,17
19965,ORD_19966,634,CROSSVOLT Type C VOOC Flash Charging Cable Compatible for Oppo Reno/2/2Z/2F/Reno 10x Zoom/k3(C Type Cable Charger),Warehouse C,112,97,2025-02-12 21:20:00,15
19966,ORD_19967,6478,Seten 60mg Injection,Warehouse B,21,10,2025-02-12 12:44:00,11
19967,ORD_19968,35275,Superdry - Heritage Athletic Mens Body + Hair Wash 250 ml,Warehouse A,48,39,2025-02-12 13:05:00,9
19968,ORD_19969,1078,Gfc Forte Eye Drop,Warehouse B,36,24,2025-02-12 22:49:00,12
19969,ORD_19970,8468,Amity 100mg Tablet DT,Warehouse A,64,47,2025-02-12 03:35:00,17
19970,ORD_19971,22660,Glymin Tablet,Warehouse A,63,51,2025-02-12 01:57:00,12
19971,ORD_19972,24429,Mi 80 cm (32 inches) HD Ready Android Smart LED TV 4A PRO | L32M5-AL (Black),Warehouse B,54,38,2025-02-12 01:47:00,16
19972,ORD_19973,36838,Fexgold 120mg Tablet,Warehouse C,38,26,2025-02-12 01:41:00,12
19973,ORD_19974,36790,Zydim 250mg Injection,Warehouse B,91,76,2025-02-12 16:21:00,15
19974,ORD_19975,13627,Colitol 200mg Capsule SR,Warehouse C,91,72,2025-02-12 15:54:00,19
19975,ORD_19976,13625,"Ant Esports ICE-C612 with RGB CPU Cooler/Fan Support Intel LGA775, LGA1200, LGA1150, LGA1151, LGA1155, LGA1156, LGA2066, L...",Warehouse C,81,64,2025-02-12 06:36:00,17
19976,ORD_19977,13623,Kaya On The Move Kit,Warehouse C,109,91,2025-02-12 05:10:00,18
19977,ORD_19978,179,"Maybelline New York Baby Lips Lip Balm , Anti-Oxidant Berry 4 gm",Warehouse B,89,73,2025-02-12 23:41:00,16
19978,ORD_19979,22631,Femiclean CC 100mg/200mg Vaginal Capsule,Warehouse B,94,80,2025-02-12 19:14:00,14
19979,ORD_19980,36799,"Crysendo Headphone Cushion Compatible with JBL C300SI, T250SI, T450, T460BT, T600 Headphone | 70mm Frog Leather & Memory F...",Warehouse C,25,18,2025-02-12 01:35:00,7
19980,ORD_19981,175,Hipower 50mg Tablet,Warehouse C,71,65,2025-02-12 01:39:00,6
19981,ORD_19982,13606,RGY Clear Screen Guard Compatible with 2022 Macbook Air 13.6Inch M2 Chip laptop Protection Film,Warehouse C,17,7,2025-02-12 19:35:00,10
19982,ORD_19983,36857,Zystroin 20mg Capsule,Warehouse A,21,9,2025-02-12 04:59:00,12
19983,ORD_19984,24419,"Nycil Cool Classic Prickly Heat Talcum Powder, Pack of 150gm",Warehouse B,96,84,2025-02-12 05:01:00,12
19984,ORD_19985,23447,Ambrane Lithium Polymer Stylo Max 50000mAh Power Bank - Blue,Warehouse B,27,18,2025-02-12 15:33:00,9
19985,ORD_19986,35270,Hello Zone Exclusive Matte Finish Soft Back Case Cover for Motorola Moto One Fusion Plus  - Black,Warehouse B,30,20,2025-02-12 16:21:00,10
19986,ORD_19987,1081,Forlex 100mg Injection,Warehouse B,49,36,2025-02-12 10:15:00,13
19987,ORD_19988,22794,Tnw The Natural Wash Amla Shampoo for Hair Growth & Controlling Hair Fall 200 ml,Warehouse A,90,82,2025-02-12 17:19:00,8
19988,ORD_19989,6471,Nutriment Foot Scrub All Skin Type 250 gm,Warehouse C,72,64,2025-02-12 23:16:00,8
19989,ORD_19990,6445,Jovees Foot Cream & Scrub - Jojoba & Sesame 100 gm,Warehouse A,60,44,2025-02-12 12:28:00,16
19990,ORD_19991,23408,Itcorax 100 Capsule,Warehouse A,88,74,2025-02-12 12:15:00,14
19991,ORD_19992,25445,Allure Highlighter Brush - (141) 1's,Warehouse C,73,58,2025-02-12 10:25:00,15
19992,ORD_19993,14568,Bonjour Paris Photo Match Liquid Concealer - Honey 4 ml,Warehouse B,109,90,2025-02-12 06:13:00,19
19993,ORD_19994,12697,TheGiftKart Back Cover Soft Case for Samsung Galaxy A23 4G / A23 5G | Best Camera Protection | Inbuilt Dust Plugs & Anti-S...,Warehouse B,39,20,2025-02-12 07:41:00,19
19994,ORD_19995,25349,VITRO MY BEAUTY BUNDLE Herbal Skin Care Set (Pack of 5) 800 ml,Warehouse C,35,27,2025-02-12 18:10:00,8
19995,ORD_19996,8818,WOW IMAGINE Tough Armor Polycarbonate 1+ OnePlus Nord 2T 5G Bumper Back Cover Ring Holder & Kickstand in-Built 360 Degree ...,Warehouse C,63,52,2025-02-12 14:33:00,11
19996,ORD_19997,25334,Secnil 500mg Syrup,Warehouse B,78,59,2025-02-12 15:13:00,19
19997,ORD_19998,21306,Eyelet-DS Eye Drop,Warehouse C,37,32,2025-02-12 19:16:00,5
19998,ORD_19999,8811,Daily Detox Charcoal Gel Mask,Warehouse B,47,33,2025-02-12 11:24:00,14
19999,ORD_20000,1030,Cefritec TZ 250mg/31.25mg Injection,Warehouse B,74,58,2025-02-12 16:56:00,16
20000,ORD_20001,35377,AmazonBasics Type C to Type C Braided 60W Fast Charging Data Cable (Black/Blackish Green - 1.2 Meter),Warehouse C,92,83,2025-02-12 11:50:00,9
20001,ORD_20002,35387,Oceclo-T 4 Tablet,Warehouse A,67,54,2025-02-12 11:41:00,13
20002,ORD_20003,14509,Insuman Rapid 40IU/ml Solution for Injection,Warehouse B,33,17,2025-02-12 11:15:00,16
20003,ORD_20004,6467,TheGiftKart Crystal Clear Samsung Galaxy S20 FE / S20 FE 5G Back Cover Case |360 Degree Protection Shock Proof Design |Tra...,Warehouse B,79,66,2025-02-12 00:42:00,13
20004,ORD_20005,25312,Remove Soft Wax - Aloe Vera 400 ml,Warehouse A,25,16,2025-02-12 04:33:00,9
20005,ORD_20006,21355,Nicef 200mg Tablet DT,Warehouse C,25,15,2025-02-12 01:27:00,10
20006,ORD_20007,991,"Jasmine Pure Glycerin Soap - Cold Processed, 100% Natural & Organic",Warehouse C,76,71,2025-02-12 06:04:00,5
20007,ORD_20008,25289,Stand & Pee Reusable Portable Urination Funnel For Women,Warehouse A,21,3,2025-02-12 18:06:00,18
20008,ORD_20009,35484,Fexogen 120 Tablet,Warehouse B,79,70,2025-02-12 09:50:00,9
20009,ORD_20010,25248,Broncolite Tablet,Warehouse B,61,50,2025-02-12 07:54:00,11
20010,ORD_20011,35490,"AmazonBasics Premium Flexible HDMI Cable and Mini HDMI Adapter, 6-Feet, Black, NOT Compatible with Mobile Phones and Laptops",Warehouse B,19,12,2025-02-12 01:28:00,7
20011,ORD_20012,35493,"Titu Ki Baatein Vintage Aesthetic Stickers 50 Pcs, Vinyl Waterproof Stickers for Water Bottles Laptop Phone Computer Guitar",Warehouse B,39,34,2025-02-12 22:11:00,5
20012,ORD_20013,12696,Rabopep-L Tablet SR,Warehouse A,23,4,2025-02-12 01:04:00,19
20013,ORD_20014,35354,"Maxima New Samurai Smartwatch 1.85"", 1st Time Call Accept Feature, Hindi Language Support, 600Nits Brightness, Longer Batt...",Warehouse C,54,40,2025-02-12 15:30:00,14
20014,ORD_20015,35334,"Tecno Spark 8T (Turquoise Cyan, 4GB RAM,64GB Storage) | 50MP AI Camera | 7GB Expandable RAM",Warehouse B,98,92,2025-02-12 03:51:00,6
20015,ORD_20016,8859,Bepride MF 2mg/500mg Tablet,Warehouse C,62,55,2025-02-12 05:43:00,7
20016,ORD_20017,36937,"Agaro Blaze USBA to micro +Type C 2in1 Braided 1.2M Cable, Grey",Warehouse C,28,23,2025-02-12 18:24:00,5
20017,ORD_20018,23400,Episron D 150mg/50mg Tablet SR,Warehouse A,54,45,2025-02-12 11:26:00,9
20018,ORD_20019,7858,"Fullmosa Compatible Apple Watch Straps 38mm 40mm 41mm 42mm 44mm 45mm 49mm, Stainless Steel iWatch Band with Case for Apple...",Warehouse B,66,47,2025-02-12 13:00:00,19
20019,ORD_20020,37040,"AmazonBasics RJ45 Cat 7 High-Speed Gigabit Ethernet Patch Printer, Server Internet Cable, 10Gbps, 600MHz - (Black, 5-Foot)",Warehouse C,92,79,2025-02-12 09:08:00,13
20020,ORD_20021,13441,Charcoal Nose Strip,Warehouse A,58,47,2025-02-12 04:40:00,11
20021,ORD_20022,23132,"FLiX (Beetel Flow 03M USB Type A to Micro USB Braided Charge and data Sync Cable, upto 15W(3A) super fast charging, upto 4...",Warehouse A,25,10,2025-02-12 23:02:00,15
20022,ORD_20023,7930,Pxr 25mg Tablet CR,Warehouse A,18,7,2025-02-12 02:29:00,11
20023,ORD_20024,23116,HP 680 Original Ink Advantage Cartridge (Black),Warehouse C,90,79,2025-02-12 15:03:00,11
20024,ORD_20025,7794,Riflaza Syrup,Warehouse A,58,44,2025-02-12 05:35:00,14
20025,ORD_20026,34,Havells-Lloyd 146cm (58 Inches) Ultra HD Android Smart LED TV (58US900C) Black,Warehouse A,48,36,2025-02-12 00:22:00,12
20026,ORD_20027,22903,"Samsung Galaxy M13 5G (Midnight Blue, 4GB, 64GB Storage) | 5000mAh Battery | Upto 8GB RAM with RAM Plus",Warehouse B,41,26,2025-02-12 17:18:00,15
20027,ORD_20028,22917,Clx 250mg Capsule,Warehouse B,99,91,2025-02-12 07:12:00,8
20028,ORD_20029,23032,"Ozone Perfect Skin Tone Face Wash For Men & Women | Ideal For All Skin Types Helps in Nourishing, Glowing & Moisturising T...",Warehouse B,25,20,2025-02-12 23:41:00,5
20029,ORD_20030,7893,DOMS Painting Kit,Warehouse C,101,93,2025-02-12 21:47:00,8
20030,ORD_20031,37122,Maryaj Cosmo Girl EDP Floral Powdery Perfume And Maryaj M For Her EDP Fruity Floral Perfume 190 ml,Warehouse C,51,36,2025-02-12 21:06:00,15
20031,ORD_20032,22937,Cello Signature Creme Ivory Roller Pen | Premium metal pen | Suitable for gifting | Smooth writing pen built with premium ...,Warehouse B,30,22,2025-02-12 10:14:00,8
20032,ORD_20033,22948,Kids 3-in-1 Tip To Toe Wash - Mango,Warehouse B,21,4,2025-02-12 14:54:00,17
20033,ORD_20034,22698,Kayatic AC Ear Drop,Warehouse A,28,21,2025-02-12 23:04:00,7
20034,ORD_20035,69,Primolut-N Tablet,Warehouse A,28,12,2025-02-12 13:28:00,16
20035,ORD_20036,13451,Tampres 0.4mg Tablet MD,Warehouse A,16,4,2025-02-12 06:56:00,12
20036,ORD_20037,7670,"TP-LINK TL-PoE150S PoE Injector Adapter, IEEE 802.3af Compliant, up to 100 Meters (325 Feet),Gigabit -10/100/1000,Black",Warehouse C,70,56,2025-02-12 07:11:00,14
20037,ORD_20038,22825,"Pilot Hi-Techpoint 05 Super Value Pen - Pack of 3, Blue",Warehouse B,59,48,2025-02-12 23:39:00,11
20038,ORD_20039,8008,C Pod 50mg Tablet DT,Warehouse A,17,3,2025-02-12 22:15:00,14
20039,ORD_20040,13507,Tryptoheal Tablet,Warehouse B,17,2,2025-02-12 23:30:00,15
20040,ORD_20041,23298,Portronics Adapto 62 USB Wall Adapter Without Cable 2.4A Fast Charging Single USB Port for All iOS & Android Devices (Black),Warehouse B,66,57,2025-02-12 14:11:00,9
20041,ORD_20042,7996,Unitrac 0.5mg/50mg Tablet,Warehouse A,53,41,2025-02-12 01:30:00,12
20042,ORD_20043,23294,Rosupal Gold 75mg/10mg/75mg Capsule,Warehouse B,21,3,2025-02-12 16:19:00,18
20043,ORD_20044,22762,Khadi Organique Red Onion Hair Oil For Hair Growth - 200Ml,Warehouse A,56,43,2025-02-12 00:46:00,13
20044,ORD_20045,7712,"HDMI Video Capture, 4K HDMI to USB 2.0 Video Capture Device, 1080P HD 30fps Broadcast Live and Record Video Audio Grabber ...",Warehouse A,24,8,2025-02-12 11:07:00,16
20045,ORD_20046,36939,VIBOTON USB 2.0 Wired Numeric Keypad Slim Mini Number Pad Digital Keyboard 18 Keys Numpad for iMac/Mac Pro/MacBook/MacBook...,Warehouse C,78,63,2025-02-12 13:21:00,15
20046,ORD_20047,7980,Milani Supreme Kohl Kajal Eyeliner - Blackest Black 0.35 gm,Warehouse A,54,42,2025-02-12 18:31:00,12
20047,ORD_20048,35046,Glimzy M 2mg/500mg Tablet ER,Warehouse A,96,80,2025-02-12 09:03:00,16
20048,ORD_20049,23141,Onida 108 cm (43 inches) Full HD Smart LED Fire TV 43FIF3 (Black),Warehouse C,26,8,2025-02-12 08:09:00,18
20049,ORD_20050,7943,Revolution Pro Supreme Matte Lip Pigment-Ardent 2.5 ml,Warehouse B,94,75,2025-02-12 10:57:00,19
20050,ORD_20051,7764,House Of Makeup Good On You Hydra Matte Lipstick - Peach Perfect 3.5 gm,Warehouse B,51,41,2025-02-12 08:28:00,10
20051,ORD_20052,22706,Medimade Caffeine Face Mask 250 gm,Warehouse A,31,25,2025-02-12 19:20:00,6
20052,ORD_20053,125,Disetron 4 Tablet MD,Warehouse A,92,79,2025-02-12 04:07:00,13
20053,ORD_20054,8025,Herbal Cucumber & Aloe Vera Cleansing Milk,Warehouse C,112,99,2025-02-12 00:51:00,13
20054,ORD_20055,8084,Natflox 200mg Tablet,Warehouse A,40,35,2025-02-12 00:44:00,5
20055,ORD_20056,188,Triolmighty 40 Tablet,Warehouse A,30,15,2025-02-12 07:51:00,15
20056,ORD_20057,23581,Clavactum 500 mg/125 mg Tablet,Warehouse B,30,12,2025-02-12 19:49:00,18
20057,ORD_20058,7539,Pnz 40 Tablet,Warehouse C,59,50,2025-02-12 10:08:00,9
20058,ORD_20059,23704,Epirate Chrono 200mg Tablet,Warehouse A,79,62,2025-02-12 19:22:00,17
20059,ORD_20060,36659,"Ajmal 1 Silver Shade Homme, 1 Wisal Dhahab, 1 Distraction And 1 Magnetize Deodorants Pack of 4 200 ml",Warehouse A,41,30,2025-02-12 12:37:00,11
20060,ORD_20061,7471,Rufus 500mcg Tablet,Warehouse A,69,58,2025-02-12 18:33:00,11
20061,ORD_20062,36691,Oltrova A 10mg/75mg Tablet,Warehouse A,72,54,2025-02-12 12:26:00,18
20062,ORD_20063,8117,Ecsis Lotion,Warehouse C,88,80,2025-02-12 01:18:00,8
20063,ORD_20064,36711,BB Home Loofah Light Pink BH008 LPNK 1 pc+Nivea Shower Gel Body Wash Women 250ml,Warehouse B,30,22,2025-02-12 01:22:00,8
20064,ORD_20065,22570,HIFFIN® Studio Background Support Kit for Backdrop Photography and Videography (9ft x 9ft) | Portable and Foldable Stand K...,Warehouse B,58,52,2025-02-12 09:47:00,6
20065,ORD_20066,23642,Ozzipan D 30mg/40mg Capsule SR,Warehouse A,44,27,2025-02-12 03:52:00,17
20066,ORD_20067,7506,"Lecherous Beauty 3 in 1 Combo of Waterproof Eyeliner, Mascara With Eyeconic Kajal & Fit Me Matte+Poreless Liquid Tube Foun...",Warehouse A,69,58,2025-02-12 21:22:00,11
20067,ORD_20068,209,Vertiriv 8mg Tablet,Warehouse A,27,14,2025-02-12 01:00:00,13
20068,ORD_20069,23605,Allure Classic Large Powder Makeup Brush 1's,Warehouse A,92,76,2025-02-12 18:05:00,16
20069,ORD_20070,36745,Vaadi Herbals Vitamin C Rich Fairness Facial Serum 10 ml,Warehouse A,78,60,2025-02-12 09:49:00,18
20070,ORD_20071,22594,Glesomep 20mg Tablet,Warehouse B,88,73,2025-02-12 10:20:00,15
20071,ORD_20072,13221,Amazon Brand - Solimo Acrylic Case Hard Back and Soft Bumper Cover with Cushioned Edges for Apple iPhone Xs (Transparent),Warehouse C,94,79,2025-02-12 13:43:00,15
20072,ORD_20073,36752,VU 139 cm (55 inches) The GloLED Series 4K Smart LED Google TV 55GloLED (Grey),Warehouse C,66,56,2025-02-12 02:58:00,10
20073,ORD_20074,36766,"PiBOX India - USB 3.0 USB C OTG to 2.5"" SATA III Hard Drive Adapter 0.5 M Long Cable w/UASP - SATA to USB 3.0 Converter fo...",Warehouse C,94,84,2025-02-12 20:46:00,10
20074,ORD_20075,13533,Sennheiser PC 8.2 Wired On Ear Headphones with Mic (Black),Warehouse C,84,79,2025-02-12 20:48:00,5
20075,ORD_20076,121,SUGAR Cosmetics Face Fwd Blush Stick - 01 Coral Climax (Bright Coral) 7 gm,Warehouse A,100,95,2025-02-12 13:35:00,5
20076,ORD_20077,6343,Gel Bar - Peach & Avocado Mild Dew,Warehouse A,68,50,2025-02-12 22:32:00,18
20077,ORD_20078,21613,"Fashion Colour Non - Transfer Matt Waterproof Lipstick, 44 Ocher 2.6 gm",Warehouse A,80,64,2025-02-12 00:59:00,16
20078,ORD_20079,1197,Maxxcode Fresh Airfreshener - Oud Arabian 200 ml,Warehouse B,115,96,2025-02-12 18:36:00,19
20079,ORD_20080,690,Pocket Comb - HMC-11,Warehouse A,83,75,2025-02-12 01:33:00,8
20080,ORD_20081,14417,Ajmal Sacrifice Ll Him & Wisal Dhahab Of Deo & Prose EDP Pack of 3 420 ml,Warehouse A,98,80,2025-02-12 01:07:00,18
20081,ORD_20082,34068,Stbotanica Pomegranate & Mango Body Wash With Shea & Vitamin E 250 ml,Warehouse A,85,79,2025-02-12 02:52:00,6
20082,ORD_20083,907,I Am Eyeconic Matte Neon Pure Pigments BLAZING BLUE 2 gm,Warehouse A,57,47,2025-02-12 14:11:00,10
20083,ORD_20084,6672,Dental Cream,Warehouse C,68,52,2025-02-12 11:42:00,16
20084,ORD_20085,35611,"Tecno Phantom X2 5G Moonlight Silver (8GB RAM,256GB Storage) | World's 1st 4nm Dimensity 9000 5G Processor | Dual Curved A...",Warehouse A,93,86,2025-02-12 00:09:00,7
20085,ORD_20086,25063,Scaboz Cream,Warehouse C,46,27,2025-02-12 02:55:00,19
20086,ORD_20087,35618,"CZARTECH Type C Fast Charging & Data Sync Cable Compatible For Samsung Galaxy A11, A12, A21/A21s, A31, A51, A52, M21, M31,...",Warehouse A,24,15,2025-02-12 00:10:00,9
20087,ORD_20088,25042,Remove Waxing Paper 2M 2 gm,Warehouse A,89,83,2025-02-12 03:06:00,6
20088,ORD_20089,12853,KYOSEI Tempered Glass Compatible with OnePlus Nord 2T 5G with Military-Grade Anti-Explosion Edge-to-Edge Coverage Screen P...,Warehouse A,97,85,2025-02-12 21:56:00,12
20089,ORD_20090,35774,Cepodem 100 Tablet,Warehouse C,18,2,2025-02-12 00:51:00,16
20090,ORD_20091,21716,Physicians Formula Pore Refining White Halloysite Clay Mask - Refine 17 gm,Warehouse B,28,13,2025-02-12 18:29:00,15
20091,ORD_20092,6958,"Blue Heaven Studio Perfection Primers, 60g (Transparent, BHPRIMER) - Set of 2",Warehouse C,84,72,2025-02-12 11:44:00,12
20092,ORD_20093,21873,"MOTIVATE BOX, Black PVC Wooden Framed with White Border 10 * 10 Inch Felt Letter Board with 128 Letters & Numbers (Wall Mo...",Warehouse B,73,68,2025-02-12 11:55:00,5
20093,ORD_20094,14173,Ciflox-OZ Tablet,Warehouse B,98,80,2025-02-12 02:04:00,18
20094,ORD_20095,14169,Maryaj Direction East EDP Citrus Spicy Perfume And Ajmal Evoke Silver Edition Him Deodorant Spicy Floral Fragrance 300 ml,Warehouse A,54,37,2025-02-12 04:45:00,17
20095,ORD_20096,35979,Artho Sure Capsules,Warehouse A,84,75,2025-02-12 20:09:00,9
20096,ORD_20097,21879,SanDisk SDCZ430-032G-I35 Ultra Fit 3.1 32GB USB Flash Drive (Black),Warehouse B,30,25,2025-02-12 22:50:00,5
20097,ORD_20098,21881,Albifen 200mg Oral Suspension,Warehouse B,54,36,2025-02-12 20:49:00,18
20098,ORD_20099,8497,Gemblue Biocare Vitamin C Gel 500 ml,Warehouse A,100,83,2025-02-12 11:32:00,17
20099,ORD_20100,36001,Reliance Smart Point - E-Gift Card - Flat 1% Off - Redeemable in Stores,Warehouse A,53,42,2025-02-12 02:07:00,11
20100,ORD_20101,674,Ajmal Zeal EDP Aquatic Woody Perfume And Wisal Dhahab Deodorant Fruity Floral Fragrance 300 ml,Warehouse A,97,80,2025-02-12 18:50:00,17
20101,ORD_20102,21910,Pre Shave Foam - Classic Regular,Warehouse B,92,84,2025-02-12 11:27:00,8
20102,ORD_20103,24477,"Oblivion Multi-Purpose Wall Holder Stand for Charging Mobile Just Fit in Socket, Support All Charger and Hang (Yellow)",Warehouse A,89,74,2025-02-12 22:32:00,15
20103,ORD_20104,14143,Sulfozid-M 80 Tablet,Warehouse A,72,63,2025-02-12 00:37:00,9
20104,ORD_20105,36010,Spigen Liquid Air Back Cover Case Compatible For Google Pixel 7 Pro (TPU | Navy Blue),Warehouse B,38,29,2025-02-12 19:32:00,9
20105,ORD_20106,21921,Metopole-RM Tablet,Warehouse C,31,13,2025-02-12 13:54:00,18
20106,ORD_20107,21923,Ajmal Diza EDP Fruity Floral Perfume And Raindrops Femme Deodorant Floral Chypre Fragrance 300 ml,Warehouse B,92,73,2025-02-12 14:16:00,19
20107,ORD_20108,659,Skin Brightening Face Sheet Mask,Warehouse B,22,5,2025-02-12 18:28:00,17
20108,ORD_20109,36024,Miss Claire Full Coverage Makeup + Concealer - 12 6 Gm,Warehouse B,89,79,2025-02-12 14:09:00,10
20109,ORD_20110,655,Riaceclo SP 100mg/325mg/15mg Tablet,Warehouse C,34,16,2025-02-12 09:38:00,18
20110,ORD_20111,918,Immune Up Tablets,Warehouse B,74,55,2025-02-12 11:07:00,19
20111,ORD_20112,6664,Nutriment Papaya Cream All Skin Type 250 gm,Warehouse C,11,6,2025-02-12 13:38:00,5
20112,ORD_20113,25107,Petu D 10mg/40mg Tablet,Warehouse C,62,49,2025-02-12 01:21:00,13
20113,ORD_20114,21475,"ELV DIRECT Ergonomic Aluminum Ventilated Overheat Protection Detachable Computer Laptop Tabletop Mount Stand Riser (Black,...",Warehouse A,23,6,2025-02-12 00:31:00,17
20114,ORD_20115,23206,CEDO Samsung A71 Case Back Cover Shockproof Bumper Crystal Clear | 360 Degree Protection TPU+PC | Camera Protection | Acry...,Warehouse A,24,19,2025-02-12 16:08:00,5
20115,ORD_20116,24946,Revlon Colorstay Gel Envy Long Wear Nail Enamel - Blackjack 11.6 Ml,Warehouse C,102,89,2025-02-12 22:55:00,13
20116,ORD_20117,6765,"boAt Newly Launched Aavante Bar 1680D Bluetooth Soundbar with Dolby Audio, 120W RMS Signature Sound, 2.1 Channel, 3D Surro...",Warehouse C,83,75,2025-02-12 06:09:00,8
20117,ORD_20118,21612,Amozo Frameless Slim Design Translucent Matte Back Case Cover for iPhone 13 / iPhone 14 (Polycarbonate|Black),Warehouse C,90,85,2025-02-12 22:51:00,5
20118,ORD_20119,24910,7SEVEN® Compatible for Sony Bravia LCD LED UHD OLED QLED 4K Ultra HD TV remote control with YouTube and NETFLIX Hotkeys. U...,Warehouse B,23,5,2025-02-12 21:54:00,18
20119,ORD_20120,6788,Gloritel CT 80 Tablet,Warehouse C,103,94,2025-02-12 10:01:00,9
20120,ORD_20121,12821,"Portronics Mport 51 5-in-1 Type C HUB with RJ 45 Ethernet Port, 5Gbps Data Transfer, HDMI Port, USB 3.0, PD Quick Charge, ...",Warehouse C,102,93,2025-02-12 03:59:00,9
20121,ORD_20122,25242,Dexamaxx 0.5mg Tablet,Warehouse B,81,69,2025-02-12 03:11:00,12
20122,ORD_20123,21635,Digway 8+1 Round Strip Extension Cord 6 A 8 Universal Socket Multi Plug Point Extension Board with LED Indicator and Switc...,Warehouse B,69,52,2025-02-12 02:28:00,17
20123,ORD_20124,35721,Permarid Cream,Warehouse C,112,94,2025-02-12 16:50:00,18
20124,ORD_20125,24878,Sirona FDA Approved Non-Applicator Tampon - Medium Flow 20's,Warehouse A,73,64,2025-02-12 01:34:00,9
20125,ORD_20126,24870,Soya Rich Triple Action Shampoo,Warehouse A,13,4,2025-02-12 20:25:00,9
20126,ORD_20127,21657,Omistil 20mg Capsule,Warehouse A,101,89,2025-02-12 16:34:00,12
20127,ORD_20128,6809,N95 + PM2.5 Anti Pollution Face Mask With Activated Carbon - Large,Warehouse C,76,60,2025-02-12 20:18:00,16
20128,ORD_20129,14283,Lakme Eyeconic Curling Mascara Royal Blue 9 Ml,Warehouse A,12,5,2025-02-12 14:54:00,7
20129,ORD_20130,24861,Zoecort 100mg Injection,Warehouse A,38,31,2025-02-12 22:48:00,7
20130,ORD_20131,24835,"Adult Diapers Economy, Extra Large",Warehouse B,55,36,2025-02-12 21:14:00,19
20131,ORD_20132,24983,Daily Face Care Lotion Oil Balance - Combination To Normal Skin,Warehouse A,29,12,2025-02-12 16:03:00,17
20132,ORD_20133,21565,TheGiftKart Crystal Clear Back Cover Case for Xiaomi 11i 5G / 11i HyperCharge 5G | 360 Degree Protection | Shock Proof Des...,Warehouse A,20,2,2025-02-12 10:26:00,18
20133,ORD_20134,8686,Tromax P 50mg/500mg Tablet,Warehouse B,37,31,2025-02-12 21:12:00,6
20134,ORD_20135,6703,Lakme Absolute Matte Ultimate Lip Color With Argan Oil Rose Pink 3.4 Gm,Warehouse A,40,25,2025-02-12 08:29:00,15
20135,ORD_20136,14450,Cozin LC Syrup,Warehouse C,52,47,2025-02-12 14:35:00,5
20136,ORD_20137,12753,"Caffeine Series - Coffee Peel Off Mask, Grounded With Real Coffee Beans",Warehouse C,83,67,2025-02-12 21:27:00,16
20137,ORD_20138,25177,"POPIO Camera Lens Protector for iPhone 14 Pro/iPhone 14 Pro Max (Transparent), Pack of 2",Warehouse A,29,12,2025-02-12 06:59:00,17
20138,ORD_20139,941,Bonjour Paris Photo Match Liquid Concealer - Fair 4 ml,Warehouse A,42,31,2025-02-12 11:03:00,11
20139,ORD_20140,25154,Meridol 50mg Injection,Warehouse A,59,52,2025-02-12 02:46:00,7
20140,ORD_20141,6659,Jean Paul Gaultier Le BEAU Eau De Toilette 75ml with Shower Gel 75ml,Warehouse C,78,72,2025-02-12 23:13:00,6
20141,ORD_20142,7002,Wild Set for Women,Warehouse B,75,66,2025-02-12 02:07:00,9
20142,ORD_20143,24579,Portronics My Buddy D Wood Multipurpose Movable & Adjustable Table for Computer & Laptop(Brown),Warehouse A,38,32,2025-02-12 08:25:00,6
20143,ORD_20144,25653,Digicrown Original DC024 / H12348 Battery for Airtel My WiFi AMF-311WW Data Card 4G Hotspot Dongle - 2300mAh - 1 Year Warr...,Warehouse C,65,54,2025-02-12 23:28:00,11
20144,ORD_20145,1191,Gatidrops FP Eye Drop,Warehouse B,37,29,2025-02-12 18:49:00,8
20145,ORD_20146,25507,Anuradha Art Maroon Multi Colour Fancy Binid For Women & Girls | Plain Bindis For Ladies | Black Bindis For Ladies Small (...,Warehouse C,47,42,2025-02-12 08:31:00,5
20146,ORD_20147,21171,Yves Rocher Hair Repair Oil - Multipurpose Flower Oil Bath 150 ml,Warehouse C,77,66,2025-02-12 07:54:00,11
20147,ORD_20148,14661,Sun + Pollution Protection SPF 30 Body Lotion,Warehouse C,83,76,2025-02-12 11:37:00,7
20148,ORD_20149,8884,"Gizga Essentials Multi-Purpose Portable & Foldable Wooden Desk for Bed Tray, Laptop Table, Study Table (Black)",Warehouse C,115,98,2025-02-12 05:17:00,17
20149,ORD_20150,6438,"Amazon Basics Micro Usb Fast Charging Cable For Android Phones With Gold Plated Connectors (3 Feet, Black)",Warehouse B,86,78,2025-02-12 03:24:00,8
20150,ORD_20151,14655,Flormar Baked Blush-On 044 Pink Bronze 9 gm,Warehouse A,94,82,2025-02-12 10:19:00,12
20151,ORD_20152,1121,Medimade Aloe Vera And Vitamin E Moisturising Cream (Pack of 2) 1's,Warehouse C,75,62,2025-02-12 10:23:00,13
20152,ORD_20153,8875,ZEN Retard 400 Tablet ER,Warehouse B,50,44,2025-02-12 00:48:00,6
20153,ORD_20154,35196,"SAHU KRAFT Non-Slip Do More What Makes You Happy Motivational Quote Printed Mouse Pad for Computer, PC, Laptop Mousepad (M...",Warehouse B,80,69,2025-02-12 07:21:00,11
20154,ORD_20155,6355,BEAUTYRELAY LONDON - MARKER 24 hours of comfortable color the pigmented -2 In 1 Matte Lipstick| color of a Longwear matte|...,Warehouse A,106,94,2025-02-12 18:37:00,12
20155,ORD_20156,25617,Vigeron Forte 75mg Tablet,Warehouse A,95,79,2025-02-12 01:53:00,16
20156,ORD_20157,25625,Tocip 500mg Tablet,Warehouse B,88,70,2025-02-12 01:03:00,18
20157,ORD_20158,14804,Ajmal Blu Dreams EDP Citurs Fruity Perfume And Evoke Silver Edition Him Deodorant Spicy Floral Fragrance 300 ml,Warehouse A,40,26,2025-02-12 13:43:00,14
20158,ORD_20159,35784,MAHABIR Digital Meter Screen Protector Guard Compatible for Scooter 450X & 450 Plus,Warehouse C,57,45,2025-02-12 04:47:00,12
20159,ORD_20160,34976,Raxcef SB 250mg/125mg Injection,Warehouse A,61,54,2025-02-12 10:07:00,7
20160,ORD_20161,25732,"Sounce Screen Protector Compatible with Fitbit Versa 3 / Fitbit Sense Case, Soft TPU Plated Case All-Around Protective Scr...",Warehouse A,51,42,2025-02-12 19:41:00,9
20161,ORD_20162,1231,Efelac Tablet,Warehouse A,28,17,2025-02-12 21:06:00,11
20162,ORD_20163,21066,Aegte Kisproof Liquid Matte Lipstick - French Plum 704 5 ml,Warehouse C,81,76,2025-02-12 19:01:00,5
20163,ORD_20164,14793,7SEVEN® Infrared Remote Control for Realme Smart 4K Android LED OLED QLED TV replacement for original realme remote with N...,Warehouse A,91,81,2025-02-12 12:46:00,10
20164,ORD_20165,25729,Beard & Mustache Oil - Godfather Lite,Warehouse C,105,98,2025-02-12 13:07:00,7
20165,ORD_20166,25728,Plantas Cell Renewal Organic Face Wash 50 ml,Warehouse C,31,23,2025-02-12 18:42:00,8
20166,ORD_20167,21072,"Wolpin Portable Travel Organizer Case for Earphones, Data Cables, Charger, Pen Drives, Memory Card, (Black)",Warehouse C,90,78,2025-02-12 16:20:00,12
20167,ORD_20168,12586,Otomist Ear Drop,Warehouse A,18,5,2025-02-12 17:12:00,13
20168,ORD_20169,25703,Moringa Skin Toner,Warehouse C,30,16,2025-02-12 02:08:00,14
20169,ORD_20170,35013,Mandcef LB 200 LB Tablet,Warehouse B,14,9,2025-02-12 00:27:00,5
20170,ORD_20171,14750,Panty liner - Ultradry,Warehouse B,95,78,2025-02-12 19:54:00,17
20171,ORD_20172,25670,Temic ET 250mg/250mg Tablet,Warehouse A,88,71,2025-02-12 19:40:00,17
20172,ORD_20173,8892,Naxef 1.5 Injection,Warehouse B,25,17,2025-02-12 18:52:00,8
20173,ORD_20174,35133,Allure Face Massage Roller - Jade Roller 1's,Warehouse A,54,41,2025-02-12 09:05:00,13
20174,ORD_20175,35132,Novaswift 1000mg/200mg Injection,Warehouse C,22,15,2025-02-12 15:06:00,7
20175,ORD_20176,35127,Trihexol 5mg Tablet,Warehouse A,102,94,2025-02-12 03:55:00,8
20176,ORD_20177,8511,Lakme Sun Expert Ultra Matte Spf 40 Pa+++ Compact 7 Gm,Warehouse A,79,70,2025-02-12 22:50:00,9
20177,ORD_20178,21739,"Xifo LYF Earth 1 (3GB RAM, 32GB Storage) 4G Smartphone in White Colour",Warehouse B,104,96,2025-02-12 22:44:00,8
20178,ORD_20179,12864,Swarnamukhi Face Pack,Warehouse C,105,98,2025-02-12 16:04:00,7
20179,ORD_20180,12866,Levoce Tablet,Warehouse A,72,53,2025-02-12 16:03:00,19
20180,ORD_20181,8575,Edge to Edge Tempered Glass for Noise COLORFIT PRO 2 SMARTWATCH (Pack of 2),Warehouse A,91,84,2025-02-12 22:19:00,7
20181,ORD_20182,6861,Kavpime 1000mg Injection,Warehouse A,47,40,2025-02-12 22:58:00,7
20182,ORD_20183,6865,Evocet MD Tablet,Warehouse B,21,9,2025-02-12 03:14:00,12
20183,ORD_20184,35840,Prasic-DSR Capsule,Warehouse C,89,73,2025-02-12 01:28:00,16
20184,ORD_20185,21781,"ZEBRONICS Zeb-Astra 20 Wireless BT v5.0 Portable Speaker with 10W RMS Output, TWS, 10H Backup Approx, Built in Rechargeabl...",Warehouse B,45,38,2025-02-12 00:33:00,7
20185,ORD_20186,6878,Odimik 250mg Injection,Warehouse B,86,78,2025-02-12 14:25:00,8
20186,ORD_20187,21808,Ceftocid TZ 250 mg/31.25 mg Injection,Warehouse A,76,67,2025-02-12 12:23:00,9
20187,ORD_20188,35868,Flaxseed Oil Capsules,Warehouse B,107,91,2025-02-12 06:11:00,16
20188,ORD_20189,24703,Conbre CruizerXR Outdoor WiFi 1080p Motorized Pan/Tilt Camera |Color Night Vision | Dust and Water Protection | Auto Cruis...,Warehouse A,76,66,2025-02-12 15:28:00,10
20189,ORD_20190,751,Miss Rose 15 Color Correcting Concealer Palette 7601 - 012N 20 gm,Warehouse C,24,14,2025-02-12 01:06:00,10
20190,ORD_20191,35883,"Bestor® Portable Ruff 12 inches/30.48 cm LCD Paperless Memo Digital Tablet E-Writer/Writing/Drawing Pad, Graffiti Drawing ...",Warehouse B,23,4,2025-02-12 11:14:00,19
20191,ORD_20192,8547,Triglimiqueen 2 Tablet SR,Warehouse A,39,29,2025-02-12 02:00:00,10
20192,ORD_20193,14190,Nuclona 0.5mg Tablet,Warehouse A,51,37,2025-02-12 14:27:00,14
20193,ORD_20194,24609,Abcov 150mg Injection,Warehouse A,52,35,2025-02-12 09:21:00,17
20194,ORD_20195,8512,Terfexx 250mg Tablet,Warehouse B,51,46,2025-02-12 03:09:00,5
20195,ORD_20196,21376,Toxi Syrup,Warehouse B,75,68,2025-02-12 11:54:00,7
20196,ORD_20197,14809,Flormar Perfect Coverage Foundation 108 Honey 30 ml,Warehouse C,104,95,2025-02-12 23:22:00,9
20197,ORD_20198,25512,"Archer Tech Lab Recurve 100 Ultra Light 69g Wired Gaming Mouse with 3600 DPI and 6 Buttons, 7 Color RGB , Gaming Grade Sen...",Warehouse B,92,84,2025-02-12 09:02:00,8
20198,ORD_20199,21120,"Just Herbs Silksplash Neem-Orange Rehydrant Face Wash, 100ml and Lively Clean Honey Exfoliating Face Cleansing Gel, 100ml",Warehouse A,31,12,2025-02-12 17:35:00,19
20199,ORD_20200,21127,GadgetBite External Printed Hard Drive Disk Enclosure Portable Carrying Case Cover Pouch Casing for 2.5-Inch Hard Drive (S...,Warehouse B,90,83,2025-02-12 15:29:00,7
20200,ORD_20201,25574,"D-DIVINE Hair Wigs Tape, Hair Patch Tape, Hair Toupee Tape, Yellow Double Sided Tape For Hair Patch & Hair Toupee (1 Inch ...",Warehouse A,97,87,2025-02-12 20:07:00,10
20201,ORD_20202,25548,CARDEM 30MG TABLET,Warehouse A,50,34,2025-02-12 22:43:00,16
20202,ORD_20203,7733,Axmon Extension Cord with 2 USB Charging Ports and 6 Socket - 10 Amp Heavy Duty Multiplug Extension Board for Multiple Dev...,Warehouse C,63,48,2025-02-12 05:38:00,15
20203,ORD_20204,34236,"Fashion Colour Soft Lip Mousse, 3 Fetal Apple 8 gm",Warehouse B,50,32,2025-02-12 13:09:00,18
20204,ORD_20205,7749,Acecloder 100mg/500mg Tablet,Warehouse C,15,9,2025-02-12 21:28:00,6
20205,ORD_20206,34524,Malther 150mg Injection,Warehouse C,36,19,2025-02-12 14:20:00,17
20206,ORD_20207,6022,"ZEBRONICS Zeb-MA5222 USB Charger Adapter with 1 Metre Micro USB Cable, 2 USB Ports, for Mobile Phone/Tablets (Black)",Warehouse B,46,36,2025-02-12 01:12:00,10
20207,ORD_20208,20650,"Extra Long Selfie Stick Tripod,celfiexpt 63 inch Long Selfie Stick with Reinforced Tripod Stand,Camera Gopro Mobile Phone ...",Warehouse A,93,83,2025-02-12 06:40:00,10
20208,ORD_20209,9178,Ajmal Asher Concentrated Perfume Oil Oriental And Wisal Dhahab Deodorant Fruity Floral Fragrance 212 ml,Warehouse C,58,45,2025-02-12 17:42:00,13
20209,ORD_20210,26274,VITRO I AM NATURAL Premium Gulab Jal (Rose Water) Spray 200 ml,Warehouse A,72,61,2025-02-12 16:04:00,11
20210,ORD_20211,26276,"Pure Orange Glycerin Soap With Coconut Oil - Cold Processed, 100% Natural & Organic",Warehouse C,62,53,2025-02-12 07:18:00,9
20211,ORD_20212,26282,Canon PG-89 Ink Cartridge (Black),Warehouse B,59,47,2025-02-12 02:53:00,12
20212,ORD_20213,26288,Oil-Free Moisture Combination Skin,Warehouse A,72,62,2025-02-12 18:16:00,10
20213,ORD_20214,34552,Mazetol 200 Tablet,Warehouse A,63,52,2025-02-12 05:19:00,11
20214,ORD_20215,20633,Pikkme Samsung Galaxy M12 / F12 / A12 Leather Magnetic Flip Wallet Case Cover for M12 / F12 / A12 (Blue),Warehouse C,92,75,2025-02-12 23:19:00,17
20215,ORD_20216,26298,"Portronics Mport 7 Multiport 7-in-1 USB Hub with Convertible Heads, Compatible for Laptop, MacBook & Type-C Devices with T...",Warehouse B,51,44,2025-02-12 00:05:00,7
20216,ORD_20217,26336,Gemblue Biocare Lemon cream 500 ml,Warehouse C,102,86,2025-02-12 20:55:00,16
20217,ORD_20218,15168,Myglamm K.Play Mandarin Brightening Sheet Mask 20 Gm,Warehouse C,86,70,2025-02-12 09:11:00,16
20218,ORD_20219,9207,L.A. Colors Auto Eyeliner - Black 0.3 gm,Warehouse C,49,35,2025-02-12 19:52:00,14
20219,ORD_20220,34525,Estfres Tablet,Warehouse A,67,58,2025-02-12 03:57:00,9
20220,ORD_20221,34619,Total Effects - SPF 15,Warehouse B,51,44,2025-02-12 19:41:00,7
20221,ORD_20222,15205,Vega Flat Brush (R9 - FB) 106 gm,Warehouse A,8,3,2025-02-12 10:10:00,5
20222,ORD_20223,26478,Half N' Half Lipstick 05-Deep Maroon (Matte),Warehouse B,46,30,2025-02-12 23:59:00,16
20223,ORD_20224,15264,Emetek 4mg Tablet MD,Warehouse A,107,90,2025-02-12 08:39:00,17
20224,ORD_20225,9286,"Duracell Ultra Alkaline AAA Battery, 6 Pcs",Warehouse B,79,62,2025-02-12 18:50:00,17
20225,ORD_20226,6137,M.G.R.J® Tempered Glass Screen Protector for Samsung Galaxy Tab A8 (SM-X200 / X205 / X207) (10.5 inch),Warehouse A,96,91,2025-02-12 12:21:00,5
20226,ORD_20227,1588,ETI Colour Tape 2 Inch 65M (Black),Warehouse A,23,4,2025-02-12 12:14:00,19
20227,ORD_20228,15054,Citrodora & Clary Sage Hair Oil,Warehouse B,56,38,2025-02-12 00:36:00,18
20228,ORD_20229,26543,"Miss Claire Glimmersticks for Eyes E-10, Denim Blue, 1.8 g",Warehouse B,80,73,2025-02-12 02:38:00,7
20229,ORD_20230,34394,"NutriGlow NATURAL'S Bamboo & Charcoal Face wash For Deep Clean, Acne, Skin Lightening, Hydrate & Glowing Skin, All Skin Ty...",Warehouse A,22,13,2025-02-12 19:22:00,9
20230,ORD_20231,26079,"ELV Direct Book Holder Stand, Portable Handsfree Reading,Book Holding Tray, Sturdy, Lightweight, A4 Size (28cmX21cm)/(11 i...",Warehouse C,26,12,2025-02-12 01:34:00,14
20231,ORD_20232,12313,Glicsaan 80mg Tablet,Warehouse A,94,86,2025-02-12 00:17:00,8
20232,ORD_20233,15069,"Amazon Basics 4K HDMI to HDMI and Audio (RCA Stereo or Spdif) Extractor Converter (Supports Apple TV, Fire TV and Blue-Ray...",Warehouse C,57,38,2025-02-12 15:48:00,19
20233,ORD_20234,1405,DUDAO X14PROT Type-C Wired Earphones HiFi Stereo Headset in-Ear Attractive Designs Headphones with Microphone & Noise Canc...,Warehouse C,44,32,2025-02-12 07:48:00,12
20234,ORD_20235,26125,The Natural Wash Banana Hair Conditioner For Damaged & Frizzy Hair 200 Ml,Warehouse C,25,6,2025-02-12 02:32:00,19
20235,ORD_20236,1465,Intensive Care Calming Lavender Body Lotion,Warehouse A,39,24,2025-02-12 11:53:00,15
20236,ORD_20237,26242,MARS Lip Mist lip gloss (Soaked),Warehouse C,13,6,2025-02-12 11:11:00,7
20237,ORD_20238,20659,"SHREENOVA XA Smart Watch for Men & Women Latest Bluetooth 1.3"" LED with Daily Activity Tracker, Heart Rate Sensor,Sports G...",Warehouse A,88,83,2025-02-12 09:20:00,5
20238,ORD_20239,5694,Care Hand Sanitizer,Warehouse C,36,27,2025-02-12 22:27:00,9
20239,ORD_20240,34819,Synobrim-T Eye Drops,Warehouse A,77,60,2025-02-12 08:29:00,17
20240,ORD_20241,20269,Augliff 625 Tablet,Warehouse B,116,99,2025-02-12 15:36:00,17
20241,ORD_20242,6210,Rabip-DSR Capsule,Warehouse A,22,14,2025-02-12 20:50:00,8
20242,ORD_20243,9043,EGOTUDE Shock Proof Hard Back Soft Bumper Cover Case for iPhone 7 Plus / 8 Plus (Transparent),Warehouse B,51,37,2025-02-12 04:39:00,14
20243,ORD_20244,1667,"ZEBRONICS Zeb-Bro in Ear Wired Earphones with Mic, 3.5mm Audio Jack, 10mm Drivers, Phone/Tablet Compatible(Red)",Warehouse A,89,80,2025-02-12 14:51:00,9
20244,ORD_20245,5699,Safe Hair Color - Soft Black,Warehouse A,61,44,2025-02-12 03:29:00,17
20245,ORD_20246,20866,Sampep D 50mg/10mg Tablet,Warehouse C,90,82,2025-02-12 00:36:00,8
20246,ORD_20247,26837,OUXUS B11 Wireless Neckband Bluetooth EarphoneIn Ear Headset Earbud Portable Headphone Handsfree Sports Running Sweatproof...,Warehouse C,14,8,2025-02-12 21:56:00,6
20247,ORD_20248,9385,Deo Milk Elixir Women Deodorant Roll On - Sensitive Skin,Warehouse C,29,19,2025-02-12 05:06:00,10
20248,ORD_20249,25912,"ASUS WT200 Wireless Mouse, Blue",Warehouse B,102,85,2025-02-12 10:50:00,17
20249,ORD_20250,12252,Torcuf LS Syrup Mixed Fruit Sugar Free,Warehouse B,94,76,2025-02-12 16:23:00,18
20250,ORD_20251,15377,Zapcase Back Case Cover for iPhone 7 / iPhone 8 / iPhone SE 2020 | Compatible for iPhone 7 / iPhone 8 / iPhone SE 2020 Bac...,Warehouse A,23,6,2025-02-12 00:30:00,17
20251,ORD_20252,25922,Lemon & Tea Tree Oil Body Wash,Warehouse C,34,27,2025-02-12 16:00:00,7
20252,ORD_20253,5714,Fruity Soap Enriched with Narural Grape Extract,Warehouse B,29,12,2025-02-12 05:47:00,17
20253,ORD_20254,5723,"Egate i9 Pro-Max Android 9.0, Projector for Home 4K I Full HD 1080p Native 420 ANSI 4500 Lumens LED, 4D Digital Keystone w...",Warehouse A,84,65,2025-02-12 03:26:00,19
20254,ORD_20255,34792,"TOSHIBA Canvio Ready 2TB Portable External HDD - USB3.0 for PC Laptop Windows and Mac, 3 Years Warranty, External Hard Dri...",Warehouse B,87,70,2025-02-12 15:14:00,17
20255,ORD_20256,20305,7SEVEN® Compatible for Tata Sky Remote Original Set Top HD Box and Suitable for SD Tata Play setup Box Remote Control,Warehouse A,75,57,2025-02-12 21:20:00,18
20256,ORD_20257,6199,"Samsung ram memory 4GB (1 x 4GB) DDR3 PC3L-12800,1600MHz, 204 PIN SODIMM for laptops",Warehouse A,36,22,2025-02-12 17:55:00,14
20257,ORD_20258,9294,"SanDisk Ultra 64 GB USB Pen Drives (SDDDC2-064G-I35, Black, Silver)",Warehouse C,109,95,2025-02-12 17:14:00,14
20258,ORD_20259,15052,"AmazonBasics Truly Wireless in Ear Earbuds with Built-in Mic, Touch Control, IPX5 Water Resistant, Bluetooth 5.3, Up to 25...",Warehouse B,95,76,2025-02-12 00:29:00,19
20259,ORD_20260,34835,Action Pro™ Phone Holder Set for Chin Mount Compatible for iPhone Samsung Vivo Oppo IQOO,Warehouse B,27,20,2025-02-12 21:10:00,7
20260,ORD_20261,15289,"Sery Stay On Matte Liquid Lipstick Sand Nude, Brown (LSO - 04) 5 ml",Warehouse B,104,91,2025-02-12 05:10:00,13
20261,ORD_20262,26185,Kavcet-M Kid Syrup,Warehouse A,111,99,2025-02-12 01:15:00,12
20262,ORD_20263,20709,Cefdee 50mg Dry Syrup,Warehouse B,94,86,2025-02-12 03:56:00,8
20263,ORD_20264,15201,Remove Retouch Eyebrow And Facial Wax Pen 4ml - Normal Hair 4 ml,Warehouse A,35,18,2025-02-12 06:44:00,17
20264,ORD_20265,26424,"RRTBZ Type C Earphone For OnePlus 10 Pro, 10R, 10T Type C Wired Earphone with Mic, Rich Bass and Noise Isolation Compatibl...",Warehouse B,91,84,2025-02-12 18:55:00,7
20265,ORD_20266,12409,"AmazonBasics Expanding File Folder, Letter Size (Fits A4 Paper) - Black - with 13 pockets",Warehouse B,97,88,2025-02-12 21:11:00,9
20266,ORD_20267,15101,Woman - Casual Eau De Toilette Deodorant,Warehouse C,37,28,2025-02-12 14:41:00,9
20267,ORD_20268,6091,Rose 100mg Tablet,Warehouse A,93,77,2025-02-12 05:54:00,16
20268,ORD_20269,34407,House of Aroma Lemongrass Fragrance Oil 100 ml,Warehouse C,46,29,2025-02-12 21:59:00,17
20269,ORD_20270,25887,Matrix 500GB SATA Hard Drive for Desktop (HDD) 3.5 Inch SATA 6 GB/s 7200 RPM High Speed Data Transferability Boost The Per...,Warehouse A,94,81,2025-02-12 01:36:00,13
20270,ORD_20271,25773,Cipliv Syrup,Warehouse C,101,95,2025-02-12 11:01:00,6
20271,ORD_20272,25818,6 Oil Nourish Conditioner,Warehouse C,69,58,2025-02-12 02:16:00,11
20272,ORD_20273,9008,Ant Esports GM320 RGB Optical Wired Gaming Mouse | 8 Programmable Buttons | 12800 DPI,Warehouse C,61,43,2025-02-12 17:55:00,18
20273,ORD_20274,15454,"Amazon Brand - Solimo Women's Rubber Bands, Plain Black, Pack of 4",Warehouse A,48,29,2025-02-12 19:31:00,19
20274,ORD_20275,34085,"Earth Rhythm Lip, Cheek and Eye Shadow Tint Mermaid, with Goodness of Jojoba Oil and Pomegranate, Nourishes Hydrates Dry C...",Warehouse B,97,90,2025-02-12 12:51:00,7
20275,ORD_20276,34968,Vogisir M 500mg/0.3mg Tablet SR,Warehouse C,96,90,2025-02-12 17:27:00,6
20276,ORD_20277,20142,"boAt Deuce USB 300 2 in 1 Type-C & Micro USB Stress Resistant, Tangle-Free, Sturdy Cable with 3A Fast Charging & 480mbps D...",Warehouse C,96,85,2025-02-12 15:26:00,11
20277,ORD_20278,9465,"Brustro Artists Wiro Bound Sketch Book, A5 Size, 120 Pages, 160 GSM (Acid Free)",Warehouse B,104,97,2025-02-12 11:48:00,7
20278,ORD_20279,27030,Cello Gripper Ball Pen | Jar of 25 | Blue Ball Pens | Smooth writing Ball Pens | Exam Pens with Grip | Ball pens set for S...,Warehouse B,68,62,2025-02-12 22:09:00,6
20279,ORD_20280,14832,Myvn 20W Flash Super Vooc Micro Usb 7 Pin Data Sync Fast Charging Cable For Cellular Phones Oppo Reno/Oppo F9 Pro/ F11 Pro...,Warehouse B,36,19,2025-02-12 07:52:00,17
20280,ORD_20281,5622,Doc Cort 6mg Tablet,Warehouse B,90,72,2025-02-12 09:39:00,18
20281,ORD_20282,25772,Tira 500mg Tablet,Warehouse C,29,24,2025-02-12 07:26:00,5
20282,ORD_20283,8975,Myforce 50mg Tablet,Warehouse A,10,2,2025-02-12 16:46:00,8
20283,ORD_20284,14839,"Airtel DigitalTV E5573Cs-609 Wireless Hotspot Wi-Fi Data Device, White",Warehouse C,84,74,2025-02-12 02:23:00,10
20284,ORD_20285,8976,Ponds Starlight Talc 300 g,Warehouse B,53,47,2025-02-12 23:36:00,6
20285,ORD_20286,8983,RED4 Liquid Lipstick Matte Creamy Finish Natural Colors Non Transfer Long stay lipsticks for Girls Womena Nude Red Maroon ...,Warehouse B,37,31,2025-02-12 20:34:00,6
20286,ORD_20287,20723,Albendawin 400mg Oral Suspension,Warehouse B,79,60,2025-02-12 21:23:00,19
20287,ORD_20288,34127,Esopera-L Capsule,Warehouse B,95,77,2025-02-12 14:07:00,18
20288,ORD_20289,26990,"Live Tech PS05 Extension Cords with USB Slots, 3 USB Ports 3 Way Outlets Power Strips with USB Surge Protection Extension ...",Warehouse A,28,16,2025-02-12 17:18:00,12
20289,ORD_20290,9440,Nourishing Winter Lotion - Almond & Honey,Warehouse A,57,38,2025-02-12 13:09:00,19
20290,ORD_20291,25813,Aricip TZ 500mg/600mg Tablet,Warehouse A,95,86,2025-02-12 04:29:00,9
20291,ORD_20292,6268,Supernim 100mg Tablet,Warehouse C,93,75,2025-02-12 23:36:00,18
20292,ORD_20293,20230,MADES Body Resort Clear Blue Pet Bottle Body Lotion 250 ml,Warehouse B,12,3,2025-02-12 10:44:00,9
20293,ORD_20294,26356,TheGiftKart Back Cover For Xiaomi Mi 11X / Mi 11X Pro ( Poly Carbonate ; Polymer|Black ),Warehouse B,81,73,2025-02-12 16:23:00,8
20294,ORD_20295,34205,Risorine Capsule,Warehouse B,34,16,2025-02-12 19:59:00,18
20295,ORD_20296,20953,Embeta-TM 25 Tablet ER,Warehouse B,44,36,2025-02-12 05:32:00,8
20296,ORD_20297,20232,Azafran Organics Ultra Rich Hydrating Body Butter 150 gm,Warehouse B,42,35,2025-02-12 17:40:00,7
20297,ORD_20298,1317,(Renewed) Lenovo ThinkCentre Desktop Mini PC (Intel Core i5 6th Gen|8 GB DDR4 RAM|512 GB SSD|WiFi|Windows 11|MS Office),Warehouse B,98,83,2025-02-12 18:27:00,15
20298,ORD_20299,14346,Nataraj 621 Pencil Jar - Pack of 50,Warehouse A,89,77,2025-02-12 21:09:00,12
20299,ORD_20300,15444,"TRAXOT UI Water Proof Smart Watch Latest Bluetooth 1.3"" LED with Daily Activity Tracker, Heart Rate Sensor, BP Monitor, Sp...",Warehouse B,73,55,2025-02-12 13:23:00,18
20300,ORD_20301,20955,"Xiaomi Wired in-Ear Earphones with Mic, Ultra Deep Bass & Metal Sound Chamber (Black)",Warehouse A,67,58,2025-02-12 17:20:00,9
20301,ORD_20302,20227,Feblast 40mg Tablet,Warehouse B,67,51,2025-02-12 18:12:00,16
20302,ORD_20303,20515,Rabden 20mg Tablet,Warehouse A,19,5,2025-02-12 23:32:00,14
20303,ORD_20304,15245,Nailrox Cream,Warehouse C,108,98,2025-02-12 07:38:00,10
20304,ORD_20305,1428,Soft Aloe Moisturising Cream - All Skin Types,Warehouse A,110,99,2025-02-12 22:10:00,11
20305,ORD_20306,5879,Laprite Aluminium Tabletop Headphone Stand (Black),Warehouse B,14,8,2025-02-12 21:39:00,6
20306,ORD_20307,26521,Scipdep 5mg Tablet,Warehouse A,29,23,2025-02-12 07:55:00,6
20307,ORD_20308,1435,Freeskin Lemon Shower Gel 400 ml,Warehouse B,70,58,2025-02-12 06:55:00,12
20308,ORD_20309,5892,Rabized-DSR Capsule,Warehouse A,22,11,2025-02-12 13:15:00,11
20309,ORD_20310,25982,Sirona Natural Anti Chafing Rash Cream for Women 25 Gm,Warehouse C,89,76,2025-02-12 22:52:00,13
20310,ORD_20311,12508,Apple iPhone 14 (128 GB) - (Product) RED,Warehouse C,102,96,2025-02-12 14:29:00,6
20311,ORD_20312,12212,Pumic Stone No 10,Warehouse A,48,39,2025-02-12 04:46:00,9
20312,ORD_20313,1261,Cugaba 300mg Capsule,Warehouse C,81,66,2025-02-12 12:24:00,15
20313,ORD_20314,20202,"CZARTECH Tempered Glass Screen Guard For iPhone 12/ iPhone 12 Pro (6.1"") with Easy Cleaning Kit (Pack of 1)",Warehouse C,56,43,2025-02-12 23:19:00,13
20314,ORD_20315,1709,"Dragonhawk Extreme Rotary Tattoo Machine Mini Power Supply Immortal Tattoo Inks Needles Complete Kits, 0.5 oz",Warehouse B,31,12,2025-02-12 18:34:00,19
20315,ORD_20316,6259,Bella Voste Luxe Matt Chrome Shade 226 10 Ml,Warehouse C,41,32,2025-02-12 14:41:00,9
20316,ORD_20317,34945,Ceeflash 200 Tablet,Warehouse B,99,85,2025-02-12 20:09:00,14
20317,ORD_20318,26946,Evopin 400 Capsule,Warehouse C,27,15,2025-02-12 09:53:00,12
20318,ORD_20319,34186,Trika 0.5mg Tablet,Warehouse C,94,89,2025-02-12 20:34:00,5
20319,ORD_20320,25843,Non-Gas Body Perfume For Men - Noir,Warehouse B,89,79,2025-02-12 09:09:00,10
20320,ORD_20321,14882,Stenz S 1000mg/500mg Injection,Warehouse B,23,12,2025-02-12 08:39:00,11
20321,ORD_20322,9426,Etharest AH 150mg/30mg Tablet,Warehouse B,53,40,2025-02-12 06:26:00,13
20322,ORD_20323,12223,"RPM Euro Games Finger Sleeves Pack of 2 Boxes/ 4 Pieces for Mobile Gaming with Super Conductive Fiber Fabric, Anti-Sweat a...",Warehouse C,72,64,2025-02-12 23:25:00,8
20323,ORD_20324,34917,"D-Link DAP-1325 N 300 Wi-Fi Range Extender, (White)",Warehouse A,88,80,2025-02-12 05:11:00,8
20324,ORD_20325,20961,"Vivo Y56 5G (Orange Shimmer, 8GB RAM, 128GB Storage) with No Cost EMI/Additional Exchange Offers",Warehouse B,60,50,2025-02-12 14:53:00,10
20325,ORD_20326,9002,Vega Round Brush (E4 - RB) 96 gm,Warehouse A,103,85,2025-02-12 17:42:00,18
20326,ORD_20327,14896,"Irusu Play VR Plus VR Headset with Headphones,40MM HD Lens for Mobiles (with Remote)",Warehouse C,18,8,2025-02-12 12:50:00,10
20327,ORD_20328,25851,"Amazon Brand - Solimo Thermoplastic Polyurethane, Plastic Transparent Black Bumper Case, Hard Back and Soft Bumper Cover f...",Warehouse A,42,30,2025-02-12 23:26:00,12
20328,ORD_20329,26872,EGOTUDE Shock Proof Crystal Clear Hard Back Hybrid Soft Bumper Anti Scratch Cover Case for iPhone XR (Transparent),Warehouse A,110,96,2025-02-12 01:30:00,14
20329,ORD_20330,34823,L.A Girl Shockwave Neon Eye Liner - Blackout ( Black ) 1.2 gm,Warehouse A,81,70,2025-02-12 04:17:00,11
20330,ORD_20331,7960,Flormar Deluxe Cashmere Lipstick Stylo DC28 Absolute Nude 3 gm,Warehouse A,24,18,2025-02-12 19:20:00,6
20331,ORD_20332,8387,Revlon Colorsilk Hair Color With Keratin - Light Golden Brown 5G 40 Gm,Warehouse C,34,20,2025-02-12 23:45:00,14
20332,ORD_20333,36085,Timur 40mg Tablet,Warehouse C,42,36,2025-02-12 21:09:00,6
20333,ORD_20334,24361,Lecozine M 5mg/10mg Tablet,Warehouse B,41,33,2025-02-12 01:55:00,8
20334,ORD_20335,36098,Natural Age Control Day Cream,Warehouse B,31,24,2025-02-12 07:23:00,7
20335,ORD_20336,7082,Gliten AM 5mg/50mg Tablet,Warehouse B,83,65,2025-02-12 23:04:00,18
20336,ORD_20337,22021,Tan Removal Sundried Oranges & Papaya Facial Scrub,Warehouse B,47,31,2025-02-12 12:22:00,16
20337,ORD_20338,36122,"Spigen Rugged Armor Pro Back Cover Case foriPad 10.2"" Gen 9th / 8th / 7th (2021 | 2020 | 2019) - Black, Thermoplastic Poly...",Warehouse C,68,49,2025-02-12 23:35:00,19
20338,ORD_20339,579,"Fashion Colour Oil Free Foundation, Shade 03 30 ml",Warehouse B,32,23,2025-02-12 22:06:00,9
20339,ORD_20340,7095,Cefowaq 100 Tablet DT,Warehouse A,31,19,2025-02-12 05:05:00,12
20340,ORD_20341,24296,Cello Maxriter Ball Pen | Pack of 10 | Blue Ball Pens | Lightweight Ball Pens for Pressure Free & Fine Writing | Elasto Gr...,Warehouse C,35,30,2025-02-12 09:33:00,5
20341,ORD_20342,13007,"Quantum Rapid Strike Mechanical Wired Gaming Keyboard with Dedicated Multimedia Keys, 6-Colour RGB LED, 12 Adjustable Ligh...",Warehouse C,87,68,2025-02-12 04:34:00,19
20342,ORD_20343,7105,FLC 150mg Tablet,Warehouse B,38,28,2025-02-12 06:13:00,10
20343,ORD_20344,7110,Pacer Oral Suspension,Warehouse A,53,44,2025-02-12 05:28:00,9
20344,ORD_20345,36176,Lemont LC 5mg/10mg Tablet,Warehouse B,56,40,2025-02-12 19:42:00,16
20345,ORD_20346,14007,Allegratune 180 Tablet,Warehouse C,89,81,2025-02-12 12:05:00,8
20346,ORD_20347,13996,Boujee Beauty Fool Proof Cut Crease Brush B213 135 gm,Warehouse C,67,48,2025-02-12 05:59:00,19
20347,ORD_20348,13755,Glimpee M 2mg/500mg Tablet,Warehouse A,94,84,2025-02-12 09:58:00,10
20348,ORD_20349,8381,"Strauss Skipping Rope, (Grey/Blue)",Warehouse A,105,94,2025-02-12 20:40:00,11
20349,ORD_20350,441,"One94Store LCD Writing Tablet Digital Magic Slate Ruffpad Portable Drawing Tab Writing Pad for Kids (8.5 inch, Pack of 1, ...",Warehouse A,51,41,2025-02-12 16:38:00,10
20350,ORD_20351,8259,Wesley Unisex Milestone Casual Waterproof Laptop Office School College Business Travel Backpack 25 L (Dimensions: 12.5x18 ...,Warehouse C,67,48,2025-02-12 12:15:00,19
20351,ORD_20352,23733,"Amkette EvoFox Fireblade Gaming Wired Keyboard with LED Backlit, 19 Anti-Ghosting Keys and Windows Lock Key (TKL) (Black)",Warehouse B,12,6,2025-02-12 15:30:00,6
20352,ORD_20353,36454,"Pre Shave Foam - Classic, Regular",Warehouse C,27,12,2025-02-12 20:11:00,15
20353,ORD_20354,8195,Dapixa DM 5mg/1000mg Tablet ER,Warehouse A,50,32,2025-02-12 08:32:00,18
20354,ORD_20355,351,Glimmer Premium Nail Enamel Purple Tulip 10 ml,Warehouse C,46,38,2025-02-12 20:28:00,8
20355,ORD_20356,36473,Salcob 1500mcg Injection,Warehouse B,45,37,2025-02-12 12:16:00,8
20356,ORD_20357,13770,Lorazee 500 Tablet,Warehouse C,63,51,2025-02-12 16:27:00,12
20357,ORD_20358,23800,AmazonBasics 9 Volt Everyday Alkaline Batteries (4-Pack),Warehouse B,100,90,2025-02-12 06:13:00,10
20358,ORD_20359,22447,Primelox 50mg Tablet,Warehouse C,70,51,2025-02-12 13:46:00,19
20359,ORD_20360,22459,Robten-D 10mg/20mg Tablet,Warehouse B,43,25,2025-02-12 05:39:00,18
20360,ORD_20361,7426,Activ Beaute Anti-Pollution Rapid Recovery Night Cream 25 gm,Warehouse C,44,36,2025-02-12 17:02:00,8
20361,ORD_20362,22473,The Beard Story Men's 2-in-1 Hair & Body Wash - Energy Blast 200 ml,Warehouse A,95,77,2025-02-12 06:09:00,18
20362,ORD_20363,14081,Confect OZ 200mg/500mg Tablet,Warehouse B,80,70,2025-02-12 06:25:00,10
20363,ORD_20364,14082,"Beard Growth Onion Oil - 10X Nourishing Oils For Stronger, Fluffier & Shinier Beard",Warehouse B,29,16,2025-02-12 14:59:00,13
20364,ORD_20365,13022,Biorid 50 Tablet,Warehouse B,15,2,2025-02-12 00:16:00,13
20365,ORD_20366,22288,Enzoril 50mg Tablet,Warehouse B,33,21,2025-02-12 12:22:00,12
20366,ORD_20367,13311,"Amazon Brand - Solimo Laptop Backpack for 15.6-inch Laptops (27 litres, Black)",Warehouse C,63,52,2025-02-12 13:34:00,11
20367,ORD_20368,23180,Hair Fall Control Serum,Warehouse B,39,33,2025-02-12 08:29:00,6
20368,ORD_20369,36998,Essential Souls Face Scrub for Oily Skin - Matcha 50 gm,Warehouse A,32,26,2025-02-12 23:24:00,6
20369,ORD_20370,23170,"Revlon Revlonissimo Colorsmetique Colour & Care Permanent Hair Colour, No. 5.65 Light Brown Red Mahogany, 60 Ml",Warehouse C,69,61,2025-02-12 08:18:00,8
20370,ORD_20371,22518,"Nokia 2660 Flip 4G Volte keypad Phone with Dual SIM, Dual Screen, inbuilt MP3 Player & Wireless FM Radio | Red",Warehouse C,70,55,2025-02-12 14:56:00,15
20371,ORD_20372,22516,Plantas Shine & Glow Skin Brightening Organic Face Wash 100 ml,Warehouse A,54,40,2025-02-12 01:30:00,14
20372,ORD_20373,7450,Tidoxyl 500mg Capsule,Warehouse B,45,28,2025-02-12 18:53:00,17
20373,ORD_20374,22105,"Dyazo Laptop Sleeve Compatible for 13"" / 13.3 Inch Notebook Compatible with MacBook Pro/Air & All Notebooks with 2 Front A...",Warehouse C,61,45,2025-02-12 12:19:00,16
20374,ORD_20375,13960,Dipra 0.5mg Tablet,Warehouse C,21,16,2025-02-12 08:47:00,5
20375,ORD_20376,506,Coxpride TH 60mg/4mg Tablet,Warehouse B,95,84,2025-02-12 01:28:00,11
20376,ORD_20377,36255,Moxy Mucolite Suspension,Warehouse A,103,92,2025-02-12 13:10:00,11
20377,ORD_20378,486,Rabadar 20mg Tablet,Warehouse B,74,65,2025-02-12 23:33:00,9
20378,ORD_20379,13930,The Moms Co. Natural Vitamin C Face Cream I Cleans & Brightens Skin I Oil Free Look I Instant Glow I Orange Beads I 25 gm,Warehouse C,96,85,2025-02-12 08:05:00,11
20379,ORD_20380,7232,MEDROL 8 MG CAPSULE,Warehouse A,95,78,2025-02-12 11:31:00,17
20380,ORD_20381,24091,Quantum QHM8106 USB to RJ45 Ethernet LAN Adapter (White),Warehouse A,75,60,2025-02-12 20:35:00,15
20381,ORD_20382,8300,Relmisart-H-40 Tablet,Warehouse B,64,46,2025-02-12 23:30:00,18
20382,ORD_20383,24057,Uniron S 100mg Injection,Warehouse A,62,45,2025-02-12 08:39:00,17
20383,ORD_20384,24051,Arreno Capsule ER,Warehouse A,86,73,2025-02-12 19:47:00,13
20384,ORD_20385,36294,Roll on Glass Deodorant - Musk For Men,Warehouse A,101,85,2025-02-12 04:39:00,16
20385,ORD_20386,22245,2 Ply Reusable Reversible Cotton Face Mask,Warehouse A,42,34,2025-02-12 06:27:00,8
20386,ORD_20387,24010,"LG UltraWide 29 inch (73 cm) IPS FHD, Color Calibrated, 100Hz, 7W x 2 Inbuilt Speaker, USB-C, Display Port, HDMI, White Co...",Warehouse A,11,5,2025-02-12 22:57:00,6
20387,ORD_20388,13895,"AmazonBasics 20W Phone Charger for Cellular Phones | Type C Adapter, Fast Charging (Black)",Warehouse C,33,17,2025-02-12 13:22:00,16
20388,ORD_20389,22259,Imitation Badger Shaving Brush,Warehouse B,41,32,2025-02-12 15:50:00,9
20389,ORD_20390,7284,Aeropan D 10mg/40mg Tablet,Warehouse C,28,13,2025-02-12 16:16:00,15
20390,ORD_20391,24006,CROSSVOLT Tough Rugged Cover Case Compatible with Airpods 1/2 - Black,Warehouse B,77,59,2025-02-12 19:46:00,18
20391,ORD_20392,22266,"Careflection || Bluetooth Receiver/Hands-Free Car Kit, Portable 3.5mm Bluetooth Aux Adapter Wireless Music Streaming for H...",Warehouse C,44,35,2025-02-12 17:07:00,9
20392,ORD_20393,7290,Alox 200mg Tablet,Warehouse C,12,3,2025-02-12 00:23:00,9
20393,ORD_20394,7136,TheGiftKart Crystal Clear Back Cover Case for OnePlus 9R | 360 Degree Protection | Shock Proof Design | Transparent Back C...,Warehouse C,111,92,2025-02-12 13:32:00,19
20394,ORD_20395,8375,"MINISO Synthetic Bristle Makeup Brush Set- Pink, 7 Piece",Warehouse A,107,92,2025-02-12 02:10:00,15
20395,ORD_20396,23759,Syncef T 1000mg/125mg Injection,Warehouse A,110,97,2025-02-12 13:07:00,13
20396,ORD_20397,13753,"Facejewel 4 Pcs Makeup Sponge Set Blender Beauty Foundation Blending Sponge, Flawless for Liquid,Cream, and Powder, Multi-...",Warehouse B,74,67,2025-02-12 14:00:00,7
20397,ORD_20398,26879,Deodorant Spray - Thrill Seeker,Warehouse A,33,28,2025-02-12 16:20:00,5
20398,ORD_20399,5837,Sadhev Anti Wrinkle & Radiant Glow Bathing Bar - Orange and Cinnamon 125 gm,Warehouse B,104,89,2025-02-12 10:07:00,15
20399,ORD_20400,14979,"RISSACHI Heavy Duty TV Wall Mount Bracket for 14 inch to 42 inch LCD/LED/Monitor/Smart TV, Fixed Universal TV Wall Stand (...",Warehouse B,69,61,2025-02-12 07:12:00,8
20400,ORD_20401,25947,Zona 0.25mg Tablet,Warehouse A,51,42,2025-02-12 20:07:00,9
20401,ORD_20402,9334,"LOHAYA Remote Compatible for Mi Smart LED TV 4A Remote Control (32""/43"") [ Compatible for Mi Tv Remote Control ] [ Compati...",Warehouse C,71,55,2025-02-12 12:29:00,16
20402,ORD_20403,20396,Easodil-DSR Capsule,Warehouse A,116,97,2025-02-12 07:53:00,19
20403,ORD_20404,25957,Alkorina Syrup,Warehouse C,34,21,2025-02-12 00:44:00,13
20404,ORD_20405,5813,Hynorax 25mg Tablet,Warehouse B,33,25,2025-02-12 22:31:00,8
20405,ORD_20406,20434,T 98 1000mg Infusion,Warehouse C,36,29,2025-02-12 00:03:00,7
20406,ORD_20407,15012,Revolution Pro Supreme Matte Lip Pigment-Semblance 2.5 ml,Warehouse B,33,17,2025-02-12 08:04:00,16
20407,ORD_20408,1365,CEDO Samsung Tab A7 Lite 8.7 Inch (2021) Flip Cover | Leather Finish | 360 Degree Rotate Flip Cover | Shockproof Back Cove...,Warehouse B,59,51,2025-02-12 20:53:00,8
20408,ORD_20409,1601,EGOTUDE Premium Hybrid Slim fit Rubberized Matte Semi Transparent Back Cover Case with Metallic Buttons for iPhone 12 & iP...,Warehouse A,89,77,2025-02-12 13:40:00,12
20409,ORD_20410,20823,OXYDERM ANTI AGING,Warehouse C,99,93,2025-02-12 02:12:00,6
20410,ORD_20411,5841,"La Roche Posay Effaclar Dermatological Acne Treatment System Cleanser, 100ml + Tone, 100ml and Treat, 20ml",Warehouse B,20,2,2025-02-12 22:22:00,18
20411,ORD_20412,23751,Viknim P 100 mg/500 mg Tablet,Warehouse A,23,17,2025-02-12 20:48:00,6
20412,ORD_20413,25995,Triolene 333mg Capsule,Warehouse C,90,75,2025-02-12 05:48:00,15
20413,ORD_20414,15301,Ajmal Avid & Raindropss & Blu & Aurum Deo & Yearn EDP Pack of 5 20 ml,Warehouse A,52,46,2025-02-12 12:34:00,6
20414,ORD_20415,9081,"BOBO BM4 Jaw-Grip Waterproof Bike / Motorcycle / Scooter Mobile Phone Holder Mount, Ideal for Maps and GPS Navigation (Black)",Warehouse B,55,43,2025-02-12 14:24:00,12
20415,ORD_20416,1376,Epson EcoTank L3210 A4 All-in-One Ink Tank Printer,Warehouse C,44,26,2025-02-12 11:53:00,18
20416,ORD_20417,1596,Periway DX Syrup,Warehouse C,14,3,2025-02-12 21:31:00,11
20417,ORD_20418,15296,Troxom 1000mg Injection,Warehouse C,108,99,2025-02-12 21:07:00,9
20418,ORD_20419,26028,Ozodimol MR Tablet,Warehouse B,85,79,2025-02-12 23:55:00,6
20419,ORD_20420,34722,Luminosity - Anti Pigmentation Cream,Warehouse A,80,73,2025-02-12 07:48:00,7
20420,ORD_20421,1593,"Fashion Colour Professional Makeup Kit, 1822 - 3 109.3 gm",Warehouse A,87,75,2025-02-12 12:41:00,12
20421,ORD_20422,26776,Sanfe Beauty Micellar Pack of 3 | 2 in 1 Reusable Makeup Remover and Face Exfoliating Pads | Effectively & Gently Removes ...,Warehouse A,14,1,2025-02-12 00:39:00,13
20422,ORD_20423,1632,Tear Free Baby Shampoo,Warehouse B,39,28,2025-02-12 20:13:00,11
20423,ORD_20424,34238,"Pragati Systems® Medium Grain 24x36 Inch 10 Oz. Primed Cotton Pre Stretched Canvas with Wooden Frame for Painting ACS2436,...",Warehouse B,42,24,2025-02-12 08:18:00,18
20424,ORD_20425,20270,"Oraimo 18W USB Wall Charger,3A Super Fast Charger Wall Adapter PE2.0&Quick Charge 3.0 Wall Charger Phone Adapter with 1m T...",Warehouse B,49,38,2025-02-12 08:42:00,11
20425,ORD_20426,34824,Maxxcode Fresh Airfreshener - Lavender Fresh 200 ml,Warehouse C,75,70,2025-02-12 22:32:00,5
20426,ORD_20427,12302,Wild Argan Oil Body Butter,Warehouse C,89,73,2025-02-12 19:37:00,16
20427,ORD_20428,15128,Zovifast-P Tablet,Warehouse C,74,66,2025-02-12 02:14:00,8
20428,ORD_20429,27015,"Fashion Colour Face & Body Hi - Lite Bronzer, Shade 05 4 gm",Warehouse A,106,97,2025-02-12 09:35:00,9
20429,ORD_20430,1235,Hyaluronate Collagen Essence Mask,Warehouse C,85,68,2025-02-12 04:50:00,17
20430,ORD_20431,22478,Ferrous Max Tablet,Warehouse C,45,31,2025-02-12 17:09:00,14
20431,ORD_20432,22482,Zifi 50 DT Tablet,Warehouse B,99,88,2025-02-12 21:17:00,11
20432,ORD_20433,13741,Mikanext 100mg Injection,Warehouse A,15,1,2025-02-12 02:56:00,14
20433,ORD_20434,13736,"Quench Botanics Matcha Better Anti-Shine Moisturizer, Licorice Root and Cica, Cherry Blossom | Skin-Rejuvenating Formulas...",Warehouse B,63,47,2025-02-12 17:48:00,16
20434,ORD_20435,22485,Ilaset 10mg Tablet,Warehouse B,66,55,2025-02-12 14:21:00,11
20435,ORD_20436,7441,Tocef 250mg Injection,Warehouse A,112,97,2025-02-12 17:25:00,15
20436,ORD_20437,358,"Nature Prime Vitamin E Capsules 400 IU for face, skin and hair with Evening Oil",Warehouse B,35,18,2025-02-12 15:01:00,17
20437,ORD_20438,23819,CASEOLOGY by Spigen Parallax Back Cover Case Compatible with Samsung Galaxy S23 Ultra (TPU and PC | Midnight Green),Warehouse B,115,98,2025-02-12 21:06:00,17
20438,ORD_20439,13095,"Sunscreen - Lotion, With Aloevera & Liquorice",Warehouse C,27,21,2025-02-12 19:23:00,6
20439,ORD_20440,23828,SNOOZEHUB m i New Version Smart Watch - ID116 Bluetooth Smartwatch Touch Screen Bluetooth Smart Watch Daily Activity Track...,Warehouse A,56,51,2025-02-12 23:07:00,5
20440,ORD_20441,36366,Endotif Tablet,Warehouse B,20,11,2025-02-12 03:55:00,9
20441,ORD_20442,36371,Skin Brightening Haldi & Chandan Face Wash 100 Ml,Warehouse C,73,57,2025-02-12 18:41:00,16
20442,ORD_20443,13859,Insucare M 50 Injection 40IU/ml,Warehouse B,35,18,2025-02-12 15:58:00,17
20443,ORD_20444,7305,Beauty Moisture Face Wash,Warehouse C,41,24,2025-02-12 01:50:00,17
20444,ORD_20445,23941,"MAKE UP FOR LIFE 12 Hr Liquid Lip Gloss-119, Pink Brown, 5 g",Warehouse B,77,66,2025-02-12 00:02:00,11
20445,ORD_20446,22315,M Kast 5mg Tablet,Warehouse A,46,39,2025-02-12 21:32:00,7
20446,ORD_20447,36392,Maybelline Tattoo Studio Duos - Tattoo High Impact Liner & Tattoo Smokey Gel Eye Pencil - Eye Kit Combo (Pack Of 2) 1 g + ...,Warehouse C,24,11,2025-02-12 02:02:00,13
20447,ORD_20448,7338,"RAEGR Arc One 15W Type-C PD | Made in India | Qi-Certified Wireless Charger with Fabric for iPhone 14/13/12/11/X/8 Series,...",Warehouse A,21,12,2025-02-12 20:38:00,9
20448,ORD_20449,8234,ALCRAFT Real Leather Green Stone Brown Embossed Handmade Diary with Metal Lock -Size of (H) 7*(L) 5* Brown,Warehouse B,69,62,2025-02-12 20:34:00,7
20449,ORD_20450,23910,"Faces Canada Weightless Creme Lipstick - 4 g Love Nude 09 (Brown Nude) and Faces Canada Weightless Matte Lipstick, Fuschia...",Warehouse A,48,30,2025-02-12 23:20:00,18
20450,ORD_20451,389,Opanta LS 75mg/40mg Capsule,Warehouse C,92,77,2025-02-12 22:54:00,15
20451,ORD_20452,22346,Alcer RD 30mg/20mg Capsule,Warehouse A,116,97,2025-02-12 11:27:00,19
20452,ORD_20453,13828,Relinase 5mg Injection,Warehouse B,94,84,2025-02-12 05:28:00,10
20453,ORD_20454,7362,Clotrol S Ointment,Warehouse A,65,55,2025-02-12 02:55:00,10
20454,ORD_20455,23879,Denver Black Code Talcum Powder 300GM Each - (Pack of 2) | Scented Talc for Men,Warehouse A,22,16,2025-02-12 12:23:00,6
20455,ORD_20456,7375,"MI Portable Bluetooth Speaker with 16W Hi-Quality Speaker, Type C Charging, Upto 13hrs of Playback Time & IPX7 Waterproof...",Warehouse C,71,60,2025-02-12 13:58:00,11
20456,ORD_20457,22369,"Brother DCP-T820DW - Wi-Fi & Auto Duplex Color Ink Tank Multifunction (Print, Scan & Copy) All in One Printer for Home & O...",Warehouse A,13,5,2025-02-12 15:24:00,8
20457,ORD_20458,7381,Protolock L 75mg/20mg Capsule SR,Warehouse B,66,48,2025-02-12 13:57:00,18
20458,ORD_20459,368,"Archer Tech Lab, Squall 300 RGB Gaming Laptop Cooling Pad with Aluminium Metal Grid, 5 Turbo Fans, Dual USB Ports, 7 Adjus...",Warehouse B,38,31,2025-02-12 23:07:00,7
20459,ORD_20460,857,"Wella Professionals Invigo Balance Aqua Pure Purifying Shampoo, 250 ml",Warehouse A,44,36,2025-02-12 04:11:00,8
20460,ORD_20461,845,Sparef 200mg Tablet,Warehouse B,88,82,2025-02-12 11:37:00,6
20461,ORD_20462,16866,Olmezole D 10mg/20mg Capsule SR,Warehouse A,96,85,2025-02-12 07:18:00,11
20462,ORD_20463,32164,"CodersParadise Pack of 50 Random Anime Aesthetic Vinyl Stickers for Laptop, Journal, Bike Helmet, Diary, Guitar, Mobile Ca...",Warehouse A,79,62,2025-02-12 03:09:00,17
20463,ORD_20464,17518,Sandal & Turmeric Soap 150gx4 + Bathing Soap - Sandal & Almond Milk 150gx3,Warehouse C,110,96,2025-02-12 00:15:00,14
20464,ORD_20465,9496,Amozo Back Cover for OnePlus NORD (Poly Carbonate TPU|Transparent),Warehouse C,110,94,2025-02-12 13:44:00,16
20465,ORD_20466,12161,Lcoz 1% Lotion,Warehouse A,56,40,2025-02-12 22:21:00,16
20466,ORD_20467,29412,Wet N Wild Rose Brush - Style 1 1's,Warehouse B,54,38,2025-02-12 04:39:00,16
20467,ORD_20468,1795,House Of Makeup Pout Potion Liquid Matte Lipstick - Girl Boss ,Warehouse A,82,72,2025-02-12 15:57:00,10
20468,ORD_20469,17521,Tough Lee Back Cover Case for Oneplus Nord CE 2 5G (Silicon | Transparent) (Soft & Thin Cover) (Will NOT FIT Any Other Mod...,Warehouse B,90,77,2025-02-12 12:03:00,13
20469,ORD_20470,15533,Atorkare 20mg Tablet,Warehouse C,72,64,2025-02-12 05:59:00,8
20470,ORD_20471,32155,Ajmal Nightingale And Distraction For Men & Women And Raindrops Femme Deodorants Pack of 3 200 ml,Warehouse A,76,67,2025-02-12 03:24:00,9
20471,ORD_20472,27110,Nimirite 100mg Tablet,Warehouse C,42,37,2025-02-12 16:23:00,5
20472,ORD_20473,20053,Flormar Nail Enamel 426 Red Love 11 ml,Warehouse C,20,5,2025-02-12 16:17:00,15
20473,ORD_20474,12154,Relceft 1.5gm Injection,Warehouse A,40,30,2025-02-12 15:25:00,10
20474,ORD_20475,29570,StayHappi Ceftriaxone+Sulbactam 1000mg/500mg Injection,Warehouse B,103,88,2025-02-12 16:21:00,15
20475,ORD_20476,17579,Flemiclav Forte Dry Syrup,Warehouse B,101,95,2025-02-12 16:57:00,6
20476,ORD_20477,18413,"SHIDU Portable Rechargeable Voice Amplifier with Wired Neckband Microphone, Supports AUX, USB & Micro-SD Card Input for Te...",Warehouse A,79,66,2025-02-12 19:27:00,13
20477,ORD_20478,34014,Beauty People Natural HD Matte Lip Crayon Dolce - 110 4 gm,Warehouse B,35,27,2025-02-12 05:27:00,8
20478,ORD_20479,29630,AND Love Muse EDP & Serene Bliss Body Mist Pack of 2 250 ml,Warehouse B,77,58,2025-02-12 15:49:00,19
20479,ORD_20480,5377,Relanta Collection Plain Bindis For WomensGirls || Bindis For All Occasions || Simple Design || Maroon Color || For Prospe...,Warehouse A,41,22,2025-02-12 15:30:00,19
20480,ORD_20481,27444,Nimbadi Kwath,Warehouse A,81,75,2025-02-12 21:18:00,6
20481,ORD_20482,32071,Flormar Waterproof Lipliner 241 Sour Cherry 1.14 gm,Warehouse B,37,21,2025-02-12 17:19:00,16
20482,ORD_20483,30855,"Body Wash, Fresh Pure Shower Gel, Refreshing Aquatic Scent",Warehouse B,33,15,2025-02-12 11:15:00,18
20483,ORD_20484,11089,Gasoclik IT 20mg/150mg Capsule,Warehouse C,39,21,2025-02-12 01:32:00,18
20484,ORD_20485,30857,"SONATA GOLD Series 1080p HD Bulb Light Wireless IP Camera,Fish Eye 360 Degree Panoramic Mini Lamp IR CCTV Home Security Ca...",Warehouse A,22,15,2025-02-12 02:56:00,7
20485,ORD_20486,30899,HP USB 3.1 Flash Drive 64GB 796W,Warehouse C,29,11,2025-02-12 18:04:00,18
20486,ORD_20487,27424,Absolute Ideal Tone Refinishing Night Concentrate,Warehouse A,39,32,2025-02-12 23:44:00,7
20487,ORD_20488,30859,Nimcare P 100mg/500mg Tablet,Warehouse A,9,4,2025-02-12 19:46:00,5
20488,ORD_20489,4369,Tenligress 20mg Tablet,Warehouse B,97,89,2025-02-12 01:47:00,8
20489,ORD_20490,15689,TEMPERIA Tic Tac Hair Clips for Girls (Pack of 36pcs) (5cm) (Matte Black) - Tik Tak Pins for Women,Warehouse C,95,85,2025-02-12 21:32:00,10
20490,ORD_20491,1944,Ktrol 0.2mg Tablet,Warehouse B,8,3,2025-02-12 09:35:00,5
20491,ORD_20492,27078,"Tukzer 5-Replacement Tip Compatible with Tukzer Stylus Pen for iPad Palm Rejection, 2nd Gen Compatible for (2018-2021) iPa...",Warehouse A,37,30,2025-02-12 14:33:00,7
20492,ORD_20493,29422,TheGiftKart Back Cover for Redmi 9 Power (Poly Carbonate | Black),Warehouse B,90,75,2025-02-12 16:53:00,15
20493,ORD_20494,16301,"pTron Solero 331 3.4Amps Multifunction Fast Charging Cable, 3-in-1 USB Cable Micro USB/Type-C/iOS, Made in India, Durable...",Warehouse C,103,92,2025-02-12 21:50:00,11
20494,ORD_20495,9481,Nircip 500mg Infusion,Warehouse A,53,46,2025-02-12 00:03:00,7
20495,ORD_20496,5481,Crocemol 650mg Tablet,Warehouse A,49,37,2025-02-12 10:10:00,12
20496,ORD_20497,10969,"Stbotanica Mandarin & Cypress Hand Wash, No Parabens, Sls - With Shea Butter 250 ml",Warehouse C,51,32,2025-02-12 16:42:00,19
20497,ORD_20498,27261,Lakme True Wear Color Crush Nail Color Reds 22 9 Ml,Warehouse B,12,3,2025-02-12 13:35:00,9
20498,ORD_20499,30971,DOMS X1 Pencil 10 Pcs,Warehouse A,18,1,2025-02-12 05:05:00,17
20499,ORD_20500,9566,"FINGERS Magnifico Moonlit Wired USB Keyboard (Laser-Etched, Backlit Keys with White Color Lighting, Instant Media Access, ...",Warehouse A,100,82,2025-02-12 09:36:00,18
20500,ORD_20501,5467,Terbitor 1% Cream,Warehouse C,60,55,2025-02-12 14:34:00,5
20501,ORD_20502,33829,Comb - 5 Flat Pocket Derby No 58,Warehouse B,33,27,2025-02-12 13:15:00,6
20502,ORD_20503,32243,Acifit-DSR Capsule,Warehouse A,55,39,2025-02-12 04:40:00,16
20503,ORD_20504,30952,Huchnil Adult 0.1% Nasal Spray,Warehouse C,109,94,2025-02-12 07:28:00,15
20504,ORD_20505,11064,realme Buds Q2s Bluetooth Truly Wireless in Ear Earbuds with Mic (White),Warehouse C,36,21,2025-02-12 12:29:00,15
20505,ORD_20506,32215,Onsitego 1 Year Extended Warranty for Small Appliances (Rs.5001-10000) (Email Delivery - No Physical Kit),Warehouse C,19,7,2025-02-12 04:33:00,12
20506,ORD_20507,31147,Deborah Milano Love My Lashes - Mascara Transparent 9 ml,Warehouse C,40,21,2025-02-12 11:43:00,19
20507,ORD_20508,27076,Decolin 50mg Injection,Warehouse C,100,83,2025-02-12 12:31:00,17
20508,ORD_20509,29488,SERY Satin Flawless Longwear Foundation Medium 30 ml,Warehouse C,44,27,2025-02-12 21:32:00,17
20509,ORD_20510,27057,ProElite Smart Trifold Flip case Cover for Samsung Galaxy Tab S8 Plus/S7 Plus/S7 FE 12.4 inch [SM-X800/X806/T970/T975/T97...,Warehouse B,69,58,2025-02-12 17:02:00,11
20510,ORD_20511,18488,IT-Quin 100 Capsule,Warehouse A,16,7,2025-02-12 08:42:00,9
20511,ORD_20512,3394,Nubend 400mg Tablet,Warehouse B,99,83,2025-02-12 15:55:00,16
20512,ORD_20513,12173,Nimuram Plus 100mg/500mg Tablet,Warehouse A,24,6,2025-02-12 06:16:00,18
20513,ORD_20514,11027,Medimade Anti Dandruff Conditioner (Pack of 2) 1's,Warehouse B,73,63,2025-02-12 14:26:00,10
20514,ORD_20515,34044,Jovees Peel Off Mask - Apricot & Honey 100 gm,Warehouse C,101,85,2025-02-12 17:09:00,16
20515,ORD_20516,9504,Sri Sri Tattva Mamatva Granules 250 gm,Warehouse B,34,19,2025-02-12 21:31:00,15
20516,ORD_20517,5584,Exipain MR 100mg/325mg/250mg Tablet,Warehouse A,104,85,2025-02-12 21:07:00,19
20517,ORD_20518,10408,"Amazfit T-Rex 2 Premium Multisport GPS Sports Watch, Real-time Navigation, Strength Exercise, 150+ Sports Modes& 10 ATM Wa...",Warehouse B,40,29,2025-02-12 04:56:00,11
20518,ORD_20519,1770,SToK ST-L11A A4 Lamination/Laminating Machine Hot & Cold 9 inch laminator with One Year Offsite Warranty,Warehouse C,94,80,2025-02-12 23:40:00,14
20519,ORD_20520,17474,Myglamm Lit - Ph Lip Balm - Main Squeeze 2 Gm,Warehouse A,71,62,2025-02-12 03:23:00,9
20520,ORD_20521,31122,Novatax 500mg Injection,Warehouse C,79,71,2025-02-12 01:44:00,8
20521,ORD_20522,34053,Itgoal-OC Cream,Warehouse B,95,81,2025-02-12 05:18:00,14
20522,ORD_20523,34028,House of Aroma Jasmin Joy Fragrance Oil 10 ml,Warehouse C,60,53,2025-02-12 10:03:00,7
20523,ORD_20524,5370,Yeppen Anti Gravity Lifting Facial Mask,Warehouse A,15,9,2025-02-12 19:17:00,6
20524,ORD_20525,15706,"Zitel Case with Screen Protector Compatible with Apple Watch SE 2nd gen 2022 / Series 6/5/4 SE, 40mm Hard PC Cover with Bu...",Warehouse B,35,21,2025-02-12 07:36:00,14
20525,ORD_20526,10907,Vetiver Man EDT,Warehouse B,22,12,2025-02-12 04:53:00,10
20526,ORD_20527,33730,"IFB 1.5 Ton 3 Star Heavy Duty Inverter Split AC (Copper, Convertible Flexi 8-in-1 Cooling, PM 0.3 Filter, 2022 Model, CI18...",Warehouse B,45,35,2025-02-12 07:03:00,10
20527,ORD_20528,16752,ZEBRONICS Zeb-Transformer-M Optical USB Gaming Mouse with LED Effect(White),Warehouse A,65,48,2025-02-12 08:09:00,17
20528,ORD_20529,18419,Moxiz CV Dry Syrup,Warehouse C,41,29,2025-02-12 20:48:00,12
20529,ORD_20530,16751,"Fashion Colour Proffessional Makeup Kit, Fc977 - 24 - 02 28.8 gm",Warehouse B,95,79,2025-02-12 07:24:00,16
20530,ORD_20531,29628,M.G.R.J® Portable Carrying Hard Case Cover for JBL Flip 6 / Flip 5 / Flip 4 / Flip 3 / Flip Essential (Hard|EVA|Black),Warehouse C,99,86,2025-02-12 23:38:00,13
20531,ORD_20532,27364,IKONIC Blaze Black Hair Dryer - 1800 Watts,Warehouse B,46,32,2025-02-12 00:07:00,14
20532,ORD_20533,12085,"Pink Shimmer Lollipop 2in1 Fruity Lip Balm & Lip Gloss, 7g",Warehouse C,61,45,2025-02-12 15:29:00,16
20533,ORD_20534,18416,Cardisec 120mg Tablet,Warehouse C,91,84,2025-02-12 00:11:00,7
20534,ORD_20535,10939,"POPIO Camera Lens Protector for iPhone 13 / iPhone 13 Mini (Transparent), Pack of 2",Warehouse B,55,50,2025-02-12 08:39:00,5
20535,ORD_20536,33744,Wet N Wild Color Icon Eyeshadow Quads - Sweet As Candy 4.5 gm,Warehouse B,39,32,2025-02-12 18:41:00,7
20536,ORD_20537,9600,Makeup Revolution Balayage Brow Brown 0.38 gm,Warehouse A,41,26,2025-02-12 02:03:00,15
20537,ORD_20538,27407,HP v222w 16GB USB 2.0 Pen Drive (Silver),Warehouse C,44,33,2025-02-12 14:04:00,11
20538,ORD_20539,15681,Acneclin Gel,Warehouse C,59,43,2025-02-12 11:20:00,16
20539,ORD_20540,1933,"Portronics Chicklet POR-973 Foldable QWERTY Keyboard, Mini Pocket Sized, Rechargeable, Bluetooth Wireless, One Touch Conne...",Warehouse A,95,85,2025-02-12 05:47:00,10
20540,ORD_20541,4367,Thick & Full Shampoo,Warehouse B,83,70,2025-02-12 11:40:00,13
20541,ORD_20542,2136,"Belkin USB-C to USB-C Fast Charging PD supports up to 100W Charge and Sync Ultra Flexible Silicone, Double Nylon Braided C...",Warehouse C,52,36,2025-02-12 16:49:00,16
20542,ORD_20543,27481,Algicure-M Tablet,Warehouse C,70,55,2025-02-12 17:32:00,15
20543,ORD_20544,30597,Revlon Colorstay Gel Envy Long Wear Nail Enamel - Perfect Pair 11.6 Ml,Warehouse A,17,12,2025-02-12 02:11:00,5
20544,ORD_20545,33359,Diaper Rash Cream,Warehouse C,92,84,2025-02-12 00:23:00,8
20545,ORD_20546,19040,Oxitil 250mg Tablet,Warehouse C,108,93,2025-02-12 06:32:00,15
20546,ORD_20547,10078,HP 16GB Class 10 MicroSD Memory Card (HP-MSDCWAU1-16GB),Warehouse B,95,89,2025-02-12 15:20:00,6
20547,ORD_20548,2431,"WeCool B1 Mobile Holder for Bikes or Bike Mobile Holder for Maps and GPS Navigation, one Click Locking, Firm Gripping, Ant...",Warehouse C,105,98,2025-02-12 03:08:00,7
20548,ORD_20549,28550,Tulsi Turmeric Face Wash,Warehouse A,101,84,2025-02-12 03:14:00,17
20549,ORD_20550,4764,The Face Shop Rice Ceramide Moisturizing Cream 50 Ml,Warehouse A,79,67,2025-02-12 02:44:00,12
20550,ORD_20551,10081,Berina A33 Light Blonde Hair Color Cream 60 gm,Warehouse A,88,70,2025-02-12 01:02:00,18
20551,ORD_20552,10655,Wet N Wild Proline Makeup Brush - Precision Flat Face Brush 1's,Warehouse A,14,4,2025-02-12 22:17:00,10
20552,ORD_20553,11712,Atorless 10mg Tablet,Warehouse C,60,45,2025-02-12 01:40:00,15
20553,ORD_20554,28532,Hair Oil - Amla,Warehouse C,55,38,2025-02-12 12:25:00,17
20554,ORD_20555,27334,Faces Canada Splash Nail Enamel Aurous 152 8 Ml,Warehouse C,49,30,2025-02-12 06:54:00,19
20555,ORD_20556,15656,NHS 870 Temperature Control Professional Hair Straightener,Warehouse B,46,33,2025-02-12 22:55:00,13
20556,ORD_20557,3343,"Adidas Pure Game Eau de Toilette For Men, 100ml",Warehouse A,38,25,2025-02-12 17:47:00,13
20557,ORD_20558,33800,Neofex LB 200mg Tablet,Warehouse C,61,46,2025-02-12 10:01:00,15
20558,ORD_20559,5357,Blupiflox 500mg Tablet,Warehouse B,99,94,2025-02-12 12:06:00,5
20559,ORD_20560,5351,"Screen Magnifier for Smartphone – Mobile Phone 3D HD Magnifier Screen Expanders for Movies, Videos, and Gaming – Foldable ...",Warehouse B,63,57,2025-02-12 22:12:00,6
20560,ORD_20561,32019,OpenTech® Tempered Glass Screen Protector Compatible for Xiaomi Mi 10i 5G / MI 11i / 11i Hypercharge / 11T Pro/Redmi Note ...,Warehouse A,93,83,2025-02-12 12:46:00,10
20561,ORD_20562,29250,"RPM Euro Games Pubg Gaming for Mobile Gaming. Works with BGMI, CODM & Other Shooting Games",Warehouse C,103,90,2025-02-12 04:01:00,13
20562,ORD_20563,12046,VW 80 cm (32 inches) HD Ready Android Smart LED TV VW32PRO (Black),Warehouse B,100,87,2025-02-12 19:34:00,13
20563,ORD_20564,19802,Isinac PS 100mg/325mg/15mg Tablet,Warehouse B,24,10,2025-02-12 22:34:00,14
20564,ORD_20565,30798,Biofluence Therapeutic Shampoo,Warehouse B,44,37,2025-02-12 14:51:00,7
20565,ORD_20566,18402,Skineace Nail Cutter Finger Nail Cutter for Thick and Ingrown Toenails Stainless Steel for Men's and Women (Multicolor),Warehouse A,47,32,2025-02-12 18:25:00,15
20566,ORD_20567,33646,"Wella Color Save Shampoo for Coloured Hair, 250ml",Warehouse B,20,10,2025-02-12 23:46:00,10
20567,ORD_20568,11100,Gaurcet 5mg Tablet,Warehouse A,28,12,2025-02-12 13:45:00,16
20568,ORD_20569,19796,"Vemigon Compatible with Apple Watch Straps with Rugged Case Bumper, Crystal Bands with Shockproof Protective Cover for iWa...",Warehouse C,25,20,2025-02-12 08:41:00,5
20569,ORD_20570,19855,"Day Cream With SPF 20+, Whitening & Tightening Face Cream With Moringa & Pomegranate Oil",Warehouse A,53,37,2025-02-12 15:07:00,16
20570,ORD_20571,33723,"Droposale Multi-functional Makeup Removal Facial Cleansing Pads for Women / Facial Makeup Remover, Eye Makeup Remover & Fo...",Warehouse B,111,94,2025-02-12 02:14:00,17
20571,ORD_20572,33820,Telzen 40mg Tablet,Warehouse A,108,99,2025-02-12 18:54:00,9
20572,ORD_20573,19928,Bose Quietcomfort Noise Cancelling Bluetooth Truly Wireless in Ear Earbuds with Mic with Touch Control (Triple Black),Warehouse B,17,2,2025-02-12 18:44:00,15
20573,ORD_20574,1905,Nokia 150 (2020) (Black),Warehouse B,30,13,2025-02-12 15:42:00,17
20574,ORD_20575,9579,N Tron 4mg Tablet MD,Warehouse B,61,45,2025-02-12 12:11:00,16
20575,ORD_20576,18421,Oflay OZ 200mg/500mg Tablet,Warehouse B,36,29,2025-02-12 05:02:00,7
20576,ORD_20577,3334,Purifying Neem Foaming Face Wash,Warehouse C,53,38,2025-02-12 00:42:00,15
20577,ORD_20578,4347,"ZEBRONICS XPON ONU (Optical Network Unit) | Fibre Device | Match LB-Link, 2GB,ddr3_sdram,pci_e",Warehouse B,50,37,2025-02-12 18:55:00,13
20578,ORD_20579,4342,Line Art Tattoo Needle And Disposable Tip Combo 5RL & 5RT,Warehouse A,52,43,2025-02-12 02:52:00,9
20579,ORD_20580,33795,Bxicom LB 100mg Tablet,Warehouse B,48,32,2025-02-12 23:33:00,16
20580,ORD_20581,19875,A3sprime Back Camera Lens Ring Guard Protector for Samsung Galaxy S23 Ultra 5G [9H Surface Hardness Tempered Glass with Me...,Warehouse A,106,92,2025-02-12 10:44:00,14
20581,ORD_20582,1896,Acino-DSR Capsule,Warehouse A,114,99,2025-02-12 20:22:00,15
20582,ORD_20583,17591,Pretyline 50mg/10mg Tablet,Warehouse B,110,93,2025-02-12 19:54:00,17
20583,ORD_20584,3489,Ofloled Ord Oral Suspension,Warehouse B,78,71,2025-02-12 18:30:00,7
20584,ORD_20585,3364,"Lenovo Tab M10 HD 2nd Gen (10.1 inch (25.65 cm), 3 GB, 32 GB, Wi-Fi) with Metallic Body and Octa Core Processor",Warehouse A,20,13,2025-02-12 12:30:00,7
20585,ORD_20586,11468,HP v222w 64GB USB 2.0 Pen Drive (Silver),Warehouse C,20,2,2025-02-12 05:40:00,18
20586,ORD_20587,18530,URBN 20000 mAh 20W Super Fast Charging Metal Power Bank | Type C PD (Input& Output) QC 3.0 Dual USB Output Two-Way Fast Ch...,Warehouse C,42,37,2025-02-12 05:05:00,5
20587,ORD_20588,27727,Sianorm 5mg Injection,Warehouse C,32,20,2025-02-12 02:43:00,12
20588,ORD_20589,15771,"CrossBeats Spectra max Super Retina AMOLED Always on Display Smart Watch, 1.81 Inch 368 * 448 Resolution Smartwatch, AI EN...",Warehouse C,93,88,2025-02-12 21:57:00,5
20589,ORD_20590,15784,Appetin PL Syrup,Warehouse A,115,97,2025-02-12 14:16:00,18
20590,ORD_20591,29231,Bioten M 500mg/20mg Tablet,Warehouse A,84,75,2025-02-12 05:30:00,9
20591,ORD_20592,31326,INFLACURE P 50 MG/325 MG TABLET,Warehouse B,104,95,2025-02-12 16:33:00,9
20592,ORD_20593,12014,"Zayn & Myza Breathable Nail Enamel With Raspberry & Almond Oil, Coffee Cream 6 ml",Warehouse A,96,91,2025-02-12 14:46:00,5
20593,ORD_20594,9679,"Ultra Night Sanitary Pads For Women - XXL+, Koala Soft",Warehouse C,55,36,2025-02-12 02:28:00,19
20594,ORD_20595,31327,Mistears Eye Drop,Warehouse B,64,59,2025-02-12 15:36:00,5
20595,ORD_20596,17343,"Lenovo IdeaPad Gaming 3 Intel Core i5 11th Gen 15.6"" (39.62cm) FHD IPS Gaming Laptop (8GB/512GB SSD/4GB NVIDIA GTX 1650/12...",Warehouse A,57,43,2025-02-12 17:01:00,14
20596,ORD_20597,17724,Fashion Colour Normal Eyelashes 1's,Warehouse C,102,85,2025-02-12 00:24:00,17
20597,ORD_20598,19707,Itcozole 100mg Capsule,Warehouse C,117,98,2025-02-12 17:59:00,19
20598,ORD_20599,32295,"Blue Heaven Walkfree Kajal, Black (Pack of 2) Matte Finish",Warehouse A,74,58,2025-02-12 22:57:00,16
20599,ORD_20600,29675,"Samsung Original 25W USB Travel Lightning Adapter for Cellular Phones, Black",Warehouse A,102,94,2025-02-12 11:41:00,8
20600,ORD_20601,5266,SupCares Edge to Edge Tempered Glass for Samsung Galaxy S21 FE 5G (6.4 Inch) with Easy Self Installation Kit | Black,Warehouse B,109,95,2025-02-12 02:49:00,14
20601,ORD_20602,17763,"Himalaya Herbals Moisturizing Aloe Vera Face Wash Cream, 50ml",Warehouse C,86,77,2025-02-12 15:36:00,9
20602,ORD_20603,9756,"Muuchstac Men's Herbal Beard Growth Oil - 60ml & Refreshing Ocean Face Wash - Fights Acne & Pimple, Skin Whitening & Brigh...",Warehouse A,115,99,2025-02-12 19:59:00,16
20603,ORD_20604,33420,Flupitol-M Tablet,Warehouse C,27,11,2025-02-12 16:54:00,16
20604,ORD_20605,10839,Skin Lightening Natural Fruit Bleach,Warehouse B,35,18,2025-02-12 11:44:00,17
20605,ORD_20606,11148,Pearl - Skin Whitening Facial Kit,Warehouse C,21,4,2025-02-12 01:58:00,17
20606,ORD_20607,4421,Berina A28 Dark Chocolate Hair Color Cream 60 gm,Warehouse B,32,16,2025-02-12 19:08:00,16
20607,ORD_20608,11150,Tenzima 20mg Tablet,Warehouse B,91,77,2025-02-12 01:45:00,14
20608,ORD_20609,5221,Lotus Herbals Lip Lush Rosy Rose Blush Spf 20 4 Gm,Warehouse A,85,71,2025-02-12 01:39:00,14
20609,ORD_20610,31446,Remote Compatible for Samsung LED/LCD Remote Control Works with Samsung LED/LCD TV by Trend Trail,Warehouse B,99,80,2025-02-12 14:42:00,19
20610,ORD_20611,31450,Numiglide-M 2 Tablet PR,Warehouse B,42,28,2025-02-12 19:53:00,14
20611,ORD_20612,3652,Nefcort 6mg Tablet,Warehouse C,51,33,2025-02-12 19:50:00,18
20612,ORD_20613,19571,Moisturizing Color Change to Pink Gel Lipstick for girl & woman,Warehouse A,46,36,2025-02-12 17:07:00,10
20613,ORD_20614,18616,Hifezol Gel,Warehouse A,49,41,2025-02-12 23:51:00,8
20614,ORD_20615,3207,Lezosec D 10mg/20mg Capsule,Warehouse A,86,77,2025-02-12 12:38:00,9
20615,ORD_20616,11159,Monomer 5mg/10mg Tablet,Warehouse A,52,43,2025-02-12 00:03:00,9
20616,ORD_20617,9751,Skywalk Microfiber Plastic Laptop/Computer/Keyboard Dust Cleaning Brush,Warehouse A,107,91,2025-02-12 08:38:00,16
20617,ORD_20618,19737,Rapidcold Tablet,Warehouse B,39,21,2025-02-12 03:30:00,18
20618,ORD_20619,5315,Otis D Capsule,Warehouse A,56,51,2025-02-12 08:28:00,5
20619,ORD_20620,30740,Cutspas-C Tablet,Warehouse B,54,45,2025-02-12 01:23:00,9
20620,ORD_20621,29243,VW 109 cm (43 inches) Playwall Frameless Series Full HD Android Smart LED TV VW43F1 (Black),Warehouse C,26,9,2025-02-12 22:58:00,17
20621,ORD_20622,34067,Urban Gabru Purifying Face Wash - Activated Charcoal with Apple Cider Vinegar 120 gm,Warehouse C,68,56,2025-02-12 19:15:00,12
20622,ORD_20623,2037,"Charmacy Milano Ultra Defining Eyebrow Pencil, Dark Brunette, 0.1 G",Warehouse C,22,12,2025-02-12 19:47:00,10
20623,ORD_20624,10322,"Kinsound Headphone Splitter, 3.5mm TRRS Stereo Adapter Dual Headphone Auxiliary Splitter Support Mic & Audio Compatible wi...",Warehouse A,96,79,2025-02-12 13:33:00,17
20624,ORD_20625,4165,Beauty Berry Oil Control BB Double Powder 2 IN 1 Formula Compact Powder (Beige),Warehouse C,21,9,2025-02-12 09:05:00,12
20625,ORD_20626,30739,Recard H 40mg/12.5mg Tablet,Warehouse A,104,89,2025-02-12 14:39:00,15
20626,ORD_20627,15806,Faces Canada Weightless Creme Finish Lipstick Rose Bouquet 13 4 Gm,Warehouse C,110,92,2025-02-12 16:01:00,18
20627,ORD_20628,9696,"Fashion Colour 24hrs Matte Finish Foundation, Shade 03 30 ml",Warehouse A,85,78,2025-02-12 01:05:00,7
20628,ORD_20629,30735,Insight Cosmetics HD Conceal - Sun Beige 8 gm,Warehouse B,20,1,2025-02-12 11:40:00,19
20629,ORD_20630,27633,"[Apple MFi Certified] iPhone Headphones Adapter & Splitter, 2 in 1 Dual Lightning Charger and Headphone Adapter Splitter f...",Warehouse B,83,72,2025-02-12 12:37:00,11
20630,ORD_20631,27640,DailyObjects Surge™ PD GaN 65W PPS 5x Ultra Super Fast Dual Port Type-C | Type-A Charger | Smart USB Compact Mobile Adapte...,Warehouse C,102,87,2025-02-12 15:45:00,15
20631,ORD_20632,27643,Nelzith 500mg Tablet,Warehouse A,87,72,2025-02-12 06:24:00,15
20632,ORD_20633,15802,Zedon 2mg Injection,Warehouse B,74,61,2025-02-12 04:46:00,13
20633,ORD_20634,28861,"SKY HUB V380 HD 1080P Night Vision Wireless WiFi IP Camera with 2 Way Audio and Upto 128 GB SD Card Support CCTV Camera, B...",Warehouse A,39,31,2025-02-12 15:42:00,8
20634,ORD_20635,33566,Ayurvedic Bhringaraj Hair Oil,Warehouse A,112,99,2025-02-12 00:20:00,13
20635,ORD_20636,33613,"Tenda AC10 AC1200 Wireless Smart Dual-Band Gigabit WiFi Router, MU-MIMO, 4 Gigabit Ports, 867Mbps/5 GHz+ 300Mbps /2.4GHz, ...",Warehouse C,20,14,2025-02-12 13:26:00,6
20636,ORD_20637,16711,Aloe Veda Aloe Calamine Soothing Lotion 200 ml,Warehouse C,40,30,2025-02-12 10:01:00,10
20637,ORD_20638,17686,Kartron 4mg Tablet MD,Warehouse B,96,77,2025-02-12 18:00:00,19
20638,ORD_20639,33630,Omstal 10mg/20mg Tablet,Warehouse C,40,24,2025-02-12 12:33:00,16
20639,ORD_20640,1992,Haldi & Chandan FaceWash 100ml+DeTan SPF 50 SunScreen 100g+Rosewater Toner 100ml,Warehouse A,25,16,2025-02-12 21:52:00,9
20640,ORD_20641,27547,Apple Pencil (2nd Generation),Warehouse C,76,67,2025-02-12 10:58:00,9
20641,ORD_20642,9655,"Chambor Trinity All Over Face Powder, Pink Peach Neutral 15 gm",Warehouse B,27,22,2025-02-12 03:16:00,5
20642,ORD_20643,11108,PC 2.1 A 2 USB Wall Socket Charger Power Panel Receptacle 5 Outlet Switch (White),Warehouse C,56,47,2025-02-12 10:15:00,9
20643,ORD_20644,17709,Maryaj Dynamic EDP Spicy Woody Perfume And Ajmal Evoke Silver Edition Him Deodorant Spicy Floral Fragrance 300 ml,Warehouse A,37,20,2025-02-12 10:21:00,17
20644,ORD_20645,30753,Apple iPhone 14 Pro (128 GB) - Deep Purple,Warehouse C,37,19,2025-02-12 09:43:00,18
20645,ORD_20646,11113,Vega Lip Filler Lip Liner (DMB - 03) 10 gm,Warehouse A,48,43,2025-02-12 01:25:00,5
20646,ORD_20647,30752,"iQOO Z6 Pro 5G by vivo (Phantom Dusk, 6GB RAM, 128GB Storage) | Snapdragon 778G 5G | 66W FlashCharge | 1300 nits Peak Brig...",Warehouse B,60,41,2025-02-12 13:32:00,19
20647,ORD_20648,17355,"Redmi A1 (Light Blue, 2GB RAM, 32GB Storage) | Segment Best AI Dual Cam | 5000mAh Battery | Leather Texture Design | Andro...",Warehouse A,8,3,2025-02-12 10:25:00,5
20648,ORD_20649,3586,Detox Charcoal Shower Gel,Warehouse C,37,20,2025-02-12 12:27:00,17
20649,ORD_20650,30619,Metvil 500mg/50mg Tablet,Warehouse C,31,13,2025-02-12 07:41:00,18
20650,ORD_20651,11393,Divaprix OD 500 Tablet PR,Warehouse A,62,50,2025-02-12 04:51:00,12
20651,ORD_20652,27233,NOTE ICON NAIL ENAMEL 524 9 ml,Warehouse A,105,93,2025-02-12 02:33:00,12
20652,ORD_20653,9534,Morning Energy Berry Blast Face Wash,Warehouse A,66,54,2025-02-12 21:20:00,12
20653,ORD_20654,15857,Ompra 20 Capsule,Warehouse B,22,7,2025-02-12 19:45:00,15
20654,ORD_20655,31393,"Farraige® Card Reader, USB 2.0 All-in-1 USB 2.0/USB C/Micro USB Card Reader - SD, Micro SD, SDHC, Micro SDHC, Micro SDXC M...",Warehouse B,51,38,2025-02-12 00:50:00,13
20655,ORD_20656,33488,Levcanto 500mg Tablet,Warehouse A,59,50,2025-02-12 05:43:00,9
20656,ORD_20657,5237,"realme C35 (Glowing Green, 6GB RAM, 128GB Storage)",Warehouse A,59,45,2025-02-12 17:12:00,14
20657,ORD_20658,30701,Fragrance Body Spray For Men (1000 sprays) - Forever,Warehouse C,36,20,2025-02-12 18:46:00,16
20658,ORD_20659,33457,Codistar T Syrup,Warehouse A,82,64,2025-02-12 07:31:00,18
20659,ORD_20660,9733,Claritus LS Syrup,Warehouse C,81,69,2025-02-12 14:30:00,12
20660,ORD_20661,31414,NOTE ICON NAIL ENAMEL 523 9 ml,Warehouse B,77,64,2025-02-12 10:04:00,13
20661,ORD_20662,10483,Arvpod CV 200mg/125mg Tablet,Warehouse B,96,83,2025-02-12 20:15:00,13
20662,ORD_20663,19794,Tygot Lightweight & Portable Portable 7 Feet (84 Inch) Long Tripod Stand with Adjustable Mobile Clip Holder for All Mobile...,Warehouse C,49,33,2025-02-12 22:31:00,16
20663,ORD_20664,10338,Gaptodol-TH 4 Tablet,Warehouse C,19,12,2025-02-12 11:27:00,7
20664,ORD_20665,16714,"Promega Softgels - Omega 3 Rich Fish Oil Supplements, Chocolate Flavour",Warehouse A,87,73,2025-02-12 19:41:00,14
20665,ORD_20666,5530,Total 10 Soap Bar,Warehouse A,40,24,2025-02-12 11:22:00,16
20666,ORD_20667,29548,Zobert 250 mg/250 mg Injection,Warehouse B,89,79,2025-02-12 11:15:00,10
20667,ORD_20668,17269,Nikal 400mg Tablet,Warehouse C,98,92,2025-02-12 10:46:00,6
20668,ORD_20669,29545,Diamond Facial Kit,Warehouse C,34,29,2025-02-12 06:32:00,5
20669,ORD_20670,10984,Neotea™ Thazhampoo Kumkum - Maroon Color 200gm,Warehouse B,61,56,2025-02-12 05:51:00,5
20670,ORD_20671,27161,Calliditas A Lupus Shaving Brush,Warehouse B,63,54,2025-02-12 04:38:00,9
20671,ORD_20672,15559,Azigram 500mg Tablet,Warehouse C,38,26,2025-02-12 07:44:00,12
20672,ORD_20673,27145,"MAIVED Women's & Girl's TYA 6155 Multicolor Makeup Kit and 7 Black Makeup Brushes,1 36H Eyeliner, 3in1 Eyeliner,Mascara,Ey...",Warehouse C,44,25,2025-02-12 09:07:00,19
20673,ORD_20674,27129,Pikkme Samsung Galaxy M31 / F41 / M31 Prime Smoke Cover Protective Shockproof Matte Hard Back Case Cover for Samsung Galax...,Warehouse B,112,93,2025-02-12 22:16:00,19
20674,ORD_20675,10987,Bath & Body Works Gingham Wallflowers Fragrance Refill 24 ml,Warehouse A,20,9,2025-02-12 10:19:00,11
20675,ORD_20676,29522,Stbotanica Pure Lemon Essential Oil 15 ml,Warehouse B,97,79,2025-02-12 23:09:00,18
20676,ORD_20677,27141,Anti Tan Srcub,Warehouse A,35,16,2025-02-12 16:41:00,19
20677,ORD_20678,30994,Rep D 30mg/20mg Capsule SR,Warehouse A,56,49,2025-02-12 02:47:00,7
20678,ORD_20679,29408,Eldikof D Syrup,Warehouse B,27,22,2025-02-12 06:52:00,5
20679,ORD_20680,27211,Ajmal Mukhallat Raaqi Concentrated Perfume Oil Floral Fruity Attar And Impress Concentrated Perfume Oil Citrus Attar 20 ml,Warehouse B,108,96,2025-02-12 11:48:00,12
20680,ORD_20681,33878,BayAce Capsule,Warehouse A,95,87,2025-02-12 16:09:00,8
20681,ORD_20682,5239,Biztel M 500mg/20mg Tablet,Warehouse A,23,18,2025-02-12 09:59:00,5
20682,ORD_20683,19621,Roxe Kid 50mg Tablet,Warehouse B,22,4,2025-02-12 12:55:00,18
20683,ORD_20684,2066,Pantovent D 10mg/40mg Tablet,Warehouse C,103,93,2025-02-12 13:06:00,10
20684,ORD_20685,17267,Yodel Yo-3D Bluetooth Wireless In Ear Earphones With Microphone Black,Warehouse C,18,5,2025-02-12 02:18:00,13
20685,ORD_20686,15916,Spantra Indian Rose Sugar Scrub 125 gm,Warehouse C,49,41,2025-02-12 14:59:00,8
20686,ORD_20687,33377,"OPPO A74 5G (Fantastic Purple,6GB RAM,128GB Storage) with No Cost EMI/Additional Exchange Offers",Warehouse B,99,83,2025-02-12 10:31:00,16
20687,ORD_20688,2127,House of Aroma Fragrance Oil - Citrus Forest 100 ml,Warehouse C,79,61,2025-02-12 10:17:00,18
20688,ORD_20689,17266,Kofmol Plus Tablet,Warehouse C,97,90,2025-02-12 08:50:00,7
20689,ORD_20690,10817,Acne & Oil Control Face Wash,Warehouse C,21,11,2025-02-12 13:18:00,10
20690,ORD_20691,31483,Kosfix 50mg Tablet DT,Warehouse B,74,64,2025-02-12 17:18:00,10
20691,ORD_20692,5206,"7 Days Eyebrow & Eyelash Growth Oil 30 ml | Organic -Eye Brows Eyelash Hair Growth and Volume Serum with Castor, Onion Oil...",Warehouse A,73,59,2025-02-12 00:32:00,14
20692,ORD_20693,27764,Kypen 1.37gm Syrup,Warehouse B,47,32,2025-02-12 19:33:00,15
20693,ORD_20694,19542,Navneet Youva | Spiral Long Book for students and executives | Spiral Bound with Safety lock | A4 size - 21 x 29.7 cm | Si...,Warehouse B,69,56,2025-02-12 17:26:00,13
20694,ORD_20695,2091,"All-new Kindle Paperwhite (8 GB) – Now with a 6.8"" display and adjustable warm light",Warehouse B,52,40,2025-02-12 21:53:00,12
20695,ORD_20696,31429,"Zebronics Zeb-Companion 500 2.4GHz Wireless Keyboard & Mouse Combo, USB Nano Receiver, Chiclet Keys, Ultra Silent, Power O...",Warehouse C,58,52,2025-02-12 13:59:00,6
20696,ORD_20697,27664,Vis 3 Vaginal Capsule,Warehouse B,74,68,2025-02-12 09:07:00,6
20697,ORD_20698,19593,Triple Action Hair Tonic,Warehouse B,110,96,2025-02-12 07:58:00,14
20698,ORD_20699,11130,Vega Grooming Comb (HMC - 27) 30 gm,Warehouse A,53,45,2025-02-12 15:19:00,8
20699,ORD_20700,9713,Intimate Lightening Serum,Warehouse B,62,52,2025-02-12 08:21:00,10
20700,ORD_20701,27670,Maryaj Tuxedo EDP Spicy Woody Perfume And Ajmal Silver Shade Homme Deodorant Citrus Woody Fragrance 300 ml,Warehouse C,76,67,2025-02-12 04:25:00,9
20701,ORD_20702,32311,Fulstrch-TP Tablet,Warehouse B,22,6,2025-02-12 18:20:00,16
20702,ORD_20703,33499,Ndr 25mg Injection,Warehouse A,49,37,2025-02-12 07:29:00,12
20703,ORD_20704,18604,DeBelle Gel Nail Lacquer Canopus Beige Gold With Black Glitter Nail Polish 8 ml,Warehouse C,37,20,2025-02-12 20:30:00,17
20704,ORD_20705,31374,Paraxone 1000mg Injection,Warehouse B,91,79,2025-02-12 09:54:00,12
20705,ORD_20706,2697,Charcoal Face Scrub For Men,Warehouse B,84,79,2025-02-12 10:21:00,5
20706,ORD_20707,27697,Antrima 400mg/80mg Tablet,Warehouse B,60,45,2025-02-12 05:58:00,15
20707,ORD_20708,15842,Lordif P Tablet,Warehouse A,50,36,2025-02-12 15:33:00,14
20708,ORD_20709,15848,EGOTUDE Ultra Hybrid Camera Lens Protection [Never Yellowing] Back Cover Case for iPhone 14 (Sierra Blue),Warehouse A,45,27,2025-02-12 14:25:00,18
20709,ORD_20710,5241,Amazon Brand - Solimo Mobile Cover (Soft & Flexible Back case) Transparent for Apple iPhone 6,Warehouse A,60,50,2025-02-12 10:53:00,10
20710,ORD_20711,32341,OpenTech® Tempered Glass Screen Protector Compatible with iQOO Z3 5G / iQOO Z6 5G / IQOO Z6 Lite with Edge to Edge Coverag...,Warehouse B,69,52,2025-02-12 07:22:00,17
20711,ORD_20712,33491,"Google Pixel 6a 5G (Chalk, 6GB RAM, 128GB Storage)",Warehouse B,48,33,2025-02-12 05:12:00,15
20712,ORD_20713,28528,Bright Beauty Spot-less Glow SPF 15 Day Cream,Warehouse A,54,40,2025-02-12 07:11:00,14
20713,ORD_20714,2035,Tricet 10mg Tablet DT,Warehouse C,44,28,2025-02-12 14:29:00,16
20714,ORD_20715,3020,The Moms Co. Natural Green Tea Face Cream 50 gm,Warehouse B,66,48,2025-02-12 04:16:00,18
20715,ORD_20716,27909,FIXX CLAV TABLET,Warehouse C,53,41,2025-02-12 17:27:00,12
20716,ORD_20717,11920,"Inefable® (10 Pcs with Black Pouch) Pubg Anti-Slip Thumb Sleeve, Slip-Proof Sweat-Proof Professional Touch Screen Thumbs F...",Warehouse A,27,17,2025-02-12 15:55:00,10
20717,ORD_20718,17853,"Fashion Colour Oil Control Powder, Shade 02 10 gm",Warehouse B,96,79,2025-02-12 21:52:00,17
20718,ORD_20719,17806,Moxivin LB 500mg/125mg Tablet,Warehouse C,38,23,2025-02-12 13:25:00,15
20719,ORD_20720,11525,"Fashion Colour Terra Cotta Blusher, Shade 18 16 gm",Warehouse A,11,3,2025-02-12 03:09:00,8
20720,ORD_20721,2142,Ajmal Mukhallat Raaqi Concentrated Perfume Oil Floral Fruity And Aurum Femme Deodorant Fruity Floral Fragrance 210 ml,Warehouse A,88,70,2025-02-12 01:23:00,18
20721,ORD_20722,15952,Jovees Fairness Face Wash - Grape 120 ml,Warehouse B,55,38,2025-02-12 20:01:00,17
20722,ORD_20723,10492,Drotavin 40mg Tablet,Warehouse A,20,5,2025-02-12 08:24:00,15
20723,ORD_20724,18634,"Lify Silicone Heel Cups and PU Gel Heel Protectors for Men, Heel Pads, Plantar Fasciitis Inserts, Heel Inserts, Heel Suppo...",Warehouse B,52,40,2025-02-12 18:53:00,12
20724,ORD_20725,2164,Clonopam 0.5mg Tablet MD,Warehouse C,36,23,2025-02-12 12:17:00,13
20725,ORD_20726,11903,Rabitop Tablet,Warehouse B,91,77,2025-02-12 01:40:00,14
20726,ORD_20727,4433,Bectocef 500mg/500mg Injection,Warehouse C,73,55,2025-02-12 02:52:00,18
20727,ORD_20728,19468,"HP 15s,12th Gen Intel Core i3-1215U, 15.6 inch(39.6cm) FHD IPS Laptop(8GB RAM/512 GB SSD/Intel UHD Graphics/Win 11/Backlit...",Warehouse C,38,20,2025-02-12 19:30:00,18
20728,ORD_20729,29120,Be Sat Plus 0.5mg/10mg Tablet,Warehouse C,31,17,2025-02-12 01:43:00,14
20729,ORD_20730,19444,"Fashion Colour Light Corrective Concealer Stick, Shade 02 11 gm",Warehouse B,56,40,2025-02-12 18:57:00,16
20730,ORD_20731,3698,ENVOUS Newly Launched Fire Bolt Phoenix Smartwatch Charging Cable USB Fast Charger Magnetic Charging Cable Adapter (Charge...,Warehouse C,70,51,2025-02-12 09:59:00,19
20731,ORD_20732,9966,"Sennheiser New ANC CX Plus SE True Wireless in Ear Earbuds Special Edition, Bluetooth Headphone with Mic for Music & Call...",Warehouse A,89,75,2025-02-12 23:13:00,14
20732,ORD_20733,29101,"Pearl Eyeflax Kumkum Bindi Black Round PACK OF 2 with 15 Flaps Each Box (Size 11 Diameter 1.5mm, Black Round)",Warehouse C,112,95,2025-02-12 09:42:00,17
20733,ORD_20734,4462,My.Shop Multi Color Fancy Bindis for Women with Shiny Glitter and Faux Pearl,Warehouse A,78,72,2025-02-12 17:13:00,6
20734,ORD_20735,27938,Robustrion Smart Flexible Trifold Flip Stand Case Cover for iPad Air 5th Generation Cover / iPad Air 4th Generation iPad A...,Warehouse A,60,46,2025-02-12 06:25:00,14
20735,ORD_20736,18376,Airbus 50mg Tablet,Warehouse B,90,74,2025-02-12 05:43:00,16
20736,ORD_20737,17244,Depik Plus 2 mg/25 mg Tablet,Warehouse A,26,15,2025-02-12 21:12:00,11
20737,ORD_20738,19399,Onsitego 1 Year Extended Warranty for Small Home & Kitchen Appliances from Rs. 3001-4000 (Email Delivery - No Physical Kit),Warehouse B,28,19,2025-02-12 20:51:00,9
20738,ORD_20739,11387,HAMMER KO 2.0 Wireless Bluetooth in Ear True Wireless Earbuds with Mic (Black),Warehouse B,22,8,2025-02-12 22:17:00,14
20739,ORD_20740,31525,"INOVERA (LABEL) Cosmetic Makeup Storage Holder Organizer Adjustable 360 Rotation Box, 23L x 23B x 30H cm. (Transparent)",Warehouse A,44,30,2025-02-12 15:32:00,14
20740,ORD_20741,16611,Neurostab 75mg Capsule,Warehouse A,102,87,2025-02-12 09:08:00,15
20741,ORD_20742,10752,Ceficod-AZ Tablet,Warehouse B,32,21,2025-02-12 16:19:00,11
20742,ORD_20743,28418,HP 802 Small Ink Cartridge - Black,Warehouse C,48,40,2025-02-12 17:07:00,8
20743,ORD_20744,32501,Flaxseed Oil Softgel Capsule - 1000 Mg,Warehouse A,71,64,2025-02-12 11:37:00,7
20744,ORD_20745,28302,"JSB H03 Electric Heating Pad Multipurpose for Back, Shoulder & Legs Pain Relief with Adjustable Temperature & Velcro Belt",Warehouse A,22,13,2025-02-12 05:18:00,9
20745,ORD_20746,5192,Flavedon 20 Tablet,Warehouse B,85,70,2025-02-12 09:16:00,15
20746,ORD_20747,4609,"Peiroks LCD Writing Pad/ Tablet for Kids, Study Tab, e-Slate, Notebook, Portable writting Learning Slate Erasable Electric...",Warehouse A,113,99,2025-02-12 18:57:00,14
20747,ORD_20748,27823,"Doy Aloe Natural Soap, 125 g (Pack of 6)",Warehouse C,19,14,2025-02-12 09:57:00,5
20748,ORD_20749,10806,Eveready Red AA & AAA Batteries -Multi Pack of 8 (4 AA & 4 AAA Batteries),Warehouse B,59,44,2025-02-12 09:42:00,15
20749,ORD_20750,31548,Cyclochek Capsule SR,Warehouse A,58,48,2025-02-12 14:51:00,10
20750,ORD_20751,31546,Ezimet Cream,Warehouse B,38,29,2025-02-12 14:56:00,9
20751,ORD_20752,10784,Geoflu 150mg Tablet,Warehouse A,63,45,2025-02-12 15:55:00,18
20752,ORD_20753,18676,Yuvicyp T Syrup,Warehouse A,97,89,2025-02-12 09:19:00,8
20753,ORD_20754,10785,Flash Deodorant - Body Spray,Warehouse A,23,11,2025-02-12 04:56:00,12
20754,ORD_20755,19383,"FAITH & PATIENCE Hair Removal Powder For Men & Women, Faith and Patience Camel Milk Wax 10 Min Herbal Wax, Hair Removal Bi...",Warehouse B,15,6,2025-02-12 09:30:00,9
20755,ORD_20756,31561,"S.A.V.I Full Arm Tattoo, Full Sleeve Arm Tattoo For Men, Angel Wings, Soldiers War Scene, Horses, Lion Tattoo For Girls Wo...",Warehouse B,97,86,2025-02-12 07:35:00,11
20756,ORD_20757,29738,"AirCase Office Canvas Sling Messenger Bag fits Upto 15.6"" Laptop/ MacBook, PU Leather Handles, Detachable Shoulder Strap, ...",Warehouse A,82,63,2025-02-12 13:55:00,19
20757,ORD_20758,32434,Croban Plus Oral Suspension,Warehouse B,37,26,2025-02-12 23:59:00,11
20758,ORD_20759,11855,Crextil 200 Tablet DT,Warehouse C,85,78,2025-02-12 12:16:00,7
20759,ORD_20760,17899,Lime Peel Powder - Promotes Skin Health & Vitality,Warehouse C,77,62,2025-02-12 15:35:00,15
20760,ORD_20761,10508,Miss Rose 6 Color Blusher Glow Palette 7004 - 015N 01 20 gm,Warehouse B,39,32,2025-02-12 09:20:00,7
20761,ORD_20762,33207,Domi 10mg/10mg Tablet,Warehouse C,87,80,2025-02-12 03:04:00,7
20762,ORD_20763,28030,"Fashion Colour Super Matte Lipstick, Intense Drama 4 gm",Warehouse A,51,41,2025-02-12 17:37:00,10
20763,ORD_20764,16053,Protecting Sunscreen - Aloe Vera Rose & Almond,Warehouse C,65,53,2025-02-12 19:37:00,12
20764,ORD_20765,19363,Camlin Strong Bond 200gm Glue (White),Warehouse C,67,62,2025-02-12 19:45:00,5
20765,ORD_20766,2887,"Mamaearth Milky Soft Body Lotion with Oats, Milk & Calendula - 400 ml",Warehouse C,89,71,2025-02-12 12:51:00,18
20766,ORD_20767,30489,Tryrox 150mg Tablet,Warehouse B,35,25,2025-02-12 22:15:00,10
20767,ORD_20768,29067,"Ajmal 1 Wisal Dhahab, 1 Wisal, 1 Magnetize And 1 Persuade Deodorants Pack of 4 200 ml",Warehouse B,32,17,2025-02-12 20:29:00,15
20768,ORD_20769,11377,"Vivo Y75 (Dancing Waves, 8GB RAM, 128GB ROM) with No Cost EMI/Additional Exchange Offers",Warehouse B,78,65,2025-02-12 01:45:00,13
20769,ORD_20770,29064,Biotique Bio Green Apple Fresh Daily Purifying Shampoo for Oily Scalp and Hair (340ml),Warehouse A,55,46,2025-02-12 21:33:00,9
20770,ORD_20771,32477,DC Dermacol Cream High Covering Waterproof Foundation Natural SPF 30 Make-up Cover (207-Very Light Beige with Apricot Unde...,Warehouse B,53,42,2025-02-12 16:45:00,11
20771,ORD_20772,16021,Restwel 0.5mg Tablet,Warehouse B,45,39,2025-02-12 13:18:00,6
20772,ORD_20773,30545,Absolute Hydra Pro Overnight Gel,Warehouse C,58,45,2025-02-12 23:19:00,13
20773,ORD_20774,29762,Faces Canada Hi Shine Nail Enamel Deep Tan 231 9 Ml,Warehouse B,47,41,2025-02-12 21:11:00,6
20774,ORD_20775,27775,Duleve 20mg Capsule,Warehouse C,101,85,2025-02-12 11:40:00,16
20775,ORD_20776,9792,Handwash Moisture Shield,Warehouse A,95,86,2025-02-12 05:26:00,9
20776,ORD_20777,18642,Opglim M 2mg/500mg Tablet SR,Warehouse A,35,22,2025-02-12 21:19:00,13
20777,ORD_20778,9967,wonder 20 mm strong acrylic adhesive clear double sided tape heat resistant double-sided transparent clear adhesive tape 2...,Warehouse B,96,82,2025-02-12 04:19:00,14
20778,ORD_20779,33019,Starace 5mg Tablet,Warehouse C,80,63,2025-02-12 20:52:00,17
20779,ORD_20780,17872,"SONATA GOLD Series 1440P HD WiFi Bulb Light Wireless IP WiFi Camera,Fish Eye 360 Degree Panoramic Mini Lamp IR CCTV Home S...",Warehouse C,43,24,2025-02-12 16:55:00,19
20780,ORD_20781,3104,"GRANOTONE Acrylic Venezia Metallic Colour, Non-Fading & Shimmering Metallic Acrylic Paint with Rich Pigments, Non-Toxic Me...",Warehouse B,105,99,2025-02-12 18:30:00,6
20781,ORD_20782,32482,Hand Wash - Tropical Friut,Warehouse C,17,3,2025-02-12 16:25:00,14
20782,ORD_20783,17936,Spigen QS11 Quad Car Phone Holder Magnetic Air Vent Phone Holder | QNMP Compatible with Most Smartphones - Black,Warehouse C,51,37,2025-02-12 05:14:00,14
20783,ORD_20784,10743,"Storite Optical Bay 2nd Hard Drive Caddy, Universal for 9.5mm CD/DVD Drive Slot (for SSD and HDD)",Warehouse C,98,93,2025-02-12 19:52:00,5
20784,ORD_20785,4993,Rdase-D 30mg/20mg Capsule SR,Warehouse C,16,11,2025-02-12 17:47:00,5
20785,ORD_20786,2619,"Dell Professional 24 inches, 1920 x 1080 Pixels Full HD Monitor - Wall Mountable, Height Adjustable, IPS Panel with HDMI, ...",Warehouse A,82,65,2025-02-12 01:57:00,17
20786,ORD_20787,33160,"Mamaearth Ubtan Body Wash With Turmeric & Saffron, Shower Gel For Glowing Skin 300 Ml",Warehouse B,68,62,2025-02-12 02:54:00,6
20787,ORD_20788,19322,"Matlek Wired Over Ear Gaming Headphones with Mic Surround Sound Deep Bass Works with All Mobile Phones, Ps5, Ps4, Xbox One...",Warehouse A,90,72,2025-02-12 05:48:00,18
20788,ORD_20789,16079,Belfix-O Tablet,Warehouse C,58,40,2025-02-12 08:43:00,18
20789,ORD_20790,4103,"boAt WavePro47 Made in India Smartwatch with 1.69"" HD Display, Fast Charging, Live Cricket Scores, 24H Heart Rate & SpO2 M...",Warehouse A,27,19,2025-02-12 13:34:00,8
20790,ORD_20791,10744,OpenTech® Tempered Glass Screen Protector Compatible for iPhone 12/12 Pro with Edge to Edge Coverage and Easy Installation...,Warehouse C,98,82,2025-02-12 03:17:00,16
20791,ORD_20792,11217,Gladyclav Forte Oral Suspension,Warehouse B,33,22,2025-02-12 09:34:00,11
20792,ORD_20793,11819,AmazonBasics AA Performance Alkaline Non-Rechargeable Batteries (8-Pack) - Appearance May Vary,Warehouse C,36,23,2025-02-12 15:42:00,13
20793,ORD_20794,30430,7SEVEN® Compatible for Samsung Smart 4K Ultra HD TV Monitor Remote Control Replacement of Original Samsung TV Remote for L...,Warehouse B,97,86,2025-02-12 11:16:00,11
20794,ORD_20795,30424,Alkakem Plus Liquid Ice Cream,Warehouse C,97,84,2025-02-12 18:03:00,13
20795,ORD_20796,11229,"WOW IMAGINE Polycarbonate, Thermoplastic Polyurethane Shockproof Crystal Clear Redmi A1 Back Cover Case 360 Degree Protect...",Warehouse A,99,88,2025-02-12 11:05:00,11
20796,ORD_20797,4535,"Bye Bye Dark Circles - Under Eye Cream For Dark Circles, With Cucumber & Peptide",Warehouse C,45,27,2025-02-12 12:36:00,18
20797,ORD_20798,32490,Drbudef 6/200 Capsule,Warehouse B,27,18,2025-02-12 06:47:00,9
20798,ORD_20799,3771,"Redmi Earbuds 2C Truly Wireless in Ear Earbuds with Mic, Bluetooth 5.0, Up to 12 Hours Playback, IPX4 Splash & Sweat Proo...",Warehouse B,15,4,2025-02-12 14:04:00,11
20799,ORD_20800,30417,Ayunac MR 250mg/50mg/325mg Tablet,Warehouse A,42,30,2025-02-12 00:13:00,12
20800,ORD_20801,16130,Sivanna Colors 6 Color Naked Eyeshadow Palette - HF312 02 07 gm,Warehouse B,76,57,2025-02-12 02:13:00,19
20801,ORD_20802,31678,Sivanna Colors Cookie Blush Duo - DU278 04 08 gm,Warehouse A,79,60,2025-02-12 01:05:00,19
20802,ORD_20803,28230,Doliprane 650mg Tablet,Warehouse A,20,11,2025-02-12 00:13:00,9
20803,ORD_20804,33078,Spigen Liquid Air Back Cover Case for iPhone 13 (TPU | Matte Black),Warehouse C,75,68,2025-02-12 12:30:00,7
20804,ORD_20805,28243,Thyrorich 75mcg Tablet,Warehouse C,89,78,2025-02-12 08:09:00,11
20805,ORD_20806,29046,Aloe Vera Hair Oil - Long & Strong Hair,Warehouse A,26,16,2025-02-12 05:02:00,10
20806,ORD_20807,33075,Sanim 100mg Tablet MD,Warehouse C,33,28,2025-02-12 04:39:00,5
20807,ORD_20808,11793,Fidelish® 2-Pin Universal AC Laptop Power Cable Cord Adapter Charger Laptop/Camera/Printer (Pack of 1),Warehouse A,22,3,2025-02-12 06:40:00,19
20808,ORD_20809,16323,Ceftarva-T 1000mg/125mg Injection,Warehouse B,68,59,2025-02-12 20:00:00,9
20809,ORD_20810,7873,"Ramona - Eau De Parfum, For Her",Warehouse A,45,35,2025-02-12 03:10:00,10
20810,ORD_20811,32484,Viscodyne Pet Syrup,Warehouse A,61,45,2025-02-12 13:23:00,16
20811,ORD_20812,16821,Lakme Rose Face Powder Warm Pink 40 Gm,Warehouse C,96,85,2025-02-12 00:23:00,11
20812,ORD_20813,16086,Gimete 1 Tablet SR,Warehouse A,47,28,2025-02-12 09:45:00,19
20813,ORD_20814,9965,Azifine 100mg/5ml Suspension,Warehouse B,28,16,2025-02-12 15:22:00,12
20814,ORD_20815,28272,Consta APS 100mg/325mg/15mg Tablet,Warehouse B,108,91,2025-02-12 13:58:00,17
20815,ORD_20816,30358,FEDUS 9.5V 1 Amp AC/DC Power Adapter for Cesio Keyboards with 6.5 Feet Extra-Long Power Cord Piano Adapter Power Supply fo...,Warehouse A,41,27,2025-02-12 04:37:00,14
20816,ORD_20817,33055,Afderm Plus Cream,Warehouse A,18,11,2025-02-12 20:33:00,7
20817,ORD_20818,17149,"Street27® Ear Pads Cushions Compatible with Sennheiser HD 4.50BT, HD 4.50, HD 4.50BTNC, HD 4.50SE, HD 4.40BT, HD 4.30G, HD...",Warehouse C,113,97,2025-02-12 15:07:00,16
20818,ORD_20819,19220,Cello Pinpoint Ball Pen | Pack of 10 | Blue Ball Pens | Lightweight Ball Pens | Pens with Grip | Ball pens set for School ...,Warehouse B,82,75,2025-02-12 03:46:00,7
20819,ORD_20820,2311,Mecoart 1500mcg Injection,Warehouse A,68,49,2025-02-12 13:35:00,19
20820,ORD_20821,10706,"SquadPixel Esp-32 Wifi, Bluetooth, Dual Core Chip Development Board (ESP-WROOM-32)",Warehouse B,46,36,2025-02-12 17:12:00,10
20821,ORD_20822,4924,VW 80 cm (32 inches) Linux Series Frameless HD Ready Smart LED TV VW32C2 (Black),Warehouse C,84,71,2025-02-12 15:31:00,13
20822,ORD_20823,4885,Neemli Naturals Tea Tree and Salicylic Face Wash 100 ml,Warehouse B,25,18,2025-02-12 03:54:00,7
20823,ORD_20824,19189,TheGiftKart Rugged Carbon Fibre Armor Back Cover Case for OnePlus 6T / OnePlus 7 (TPU | Blue),Warehouse C,26,15,2025-02-12 07:44:00,11
20824,ORD_20825,32981,Soulflower Rosemary Essential Oil 15 ml,Warehouse C,64,52,2025-02-12 21:18:00,12
20825,ORD_20826,30346,Amagen D 100mg/325mg/15mg Tablet,Warehouse B,86,67,2025-02-12 23:30:00,19
20826,ORD_20827,29795,Rabifeel D 30mg/20mg Capsule SR,Warehouse A,85,70,2025-02-12 03:34:00,15
20827,ORD_20828,18025,"ZM Selfie Ready Face Primer, for Smooth & Long Lasting Makeup Base, 30 ml",Warehouse A,16,6,2025-02-12 10:00:00,10
20828,ORD_20829,3063,"Samsung Galaxy M04 Dark Blue, 4GB RAM, 64GB Storage | Upto 8GB RAM with RAM Plus | MediaTek Helio P35 | 5000 mAh Battery",Warehouse C,37,24,2025-02-12 21:47:00,13
20829,ORD_20830,32965,Zebronics Zeb-Companion 107 USB Wireless Keyboard and Mouse Set with Nano Receiver (Black),Warehouse C,110,92,2025-02-12 05:25:00,18
20830,ORD_20831,29812,"O.TWO.O liquid matte long stay waterproof and smudge proof lip color lipstick for party, bridal, girl, engagement makeup l...",Warehouse B,35,18,2025-02-12 13:06:00,17
20831,ORD_20832,10530,Lenovo Casual Laptop Backpack B210 39.62 cm (15.6-inch) Water Repellent Blue,Warehouse C,44,29,2025-02-12 13:42:00,15
20832,ORD_20833,32963,Telvas H 80/12.5 Tablet,Warehouse A,65,59,2025-02-12 04:59:00,6
20833,ORD_20834,31972,Gexofen Suspension,Warehouse B,49,38,2025-02-12 19:37:00,11
20834,ORD_20835,30325,Vega Black Head Remover - Round (BHR - 02) 11 gm,Warehouse A,66,47,2025-02-12 01:01:00,19
20835,ORD_20836,3829,Brother HL-L2351DW Monochrome Laser Printer with Auto Duplex & Wi-Fi Printing,Warehouse B,88,82,2025-02-12 08:25:00,6
20836,ORD_20837,17158,Slazenger Fit Eau De Toilette Blue For Men 50 ml,Warehouse B,81,63,2025-02-12 00:00:00,18
20837,ORD_20838,10710,"pTron Newly Launched Bassbuds Zen in-Ear Wireless TWS Earbuds with Quad ENC Mic & TruTalk 50Hrs Playtime, BT5.3 Headphone ...",Warehouse C,80,66,2025-02-12 19:09:00,14
20838,ORD_20839,30453,KIPZO® Type C to 3.5mm Headphone Earphone Audio Jack Stereo Converter Connector Adapter for Samsung S10 Lite M40 S20 A80 S...,Warehouse B,17,4,2025-02-12 22:53:00,13
20839,ORD_20840,30542,Deltron 2mg Tablet,Warehouse B,25,13,2025-02-12 02:32:00,12
20840,ORD_20841,29473,X-Tenso Care Straight Shampoo,Warehouse B,45,35,2025-02-12 11:10:00,10
20841,ORD_20842,2208,Angelie Eyeshadow Palette Cosmetic Powder Makeup (35 Colors),Warehouse C,40,33,2025-02-12 09:27:00,7
20842,ORD_20843,19065,"Energizer CR2032, 3 Volt Zero Mercury Lithium Battery",Warehouse C,12,2,2025-02-12 19:00:00,10
20843,ORD_20844,4833,"Beardo UltraGlow Body Wash for Men, 200ml | Brightens and Lightens Skin Tone | Cleanses and helps lighten Tan | Contains M...",Warehouse A,86,77,2025-02-12 21:50:00,9
20844,ORD_20845,10014,Rafle 200 Tablet,Warehouse C,68,59,2025-02-12 18:18:00,9
20845,ORD_20846,10034,ENDOTONE Capsules - Reduces The Pain Associated With Endometriosis,Warehouse C,53,44,2025-02-12 07:27:00,9
20846,ORD_20847,31753,Celhep 5000IU Injection,Warehouse C,78,71,2025-02-12 23:26:00,7
20847,ORD_20848,18767,GK HAIR keratin enriched Dry Oil Shine Spray for instant shine & finish-115ML,Warehouse B,63,49,2025-02-12 06:40:00,14
20848,ORD_20849,32914,Zuath 500mg Tablet,Warehouse B,36,31,2025-02-12 14:05:00,5
20849,ORD_20850,18050,Manna Health Mix,Warehouse A,82,73,2025-02-12 07:41:00,9
20850,ORD_20851,28473,"EGOTUDE Ultra Thin Matte Anti Scratch Slim Fit Back Cover Case for iPhone 11, White",Warehouse A,98,92,2025-02-12 17:08:00,6
20851,ORD_20852,4802,Eucalyptus Oil,Warehouse A,105,86,2025-02-12 15:46:00,19
20852,ORD_20853,11732,"Fashion Colour 24hr Longwear Liquid Foundation With Skin Care, Golden 30 gm",Warehouse A,112,93,2025-02-12 23:27:00,19
20853,ORD_20854,31762,Global Desi Dreamy Daze Eau De Parfum 100ML & Star Gazer Body Mist 200ML Pack of 2 for Women Crafted by Ajmal,Warehouse B,87,70,2025-02-12 09:14:00,17
20854,ORD_20855,4554,Sinofin 250mg Tablet,Warehouse A,60,54,2025-02-12 06:00:00,6
20855,ORD_20856,30270,"Lapster USB 3.0 sata Cable for 2.5 inch SSD and HDD , USB 3.0 to SATA III Hard Driver Adapter , sata to USB Cable-(Blue)",Warehouse C,35,30,2025-02-12 09:27:00,5
20856,ORD_20857,32867,"Tukzer 3-in-1 USB Type C HUB to HDMI 4K@30Hz, 100W PD Fast Charging, USB A 3.0, 5Gbps Data Sync, MultiPort Adapter for Mac...",Warehouse C,70,58,2025-02-12 10:37:00,12
20857,ORD_20858,4790,Sheamoist Shea Butter & Real Strawberry 24 Hrs Moisturiser,Warehouse B,96,80,2025-02-12 18:44:00,16
20858,ORD_20859,11606,"HP 14s, AMD Ryzen 5-5500U 14 inches(35cm) FHD, IPS, Micro-Edge Display Laptop (8GB RAM/512GB SSD /Radeon Graphics/Windows ...",Warehouse C,30,11,2025-02-12 19:44:00,19
20859,ORD_20860,11584,"Amazon Basics New Release Nylon USB-A to Lightning Cable Cord, Fast Charging MFi Certified Charger for Apple iPhone, iPad...",Warehouse C,74,59,2025-02-12 16:18:00,15
20860,ORD_20861,18071,Ceforf 250mg Injection,Warehouse A,27,11,2025-02-12 02:00:00,16
20861,ORD_20862,17064,"Ambrane 40000mAh Lithium-Polymer Power Bank, 65W Fast Charging, MacBook & Type C Laptops Charging, Triple Output, Type-C P...",Warehouse B,88,77,2025-02-12 02:58:00,11
20862,ORD_20863,31833,"Tukzer 5-in-1 Type-C Hub to HDMI 4K@30Hz, Type C 2.0, USB 2.0, USB 3.0 Data, 100W PD with 1000M Ethernet RJ45, MultiPort A...",Warehouse A,79,62,2025-02-12 18:53:00,17
20863,ORD_20864,3911,"Dyson Pure Cool Link Air Purifier TP03 (White/Silver), Wi-Fi Enabled, Large",Warehouse B,28,22,2025-02-12 23:38:00,6
20864,ORD_20865,4694,Mcaffeine Naked & Raw Coffee Hair Conditioner 250 ml,Warehouse B,77,59,2025-02-12 17:43:00,18
20865,ORD_20866,11637,Artline Ergoline Calligraphy Pen Set with 3 Nib Sizes - Pack of 3 (Black),Warehouse B,76,59,2025-02-12 09:38:00,17
20866,ORD_20867,27050,"Oblivion Multi-Purpose Wall Holder Stand for Charging Mobile Just Fit in Socket, Support All Charger and Hang (Black)",Warehouse B,117,99,2025-02-12 18:25:00,18
20867,ORD_20868,32683,Franide Plus 100mg/500mg Tablet,Warehouse C,103,88,2025-02-12 12:12:00,15
20868,ORD_20869,2946,ND-Con 50 Injection,Warehouse C,101,86,2025-02-12 02:07:00,15
20869,ORD_20870,32684,TheGiftKart Dual-Color Leather Finish Flip Back Cover for Samsung Galaxy M31 / F41 / M31 Prime | Inbuilt Stand & Pockets |...,Warehouse C,33,20,2025-02-12 09:18:00,13
20870,ORD_20871,4648,Gemblue Biocare Strawberry Face and Body Scrub 500 ml,Warehouse A,27,20,2025-02-12 03:13:00,7
20871,ORD_20872,10148,"MYVN 20W PD Charger for iPhone 14 | iPhone 14 Pro Type C Wall Adapter with Charging Cable Compatible for iPhone 13, 12, 1...",Warehouse A,63,51,2025-02-12 08:29:00,12
20872,ORD_20873,10686,boAt Bassheads 100 Wired in Ear Earphones with Mic (Mint Green),Warehouse C,92,78,2025-02-12 18:53:00,14
20873,ORD_20874,30304,Ronixone-S 750 Injection,Warehouse C,25,13,2025-02-12 21:38:00,12
20874,ORD_20875,4816,Flormar Nail Enamel 380 Pomegranate Flower 11 ml,Warehouse B,26,19,2025-02-12 02:57:00,7
20875,ORD_20876,27994,Fungikleen MN Cream,Warehouse C,42,31,2025-02-12 04:29:00,11
20876,ORD_20877,18144,Coldest Plus Syrup,Warehouse C,89,83,2025-02-12 00:41:00,6
20877,ORD_20878,3881,Moisturising Lotion,Warehouse A,29,12,2025-02-12 09:46:00,17
20878,ORD_20879,18991,Lotus Herbals Safe Sun Skin Lightening Anti -Tan Sunblock Pa+++ Spf-30 50 Gm,Warehouse C,97,82,2025-02-12 10:47:00,15
20879,ORD_20880,11688,DOBESIL OINTMENT,Warehouse C,29,13,2025-02-12 21:24:00,16
20880,ORD_20881,18112,Pomegrante FairnessFacial Sheet Mask EX,Warehouse B,66,47,2025-02-12 06:51:00,19
20881,ORD_20882,32797,"Portronics Clamp 2 Car AC Vent Mobile Holder 360° Rotational, Strong Grip, Easy Set Up Compatible with 4 to 6 Inch Device...",Warehouse C,101,91,2025-02-12 16:22:00,10
20882,ORD_20883,17050,"Audavibe HD Telescope Zoom 90X Astronomical Refractor Portable Tripod Stand High Power. Gift for Kids, Adults, Beginners E...",Warehouse A,79,63,2025-02-12 20:10:00,16
20883,ORD_20884,18999,Ankita Make - Up - Brush with Wooden Handle and Natural Animal/Synthetic Hair (Eye Smudger),Warehouse C,13,3,2025-02-12 20:27:00,10
20884,ORD_20885,18778,"Jasmine Aroma Bath Salt For Skin Dryness - Cleanses Pores, Relaxes Muscles",Warehouse B,65,51,2025-02-12 19:34:00,14
20885,ORD_20886,16356,Telmi-H Tablet,Warehouse B,92,75,2025-02-12 08:02:00,17
20886,ORD_20887,19008,Ajmal Aura Concentrated Perfume Oil Floral Fruity Attar And Aurum Concentrated Perfume Oil Fruity Floral Attar 20 ml,Warehouse A,57,45,2025-02-12 14:32:00,12
20887,ORD_20888,18265,"Bathing Soap - Sandal, Jasmine, Rose",Warehouse B,110,94,2025-02-12 07:51:00,16
20888,ORD_20889,2435,"mobistyle Hybrid PC+TPU Soft Grip, Enhanced Metal Camera Guard Back Cover Case Compatible for iPhone 13 (Pink)",Warehouse B,74,60,2025-02-12 17:59:00,14
20889,ORD_20890,10064,MODICARE SALON PROFESSIONAL ADVANCED FORMULA SMOOTH & SHINE SHAMPOO,Warehouse A,99,84,2025-02-12 11:51:00,15
20890,ORD_20891,17060,Fashion Colour Primer + Concealer 2 In 3 8.8 gm,Warehouse C,105,94,2025-02-12 21:27:00,11
20891,ORD_20892,3861,Doloflex-SP Tablet,Warehouse A,90,73,2025-02-12 05:41:00,17
20892,ORD_20893,11269,Jovees Face Masque - Bridal Brightening 100 gm,Warehouse C,21,10,2025-02-12 08:39:00,11
20893,ORD_20894,2590,Luzei-M Kid Tablet DT,Warehouse C,21,8,2025-02-12 14:26:00,13
20894,ORD_20895,2383,Huaderm Cream,Warehouse C,58,50,2025-02-12 07:30:00,8
20895,ORD_20896,17086,"Lollipop 2in1 Fruity Lip Balm & Lip Gloss, 7g",Warehouse C,53,45,2025-02-12 09:17:00,8
20896,ORD_20897,31749,TNW-The Natural Wash BB Cream & Pure Aloe Vera Gold Gel for Flawless and Glowing Skin | With Goodness of SPF 30 & Gold Leaves,Warehouse C,88,82,2025-02-12 07:53:00,6
20897,ORD_20898,10219,Portronics My Buddy D Wood Multipurpose Movable & Adjustable Table for Computer & Laptop(Sky Blue),Warehouse A,87,72,2025-02-12 19:18:00,15
20898,ORD_20899,32543,Parker Vector Standard Fountain Pen Chrome Trim Fine Nib with 3 Free Ink Cart | Body Color - Orange | Ink Color - Blue,Warehouse C,24,19,2025-02-12 14:29:00,5
20899,ORD_20900,32921,Norista 5mg Tablet,Warehouse C,14,4,2025-02-12 14:41:00,10
20900,ORD_20901,3026,Alergevo M 5mg/10mg Tablet,Warehouse A,82,71,2025-02-12 06:52:00,11
20901,ORD_20902,4046,Aclan SP 100mg/325mg/15mg Tablet,Warehouse C,82,69,2025-02-12 21:13:00,13
20902,ORD_20903,33356,SUGAR Cosmetics Kohl Of Honour Intense Kajal - 06 Blue Moon (Single Blister) 0.25 gm,Warehouse C,93,80,2025-02-12 12:34:00,13
20903,ORD_20904,2498,Faces Canada Ultime Pro Face Palette Glow02 12 Gm,Warehouse A,102,88,2025-02-12 20:01:00,14
20904,ORD_20905,28674,Rax 10mg Tablet,Warehouse C,83,71,2025-02-12 21:22:00,12
20905,ORD_20906,28911,Monvent FX 10mg/120mg Tablet,Warehouse B,90,79,2025-02-12 20:43:00,11
20906,ORD_20907,4688,Boujee Beauty Lip Brush B316 135 gm,Warehouse C,8,2,2025-02-12 03:48:00,6
20907,ORD_20908,32775,Revlon ColorSilk Hair Color with Keratin - 4G Medium Golden Brown 91.8 ML,Warehouse C,10,1,2025-02-12 10:29:00,9
20908,ORD_20909,2457,"Fashion Colour Vivid Matte Lipstick, 23 Chestnut 3.8 gm",Warehouse A,42,34,2025-02-12 23:05:00,8
20909,ORD_20910,30039,"BlueRigger in-Wall High Speed 18Gbps HDMI Cable - CL3 Rated - Supports 4K 60Hz, Ultra HD, 3D, 1080p, Ethernet and Audio Re...",Warehouse B,30,15,2025-02-12 15:42:00,15
20910,ORD_20911,4674,iSTAR TV Set Top Box Stand with Remote Holder Wall Mount Shelf DTH Stand for WiFi Router Stand All Type of Set Top Box (Bl...,Warehouse A,49,35,2025-02-12 16:27:00,14
20911,ORD_20912,11324,Spigen Rugged Armor Cover Case Compatible with Airpods Pro 2 (2022) - Matte Black,Warehouse B,35,22,2025-02-12 15:13:00,13
20912,ORD_20913,10201,Acnoklin-Rs Gel Face Wash,Warehouse B,20,15,2025-02-12 00:55:00,5
20913,ORD_20914,16436,Flemnil Capsule,Warehouse C,17,11,2025-02-12 21:14:00,6
20914,ORD_20915,2961,Zivast 40mg Tablet,Warehouse A,46,34,2025-02-12 17:27:00,12
20915,ORD_20916,29854,"Fashion Colour Non - Transfer Matt Waterproof Lipstick, 40 Dull Violet 2.6 gm",Warehouse A,114,97,2025-02-12 16:06:00,17
20916,ORD_20917,4671,Natural Stretch Marks Oil,Warehouse C,23,13,2025-02-12 14:26:00,10
20917,ORD_20918,18888,Prozol-P Tablet,Warehouse A,24,19,2025-02-12 08:05:00,5
20918,ORD_20919,30016,"Swisspers Facial Wet Wipes, 25 Wipes (Original, Pack of 2)",Warehouse C,26,10,2025-02-12 19:24:00,16
20919,ORD_20920,2488,LOHAYA AC Remote Compatible for IFB Split AC Remote Control (AC-204),Warehouse C,68,50,2025-02-12 11:45:00,18
20920,ORD_20921,32710,"FCL Strengthening hair conditioner for women | Hair conditioner for men & women, strengthens hair | Shiny & healthy hair |...",Warehouse A,95,89,2025-02-12 18:36:00,6
20921,ORD_20922,29872,Ludin 20mg Tablet,Warehouse B,30,15,2025-02-12 21:24:00,15
20922,ORD_20923,2926,Ringloc 1% Cream,Warehouse A,58,45,2025-02-12 10:44:00,13
20923,ORD_20924,28937,Cello Power Line Highlighter - Pack of 10 (Multicolor),Warehouse C,93,86,2025-02-12 14:09:00,7
20924,ORD_20925,16236,"WeCool G2 Gimbal with LED Fill Light for Phones, Anti-Shake 1-Axis Gimbal Stabilizer with 360° Rotation with Bluetooth Rem...",Warehouse C,52,38,2025-02-12 12:09:00,14
20925,ORD_20926,31738,Damcid OX Oral Suspension,Warehouse C,35,30,2025-02-12 16:00:00,5
20926,ORD_20927,29078,"Vero Forza Arctic Wireless Mobile Cooler for Gaming, Phone Cooler, for Bgmi, Pubg, Cod, Freefire & Fortnite(iPhone/Android)",Warehouse A,92,82,2025-02-12 15:35:00,10
20927,ORD_20928,3718,Medivas 20mg Tablet,Warehouse C,104,88,2025-02-12 05:31:00,16
20928,ORD_20929,33222,SUGAR Cosmetics Blend The Rules Eyeshadow Palette - 03 Fantasy (Mauve) 10.4 gm,Warehouse C,108,89,2025-02-12 00:36:00,19
20929,ORD_20930,11863,EMBOX 10A Extension board with usb port - 4 Universal Sockets and 3 USB (2.4 A) charging Ports with Indicator and Overload...,Warehouse A,92,80,2025-02-12 13:00:00,12
20930,ORD_20931,3717,OpenTech® Tempered Glass Screen Protector Compatible for Xiaomi Mi 11 Lite/Xiaomi Mi 11 Lite NE/Xiaomi Mi 11 Lite 5G with ...,Warehouse B,16,4,2025-02-12 07:08:00,12
20931,ORD_20932,16985,Soulflower Peppermint Essential Oil 15 ml,Warehouse C,68,54,2025-02-12 23:09:00,14
20932,ORD_20933,2979,"Fashion Colour Vivid Matte Lipstick, 5 Dica Purple 3.8 gm",Warehouse A,89,73,2025-02-12 15:56:00,16
20933,ORD_20934,32728,"Fashion Colour Proffessional Makeup Kit, Fc948 - 02 62.4 gm",Warehouse C,27,16,2025-02-12 16:20:00,11
20934,ORD_20935,18906,Amazon Basics RJ45 Cat-6 Ethernet Patch Internet Cable For Personal Computer - 50 Feet (15.2 Meters) (Black),Warehouse A,59,52,2025-02-12 08:49:00,7
20935,ORD_20936,11620,Parker Aster Shiny Chrome Gold Trim Roller Ball Pen | Body Color - Shiny chrome | Ink Color - Blue,Warehouse B,37,28,2025-02-12 08:41:00,9
20936,ORD_20937,28713,Dicdase 50 mg/10 mg Tablet,Warehouse A,26,18,2025-02-12 15:12:00,8
20937,ORD_20938,18174,Rosuzun 10mg Tablet,Warehouse A,28,9,2025-02-12 12:54:00,19
20938,ORD_20939,11349,Caldipree Silicone Case Cover Compatible for 2022 Samsung Smart TV Remote QLED TV BN68-13897A TM2280E (2022-BLACK),Warehouse B,33,20,2025-02-12 12:20:00,13
20939,ORD_20940,28769,Face and Body Mist - Frankincense,Warehouse B,48,29,2025-02-12 09:08:00,19
20940,ORD_20941,4632,"Retinol 2.5% + Vitamin E, C & Hyaluronic Acid Professional Face Serum",Warehouse C,70,55,2025-02-12 11:26:00,15
20941,ORD_20942,4023,"ProElite Faux Leather Smart Flip Case Cover for Apple iPad 10.2"" 9th Gen (2021) / 8th Gen / 7th Gen with Stylus Pen, Black",Warehouse B,95,80,2025-02-12 18:08:00,15
20942,ORD_20943,18837,Valeptol Syrup,Warehouse B,98,90,2025-02-12 16:15:00,8
20943,ORD_20944,11347,"Softly Print 12A Q2612A Toner Cartridge for HP Laserjet Laserjet 1010, 1012, 1018, 1020, 1020 Plus, 1022, 3050, 3052, 3055...",Warehouse C,43,33,2025-02-12 16:04:00,10
20944,ORD_20945,4626,Omron HN 286 Ultra Thin Automatic Personal Digital Weight Scale With Large LCD Display and 4 Sensor Technology For Accurat...,Warehouse A,46,27,2025-02-12 21:19:00,19
20945,ORD_20946,11611,Lavender Patchouli Hair Cleanser,Warehouse A,24,12,2025-02-12 17:36:00,12
20946,ORD_20947,10169,Hyceft 250mg Tablet,Warehouse C,40,34,2025-02-12 14:58:00,6
20947,ORD_20948,16489,HP 680 Ink Cartridges Combo Pack (1 Black Cartridge + 1 tri-Color Cartridge),Warehouse C,16,10,2025-02-12 06:29:00,6
20948,ORD_20949,4024,"DYAZO Slim 15 "" to 15.6 Inch Laptop Sleeve, Laptop Case with Handle & Accessories Pocket Universal Compatible for Dell, H...",Warehouse C,65,60,2025-02-12 13:12:00,5
20949,ORD_20950,16381,Vega Graduated Dressing Comb (HMSC - 01D) 46 gm,Warehouse A,91,81,2025-02-12 08:36:00,10
20950,ORD_20951,31915,"Dyazo 10 Inch LED Ring Light with 3 Level Brightness Dimmable Lighting for Vlogging , You Tube Video , Photo Shoot Live St...",Warehouse A,37,31,2025-02-12 16:12:00,6
20951,ORD_20952,28898,Azafran Organics Daily 3 In 1 Moisturizer 50 gm,Warehouse A,70,52,2025-02-12 07:19:00,18
20952,ORD_20953,2965,Levoget 500 Tablet,Warehouse A,29,15,2025-02-12 14:27:00,14
20953,ORD_20954,30061,"3M Scotch Magic Tape Roll (2N) with Refillable Dispenser | 1.9cm x 25.4 Meter | Invisible, writable and Hand tearable | fo...",Warehouse C,75,64,2025-02-12 05:21:00,11
20954,ORD_20955,30123,"Aroma Magic Almond Moisturising Lotion, 200ml",Warehouse A,86,71,2025-02-12 00:37:00,15
20955,ORD_20956,30049,Karbonn 80 cm (32 inches) Millenium Bezel-Less Series HD Ready Smart LED TV KJW32SKHD (Phantom Black),Warehouse B,18,6,2025-02-12 04:41:00,12
20956,ORD_20957,28704,Blumox LB 250mg/60Million spores Tablet,Warehouse A,28,11,2025-02-12 00:41:00,17
20957,ORD_20958,32602,Snee AM Tablet,Warehouse C,50,45,2025-02-12 15:56:00,5
20958,ORD_20959,28903,Atorcia 20mg Tablet,Warehouse B,105,90,2025-02-12 12:47:00,15
20959,ORD_20960,16502,Zemoxy-CVL Tablet,Warehouse B,98,86,2025-02-12 08:03:00,12
20960,ORD_20961,2949,Syofex M Tablet,Warehouse A,57,39,2025-02-12 22:25:00,18
20961,ORD_20962,31674,"Spigen Leather, Thermoplastic Polyurethane Rugged Armor Pro Back Cover Case Designed for Samsung Galaxy Tab S7 FE 5G | S7 ...",Warehouse C,19,8,2025-02-11 11:58:00,11
20962,ORD_20963,12091,"(Renewed) Lenovo ThinkPad T450 Intel Core i5-5300U 14 inches Business Laptop Computer, 8GB RAM, 256GB SSD, Windows 10, 1.1...",Warehouse B,81,66,2025-02-11 10:06:00,15
20963,ORD_20964,785,"O.P.I Nail Polish and Nail Lacquer Drying Drops, Tickle My France-Y, 15ml",Warehouse C,90,78,2025-02-11 01:49:00,12
20964,ORD_20965,12978,Aura Concentrated Floral Perfume Free From Alcohol For Women,Warehouse A,28,14,2025-02-11 15:58:00,14
20965,ORD_20966,621,Ibugesic Plus Oral Suspension Orange,Warehouse A,79,67,2025-02-11 10:18:00,12
20966,ORD_20967,31669,Revolution Pro Supreme Matte Lip Pigment-Veil 2.5 ml,Warehouse A,77,67,2025-02-11 01:38:00,10
20967,ORD_20968,32782,FZ 200mg Tablet,Warehouse C,115,98,2025-02-11 00:46:00,17
20968,ORD_20969,1907,"Wipro Smart extension, White (DSE2150)",Warehouse A,37,27,2025-02-11 09:55:00,10
20969,ORD_20970,32784,"Classmate Premium 6 Subject Spiral Notebook - 203mm x 267mm, Soft Cover, 300 Pages, Unruled",Warehouse B,68,63,2025-02-11 19:48:00,5
20970,ORD_20971,3088,Herbal Gold Peel Off Mask,Warehouse A,109,95,2025-02-11 19:33:00,14
20971,ORD_20972,15636,Koff Syrup,Warehouse C,71,59,2025-02-11 00:09:00,12
20972,ORD_20973,603,Neev Herbal Handmade Soap - Charcoal Soap (3x75g) | Organic Handmade Soap For Men and Women | Paraben Free & Sulphate Free...,Warehouse C,41,29,2025-02-11 06:29:00,12
20973,ORD_20974,15663,Clavox 500mg Tablet,Warehouse A,86,79,2025-02-11 10:07:00,7
20974,ORD_20975,12985,DOMS Magnetic Whiteboard Duster with 2 Whiteboard Marker,Warehouse C,56,42,2025-02-11 04:07:00,14
20975,ORD_20976,31648,Miss Rose Matte Smudge Proof LipGloss 7701 - 002M 03,Warehouse C,24,16,2025-02-11 04:46:00,8
20976,ORD_20977,600,"PTron Newly Launched Force X11P Bluetooth Calling Smartwatch with 1.3"" Full Touch Display, Heart Rate Tracking, SpO2, 100s...",Warehouse C,66,47,2025-02-11 06:37:00,19
20977,ORD_20978,15668,"Imou WiFi Wireless Security Camera 256GB SD Card Support, 1080P Full HD, Audio Recording, Night Vision, Abnormal Sound Ala...",Warehouse B,111,95,2025-02-11 14:08:00,16
20978,ORD_20979,3111,FOK Women's Non Precious Metal Minimalist Moon Circle Infinity Design Hair Clip Pin for Girls & Women (Multicolour) Set of...,Warehouse A,24,17,2025-02-11 21:41:00,7
20979,ORD_20980,36137,"Crysendo Headphone Cushion for Boat Rockers 550 Headset Replacement Ear Cushion | Earpads, Ear Cups Soft Protein Leather, ...",Warehouse A,84,73,2025-02-11 01:24:00,11
20980,ORD_20981,17184,Azivar 250mg Tablet,Warehouse A,60,48,2025-02-11 16:33:00,12
20981,ORD_20982,2438,Lakme True Wear Nail Color Shade D416 9 Ml,Warehouse B,46,28,2025-02-11 14:43:00,18
20982,ORD_20983,570,"Sounce 360 Adjustable Mobile Phone Holder, Universal Phone Holder Clip Lazy Bracket Flexible Gooseneck Clamp Long Arms Mou...",Warehouse A,70,64,2025-02-11 12:29:00,6
20983,ORD_20984,17189,Allure Flat Blending Brush (c-17) 1's,Warehouse A,20,11,2025-02-11 22:26:00,9
20984,ORD_20985,14156,Triben F 150mg Tablet,Warehouse B,87,72,2025-02-11 13:32:00,15
20985,ORD_20986,31718,SHENY WATERPROOF PINK LONGLASTING MAKEUP BLUSHER FOR ALL TYP SKIN MAKEUP,Warehouse C,40,29,2025-02-11 04:45:00,11
20986,ORD_20987,31689,Zoclox Capsule,Warehouse A,81,64,2025-02-11 16:48:00,17
20987,ORD_20988,33836,NP Com Tablet,Warehouse A,20,4,2025-02-11 03:57:00,16
20988,ORD_20989,16526,"Samsung Galaxy S23 5G (Lavender, 8GB, 256GB Storage)",Warehouse B,87,82,2025-02-11 14:53:00,5
20989,ORD_20990,11241,Sery Melt Up Makeup Removing Wipes 1's,Warehouse A,89,82,2025-02-11 22:11:00,7
20990,ORD_20991,15472,Foxis Syrup,Warehouse C,95,77,2025-02-11 22:34:00,18
20991,ORD_20992,14437,Sanface Skin Tightening Sandal Glow Pack,Warehouse A,7,2,2025-02-11 07:46:00,5
20992,ORD_20993,770,XPG ADATA GAMMIX D30 DDR4 8GB (1x8GB) 3200MHz U-DIMM Desktop Memory - AX4U32008G16A-SR30,Warehouse A,24,9,2025-02-11 07:22:00,15
20993,ORD_20994,31943,Belkin F3Y021bt2M High Speed HDMI Cable with Ethernet - 2 Meter (Black),Warehouse C,82,67,2025-02-11 11:16:00,15
20994,ORD_20995,32595,Moxtal K Eye Drop,Warehouse C,25,13,2025-02-11 19:21:00,12
20995,ORD_20996,35578,Ajmal Wisal Dhahab And Magnetize Deodorants Pack of 2 200 ml,Warehouse B,35,16,2025-02-11 04:33:00,19
20996,ORD_20997,31926,Oltha 7.5mg Tablet,Warehouse A,39,26,2025-02-11 04:10:00,13
20997,ORD_20998,35592,"Maybelline New York Color Sensational Loaded Bold Lipstick, Midnight Date, 3.9g and Maybelline Hyper Glossy Liquid Liner, ...",Warehouse C,82,69,2025-02-11 12:45:00,13
20998,ORD_20999,34192,Sanitize Gamma - Hand Sanitizing Rub,Warehouse B,62,54,2025-02-11 08:43:00,8
20999,ORD_21000,14421,The Moms Co. Vita Rich Face Cream 50 ml,Warehouse B,104,89,2025-02-11 14:14:00,15
21000,ORD_21001,14393,Berina A38 Light Ash Blonde Hair Color Cream 60 gm,Warehouse A,44,31,2025-02-11 06:15:00,13
21001,ORD_21002,865,"Xiaomi Selfie Stick with Micro USB Rechargeable Bluetooth Remote, Tripod Stand, Multifunctional Selfie Stick with Extendab...",Warehouse B,73,63,2025-02-11 01:22:00,10
21002,ORD_21003,34167,Onford 4 Tablet,Warehouse B,52,40,2025-02-11 06:41:00,12
21003,ORD_21004,11614,Orange Body Wash Soap,Warehouse B,44,28,2025-02-11 03:22:00,16
21004,ORD_21005,15445,Furaget 125mg Dry Syrup,Warehouse C,74,69,2025-02-11 12:13:00,5
21005,ORD_21006,901,Ajmal Prose EDP & Nightingale Deodorant Pack of 2 300 ml,Warehouse B,19,13,2025-02-11 16:13:00,6
21006,ORD_21007,36021,Evermentin 625 Tablet,Warehouse B,32,15,2025-02-11 02:05:00,17
21007,ORD_21008,35615,"Body Lotion For Very Dry Skin - Cocoa Nourish, With Coconut Oil & Cocoa Butter, For Men & Women",Warehouse C,98,84,2025-02-11 07:28:00,14
21008,ORD_21009,11338,Aroint 500mg Capsule,Warehouse A,42,35,2025-02-11 16:24:00,7
21009,ORD_21010,2539,Escepam 0.5mg/10mg Tablet,Warehouse C,84,75,2025-02-11 22:57:00,9
21010,ORD_21011,15492,"Sounce New Version Screen Expanders & Screen Magnifier Amplifier,3D HD New Phone Holder for Smartphones- with 1 Year Repla...",Warehouse A,70,53,2025-02-11 02:35:00,17
21011,ORD_21012,874,Moxinova 500mg Capsule,Warehouse C,42,30,2025-02-11 22:38:00,12
21012,ORD_21013,2955,Contramal 100 Injection,Warehouse C,21,14,2025-02-11 13:27:00,7
21013,ORD_21014,11623,Angitrate 10mg Tablet,Warehouse B,93,80,2025-02-11 01:39:00,13
21014,ORD_21015,11326,CEDO Clear Case for iPhone 13 | Soft Flexible Full Protection Shock Proof TPU Back Cover for iPhone 13 (Transparent),Warehouse A,61,52,2025-02-11 08:39:00,9
21015,ORD_21016,12862,Rezol 400mg Tablet,Warehouse C,21,3,2025-02-11 08:20:00,18
21016,ORD_21017,31822,Ajmal Deep Earth & Primitive Forests EDT Pack of 2 500 ml,Warehouse A,46,38,2025-02-11 23:39:00,8
21017,ORD_21018,35795,Zaporil 25mg Tablet,Warehouse A,62,46,2025-02-11 03:23:00,16
21018,ORD_21019,36076,"Glowhouse Make Up Combo Kit For Girls & Women, 1Makeup Fixer, 1 Primer, 2 In 1 Concealer And Highlighter Stick, 1 High Def...",Warehouse B,73,60,2025-02-11 04:34:00,13
21019,ORD_21020,11246,iFFALCON 108 cm (43 inches) 4K Ultra HD Smart LED Google TV iFF43U62 (Black),Warehouse A,44,37,2025-02-11 20:42:00,7
21020,ORD_21021,11257,Bejoy 100% Pure & Natural White Sandalwood Powder(100 GRAM),Warehouse C,78,64,2025-02-11 01:02:00,14
21021,ORD_21022,15680,"LIDBOX Foldable Wooden Mini Laptop Table for Bed, Study Table with Drawer, Tablet/Mobile Holder for Kids & Adults (Black)",Warehouse C,102,97,2025-02-11 01:16:00,5
21022,ORD_21023,14242,Make Up Remover+Brightening Nigt Cream,Warehouse C,26,16,2025-02-11 03:08:00,10
21023,ORD_21024,16811,Barefoot Foot Care Cream - Hydration For Dry & Cracked Heels,Warehouse A,92,73,2025-02-11 17:56:00,19
21024,ORD_21025,11451,M Cobal G 300mg/500mcg Tablet,Warehouse C,75,69,2025-02-11 18:02:00,6
21025,ORD_21026,12483,Tobracid Eye Ointment,Warehouse B,36,30,2025-02-11 15:06:00,6
21026,ORD_21027,2679,"BESTOR® USB Hub 4 in 1, USB to USB Hub,Portable 4 Ports USB Splitter Mini USB Docking Station with 5Gbps Fast Data Transfe...",Warehouse B,32,17,2025-02-11 09:35:00,15
21027,ORD_21028,1341,Oriflame Pure Colour Pressed Powder Light 20G,Warehouse B,37,28,2025-02-11 06:44:00,9
21028,ORD_21029,12336,Elegance Deodorant - For Men,Warehouse C,77,59,2025-02-11 02:09:00,18
21029,ORD_21030,15220,Diclogesic Plus 250mg/50mg/325mg Tablet,Warehouse B,106,88,2025-02-11 20:26:00,18
21030,ORD_21031,12498,Cyclodor 1% Eye Drop,Warehouse A,27,12,2025-02-11 19:32:00,15
21031,ORD_21032,15227,Intern INT-38C Acoustic Guitar Kit (Blue),Warehouse B,113,99,2025-02-11 12:42:00,14
21032,ORD_21033,34459,Alinflox Tablet,Warehouse A,93,79,2025-02-11 15:37:00,14
21033,ORD_21034,1562,Stenbar 20 Tablet,Warehouse A,73,63,2025-02-11 14:44:00,10
21034,ORD_21035,1564,Nandate 25mg Injection,Warehouse C,45,28,2025-02-11 18:24:00,17
21035,ORD_21036,16450,Tata Sky Digital TV HD Setup Box Remote,Warehouse C,79,64,2025-02-11 19:32:00,15
21036,ORD_21037,34852,Expectus LS Oral Drops,Warehouse C,108,98,2025-02-11 17:20:00,10
21037,ORD_21038,32380,"MI Type B/Micro USB 120cm fast Charging cable|480mbps support|Suitable for all Smartphones,tablet and accessories with typ...",Warehouse C,40,21,2025-02-11 06:54:00,19
21038,ORD_21039,1568,"Ant Esports 690 Neo Sata 2.5"" 256 GB SSD Internal Solid State Drive (SSD) with SATA III Interface, 6Gb/s, Fast Performanc...",Warehouse B,87,79,2025-02-11 01:45:00,8
21039,ORD_21040,12526,SUNISA 1 BB CC Cream Foundation With 1 Mushroom Head Air Cushion 20g and 10pcs Black Makeup Brushes Set - (Pack of 12),Warehouse A,67,52,2025-02-11 11:37:00,15
21040,ORD_21041,2802,"ProElite Smart Case Cover for Apple iPad Pro 11 inch (27.9cm) 2022/2021 4th/3rd Generation [Auto Sleep/Wake ], Translucent...",Warehouse A,65,58,2025-02-11 00:54:00,7
21041,ORD_21042,32409,"JBL C50HI, Wired in Ear Headphones with Mic, One Button Multi-Function Remote, Lightweight & Comfortable fit (Red)",Warehouse C,16,10,2025-02-11 16:22:00,6
21042,ORD_21043,16827,Camnerv P 1500mcg/75mg Tablet,Warehouse A,52,45,2025-02-11 10:19:00,7
21043,ORD_21044,14854,Beardo Night Shot Vitamin C Face Serum 30 ml,Warehouse A,94,86,2025-02-11 09:37:00,8
21044,ORD_21045,12546,Pinfix 200mg Tablet DT,Warehouse C,40,34,2025-02-11 18:03:00,6
21045,ORD_21046,34414,"Bath & Body Brush - Transparent, Colour May Vary",Warehouse A,54,44,2025-02-11 04:15:00,10
21046,ORD_21047,34751,"Naturally Soft Sanitary Napkin - Regular, 230 mm",Warehouse A,107,95,2025-02-11 09:00:00,12
21047,ORD_21048,1687,"GIZGA Essentials Portable Tabletop Tablet Stand Mobile Holder, Desktop Stand, Cradle, Dock for iPad, Smartphone, Kindle, ...",Warehouse B,99,94,2025-02-11 22:42:00,5
21048,ORD_21049,34620,Azirich Forte Suspension,Warehouse B,20,7,2025-02-11 20:13:00,13
21049,ORD_21050,32361,Ciffy O Dry Syrup,Warehouse B,81,70,2025-02-11 08:47:00,11
21050,ORD_21051,34759,"Honeywell Ultra-High-Speed HDMI 2.1 Cable with Ethernet, 48 GBPS Transmission Speed, Supports 8k@60Hz UHD Resolution, Dolb...",Warehouse A,65,51,2025-02-11 03:13:00,14
21051,ORD_21052,14997,TheGiftKart Shockproof Crystal Clear Back Cover Case for Samsung Galaxy A73 5G | 360 Degree Protection | Protective Design...,Warehouse B,42,35,2025-02-11 06:01:00,7
21052,ORD_21053,2775,UNI-BALL UNJSP101BL6 Jetstream Roller Ball Pen Set - Pack of 6 (Blue),Warehouse C,29,11,2025-02-11 14:17:00,18
21053,ORD_21054,32723,DeLegarde® Small Bindi Fancy Bindis Tikka for Girls Women Ladies Multi Colour,Warehouse B,29,18,2025-02-11 22:58:00,11
21054,ORD_21055,33892,"HIKVISION 2MP Eco HD 1080P Night Vision Bullet Outdoor Wired CCTV Camera for 2MP & Above DVRs, White",Warehouse B,30,18,2025-02-11 19:22:00,12
21055,ORD_21056,14219,Tan Removal Shave Care Kit,Warehouse B,53,35,2025-02-11 18:35:00,18
21056,ORD_21057,35894,"AmazonBasics Tie-Out Cable/Leash for Dogs up to 41 Kg, 25 Feet",Warehouse B,73,68,2025-02-11 09:26:00,5
21057,ORD_21058,31786,F Gear CEO Black 25 liter Laptop Backpack,Warehouse B,66,59,2025-02-11 13:22:00,7
21058,ORD_21059,2474,Teliska AM H 40mg/5mg/12.5mg Tablet,Warehouse B,7,1,2025-02-11 21:47:00,6
21059,ORD_21060,14187,"Dyazo Ergonomic Mouse Pad, Non-Slip, Anti-Skid, Reversible use, Dual Color, Splash-Proof Suitable for Gaming, Computer, La...",Warehouse B,114,98,2025-02-11 08:14:00,16
21060,ORD_21061,35916,PRAUSH (Formerly Plume) P21 - Flat Top Concealer Brush,Warehouse B,77,60,2025-02-11 11:24:00,17
21061,ORD_21062,12914,"Fashion Colour Hd Foundation, Waterproof, Long Lasting, Shade 06 30 ml",Warehouse B,58,51,2025-02-11 16:26:00,7
21062,ORD_21063,12387,Iverblaze A 6mg/400mg Tablet,Warehouse B,54,41,2025-02-11 22:16:00,13
21063,ORD_21064,35938,Zenmox 250mg Capsule,Warehouse C,24,9,2025-02-11 10:54:00,15
21064,ORD_21065,33876,Ajmal Mukhallat AL Wafa Concentrated Perfume Oil Oriental Musky Attar And CD 99 Mukhallat Concentrated Perfume Oil Floral Oriental Attar 26 ml,Warehouse C,82,63,2025-02-11 11:04:00,19
21065,ORD_21066,12920,"Camel Camlin Kokuyo Student Poster Color - 10ml Each, 14 Shades",Warehouse A,81,65,2025-02-11 06:24:00,16
21066,ORD_21067,11272,Parker Vector Gift Set - Parker Roller Ball Pen With Parker Logo Round Key Chain (Ink - Blue),Warehouse B,10,2,2025-02-11 09:53:00,8
21067,ORD_21068,702,Losazart AM 50mg/5mg Tablet,Warehouse C,51,45,2025-02-11 07:58:00,6
21068,ORD_21069,11267,Ajmal Mercurial Thunder Edt Of 2 & Distraction Deodorant Pack of 2 450 ml,Warehouse A,31,22,2025-02-11 10:58:00,9
21069,ORD_21070,3050,Zondan 8mg Tablet,Warehouse C,21,8,2025-02-11 01:36:00,13
21070,ORD_21071,31748,Fulgram 500mg Tablet,Warehouse B,41,31,2025-02-11 23:09:00,10
21071,ORD_21072,32762,"HP USB X500 Wired Optical Sensor Mouse 3 Buttons Windows 8 Supported, Black (E5C12AA)",Warehouse A,19,3,2025-02-11 19:36:00,16
21072,ORD_21073,17111,Deodorant Body Spray - Pi for Woman,Warehouse B,27,9,2025-02-11 00:45:00,18
21073,ORD_21074,12926,Spigen EZ Fit Optik Pro Tempered Glass Camera Lens Protector Guard for iPhone 14 Pro / 14 Pro Max (Silver) - 2 Pack,Warehouse A,38,21,2025-02-11 22:37:00,17
21074,ORD_21075,12935,Ciprogun TZ Kid 250mg/300mg Tablet,Warehouse A,65,48,2025-02-11 05:37:00,17
21075,ORD_21076,14163,Voglicaid-M 0.2 Tablet SR,Warehouse C,26,14,2025-02-11 08:19:00,12
21076,ORD_21077,34241,Apple Pencil (1st Generation),Warehouse A,106,98,2025-02-11 11:37:00,8
21077,ORD_21078,16808,"Ticket Perfume, Champion",Warehouse A,23,18,2025-02-11 22:20:00,5
21078,ORD_21079,2579,Cetafen-P 125mg Tablet DT,Warehouse C,109,98,2025-02-11 09:14:00,11
21079,ORD_21080,5233,"Fashion Colour Satin Smooth Lip Definer, 3 Cranberry Red 1.41 gm",Warehouse B,55,45,2025-02-11 09:31:00,10
21080,ORD_21081,31948,Storite 1.5 Meter Black 2 Pin 90 Degree Power Cord Cable for Laptop Adapter/Camera/Printer/Charger,Warehouse A,68,61,2025-02-11 01:49:00,7
21081,ORD_21082,24902,Defomit 6mg Tablet,Warehouse B,43,37,2025-02-11 03:49:00,6
21082,ORD_21083,21566,Virgin Coconut Oil,Warehouse C,94,79,2025-02-11 00:48:00,15
21083,ORD_21084,25000,"PTron Force X12N 1.85"" Full Touch Display Bluetooth Calling Smartwatch, Functional Crown, 580 NITS Brightness, HR, SpO2, W...",Warehouse C,30,20,2025-02-11 10:18:00,10
21084,ORD_21085,28927,Radhe Flutes | Right Handed C Natural With Velvet Cover | Tuned With Tanpura A=440Hz | PVC Fiber,Warehouse B,26,16,2025-02-11 17:05:00,10
21085,ORD_21086,24994,Cefarka T 1000mg/125mg Injection,Warehouse C,80,75,2025-02-11 12:18:00,5
21086,ORD_21087,24990,Beauty People Sheer Color Lipstick - Just - Berry - 414 3.8 gm,Warehouse B,28,13,2025-02-11 06:26:00,15
21087,ORD_21088,6755,Stbotanica Retinol Advanced Anti Aging Face Mask 50 gm,Warehouse B,99,87,2025-02-11 17:28:00,12
21088,ORD_21089,4496,"Street27® Protein Leather Replacement Ear Pads Cushions Compatible with Marshall Major, Boat Rockerz 600 Headset Headphone...",Warehouse A,85,80,2025-02-11 22:18:00,5
21089,ORD_21090,6756,Amiron 100mg Injection,Warehouse B,20,1,2025-02-11 22:18:00,19
21090,ORD_21091,6160,Mepoint Reusable Soft Makeup Remover Pads for All Skin - 1 pack Microfiber Face Rounds Wipes Heavy Mascara Eye Shadow Faci...,Warehouse B,110,92,2025-02-11 01:20:00,18
21091,ORD_21092,29021,ADOFYS Action Camera and Mobile Universal Aluminium Alloy Mount with Two 360° rotational Angle and with Quick Release clam...,Warehouse B,30,21,2025-02-11 08:25:00,9
21092,ORD_21093,20812,Arichlor 200mg Tablet,Warehouse C,110,94,2025-02-11 12:24:00,16
21093,ORD_21094,10247,Elzzi Microfiber Logo Cut Cover Compatible for iPhone 13 Case Cushion Liquid Soft Silicone Gel Rubber Phone Non-Slip Full ...,Warehouse C,91,83,2025-02-11 06:21:00,8
21094,ORD_21095,27760,Dapacose 10 Tablet,Warehouse C,50,35,2025-02-11 18:13:00,15
21095,ORD_21096,18719,Seflaz 6mg Oral Suspension,Warehouse B,100,91,2025-02-11 06:21:00,9
21096,ORD_21097,19569,Lamrest 5 Tablet,Warehouse C,104,91,2025-02-11 07:48:00,13
21097,ORD_21098,29260,Cuzith 500mg Tablet,Warehouse A,72,53,2025-02-11 02:36:00,19
21098,ORD_21099,6811,Vega Eye Groomer Eye Aplicator (DMB - 02) 13 gm,Warehouse A,116,99,2025-02-11 01:23:00,17
21099,ORD_21100,18673,Matra Advanced Night Recovery Serum 15 ml,Warehouse A,98,83,2025-02-11 23:15:00,15
21100,ORD_21101,10330,Tamlocept 0.2mg Capsule,Warehouse B,79,65,2025-02-11 10:00:00,14
21101,ORD_21102,19603,Torzest Plus 50mg/10mg Tablet,Warehouse B,109,93,2025-02-11 23:11:00,16
21102,ORD_21103,6875,"FACE UP 2 Way Glue (Eye Glitter Glue), Crease Less Eye Base, 6ML",Warehouse C,18,11,2025-02-11 21:43:00,7
21103,ORD_21104,24712,Genzed 1000mg Injection,Warehouse B,105,87,2025-02-11 09:32:00,18
21104,ORD_21105,29234,Lambre PURE THERAPY MAKE-UP REMOVER MICELLAR GEL 120ml,Warehouse A,100,93,2025-02-11 20:15:00,7
21105,ORD_21106,8555,Parzo Ear Cushions for Bose QC35 - Ultra Soft Ear Pads Compatible with Bose Quietcomfort 35 & 35 ii Headphones (QC35 Cushi...,Warehouse A,72,54,2025-02-11 18:20:00,18
21106,ORD_21107,9138,"Police Light Blue Deo for Men, 200 ml",Warehouse A,66,56,2025-02-11 03:36:00,10
21107,ORD_21108,6071,Tgmet-P 15mg/500mg Tablet,Warehouse C,78,59,2025-02-11 10:39:00,19
21108,ORD_21109,26180,De-Tan Facewash For Men,Warehouse C,94,86,2025-02-11 19:29:00,8
21109,ORD_21110,29249,"IKALL K470 6.26"" HD+ Display Smartphone (Dual Sim, 4G) (4GB RAM, 13MP Rear Camera) (Sky Blue)",Warehouse B,61,46,2025-02-11 00:01:00,15
21110,ORD_21111,26066,Dolgix 8GB DDR3 Desktop RAM 1333MHz |CL-9 | (Memory) U-DIMM | Long-DIMM | PC3-10600 (2Rx8 Dual Rank) 3 Years Warranty (Mad...,Warehouse A,71,59,2025-02-11 08:52:00,12
21111,ORD_21112,5231,SUGAR Cosmetics Blend The Rules Eyeshadow Palette - 01 Flawless (Warm Neutrals) 10.4 gm,Warehouse A,17,7,2025-02-11 22:41:00,10
21112,ORD_21113,6729,KeepTel-AM Tablet,Warehouse A,42,34,2025-02-11 12:11:00,8
21113,ORD_21114,20822,"Urban Gabru Red Onion Shampoo - with Caffeine, Curry Leaf and Indian Alkanet Root 200 gm",Warehouse A,35,18,2025-02-11 18:42:00,17
21114,ORD_21115,6705,Flunorm 10 Tablet,Warehouse A,49,44,2025-02-11 23:28:00,5
21115,ORD_21116,6739,Cona Standy Multiplug 3+2 with USB - (White) - (Material -PC) - Unit 2 Nos,Warehouse B,56,43,2025-02-11 02:08:00,13
21116,ORD_21117,7039,"LOXXO® Camera Lens Protector for iPhone 14 Pro 6.1"" ＆ iPhone 14 Pro Max 6.7"",Tempered Glass,9H [Does not Affect Night Shot...",Warehouse B,14,6,2025-02-11 08:11:00,8
21117,ORD_21118,34573,"Stbotanica Ultimate Hair Repair Shampoo, No Sls/Sulphate, Paraben Or Silicon 300 ml",Warehouse B,63,56,2025-02-11 22:40:00,7
21118,ORD_21119,24391,Amlopure 5 Tablet,Warehouse A,75,56,2025-02-11 17:29:00,19
21119,ORD_21120,24385,CEDO Realme 9 Pro Plus (5G) Case Back Cover Shockproof Bumper Crystal Clear | 360 Degree Protection TPU+PC | Camera Protec...,Warehouse C,85,80,2025-02-11 09:11:00,5
21120,ORD_21121,24675,Sitaglo 100 Tablet,Warehouse B,62,44,2025-02-11 08:17:00,18
21121,ORD_21122,21821,Bovose 0.3 Tablet MD,Warehouse A,92,83,2025-02-11 03:14:00,9
21122,ORD_21123,24696,YELLOWFIN Quick Release Universal Adjustable Car Mobile Phone Holder for Dashboard | Windshield with Long Telescopic Arm 3...,Warehouse B,72,53,2025-02-11 02:41:00,19
21123,ORD_21124,18688,Ajmal Aurum & Blu & Sacred Love Deo & Neea EDP Pack of 4 20 ml,Warehouse C,92,76,2025-02-11 03:03:00,16
21124,ORD_21125,20788,Mancode Charcoal Peel off Mask 100 gm,Warehouse A,81,74,2025-02-11 10:37:00,7
21125,ORD_21126,21629,OZIT® Samsung Charger Original 25W C-Type Super Fast Charger Adapter with Cable Set Charger for Galaxy S22/S21+/S21 Ultra/...,Warehouse C,12,5,2025-02-11 12:23:00,7
21126,ORD_21127,4495,Zytanix 2.5 Tablet,Warehouse C,31,14,2025-02-11 19:19:00,17
21127,ORD_21128,24890,Stbotanica Pro Keratin & Argan Oil Smooth Therapy Conditioner 300 ml,Warehouse C,92,75,2025-02-11 01:46:00,17
21128,ORD_21129,18708,KABEER ART Yellow Sponge Dabber Set of 5 pc,Warehouse C,53,39,2025-02-11 00:38:00,14
21129,ORD_21130,20780,Hair Colour - Dark Coal,Warehouse A,48,37,2025-02-11 13:15:00,11
21130,ORD_21131,29061,Hello Sun SunBlock & Anti-Tan Lotion SPF20,Warehouse A,88,82,2025-02-11 11:19:00,6
21131,ORD_21132,26035,Acepol 100 mg/500 mg Tablet,Warehouse A,75,65,2025-02-11 14:38:00,10
21132,ORD_21133,5210,MT Clav DS Dry Syrup,Warehouse A,9,1,2025-02-11 12:00:00,8
21133,ORD_21134,8632,Medit 4 Tablet,Warehouse A,18,11,2025-02-11 19:49:00,7
21134,ORD_21135,21654,Verfree 16 Tablet,Warehouse B,98,81,2025-02-11 09:11:00,17
21135,ORD_21136,27754,Herbal Rose & Papaya Face Scrub,Warehouse C,64,50,2025-02-11 20:39:00,14
21136,ORD_21137,29090,"Cosmic Byte CB-GK-05 Titan Wired Gaming Keyboard with Aluminum Body, Rainbow Backlit Keycaps, Braided Cable (Black)",Warehouse B,65,53,2025-02-11 14:20:00,12
21137,ORD_21138,4468,"Redragon Shiva K512 RGB Backlit Membrane Wired Gaming Keyboard with Multimedia Keys, 6 Extra On-Board Macro Keys, Dedicate...",Warehouse B,48,37,2025-02-11 18:50:00,11
21138,ORD_21139,20792,Man - Cool Wind Eau De Toilette,Warehouse C,48,38,2025-02-11 06:58:00,10
21139,ORD_21140,9094,Kividol 1.5mg Tablet,Warehouse B,44,27,2025-02-11 21:13:00,17
21140,ORD_21141,8548,"SQUIF Slim Soft Back Case for iPhone 14 Cover Ultra Thin, Flexible with Precise Camera Cuts and Extra Protection (Black)",Warehouse B,51,43,2025-02-11 08:42:00,8
21141,ORD_21142,18582,"Amkette Xcite Pro USB wired Keyboard & Mouse Combo for Laptop, PC and USB Support Devices with 10 dedicated Multimedia Key...",Warehouse B,57,38,2025-02-11 06:00:00,19
21142,ORD_21143,21811,TheGiftKart Back Cover Case for Xiaomi Mi 11 Lite NE 5G / Mi 11 Lite (Crystal Clear | Shockproof | Hybrid TPU & PC | Trans...,Warehouse A,76,60,2025-02-11 09:33:00,16
21143,ORD_21144,35565,CLASSY HUDA PROFESSIONAL ILLUMINATOR HIGHLIGHTER FOR ALL SKIN TONE. [PACK OF 2],Warehouse C,79,62,2025-02-11 05:54:00,17
21144,ORD_21145,32700,TheGiftKart Crystal Clear Back Cover Case for Samsung Galaxy S22 5G | 360 Degree Protection | Shock Proof Design | Transpa...,Warehouse B,54,36,2025-02-11 19:17:00,18
21145,ORD_21146,34011,"Fire-Boltt Beam Bluetooth Calling Smartwatch with 1.72” Full Touch & 320 * 380 Pixel Resolution, AI Voice Assistant, IP68 ...",Warehouse C,67,61,2025-02-11 20:36:00,6
21146,ORD_21147,35739,Rejuvenating Cucumber & Aloe Vera Face Pack For Skin,Warehouse C,41,32,2025-02-11 14:22:00,9
21147,ORD_21148,31852,Artech Plus 60mg Injection,Warehouse B,56,47,2025-02-11 16:46:00,9
21148,ORD_21149,35741,Alclef P Syrup,Warehouse A,61,47,2025-02-11 02:33:00,14
21149,ORD_21150,16473,Maryaj Grey Stone EDP Aromatic Woody Perfume For Me And Ajmal Evoke Silver Edition Him Deodorant Spicy Floral Fragrance 300 ml,Warehouse A,75,59,2025-02-11 07:24:00,16
21150,ORD_21151,12843,Rtsun SP 100mg/500mg/25mg Tablet,Warehouse B,23,11,2025-02-11 03:57:00,12
21151,ORD_21152,2992,Pilot V7 Roller Ball Pen - Pack of 5 - (Blue Ink),Warehouse A,69,50,2025-02-11 02:33:00,19
21152,ORD_21153,14345,NOTE PRECISION LINER 1 ml,Warehouse A,35,22,2025-02-11 15:55:00,13
21153,ORD_21154,16472,Ovlox 200 Tablet,Warehouse C,95,85,2025-02-11 00:03:00,10
21154,ORD_21155,34000,Plum Olive & Macadamia Mega Moisturizing Hair Mask 250 ml,Warehouse C,80,75,2025-02-11 19:35:00,5
21155,ORD_21156,17022,Tiruzirab-D Tablet,Warehouse B,50,33,2025-02-11 03:42:00,17
21156,ORD_21157,33993,Bella Voste Liquid Dip Eyeliner Glazed Green (04) 4 Ml,Warehouse B,25,8,2025-02-11 18:17:00,17
21157,ORD_21158,24702,Spigen Tough Armor Magfit Back Cover Case Compatible with MagSafe Designed for iPhone 14 Pro Max (TPU + Poly Carbonate | B...,Warehouse C,93,87,2025-02-11 18:50:00,6
21158,ORD_21159,35759,Maryaj Direction East EDP Citrus Spicy Perfume And Ajmal Wisal Dhahab Deodorant Fruity Floral Fragrance 300 ml,Warehouse A,18,8,2025-02-11 17:05:00,10
21159,ORD_21160,35765,Face Wash - Oil Clear Glow,Warehouse B,74,69,2025-02-11 19:52:00,5
21160,ORD_21161,14267,"Toothbrush - 1 2 3, With Neem Extract, Soft",Warehouse B,96,80,2025-02-11 13:04:00,16
21161,ORD_21162,11302,"Printme™ Silicone Protective Case Cover for OnePlus Nord Buds, Anti Fall Anti Dust, with Hook Earphone Case *Case Cover on...",Warehouse A,61,48,2025-02-11 20:56:00,13
21162,ORD_21163,1816,Mach 3 Shaving Blades,Warehouse B,89,76,2025-02-11 05:02:00,13
21163,ORD_21164,3001,"SYGA HDMI Switch 4K HDMI Splitter, 1080P HDMI Splitter 1 In 2 Out /2 Input 1 Output, Plug & Play, Manual HDMI Switcher for...",Warehouse A,37,24,2025-02-11 11:46:00,13
21164,ORD_21165,14258,Cianmol  200 SR Tablet,Warehouse C,27,15,2025-02-11 23:50:00,12
21165,ORD_21166,15553,Azonate Cream,Warehouse A,82,68,2025-02-11 16:30:00,14
21166,ORD_21167,17003,"Mamaearth Deeply nourishing natural baby wash (400 ml, 0-5 Yrs)",Warehouse B,99,94,2025-02-11 08:02:00,5
21167,ORD_21168,17000,Rafilon 25mg Injection,Warehouse C,59,54,2025-02-11 16:31:00,5
21168,ORD_21169,34237,"Ekan Clip Short Synthetic Hair Volumizer Extension for Women And Girls 6.5 Inches, Black",Warehouse A,23,11,2025-02-11 08:17:00,12
21169,ORD_21170,12218,Spigen Essential PF2104 Wireless Charger for iPhone 14/13/12/11 Samsung Galaxy S22/S21/S20 OnePlus 9/9 Pro with USB-A to C...,Warehouse A,74,60,2025-02-11 22:53:00,14
21170,ORD_21171,967,Telindia CH 40mg/12.5mg Tablet,Warehouse A,105,88,2025-02-11 05:48:00,17
21171,ORD_21172,35552,Elmoc 0.5% Eye Drop,Warehouse B,21,9,2025-02-11 07:22:00,12
21172,ORD_21173,31862,Kosfix OF Kid 100mg/100mg Tablet DT,Warehouse C,100,92,2025-02-11 08:43:00,8
21173,ORD_21174,31863,ENVOUS Newly Launched Fire Bolt Ring Smartwatch Charging Cable USB Fast Charger Magnetic Charging Cable Adapter (Charger o...,Warehouse A,104,96,2025-02-11 05:44:00,8
21174,ORD_21175,2964,The Moms Co. Baby Hair Oil 200 ml,Warehouse B,30,16,2025-02-11 22:28:00,14
21175,ORD_21176,34041,Palette Deluxe Oil-Care Color Permanent - 4-0 Soft Mid Brown,Warehouse C,84,69,2025-02-11 17:53:00,15
21176,ORD_21177,18573,Lzepam 1mg Tablet,Warehouse A,73,62,2025-02-11 19:44:00,11
21177,ORD_21178,10342,Veznox OZ 200mg/500mg Tablet,Warehouse B,103,84,2025-02-11 01:59:00,19
21178,ORD_21179,6871,Cathox Oral Suspension,Warehouse A,31,26,2025-02-11 05:32:00,5
21179,ORD_21180,26157,Bendol 400mg Tablet,Warehouse B,78,68,2025-02-11 15:34:00,10
21180,ORD_21181,10317,Radimox 500mg Capsule,Warehouse C,46,32,2025-02-11 01:04:00,14
21181,ORD_21182,29216,Lakme 9To5 Primer + Matte Perfect Cover Foundation W320 Warm Caramel 25 Ml,Warehouse C,82,69,2025-02-11 00:19:00,13
21182,ORD_21183,6827,"Microware VGA to HDMI with Audio Adapter for Connecting Traditional VGA Interface Laptop, PC to HDMI Monitor or Projector,...",Warehouse B,85,69,2025-02-11 07:29:00,16
21183,ORD_21184,24840,"3M Littmann Classic III Monitoring Stethoscope, Black Tube, 27 inch, 5620",Warehouse B,27,10,2025-02-11 22:13:00,17
21184,ORD_21185,4449,Bella Voste Gold-Foil Nail Paints Shade 333 10 Ml,Warehouse A,34,27,2025-02-11 01:39:00,7
21185,ORD_21186,6831,Mecovit-PG 750mcg/75mg Tablet,Warehouse B,45,32,2025-02-11 04:02:00,13
21186,ORD_21187,6110,"HP Ink Tank 416 All-in-one WiFi Colour Printer with Upto 7500 Black and 8000 Colour Pages Included in The Box. - Print, Sc...",Warehouse B,37,31,2025-02-11 17:24:00,6
21187,ORD_21188,21720,Haxone 250mg Injection,Warehouse C,55,50,2025-02-11 00:15:00,5
21188,ORD_21189,24811,"Wayona Nylon Braided (2 Pack) Lightning Fast Usb Data Cable Fast Charger Cord For Iphone, Ipad Tablet (3 Ft Pack Of 2, Grey)",Warehouse B,81,72,2025-02-11 22:20:00,9
21189,ORD_21190,6092,"ZEBRONICS Basso 100 5.1 Home Theater Speaker with 5.25"" Subwoofer, 90W RMS Powerful Bass, Bluetooth 5.1, Wall Mount, AC-3 ...",Warehouse C,27,10,2025-02-11 06:59:00,17
21190,ORD_21191,24793,"Garnier SkinActive Micellar Cleansing Water All-in-1 Cleanser &amp; Makeup Remover, 13.5 Ounce",Warehouse C,48,34,2025-02-11 04:47:00,14
21191,ORD_21192,21754,Ketovib Tablet,Warehouse C,86,79,2025-02-11 03:38:00,7
21192,ORD_21193,19587,"Seagate One Touch 2TB External HDD with Password Protection – Red, for Windows and Mac, with 3 yr Data Recovery Services, ...",Warehouse B,42,23,2025-02-11 04:18:00,19
21193,ORD_21194,24780,Etifit 90mg Tablet,Warehouse B,18,12,2025-02-11 11:49:00,6
21194,ORD_21195,27723,House of Aroma Lemongrass Fragrance Oil 10 ml,Warehouse C,67,55,2025-02-11 11:33:00,12
21195,ORD_21196,26153,Ajmal Raindrops Wisal Deo Wisal Deodorant Spray (Pack of 3) 200 ml,Warehouse B,43,29,2025-02-11 02:11:00,14
21196,ORD_21197,29197,MOSTOS ; Brings Superior® - Camera Lens Cap 55 mm For Nikon Lens Replaces LC-55 Lens Cap Front Lens Cap (55mm) - AF-P 18-5...,Warehouse A,73,61,2025-02-11 00:29:00,12
21197,ORD_21198,4404,Cyclonus Cream,Warehouse B,44,29,2025-02-11 08:12:00,15
21198,ORD_21199,4582,Pierre Cardin Paris - Studio Nails 94,Warehouse B,29,14,2025-02-11 22:59:00,15
21199,ORD_21200,35066,Cardules 5mg Capsule,Warehouse A,48,30,2025-02-11 17:18:00,18
21200,ORD_21201,12845,Metgear G 1 Tablet PR,Warehouse C,25,12,2025-02-11 23:38:00,13
21201,ORD_21202,31881,Onpar 250mg Syrup,Warehouse C,95,90,2025-02-11 15:38:00,5
21202,ORD_21203,35694,Pracid 40mg Tablet,Warehouse B,80,61,2025-02-11 14:45:00,19
21203,ORD_21204,3217,"SONATA gold series Wi-Fi, 1440p Wireless PTZ Bulb Shape V380 Pro Indoor 360, 24x7 Recording,Motion Sensor LED Lights & Aut...",Warehouse C,64,54,2025-02-11 13:51:00,10
21204,ORD_21205,1480,Lakme Forever Matte Liquid Lip Colour Purple Pout 5.6 Ml,Warehouse C,78,63,2025-02-11 08:50:00,15
21205,ORD_21206,11822,Worace-SP Tablet,Warehouse C,74,56,2025-02-11 09:55:00,18
21206,ORD_21207,11034,"Ajmal 1 Shadow Homme, 1 Wisal Dhahab, 1 Magnetize And 1 Persuade Deodorants Pack of 4 200 ml",Warehouse C,106,98,2025-02-11 16:14:00,8
21207,ORD_21208,11839,Chambor Gel Effectnail Lacquer Bare Blends - 0313 30 ml,Warehouse A,11,2,2025-02-11 01:18:00,9
21208,ORD_21209,36994,L'Oreal Paris Revitalift Crystal Micro-Essence 22 ml,Warehouse C,89,79,2025-02-11 02:53:00,10
21209,ORD_21210,16106,mCaffeine Complete Coffee Skin Care Combo 300 gm,Warehouse C,38,31,2025-02-11 14:55:00,7
21210,ORD_21211,2247,Depan L 75mg/40mg Capsule SR,Warehouse A,41,34,2025-02-11 09:46:00,7
21211,ORD_21212,11029,House Of Makeup Pout Potion Liquid Matte Lipstick - Happy Hour 2.7 ml,Warehouse C,50,33,2025-02-11 23:36:00,17
21212,ORD_21213,2254,"Mobilife Selfie Stick with Light,Long Selfie Stick with Tripod Stand 100cm Plus Bluetooth Extandable Selfie Stick Tripod R...",Warehouse C,35,24,2025-02-11 08:55:00,11
21213,ORD_21214,37109,XX Revolutioncess blush entice 3.2 gm,Warehouse C,36,24,2025-02-11 08:43:00,12
21214,ORD_21215,37111,OLWICK® 2 Pcs Power Strip Fixator Self Adhesive Socket Holder Punch-Free Wall-Mounted Desktop Fixer Plugin Holder Organize...,Warehouse C,44,35,2025-02-11 10:42:00,9
21215,ORD_21216,2270,"ESR Clear Case Compatible For iPhone 14 Pro Case, Shockproof Thin Silicone Cover, Yellowing-Resistant Slim Transparent TPU...",Warehouse B,87,74,2025-02-11 23:35:00,13
21216,ORD_21217,16082,"Ambrane 20W USB Dual Port BoostedSpeed Charger with Power Delivery & Quick Charge, Made in India, Multi-Layer Protection, ...",Warehouse A,31,20,2025-02-11 11:46:00,11
21217,ORD_21218,2257,Cofarin 3mg Tablet,Warehouse A,29,20,2025-02-11 16:49:00,9
21218,ORD_21219,37130,Cudec 50mg Injection,Warehouse C,12,5,2025-02-11 01:21:00,7
21219,ORD_21220,75,Yves Rocher White Botanical Exceptional Toner 200 ml,Warehouse C,36,27,2025-02-11 01:36:00,9
21220,ORD_21221,11146,Strocan 150mg Tablet,Warehouse C,70,59,2025-02-11 03:10:00,11
21221,ORD_21222,13465,Fairness Naturals Saffron Skin Bleach,Warehouse B,100,89,2025-02-11 07:14:00,11
21222,ORD_21223,15976,Chymolad Tablet,Warehouse A,110,93,2025-02-11 20:41:00,17
21223,ORD_21224,17392,Alcoliv Tablet,Warehouse B,65,56,2025-02-11 02:23:00,9
21224,ORD_21225,11893,Softrone 200mg Soft Gelatin Capsule,Warehouse C,110,91,2025-02-11 16:37:00,19
21225,ORD_21226,36880,"Honeywell High-Speed HDMI v2.0 Cable with Ethernet, 18 GBPS Transmission Speed, Supports 3D/4K@60Hz Ultra HD Resolution, f...",Warehouse C,37,25,2025-02-11 09:44:00,12
21226,ORD_21227,128,"BESTOR® Doodle LCD Pad Writing Tablet for Kids 10 Inch, Doodle Board Drawing Tablet with Lock Function, Erasable Reusable ...",Warehouse C,31,26,2025-02-11 15:45:00,5
21227,ORD_21228,15995,"WeCool S3 Selfie Stick with Detachable Wireless Remote , 3 in 1 Function Sturdy Tripod Stand and Mobile Stand Bluetooth Se...",Warehouse B,104,96,2025-02-11 20:30:00,8
21228,ORD_21229,33256,"Face Mask - Ultra-Light Contoured Fit, Large, Light Blue",Warehouse B,100,94,2025-02-11 23:10:00,6
21229,ORD_21230,33033,"Hair Dryer - Blue & White, HDR5001, Colour May Vary",Warehouse C,81,71,2025-02-11 20:51:00,10
21230,ORD_21231,33038,Vikrax 200mg Tablet,Warehouse B,18,2,2025-02-11 17:01:00,16
21231,ORD_21232,33243,Sedell Lipstick Dark Brown (Matte),Warehouse A,71,58,2025-02-11 03:38:00,13
21232,ORD_21233,13534,HP 682 Black Original Ink Cartridge,Warehouse B,47,30,2025-02-11 23:08:00,17
21233,ORD_21234,13332,Alflox 400 Tablet,Warehouse A,28,20,2025-02-11 04:14:00,8
21234,ORD_21235,37043,Modflox-OZ Syrup,Warehouse B,114,96,2025-02-11 22:41:00,18
21235,ORD_21236,16115,"SENS EDYSON 1 Smartwatch with 1.7 Display, BT Calling, AI Voice Assistant, 150+ Watch Faces & Free Additional Strap (Matte...",Warehouse C,78,64,2025-02-11 01:47:00,14
21236,ORD_21237,3384,"Camlin Brush Pens, 24 Shades",Warehouse B,44,31,2025-02-11 10:57:00,13
21237,ORD_21238,33520,Yellow Chimes Earrings For Women & Girls | Fashion Green And White Crystal Stone Studs | Silver Tone Earring | Ovel Shaped...,Warehouse C,82,72,2025-02-11 12:38:00,10
21238,ORD_21239,36443,Rgasin DSR Capsule,Warehouse C,99,83,2025-02-11 09:34:00,16
21239,ORD_21240,2376,TheGiftKart Back Cover Case for Samsung Galaxy M12 / F12 / A12 (Shockproof | Hybrid TPU & PC | Transparent | Black Bumper),Warehouse C,48,43,2025-02-11 11:12:00,5
21240,ORD_21241,31420,ZAINTO Green wealth Neo Hair Lotion natural herbs from thailand 120 ml (Pack of 1)…,Warehouse C,101,84,2025-02-11 19:03:00,17
21241,ORD_21242,31402,VLCC New Gold Single Facial Kit 60 gm,Warehouse B,71,66,2025-02-11 21:46:00,5
21242,ORD_21243,3283,SYGA 5 Pairs Black Replacement Ear Cushion Pads for Sennheiser PX100 Koss,Warehouse C,56,37,2025-02-11 09:13:00,19
21243,ORD_21244,370,Vega Eyelash Curler (EC - 01) 20 gm,Warehouse A,86,67,2025-02-11 09:10:00,19
21244,ORD_21245,15847,"CROSSVOLT Metal USB OTG Adapter Compatible with i-OS 13 and Later, USB Female Support Connect USB Drive, for iPhone 12Pro ...",Warehouse A,86,79,2025-02-11 20:43:00,7
21245,ORD_21246,11979,Plush Lilac Lush Microfiber Beauty Blender with Case | Makeup Sponge That Saves Up to 60% Makeup | Olive Cut Blender | For...,Warehouse B,50,44,2025-02-11 19:14:00,6
21246,ORD_21247,15854,Bectodine 5% Ointment,Warehouse A,64,54,2025-02-11 04:30:00,10
21247,ORD_21248,13782,Pregalin SR 75 Tablet,Warehouse C,103,86,2025-02-11 01:15:00,17
21248,ORD_21249,16243,TheGiftKart Shockproof Crystal Clear Back Cover Case for Oppo A78 5G | 360 Degree Protection | Protective Design | Transpa...,Warehouse A,109,94,2025-02-11 04:00:00,15
21249,ORD_21250,36471,"American Tourister VALEX BLUE LAPTOP BACKPACK 28 Ltrs,Volume, LAPTOP COMPARTMENT, BOTTLE POCKET, FRONT ORGANIZER",Warehouse A,75,67,2025-02-11 17:35:00,8
21250,ORD_21251,33456,Micromax X413 Blue,Warehouse B,98,86,2025-02-11 21:35:00,12
21251,ORD_21252,2086,Daily Life Forever52 Waterproof Smoothenin Eye Pencil Sapphire F504 1 Gm,Warehouse A,104,95,2025-02-11 16:17:00,9
21252,ORD_21253,13154,Winble Back Case Cover for OnePlus Nord 2T 5G Back Cover Metal Camera Guard Acrylic Clear Protective Back Cover for OnePlu...,Warehouse B,51,46,2025-02-11 11:57:00,5
21253,ORD_21254,13158,Whiteglow Skin Whitening & Brightening Nourishing Night Creme,Warehouse B,17,7,2025-02-11 17:03:00,10
21254,ORD_21255,32988,"Fashion Colour Non - Transfer Matt Waterproof Lipstick, 38 Puce 2.6 gm",Warehouse B,113,97,2025-02-11 16:02:00,16
21255,ORD_21256,2168,Zenmax Plus 6mg/400mg Tablet,Warehouse B,38,30,2025-02-11 05:20:00,8
21256,ORD_21257,33555,TP-link N300 WiFi Wireless Router TL-WR845N | 300Mbps Wi-Fi Speed | Three 5dBi high gain Antennas | IPv6 Compatible | AP/R...,Warehouse C,106,89,2025-02-11 07:57:00,17
21257,ORD_21258,13339,Nutriment Apricot Cream All Skin Type 250 gm,Warehouse A,97,83,2025-02-11 18:14:00,14
21258,ORD_21259,13318,Vega Graduated Dressing Comb (HMBC - 120) 18 gm,Warehouse C,44,30,2025-02-11 02:29:00,14
21259,ORD_21260,31172,"Denver Royal Oud Deodorant Body Spray 165ML Each Combo Deodorant Spray - For Men & Women (495 ml, Pack of 3)",Warehouse C,93,87,2025-02-11 22:01:00,6
21260,ORD_21261,37015,Miss Claire Multi Vita Whitening Solution Mask 25 Ml,Warehouse B,12,5,2025-02-11 04:25:00,7
21261,ORD_21262,31168,Vega Gel Eye Liner Brush (EV - 23) 8 gm,Warehouse C,25,18,2025-02-11 00:23:00,7
21262,ORD_21263,16040,Pilot Frixion Clicker Roller Pen (Black),Warehouse A,27,13,2025-02-11 09:12:00,14
21263,ORD_21264,31152,Vega Nail Clipper Set Of 10 Pcs (LNCB - 03) 490 gm,Warehouse B,46,28,2025-02-11 17:11:00,18
21264,ORD_21265,33242,Glacial 0.5% Eye Drop,Warehouse B,25,9,2025-02-11 20:28:00,16
21265,ORD_21266,13279,Gliway 1mg Tablet,Warehouse C,85,79,2025-02-11 02:57:00,6
21266,ORD_21267,11858,"Samsung Galaxy M33 5G (Emerald Brown, 6GB, 128GB Storage) | 6000mAh Battery | Upto 12GB RAM with RAM Plus | Travel Adapter...",Warehouse C,70,65,2025-02-11 21:44:00,5
21267,ORD_21268,1962,Monoscot 1000mg Injection,Warehouse A,27,16,2025-02-11 14:19:00,11
21268,ORD_21269,15767,"L'Oréal Professionnel Pro Longer Shampoo for Long Hair with Thinned Ends, With Filler-A100 and Amino Acid, Serie Expert, 3...",Warehouse C,46,35,2025-02-11 11:52:00,11
21269,ORD_21270,31551,"Fybros Comex 2 Pin Extension Cord, Extension Box, Power Strip with International Sockets Extension Board,Thermal Protectio...",Warehouse C,85,72,2025-02-11 11:53:00,13
21270,ORD_21271,3147,"Western Digital WD 5TB Elements Portable Hard Disk Drive, USB 3.0, Compatible with PC, PS4 and Xbox, External HDD (WDBHDW0...",Warehouse B,81,64,2025-02-11 08:21:00,17
21271,ORD_21272,16322,Acnox Soap,Warehouse B,64,52,2025-02-11 11:01:00,12
21272,ORD_21273,2428,"iQOO Z6 44W by vivo (Lumina Blue, 4GB RAM, 128GB Storage) | 6.44"" FHD+ AMOLED Display | 50% Charge in just 27 mins | in-Di...",Warehouse C,98,85,2025-02-11 21:47:00,13
21273,ORD_21274,16281,"Fashion Colour Kiss Lip No Transfer Lipstick, 40 Pink 2.6 gm",Warehouse A,16,4,2025-02-11 02:12:00,12
21274,ORD_21275,32889,Eveready Ultima Alkaline AAA Battery - 4 Pcs,Warehouse A,80,66,2025-02-11 01:03:00,14
21275,ORD_21276,15690,Rimceft-TGM 500mg/62.5mg Injection,Warehouse B,73,55,2025-02-11 10:39:00,18
21276,ORD_21277,528,Body Creme - For Stretch Marks,Warehouse A,26,15,2025-02-11 04:37:00,11
21277,ORD_21278,466,Lava A3 (White Beige) - Dual Sim Mobile with 1750 mAh Big Battery and 32 GB Expandable Storage,Warehouse A,81,72,2025-02-11 08:39:00,9
21278,ORD_21279,13925,TECHSHIELD® Matte Screen Protector for iPad Air 4/AIR 5 (2020/2022) and iPad Pro 11 2022/2021/2020/2018 (Transparent)(Case...,Warehouse C,97,86,2025-02-11 05:16:00,11
21279,ORD_21280,15819,Bisalto-M Tablet,Warehouse B,65,59,2025-02-11 06:03:00,6
21280,ORD_21281,15742,Feveo 100mg Oral Drops,Warehouse C,91,80,2025-02-11 19:23:00,11
21281,ORD_21282,3132,"Infinity (JBL Fuze 100, Wireless Portable Bluetooth Speaker with Mic, Deep Bass, Dual Equalizer, IPX7 Waterproof, Rugged F...",Warehouse C,65,55,2025-02-11 09:35:00,10
21282,ORD_21283,11186,Clomine 75mg Tablet,Warehouse B,109,99,2025-02-11 20:50:00,10
21283,ORD_21284,2039,Portronics Adapto III Dual USB Adapter with 1 AC Power Socket 3.4Amp Total Output (White),Warehouse B,77,71,2025-02-11 19:29:00,6
21284,ORD_21285,13098,Anaxime-OZ Tablet,Warehouse A,26,12,2025-02-11 23:29:00,14
21285,ORD_21286,432,Wypal 800mg/160mg Tablet,Warehouse C,29,17,2025-02-11 23:37:00,12
21286,ORD_21287,32849,Ajmal Jannatul Firdaus Concentrated Perfume Oil Oriental Attar And Khofooq Concentrated Perfume Oil Woody Oudhy Attar 28 ml,Warehouse A,34,15,2025-02-11 08:53:00,19
21287,ORD_21288,16338,Amazon Brand - Solimo Back Cover for Oneplus 8 (Silicone_Transparent),Warehouse B,26,21,2025-02-11 16:40:00,5
21288,ORD_21289,36214,"Fashion Colour Professional Makeup Kit, 977 - 15 - 2 29.4 gm",Warehouse C,66,47,2025-02-11 09:25:00,19
21289,ORD_21290,36264,"ShopsGoods USB Cable for Vivo V11 Pro USB Cable | Micro USB Data Cable | Quick Fast Charging Cable, Charger Cable,Transfer...",Warehouse B,84,78,2025-02-11 07:58:00,6
21290,ORD_21291,15799,Biotin & Collagen Hair Conditioner,Warehouse B,35,29,2025-02-11 04:35:00,6
21291,ORD_21292,36269,"(Renewed) Nokia 105 Plus Single SIM, Keypad Mobile Phone with Wireless FM Radio, Memory Card Slot and MP3 Player | Charcoal",Warehouse B,54,46,2025-02-11 10:32:00,8
21292,ORD_21293,31526,Cello Geltech Fun Glitter Gel Pen | Pack of 10 | Glitter gel pens for art lovers and kids| Glitter pen set | Drawing Pen S...,Warehouse C,33,21,2025-02-11 11:27:00,12
21293,ORD_21294,13033,Hand Wash Refill - Original,Warehouse A,96,91,2025-02-11 09:03:00,5
21294,ORD_21295,420,"SARTE Car Long Range AM/FM Replacement Audio Antenna for Car i20, baleno, Swift, Verna, New i10, Grand, City, Jazz, cr-v (...",Warehouse B,103,92,2025-02-11 13:14:00,11
21295,ORD_21296,7020,Belora Paris Leave No Evidence Liquid Matte Lipstick Tea Time 4.5 gm,Warehouse B,88,82,2025-02-11 09:10:00,6
21296,ORD_21297,521,Retum 250mg Tablet,Warehouse A,56,37,2025-02-11 14:57:00,19
21297,ORD_21298,516,Oncraves Camera Lens Protector for OnePlus 11R 5G [9H Hardness] [3D Lens Protector ] [Easy Installation] Black,Warehouse B,38,25,2025-02-11 20:38:00,13
21298,ORD_21299,16017,Sleep Aid - Orange,Warehouse B,45,34,2025-02-11 12:14:00,11
21299,ORD_21300,15789,Aedicool Oral Suspension Saunf,Warehouse B,40,26,2025-02-11 15:34:00,14
21300,ORD_21301,13510,Borosol Eye Drops,Warehouse A,28,10,2025-02-11 20:39:00,18
21301,ORD_21302,36918,Jovees Face Wash - Bridal Brightening 120 ml,Warehouse C,81,74,2025-02-11 11:38:00,7
21302,ORD_21303,16142,Redmi 108 cm (43 inches) 4K Ultra HD Android Smart LED TV X43 | L43R7-7AIN (Black),Warehouse A,106,90,2025-02-11 04:45:00,16
21303,ORD_21304,111,Eroica-P Tablet,Warehouse B,17,9,2025-02-11 09:58:00,8
21304,ORD_21305,16025,Reequil Pitstop Gel For Acne Scars & Pits Removal 30 gm,Warehouse C,28,14,2025-02-11 17:56:00,14
21305,ORD_21306,36926,Vega Grooming Comb (HMBC - 106) 19 gm,Warehouse B,85,71,2025-02-11 01:15:00,14
21306,ORD_21307,33220,ULTRAPROLINK UM1002 Sing Along Karaoke Bluetooth Mixer with Karaoke Microphone & Bluetooth Receiver Amplifier with Echo fo...,Warehouse B,86,78,2025-02-11 11:58:00,8
21307,ORD_21308,13487,Pantakon 40mg Tablet,Warehouse B,31,21,2025-02-11 03:45:00,10
21308,ORD_21309,3366,Flozastar 6mg Tablet,Warehouse C,65,49,2025-02-11 04:52:00,16
21309,ORD_21310,36973,"GIZGA essentials Car Phone Stand, Universal Air-Vent Mount Mobile Holder/Tablet Mount Mobile Holder, Steady Grip & Rounded...",Warehouse B,99,81,2025-02-11 23:13:00,18
21310,ORD_21311,13474,Amazon Brand- Solimo Basic Case for Samsung Galaxy M04 4G (Silicone_Black),Warehouse C,22,10,2025-02-11 12:57:00,12
21311,ORD_21312,36407,"pTron Bassbuds Revv Wireless in Ear Earbuds with Mic, ENC for Best Calling, 50ms Low Latency, 13mm Driver, Punchy Bass, BT...",Warehouse B,96,88,2025-02-11 02:50:00,8
21312,ORD_21313,32290,Magnazone-SB 1gm Injection,Warehouse B,64,56,2025-02-11 05:05:00,8
21313,ORD_21314,13075,"Silicone Case Compatible with JBL 230 NC True Wireless Earbuds case, Anti-Lost, Shockproof, Protective Case Cover (ONLY FI...",Warehouse A,78,71,2025-02-11 15:22:00,7
21314,ORD_21315,2030,Glyciday M 40mg/500mg Tablet,Warehouse C,71,57,2025-02-11 09:22:00,14
21315,ORD_21316,32848,OpenTech® Tempered Glass Screen Protector Compatible for Samsung Galaxy S22 5G / S23 5G with Edge to Edge Coverage and Eas...,Warehouse B,68,56,2025-02-11 18:08:00,12
21316,ORD_21317,31536,Midagesic TN Tablet,Warehouse C,103,96,2025-02-11 19:15:00,7
21317,ORD_21318,31508,"Amazon Basics USB 2.0 Cable - A-Male to B-Male for Personal Computer, Printer (Black, 16 Feet, 4.8 Meters)",Warehouse B,101,91,2025-02-11 05:06:00,10
21318,ORD_21319,36319,Faces Canada Ultimepro Twist Eye Kajal Liner Blue 03 0.35 Gm,Warehouse C,44,35,2025-02-11 05:58:00,9
21319,ORD_21320,3185,"Dell USB Wireless Keyboard and Mouse Set- KM3322W, Anti-Fade & Spill-Resistant Keys, up to 36 Month Battery Life, 3Y Advan...",Warehouse A,104,89,2025-02-11 01:42:00,15
21320,ORD_21321,17247,"Beetel F1K is Quad Band 2G GSM Phone, with 2-Way Speakers,LCD Display,Supports Hotline Function,Stores Upto 500 Contacts,S...",Warehouse C,18,5,2025-02-11 04:15:00,13
21321,ORD_21322,13971,"Himalaya Gentle Baby Soap Value Pack, 4 * 75g",Warehouse A,71,54,2025-02-11 13:37:00,17
21322,ORD_21323,13067,Dhathri Dheedhi Hair Conditioner | Herbal Conditioner for hair | Moisturizes hair strands | Safe on scalp | 200ml - pack of 2,Warehouse A,48,43,2025-02-11 19:47:00,5
21323,ORD_21324,33658,JNKC Mini Wi-Fi Full Wireless Motion Camera Audio and Video Live Feed with Wireless Recorded with Night Vision and Motion ...,Warehouse A,79,60,2025-02-11 04:46:00,19
21324,ORD_21325,498,Sucrawin-O Oral Suspension,Warehouse C,63,54,2025-02-11 21:18:00,9
21325,ORD_21326,379,"HIFFIN® Helmet Chin Strap Mount with Mobile Clip & Screw Compatible with All Smart Phones Go pro Hero (Helmet Mount KIT, H...",Warehouse B,68,57,2025-02-11 19:16:00,11
21326,ORD_21327,15833,Faces Canada Magneteyes Eyeshadow Palette Color Touch 02 4.8 Gm,Warehouse A,42,25,2025-02-11 19:17:00,17
21327,ORD_21328,34591,Lemon Essential Oil,Warehouse B,98,83,2025-02-11 01:10:00,15
21328,ORD_21329,12256,Keteen Medicated Soap,Warehouse C,66,57,2025-02-11 10:09:00,9
21329,ORD_21330,1127,Etonow 120 Tablet,Warehouse B,12,1,2025-02-11 15:07:00,11
21330,ORD_21331,1118,"Fashion Colour Face & Body Hi - Lite Bronzer, Shade 06 4 gm",Warehouse C,90,77,2025-02-11 05:46:00,13
21331,ORD_21332,35206,"AirCase Sleeve Messenger Bag with Handle & Detachable Shoulder Strap |for Upto 14"" Laptop/ MacBook | 3-in-1 use | 3 Zipper...",Warehouse A,60,53,2025-02-11 17:50:00,7
21332,ORD_21333,16890,HP V232w 32GB USB2.0 Pen Drive (Silver),Warehouse B,86,79,2025-02-11 18:39:00,7
21333,ORD_21334,35208,Syga Two-Finger Silicone Pencil Grips for Kids Handwriting Pencil Holder for Children Preschoolers Writing Training Grip -...,Warehouse B,37,32,2025-02-11 09:35:00,5
21334,ORD_21335,34339,Ajmal Aura Concentrated Perfume Oil Floral Fruity And Aurum Femme Deodorant Fruity Floral Fragrance 210 ml,Warehouse C,13,3,2025-02-11 12:27:00,10
21335,ORD_21336,34338,Fulrex D Syrup,Warehouse A,48,34,2025-02-11 11:49:00,14
21336,ORD_21337,12660,Fixilam 50mg Dry Syrup,Warehouse C,57,42,2025-02-11 03:00:00,15
21337,ORD_21338,35264,Lakme 9 To 5 Primer + Gloss Nail Color Lime Treat 6 Ml,Warehouse C,65,48,2025-02-11 21:32:00,17
21338,ORD_21339,16905,Fluimucil 100mg Powder,Warehouse A,82,72,2025-02-11 00:10:00,10
21339,ORD_21340,16574,Brightening Sheen Mani-Pedi Kit,Warehouse B,85,79,2025-02-11 03:51:00,6
21340,ORD_21341,35317,"Santoor Glowing Skin Body Wash, Enriched With Sandalwood Extracts & Wild Turmeric, Soap-Free, Paraben-Free, pH Balanced Sh...",Warehouse A,79,70,2025-02-11 10:15:00,9
21341,ORD_21342,32443,Boosty® 6x9FT Chroma Green Backdrop Green Screen Background Photo Light Studio Green Photography Background for VFX Editin...,Warehouse B,20,7,2025-02-11 23:00:00,13
21342,ORD_21343,31998,Sweet and Shine Beauty Matte Lipstick For Women Glossy Waterproof and Transfer proof Pink and Rani Lipstick Combo Pack of 2,Warehouse B,18,3,2025-02-11 16:53:00,15
21343,ORD_21344,2892,Glimiflo MV 1mg/500mg/0.2mg Tablet PR,Warehouse A,72,64,2025-02-11 05:26:00,8
21344,ORD_21345,31437,Ozmax 200 mg/500 mg Tablet,Warehouse C,103,90,2025-02-11 03:12:00,13
21345,ORD_21346,14539,Boujee Beauty Duo-fibre Fan Brush B105 135 gm,Warehouse C,106,89,2025-02-11 10:41:00,17
21346,ORD_21347,16557,"Kammateswara LCD Writing Tablet in Kids Slate with 8.5 Inch Screen LCD Writing pad, Writing Tablet Toys for Kids(Multicolor)",Warehouse C,26,14,2025-02-11 22:26:00,12
21347,ORD_21348,35374,"Xiaomi Mi Smart Band 6-1.56'' (3.96 cm) Large AMOLED Color Display, 2 Week Battery Life, 30 Fitness Mode, 5 ATM, SpO2, HR,...",Warehouse A,96,79,2025-02-11 04:19:00,17
21348,ORD_21349,34284,Sinarest Syrup,Warehouse C,56,47,2025-02-11 21:53:00,9
21349,ORD_21350,996,"N95 Face Mask - 5 Ply, Assorted Colour",Warehouse B,31,15,2025-02-11 05:33:00,16
21350,ORD_21351,12726,Deltanac T 100mg/4mg Tablet,Warehouse C,40,32,2025-02-11 10:13:00,8
21351,ORD_21352,31987,Duzine 0.5mg Tablet,Warehouse C,39,22,2025-02-11 21:38:00,17
21352,ORD_21353,1665,Fungikem 100 Capsule,Warehouse A,44,33,2025-02-11 22:41:00,11
21353,ORD_21354,32549,Dena-N 50mg Injection,Warehouse C,35,18,2025-02-11 00:17:00,17
21354,ORD_21355,988,Red Hot Mouth Spray,Warehouse B,64,53,2025-02-11 18:45:00,11
21355,ORD_21356,15340,"AmazonBasics USB C to Lightning Aluminum with Nylon Braided MFi Certified Charging Cable (Grey, 1.8 meter)",Warehouse C,46,34,2025-02-11 19:43:00,12
21356,ORD_21357,16877,"Cello Winner Assorted Ball Pen Set, Pack of 60 (50 Blue, 7 Black, 3 Red ink)|Lightweight Ball Pens for Pressure Free and F...",Warehouse C,57,49,2025-02-11 12:52:00,8
21357,ORD_21358,15334,Playground Hero Shadow Palette - Classic Phoenix 9 gm,Warehouse B,45,26,2025-02-11 14:42:00,19
21358,ORD_21359,15347,"F&D A140X 74 W 2.1 Channel Bluetooth Multimedia Speakers with Subwoofer Satellite Speaker, Remote, Digital FM & USB (Black)",Warehouse B,20,12,2025-02-11 12:59:00,8
21359,ORD_21360,14665,BIOFER S 100mg/5ml Injection,Warehouse B,20,1,2025-02-11 08:02:00,19
21360,ORD_21361,12639,Secret Solution Wedding Dress Facial Cream,Warehouse C,75,65,2025-02-11 13:11:00,10
21361,ORD_21362,2881,Gemblue Biocare Skin Balancing Body lotion 500 ml,Warehouse B,84,73,2025-02-11 14:40:00,11
21362,ORD_21363,1460,"Parachute Advansed Gold Coconut Hair Oil, 190 ml",Warehouse B,65,59,2025-02-11 11:29:00,6
21363,ORD_21364,16705,Digital Shoppy Eyebrow Tattoo Pen Waterproof 4 Points Eyebrow Pen Long Lasting Liquid Brow Pencil Natural Microblade Eyebr...,Warehouse C,55,50,2025-02-11 23:49:00,5
21364,ORD_21365,32265,"SHAFIRE Leather Mobile Pouch for Men,Multifunction Belt Pouch for Mobile Phone,Large Universal Leather Case Waist Bag ( Br...",Warehouse B,47,34,2025-02-11 15:37:00,13
21365,ORD_21366,16736,Myket-ZP Shampoo,Warehouse B,31,19,2025-02-11 10:09:00,12
21366,ORD_21367,15113,"boAt Deuce Usb 500 Stress Resistant, Tangle-Free, Sturdy 2-In-1 Micro Usb For Personal Computer (Rebellious Black, 1.5M Le...",Warehouse A,50,44,2025-02-11 16:11:00,6
21367,ORD_21368,34603,"ProElite Smart Flip Case Cover for Apple iPad Air 5th/4th Generation 10.9 inch , Translucent Back, Black",Warehouse B,104,90,2025-02-11 17:26:00,14
21368,ORD_21369,15103,Tuspel LS 1 Expectorant,Warehouse A,47,29,2025-02-11 06:44:00,18
21369,ORD_21370,15148,"TOUGH LEE 5 in 1 Cleaning Pen for Airpods Pro 1 2 3, Gadget Cleaner & Cleaning Kit Brush Set || Suitable for Earbuds, Mobi...",Warehouse B,22,13,2025-02-11 00:54:00,9
21370,ORD_21371,11481,Makeup Revolution Kohl Eyeliner Black 1.2 gm,Warehouse C,69,58,2025-02-11 21:03:00,11
21371,ORD_21372,12407,Wax-Off Advance Ear Drop,Warehouse A,90,81,2025-02-11 00:27:00,9
21372,ORD_21373,1429,CROSSVOLT Compatible for Xiaomi Mi Band 5/6 Silicone Adjustable Watch Strap - Set 5,Warehouse C,106,89,2025-02-11 10:57:00,17
21373,ORD_21374,16782,Tee Z 250mg Injection,Warehouse C,111,99,2025-02-11 18:57:00,12
21374,ORD_21375,34523,Cefilet LB 200mg Tablet,Warehouse C,83,78,2025-02-11 11:29:00,5
21375,ORD_21376,34650,Lejen M Syrup,Warehouse B,61,45,2025-02-11 07:42:00,16
21376,ORD_21377,16691,Party Glow Facial Kit - 5 Session,Warehouse A,53,45,2025-02-11 06:43:00,8
21377,ORD_21378,34667,Ajmal Amber Magic EDP Spicy Aromatic Perfume And Sacrifice II For Him Deodorant Fruity Aromatic Fragrance 300 ml,Warehouse A,83,76,2025-02-11 07:44:00,7
21378,ORD_21379,2758,"OTOROYS Version 2 X-Grip Universal Bike Mobile Holder with USB Charger 360 Degree Rotation for All Smartphone, Navigation,...",Warehouse B,54,40,2025-02-11 14:11:00,14
21379,ORD_21380,34519,Q Life 500mg Tablet,Warehouse C,95,86,2025-02-11 11:02:00,9
21380,ORD_21381,16683,Monseep FX 10mg/120mg Tablet,Warehouse A,75,68,2025-02-11 12:52:00,7
21381,ORD_21382,16682,Clomaxin 250mg/50mg Injection,Warehouse B,89,81,2025-02-11 18:32:00,8
21382,ORD_21383,16768,Clarity Essential Oil - 100% Natural & Organic,Warehouse C,84,79,2025-02-11 13:20:00,5
21383,ORD_21384,1393,W4 Perfume Spray - For Women,Warehouse C,101,89,2025-02-11 11:54:00,12
21384,ORD_21385,34496,Mirstar 7.5mg Tablet,Warehouse A,90,80,2025-02-11 05:01:00,10
21385,ORD_21386,12456,Natly 25mg Injection,Warehouse A,48,30,2025-02-11 17:44:00,18
21386,ORD_21387,11522,"BOBO BM4 Jaw-Grip Waterproof Bike / Motorcycle / Scooter Mobile Phone Holder Mount, Ideal for Maps and GPS Navigation (Red)",Warehouse B,38,21,2025-02-11 15:28:00,17
21387,ORD_21388,12460,Amazon Brand - Solimo Back Cover for LG G8X ThinQ (Silicone_Clear),Warehouse B,83,78,2025-02-11 04:41:00,5
21388,ORD_21389,12551,Adinep 20 Tablet,Warehouse B,96,80,2025-02-11 00:46:00,16
21389,ORD_21390,16831,"Titu Ki Baatein Stickers for Water Bottles, 90 Pack/PCS Cute Hydroflask Stickers, Waterproof Vsco Vinyl Aesthetic Computer...",Warehouse B,90,84,2025-02-11 22:27:00,6
21390,ORD_21391,12552,Hanumex® 8x10 FT Premium Professional Chroma Green Background Wrinkle Free for Photo & Video Backdrop Chromakey Screen Bac...,Warehouse B,67,55,2025-02-11 15:21:00,12
21391,ORD_21392,1611,Closap B Capsule,Warehouse C,85,68,2025-02-11 00:20:00,17
21392,ORD_21393,14828,Robustrion Pack of 2 Anti-Scratch & Smudge Proof Tempered Glass Screen Protector for Xiaomi Mi Pad 5 11 inch,Warehouse B,98,79,2025-02-11 17:28:00,19
21393,ORD_21394,2366,"Boltove® 6x9 Ft. Black Screen Backdrop Background Curtain Rod Pocket for Photography, Photoshoot, Product Photography,, Li...",Warehouse A,98,93,2025-02-11 06:30:00,5
21394,ORD_21395,15893,AE Mini Digital Voice Recorder of 32 GB Micro SD Card Supportable Professional Audio Recorder MP 3 Player TF Card Dictapho...,Warehouse A,65,50,2025-02-11 04:08:00,15
21395,ORD_21396,15894,Mancode De-Tan Peel off Mask 100 gm,Warehouse A,65,46,2025-02-11 04:00:00,19
21396,ORD_21397,36601,Aspirose 10mg/75mg Capsule,Warehouse B,22,17,2025-02-11 08:15:00,5
21397,ORD_21398,36612,BEAUTY GOLD 33 pcs Multiolor Diamond Round Stone Bindis for Women and Girl Foredead,Warehouse B,37,31,2025-02-11 23:42:00,6
21398,ORD_21399,36627,Probiotics Gummies - Enriched With Amla,Warehouse B,80,71,2025-02-11 16:56:00,9
21399,ORD_21400,33353,CADIVEU Hydrating Hair Complex Restoring Mask,Warehouse C,24,10,2025-02-11 01:58:00,14
21400,ORD_21401,11102,Mecol 100mg Injection,Warehouse C,60,48,2025-02-11 13:12:00,12
21401,ORD_21402,15956,"boAt Blaze Smart Watch with 1.75” HD Display, Fast Charge, Apollo 3 Blue Plus Processor, 24x7 Heart Rate & SpO2 Monitor, M...",Warehouse A,77,63,2025-02-11 15:46:00,14
21402,ORD_21403,11766,Fedoper 250mg Oral Suspension,Warehouse B,48,34,2025-02-11 01:18:00,14
21403,ORD_21404,15965,Kangaro Desk Essentials DP-480 2 Hole Heavy Duty Metal Paper Punch | Removable Chip Tray | 12 Sheets Capacity | Office Ess...,Warehouse C,49,33,2025-02-11 18:59:00,16
21404,ORD_21405,11112,Ramsho 2.5mg Tablet,Warehouse A,31,26,2025-02-11 09:13:00,5
21405,ORD_21406,2350,Arsulide 100mg Tablet,Warehouse C,77,61,2025-02-11 20:43:00,16
21406,ORD_21407,32978,Azolid 500mg Tablet,Warehouse C,37,21,2025-02-11 00:53:00,16
21407,ORD_21408,207,Vega Dressing Comb (HMBC - 103) 23 gm,Warehouse C,102,92,2025-02-11 09:23:00,10
21408,ORD_21409,33318,Urban Balance Youth Preserve Night Cream,Warehouse B,99,92,2025-02-11 09:47:00,7
21409,ORD_21410,36778,Pro Health SmartFlex Toothbrush,Warehouse C,105,93,2025-02-11 04:09:00,12
21410,ORD_21411,11773,Qutace 50mg Tablet,Warehouse B,96,87,2025-02-11 22:01:00,9
21411,ORD_21412,13617,"Ambrane 20000mAh Power Bank with 20W Fast Charging, Triple Output, Power Delivery, Type C Input, Made in India, Multi-Laye...",Warehouse B,55,50,2025-02-11 06:07:00,5
21412,ORD_21413,2159,"ZEBRONICS Zeb-Crystal Clear Web Camera with 3P Lens,Built-in Microphone,Auto White Balance,Night Vision and Manual Switch ...",Warehouse B,19,11,2025-02-11 01:10:00,8
21413,ORD_21414,3320,Rablear 20 Tablet,Warehouse A,84,71,2025-02-11 12:58:00,13
21414,ORD_21415,32984,"Nokia T10 Android 12 Tablets with 8 HD Display, 8MP Rear Camera, AI face Unlock, All-Day Battery, WiFi | 4 + 64GB, 8 inche...",Warehouse C,56,40,2025-02-11 18:23:00,16
21415,ORD_21416,13575,Roll on Glass Deodorant - Original For Men,Warehouse C,86,78,2025-02-11 10:38:00,8
21416,ORD_21417,320,Moxicon Eye Drop,Warehouse A,95,83,2025-02-11 02:40:00,12
21417,ORD_21418,3284,Doubledicestore Tempered Glass Screen Protector Compatible for Redmi Note 11/Note 11s with Edge to Edge Coverage and Easy ...,Warehouse A,21,13,2025-02-11 20:32:00,8
21418,ORD_21419,36860,Eurotam D 0.50mg Tablet,Warehouse B,58,45,2025-02-11 21:18:00,13
21419,ORD_21420,31407,Mischief Avatar Deodorant & Body Spray Perfume For Men,Warehouse A,111,92,2025-02-11 14:23:00,19
21420,ORD_21421,36409,Levetas 250mg Tablet,Warehouse B,100,94,2025-02-11 06:53:00,6
21421,ORD_21422,13114,Crypo™ Universal Remote Compatible with Tata Play Universal HD & SD Set top Box (Also Works with All TV),Warehouse C,34,29,2025-02-11 23:42:00,5
21422,ORD_21423,36426,Dolomas P 100mg/325mg Tablet,Warehouse B,108,92,2025-02-11 06:00:00,16
21423,ORD_21424,33409,Cosmus Darwin 29 litres Office Backpack - Sleek Everyday use Backpack - Black,Warehouse C,24,19,2025-02-11 05:55:00,5
21424,ORD_21425,13168,Fevincio Tablet,Warehouse B,67,52,2025-02-11 14:54:00,15
21425,ORD_21426,16193,Street Wear Lip2Last Matte Liquid Lipstick - Binge Berry 5 ml,Warehouse A,38,28,2025-02-11 17:13:00,10
21426,ORD_21427,2815,Antiseptic Liquid 1 L+ Disinfectant Spray- Original 225 ml,Warehouse B,43,27,2025-02-11 11:58:00,16
21427,ORD_21428,32121,Softvisc Gel,Warehouse C,30,21,2025-02-11 23:52:00,9
21428,ORD_21429,34962,Body Massage Oil - Lemongrass & Lavender,Warehouse C,37,23,2025-02-11 01:55:00,14
21429,ORD_21430,1580,Cijocalt-DS Dry Syrup,Warehouse B,79,62,2025-02-11 23:45:00,17
21430,ORD_21431,1236,"Anjaney Enterprise Smart Multipurpose Foldable Laptop Table with Cup Holder, Study Table, Bed Table, Breakfast Table, Fold...",Warehouse A,96,81,2025-02-11 08:35:00,15
21431,ORD_21432,12303,Lexadep AX Tablet,Warehouse C,94,77,2025-02-11 00:19:00,17
21432,ORD_21433,16612,Vigilant 200mg Tablet,Warehouse A,56,41,2025-02-11 15:01:00,15
21433,ORD_21434,15290,Xme LB 50mg Tablet,Warehouse C,109,96,2025-02-11 01:42:00,13
21434,ORD_21435,35010,"Crucial P3 500GB PCIe 3.0 3D NAND NVMe M.2 SSD, up to 3500MB/s - CT500P3SSD8",Warehouse B,70,65,2025-02-11 18:42:00,5
21435,ORD_21436,14759,Aquapred O Eye Drop,Warehouse A,48,41,2025-02-11 02:20:00,7
21436,ORD_21437,35016,Olways OK Eye Drop,Warehouse C,93,87,2025-02-11 01:10:00,6
21437,ORD_21438,35025,Wheatopower Tablet,Warehouse C,59,42,2025-02-11 09:23:00,17
21438,ORD_21439,16604,Luxor 1236 CD/DVD/OHP Fine Marker - Black - Box of 10,Warehouse B,89,72,2025-02-11 10:28:00,17
21439,ORD_21440,15303,"SanDisk Cruzer Glide 3.0 USB Flash Drive, CZ600 64GB, USB3.0, Black with red Slider, Retractable Design, 5Y",Warehouse C,70,58,2025-02-11 08:59:00,12
21440,ORD_21441,35058,Spigen Essential PF2104 Wireless Charger for iPhone 14/13/12/11 Samsung Galaxy S22/S21/S20 OnePlus 9/9 Pro with USB-C to C...,Warehouse C,64,46,2025-02-11 12:48:00,18
21441,ORD_21442,12613,Somaron 6mg Tablet,Warehouse C,34,21,2025-02-11 04:03:00,13
21442,ORD_21443,12617,Effy 50mg Dry Syrup,Warehouse A,24,6,2025-02-11 09:27:00,18
21443,ORD_21444,2843,Telmosar 40mg Tablet,Warehouse C,96,81,2025-02-11 02:30:00,15
21444,ORD_21445,35080,T-Cycline HC Eye Ointment,Warehouse A,62,54,2025-02-11 23:52:00,8
21445,ORD_21446,35083,Domitex 125mg Syrup,Warehouse A,33,15,2025-02-11 19:48:00,18
21446,ORD_21447,14687,realme narzo 50i Prime (Dark Blue 3 GB RAM +32 GB Storage) Octa-core Processor | 5000 mAh Battery,Warehouse C,74,58,2025-02-11 05:18:00,16
21447,ORD_21448,12632,Hand Sanitizer Gel,Warehouse B,48,36,2025-02-11 07:52:00,12
21448,ORD_21449,36173,ZEBRONICS Zeb-Grace Wired Over The Ear Headphone with Mic (Black),Warehouse C,26,15,2025-02-11 14:15:00,11
21449,ORD_21450,16419,"iBELL CP404 4 Channel SMPS for CCTV Output, Power Supply Adapter for up to 4 CCTV Cameras, White (Pack of 1)",Warehouse B,21,7,2025-02-11 14:57:00,14
21450,ORD_21451,33378,Ultrathin Sensitive Toothbrush,Warehouse A,106,93,2025-02-11 23:16:00,13
21451,ORD_21452,7023,Wet n Wild Color Icon 10 Pan Palette-Petalette Rosé in the air( Eyeshadow Palette with 10 Bright and Matte Eyeshadow Color...,Warehouse A,55,42,2025-02-11 02:49:00,13
21452,ORD_21453,36771,"Logitech MK120 Wired USB Keyboard and Mouse Set for Windows, Optical Wired Mouse, Full-Size Keyboard, USB Plug-and-Play, C...",Warehouse C,56,40,2025-02-11 14:41:00,16
21453,ORD_21454,7553,Roarx 20W USB-C Charger Original Fast Charger Adapter Compatible with Google Pixel 6 / 6A / 5/4 XL 4a / 3a XL / 3 / XL / 2...,Warehouse C,102,87,2025-02-11 22:57:00,15
21454,ORD_21455,23738,Azibrax 500mg Tablet,Warehouse B,86,76,2025-02-11 18:19:00,10
21455,ORD_21456,19898,B Set 4mg Tablet MD,Warehouse B,32,20,2025-02-11 00:25:00,12
21456,ORD_21457,22490,Ostoact,Warehouse B,68,55,2025-02-11 05:06:00,13
21457,ORD_21458,9513,Vega Cushion Brush (E3 - CB) 145 gm,Warehouse A,103,94,2025-02-11 17:06:00,9
21458,ORD_21459,23644,Clavio-DS Oral Suspension,Warehouse C,92,80,2025-02-11 15:44:00,12
21459,ORD_21460,3506,"Samsung Galaxy A23 5G, Light Blue (6GB, 128GB Storage) with Offer",Warehouse C,93,79,2025-02-11 05:59:00,14
21460,ORD_21461,30636,Novomine 1000mg Injection,Warehouse B,87,74,2025-02-11 23:13:00,13
21461,ORD_21462,3622,Touchcef SB 250mg/125mg Injection,Warehouse B,35,16,2025-02-11 09:34:00,19
21462,ORD_21463,27280,"boAt Newly Launched Aavante Bar Tune Soundbar with 60W RMS Signature Sound, 2.0 Channel, Multi-Connectivity Modes, BT v5....",Warehouse C,109,97,2025-02-11 18:41:00,12
21463,ORD_21464,23259,"RENEE Face Base BB Cream 7 in 1 with SPF 30 PA+++, Enriched with Vitamin C, Hyaluronic Acid, Hydrates, Nourishes & Smoothe...",Warehouse A,99,85,2025-02-11 18:47:00,14
21464,ORD_21465,30689,Uniquin EC 600mg Tablet,Warehouse C,105,86,2025-02-11 15:36:00,19
21465,ORD_21466,8083,Molanz-DSR 30mg/30mg Capsule,Warehouse B,69,57,2025-02-11 11:38:00,12
21466,ORD_21467,22625,Delmont F 10mg/120mg Tablet,Warehouse C,85,78,2025-02-11 09:40:00,7
21467,ORD_21468,22771,Neem & Tea Tree Face Wash,Warehouse A,118,99,2025-02-11 20:46:00,19
21468,ORD_21469,26921,"pTron Tangent Duo Bluetooth 5.2 Wireless in Ear Earphones, 13mm Driver, Deep Bass, HD Calls, Fast Charging Type-C Neckban...",Warehouse C,35,17,2025-02-11 09:08:00,18
21469,ORD_21470,26707,Acneheal Gel,Warehouse B,41,34,2025-02-11 15:22:00,7
21470,ORD_21471,30664,House of Aroma Cinnamon Fragrance Oil 100 ml,Warehouse C,14,5,2025-02-11 06:24:00,9
21471,ORD_21472,5463,Beard Growth Serum - For Oily Skin,Warehouse A,62,45,2025-02-11 21:26:00,17
21472,ORD_21473,23583,Pomegranate Face & Body Scrub,Warehouse C,59,50,2025-02-11 06:20:00,9
21473,ORD_21474,7978,Charmacy Milano Soft Satin Matte Lipstick (Fiery Rose) 3.8 gm,Warehouse B,54,41,2025-02-11 06:19:00,13
21474,ORD_21475,17621,Dilept 5mg/850mg Tablet,Warehouse B,74,58,2025-02-11 20:22:00,16
21475,ORD_21476,22571,Dazover 12mg Tablet,Warehouse B,75,70,2025-02-11 21:10:00,5
21476,ORD_21477,20328,Torstar 40mg Tablet,Warehouse B,26,12,2025-02-11 15:38:00,14
21477,ORD_21478,23591,Nutriment Lemon Scrub All Skin Type 250 gm,Warehouse B,106,87,2025-02-11 19:27:00,19
21478,ORD_21479,7537,Castop-S 1000mg/500mg Injection,Warehouse B,35,29,2025-02-11 12:46:00,6
21479,ORD_21480,30703,Efon 60mg Capsule,Warehouse B,87,81,2025-02-11 08:21:00,6
21480,ORD_21481,26746,Buscomide 10mg/325mg Tablet,Warehouse A,70,52,2025-02-11 05:34:00,18
21481,ORD_21482,17796,Flaxo 200mg Tablet,Warehouse C,60,43,2025-02-11 07:22:00,17
21482,ORD_21483,23232,Prazocin 2.5mg Tablet ER,Warehouse A,90,85,2025-02-11 14:15:00,5
21483,ORD_21484,30525,Glorifyline 200 SR Tablet,Warehouse B,25,8,2025-02-11 02:11:00,17
21484,ORD_21485,23210,Pikkme Samsung Galaxy M30s / M21 / M21 2021 Flip Cover| PU Leather Finish | 360 Protection | Wallet & Stand | Strong Magne...,Warehouse C,44,34,2025-02-11 18:28:00,10
21485,ORD_21486,5435,"ESR Stylus Pen for iPad with Tilt Sensitivity, iPad Stylus Pencil for Apple iPad 10/9/8/7/6, iPad Pro 11, iPad Pro 12.9, i...",Warehouse B,23,16,2025-02-11 21:42:00,7
21486,ORD_21487,3711,SanDisk Ultra Dual 64 GB USB 3.0 OTG Pen Drive (Black),Warehouse A,36,24,2025-02-11 17:54:00,12
21487,ORD_21488,23379,"Shopping Wave Plastic Laptop Stand, Compatible with 9-15.6 inch Laptops, Tab, Mack Book, 7 Angles Adjustable Tabletop, Ant...",Warehouse B,14,1,2025-02-11 16:14:00,13
21488,ORD_21489,17547,Caprivon 50mg/500mg Tablet,Warehouse C,53,46,2025-02-11 19:26:00,7
21489,ORD_21490,3819,Cefumon 250mg Tablet,Warehouse C,41,31,2025-02-11 19:19:00,10
21490,ORD_21491,30750,Belther-LF Tablet,Warehouse C,92,81,2025-02-11 09:33:00,11
21491,ORD_21492,8072,Daympod CV Dry Syrup,Warehouse A,30,16,2025-02-11 11:56:00,14
21492,ORD_21493,7460,Tukzer Lap Desk Fits up to 17-Inch Laptop Angled Pillow Cushion with Built-in Mouse Pad & Phone Holder(Carbon Fiber),Warehouse C,52,37,2025-02-11 02:02:00,15
21493,ORD_21494,8138,eSYSTEMS Multi Plug Point 3+3 Universal Socket Adaptor with Led Indicator & Individual Switches & Fuse Protection (Cordles...,Warehouse B,68,54,2025-02-11 02:11:00,14
21494,ORD_21495,26604,Aloe Veda Deep Pore Detox Face Wash - Activated Charcoal 100 ml,Warehouse A,72,59,2025-02-11 23:36:00,13
21495,ORD_21496,23703,"JBL Cinema SB271, Dolby Digital Soundbar with Wireless Subwoofer for Extra Deep Bass, 2.1 Channel Home Theatre with Remot...",Warehouse C,70,52,2025-02-11 13:31:00,18
21496,ORD_21497,27345,Magnocef 100 mg/62.5 mg Tablet,Warehouse C,103,84,2025-02-11 18:15:00,19
21497,ORD_21498,8133,Sedell Lipstick Light Pink Nude (Matte),Warehouse A,54,45,2025-02-11 06:58:00,9
21498,ORD_21499,22546,Parot-CR 25 Tablet,Warehouse A,41,30,2025-02-11 05:12:00,11
21499,ORD_21500,27125,Lakme Absolute 3D Lipstick Romeo Red 3.6 Gm,Warehouse B,65,48,2025-02-11 06:26:00,17
21500,ORD_21501,3692,Mirah Belle Tea Tree Aloe Vera Hand Rub Sanitizer Spray 1000 ml,Warehouse A,76,62,2025-02-11 01:00:00,14
21501,ORD_21502,17606,Oxy-Infusion Replenishing Face Mask,Warehouse A,23,4,2025-02-11 22:59:00,19
21502,ORD_21503,5812,Nanocob Injection,Warehouse C,108,95,2025-02-11 12:06:00,13
21503,ORD_21504,27253,"Alotol Lotion With Vitamin C & Vitamin D - Intense moisturizing, Men & Women",Warehouse A,68,59,2025-02-11 06:21:00,9
21504,ORD_21505,8111,Anchor White Toothpaste 150 gm (Buy 2 Get 1 Free),Warehouse A,70,60,2025-02-11 22:05:00,10
21505,ORD_21506,30538,Insight Cosmetics Non Transfer Matte Lipstick - Intension 4.2 gm,Warehouse A,47,35,2025-02-11 01:54:00,12
21506,ORD_21507,17868,"LG 24Gn650 Ultragear Gaming 24 Inch (60 Cm) LCD 1920 x 1080 Pixels IPS Full Hd - 144Hz, 1Ms, G-Sync Compatible, Freesync P...",Warehouse C,81,67,2025-02-11 12:48:00,14
21507,ORD_21508,20442,Lyforan Plus 1000 mg/500 mg Injection,Warehouse C,99,80,2025-02-11 09:19:00,19
21508,ORD_21509,27353,Bathing Soap - Ayurvedic Soap with 18 Herbs,Warehouse B,42,23,2025-02-11 08:11:00,19
21509,ORD_21510,23216,Gastrodom 10mg/150mg Tablet,Warehouse B,42,33,2025-02-11 17:28:00,9
21510,ORD_21511,30716,Oxacent 600mg Tablet,Warehouse A,52,44,2025-02-11 02:57:00,8
21511,ORD_21512,19907,"Creme - Non Greasy Moisturizer Cream for Face, Body & Hands",Warehouse C,79,60,2025-02-11 00:42:00,19
21512,ORD_21513,23718,Cezopic S 1000mg/500mg Injection,Warehouse C,73,56,2025-02-11 21:07:00,17
21513,ORD_21514,3668,Gabantin-NT Tablet,Warehouse C,23,16,2025-02-11 08:22:00,7
21514,ORD_21515,20367,"ESR Tempered-Glass Screen Protector Compatible with iPhone 14 Plus and iPhone 13 Pro Max, with Easy Installation Frame, Mi...",Warehouse B,98,84,2025-02-11 21:16:00,14
21515,ORD_21516,8180,Foaming Face Wash,Warehouse A,93,82,2025-02-11 01:28:00,11
21516,ORD_21517,7435,Taft Power Wax,Warehouse B,92,85,2025-02-11 00:40:00,7
21517,ORD_21518,5386,GK HAIR Moisturizing Shampoo & Conditioner for Normal to Dry Frizzy Hair Nourishes Dry Brittle Hair Deeply With Natural Ke...,Warehouse A,37,23,2025-02-11 10:33:00,14
21518,ORD_21519,30345,Ajmal Amber Magic EDP Spicy Aromatic Perfume 100ml for Men and Shine EDP Floral Powdery Perfume 75ml for Women + 1 Perfume...,Warehouse B,11,5,2025-02-11 07:53:00,6
21519,ORD_21520,22353,Syndopa Forte Tablet,Warehouse B,93,81,2025-02-11 07:30:00,12
21520,ORD_21521,23908,Dizone Tablet,Warehouse A,64,46,2025-02-11 20:31:00,18
21521,ORD_21522,30831,Fexoden M 10mg/120mg Tablet,Warehouse C,67,60,2025-02-11 12:49:00,7
21522,ORD_21523,22673,Ajmal Classic Oud Concentrated Perfume Oil Woody Oudh Attar And Impress Concentrated Perfume Oil Citrus Attar 20 ml,Warehouse C,29,12,2025-02-11 01:29:00,17
21523,ORD_21524,30408,"MOCA 13-inch Laptop Sleeve Case for 13.3” - 14 inch MacBook Pro/Air M1 M2, Surface Laptop 3/2, Dell Inspiron 13/XPS 13, Sh...",Warehouse B,21,6,2025-02-11 10:34:00,15
21524,ORD_21525,22828,Auglife 625 Tablet,Warehouse C,54,42,2025-02-11 23:06:00,12
21525,ORD_21526,19886,"OFIXO File Folder Leatherette Material Professional File Folders for Certificates, Documents Holder, Card Holder, Cheque B...",Warehouse B,92,83,2025-02-11 13:12:00,9
21526,ORD_21527,26947,Ventrox PD Tablet,Warehouse A,66,48,2025-02-11 02:12:00,18
21527,ORD_21528,19891,Auxone S 1000 mg/500 mg Injection,Warehouse B,84,78,2025-02-11 22:02:00,6
21528,ORD_21529,7755,Sivanna Colors Cookie Blush Duo - DU278 07 08 gm,Warehouse A,22,3,2025-02-11 08:45:00,19
21529,ORD_21530,8161,Faber-Castell Chisel Textliner - Pack of 10 (Yellow),Warehouse A,36,25,2025-02-11 02:41:00,11
21530,ORD_21531,22760,Baby Happy Cotton Pads,Warehouse C,51,35,2025-02-11 00:46:00,16
21531,ORD_21532,20203,Incense Man EDT,Warehouse C,16,3,2025-02-11 07:31:00,13
21532,ORD_21533,17616,Parker Vector Standard CT(RB+BP) Pen (Black),Warehouse B,90,84,2025-02-11 00:05:00,6
21533,ORD_21534,19974,Angloflu 150mg Tablet,Warehouse B,106,98,2025-02-11 18:33:00,8
21534,ORD_21535,23517,The Natural Wash Pure Cold Pressed Neem Oil For Skin And Hair 100 Ml,Warehouse B,37,26,2025-02-11 04:11:00,11
21535,ORD_21536,3747,Roxilide 150mg Tablet,Warehouse C,102,90,2025-02-11 22:42:00,12
21536,ORD_21537,26578,"OnePlus Warp Charge Type-C Cable (100cm, Red)",Warehouse B,24,9,2025-02-11 15:11:00,15
21537,ORD_21538,23461,Zyrotram P 325 mg/37.5 mg Tablet,Warehouse B,43,25,2025-02-11 08:48:00,18
21538,ORD_21539,17924,"Samsung Galaxy M53 5G (Deep Ocean Blue, 8GB, 128GB Storage) | 108MP | sAmoled+ 120Hz | 16GB RAM with RAM Plus | Travel Ada...",Warehouse C,95,82,2025-02-11 02:16:00,13
21539,ORD_21540,17929,Ciligold 10mg Tablet,Warehouse B,45,29,2025-02-11 18:15:00,16
21540,ORD_21541,19877,Wormol Suspension,Warehouse B,22,15,2025-02-11 23:32:00,7
21541,ORD_21542,20490,Nitram 10mg Tablet,Warehouse C,17,2,2025-02-11 01:38:00,15
21542,ORD_21543,20234,Skodex Syrup,Warehouse B,48,31,2025-02-11 03:12:00,17
21543,ORD_21544,9540,Mirah Belle Charcoal Oily Skin Face wash 200 ml,Warehouse A,36,26,2025-02-11 08:03:00,10
21544,ORD_21545,17937,Forest Essentials Silken Dusting Powder Mashobra Honey & Vanilla|Talc-Free & Quick-Absorbing|For Men And Women|100 g,Warehouse B,54,40,2025-02-11 20:52:00,14
21545,ORD_21546,30436,"Seagate One Touch 4TB External HDD with Password Protection – Black, for Windows and Mac, with 3 yr Data Recovery Service...",Warehouse C,84,76,2025-02-11 06:15:00,8
21546,ORD_21547,18027,Soulflower Aroma Oil - Love is in the Air 30 ml,Warehouse B,34,28,2025-02-11 05:07:00,6
21547,ORD_21548,30748,Sympta 60mg Tablet,Warehouse C,65,46,2025-02-11 11:14:00,19
21548,ORD_21549,22705,Emerest 2mg Injection,Warehouse A,51,37,2025-02-11 04:06:00,14
21549,ORD_21550,22700,St.Botanica Body Wash - Cuban Paradise 250 ml,Warehouse C,26,17,2025-02-11 21:01:00,9
21550,ORD_21551,9577,Betkal Injection,Warehouse B,37,26,2025-02-11 04:47:00,11
21551,ORD_21552,5785,Hand Sanitizer Gel - Orange,Warehouse C,25,20,2025-02-11 05:03:00,5
21552,ORD_21553,20378,Coform AX 15 mg/50 mg/1 mg Syrup,Warehouse B,34,27,2025-02-11 18:31:00,7
21553,ORD_21554,23747,Rts&trade; High Speed 3D Full HD 1080p Support (10 Meters) HDMI Male to HDMI Male Cable TV Lead 1.4V for All Hdmi Devices-...,Warehouse B,38,24,2025-02-11 22:35:00,14
21554,ORD_21555,22635,Ceroxim I 750mg Injection,Warehouse B,103,94,2025-02-11 08:48:00,9
21555,ORD_21556,9445,PALAY BTS School Backpack Kpop Theme BTS Bangtan Girls Casual Backpack,Warehouse C,98,81,2025-02-11 03:01:00,17
21556,ORD_21557,26981,Arkaprop 40mg Tablet,Warehouse C,68,52,2025-02-11 05:02:00,16
21557,ORD_21558,3473,Professional Salon Series Platinum Silver Facial Kit,Warehouse B,91,84,2025-02-11 11:46:00,7
21558,ORD_21559,3805,Light Hydration Body Lotion,Warehouse A,21,2,2025-02-11 17:40:00,19
21559,ORD_21560,30352,Acilen SP 100mg/325mg/15mg Tablet,Warehouse C,52,36,2025-02-11 10:33:00,16
21560,ORD_21561,22400,GasoFast GASS-O-FAST JEERA Powder,Warehouse B,111,92,2025-02-11 06:32:00,19
21561,ORD_21562,9539,Dolomol 125mg Oral Suspension,Warehouse A,60,43,2025-02-11 03:17:00,17
21562,ORD_21563,7437,"DURACELL 36 Watts Fast Wall Charger Adapter, Type C Power Delivery & QC 3.0 USB Charger Fast Charging Compatible with iPho...",Warehouse A,88,83,2025-02-11 06:34:00,5
21563,ORD_21564,18000,Seradol Tablet,Warehouse B,70,57,2025-02-11 02:14:00,13
21564,ORD_21565,26967,Diresta OD 750mg Tablet ER,Warehouse C,23,17,2025-02-11 03:18:00,6
21565,ORD_21566,19853,Ebvom 10mg/10mg/5mg Tablet,Warehouse B,97,80,2025-02-11 10:12:00,17
21566,ORD_21567,26559,Gastowel L 75mg/20mg Capsule SR,Warehouse C,91,75,2025-02-11 14:17:00,16
21567,ORD_21568,30385,Parasafe 650mg Tablet,Warehouse B,76,58,2025-02-11 20:38:00,18
21568,ORD_21569,26853,Etowell TH 60mg/4mg Tablet,Warehouse A,62,53,2025-02-11 22:50:00,9
21569,ORD_21570,17556,"Amina Henna, Natural Black Mehndi Powder, 250 g (Pack of 10)",Warehouse A,43,36,2025-02-11 10:05:00,7
21570,ORD_21571,23134,Fructis Shampoo - Long & Strong Strengthening,Warehouse C,56,47,2025-02-11 23:15:00,9
21571,ORD_21572,22388,Novtech Adjustable Tabletop Laptop Stand Riser Ventilated Portable Foldable Compatible with MacBook Notebook Tablet Tray D...,Warehouse B,45,30,2025-02-11 05:31:00,15
21572,ORD_21573,30791,"PACKCESS 100ml Hair Root Applicator Bottle With Comb Cap & Flip Cap For Hair Oil Shampoo & Medicines, With Fine Mist Spray...",Warehouse B,113,97,2025-02-11 20:10:00,16
21573,ORD_21574,5394,"SanDisk Extreme uSD,160MB/s R, 90MB/s W,C10,UHS,U3,V30,A2, 128GB, for 4K Video on Smartphones, Action Cams & Drones",Warehouse A,36,19,2025-02-11 17:00:00,17
21574,ORD_21575,7934,Defen 50mg/500mg Tablet,Warehouse C,98,80,2025-02-11 06:51:00,18
21575,ORD_21576,20513,Olmite Cream,Warehouse B,37,24,2025-02-11 03:52:00,13
21576,ORD_21577,29939,"PTron Solero T241 2.4A Type-C Data & Charging USB Cable, Made in India, 480Mbps Data Sync, Durable 1-Meter Long USB Cable ...",Warehouse B,81,66,2025-02-11 22:16:00,15
21577,ORD_21578,24155,"Tronica TR-1501 Deep Bass Home Theater with Subwoofer 2.1 Channel with 55W Premium Signature Sound, Multiple Connectivity ...",Warehouse A,63,53,2025-02-11 03:29:00,10
21578,ORD_21579,19750,Ketoskip AQ 75mg Injection,Warehouse A,46,34,2025-02-11 07:12:00,12
21579,ORD_21580,26530,Trisul 1000mg/500mg Injection,Warehouse C,99,82,2025-02-11 21:55:00,17
21580,ORD_21581,9629,Trozole 40mg Injection,Warehouse B,54,48,2025-02-11 06:39:00,6
21581,ORD_21582,19984,"Vyagradhi - Decongestant, 500 mg",Warehouse A,71,58,2025-02-11 23:27:00,13
21582,ORD_21583,3837,Brethmol 4mg Tablet,Warehouse A,64,53,2025-02-11 12:15:00,11
21583,ORD_21584,7332,SebaMed Anti Dandruff Shampoo 200ml (New Packaging),Warehouse A,58,45,2025-02-11 11:38:00,13
21584,ORD_21585,27478,Cofpyl LS Syrup,Warehouse B,101,96,2025-02-11 02:44:00,5
21585,ORD_21586,8235,"Amazon Brand - Solimo Thermoplastic Polyurethane, Plastic Transparent Black Bumper Case Hard Back & Soft Bumper Cover for ...",Warehouse A,106,94,2025-02-11 19:15:00,12
21586,ORD_21587,18048,Myglamm Powder Magic Eyeshadow Pencil - Aquamarine 1.54 Gm,Warehouse A,30,19,2025-02-11 21:16:00,11
21587,ORD_21588,9234,Odeon Intense Moisturising Cocoa Butter Body Lotion 400 ml,Warehouse A,53,43,2025-02-11 20:20:00,10
21588,ORD_21589,5365,Medimade Shea Butter And Mango Butter Moisturising Body Lotion (Pack of 2) 1's,Warehouse C,21,3,2025-02-11 12:45:00,18
21589,ORD_21590,20174,IFB 20 Litre Solo Microwave Oven (20PM-MEC2) White,Warehouse C,95,82,2025-02-11 22:12:00,13
21590,ORD_21591,3459,Insant Hand Sanitizer,Warehouse A,21,9,2025-02-11 21:55:00,12
21591,ORD_21592,22343,"Random-mac Waterproof Mascara, Eyeliner, Eyebrow Pencil With Long Lasting Auto Kajal Black Pack of 4",Warehouse A,58,43,2025-02-11 04:48:00,15
21592,ORD_21593,22159,"Blue Heaven Hypergel Nailpaint - Ferrari Red, 509 11 ml",Warehouse B,48,42,2025-02-11 20:51:00,6
21593,ORD_21594,3453,Dorilyn M 80mg/250mg Tablet,Warehouse A,40,29,2025-02-11 07:23:00,11
21594,ORD_21595,23959,Dyazo Audio Headphone Earphone & Mic 3.5mm Jack Splitter 2 Male to 1 Female Gold Plated Car Aux Y Adapter Cable for Phones...,Warehouse A,91,83,2025-02-11 02:36:00,8
21595,ORD_21596,26519,"JL LCD Writing Tablet for Kids (8.5 Inch) Pad, Tab, Drawing Tablet Gift Toys Board Digital E Note Magic Slate Drawing Tabl...",Warehouse A,40,22,2025-02-11 11:23:00,18
21596,ORD_21597,19808,mCaffeine Green Tea Face Cleansing Butter with Shea Butter & Vitamin E| Moisturizing Face Cleanser and Makeup Remover| Cle...,Warehouse B,80,64,2025-02-11 04:02:00,16
21597,ORD_21598,27209,LAKMÉ 9 To 5 Vitamin C+ Serum (15 ml),Warehouse B,40,22,2025-02-11 21:59:00,18
21598,ORD_21599,18062,Hair Removal Cream For Normal Skin,Warehouse C,90,83,2025-02-11 17:03:00,7
21599,ORD_21600,7303,"EGOTUDE Soft Slim Flexible Silicone Back Cover Case for iPhone 13 (Matte Black, TPU)",Warehouse C,93,84,2025-02-11 11:13:00,9
21600,ORD_21601,26506,Omechem 2mg Injection,Warehouse A,53,46,2025-02-11 20:13:00,7
21601,ORD_21602,8258,Omsy 20mg Tablet,Warehouse C,77,68,2025-02-11 12:07:00,9
21602,ORD_21603,18088,Xelflo 10mg Tablet,Warehouse A,106,95,2025-02-11 05:25:00,11
21603,ORD_21604,26480,Sounce Silicone Soft Shock Proof Protective AirPods Case 5-in-1 Set Sleeve Skin Cover with Anti Lost Strap + Keychain + Ea...,Warehouse A,52,36,2025-02-11 16:35:00,16
21604,ORD_21605,30226,"Digitek (DRL-14) Professional 35.56 cm (14"")inch LED Ring Light | Dimmable Lighting | for YouTube | Photo-Shoot | Video Sh...",Warehouse C,23,16,2025-02-11 14:45:00,7
21605,ORD_21606,23982,Solodoxim CV Dry Syrup,Warehouse B,106,89,2025-02-11 11:26:00,17
21606,ORD_21607,22281,Votriz-Cold Tablet,Warehouse C,61,54,2025-02-11 17:57:00,7
21607,ORD_21608,30149,Dazcef 250mg Injection,Warehouse C,88,73,2025-02-11 12:07:00,15
21608,ORD_21609,24435,Anti Pigmentation Cream,Warehouse B,99,92,2025-02-11 05:19:00,7
21609,ORD_21610,23566,Thick & Natural Ayurvedic Long Growth Shikakai Shampoo,Warehouse B,35,27,2025-02-11 05:32:00,8
21610,ORD_21611,18127,Stbotanica Pure Eucalyptus Essential Oil 15 ml,Warehouse B,102,97,2025-02-11 04:31:00,5
21611,ORD_21612,23331,Trofaz Plus 5 mg/2 mg Tablet,Warehouse A,76,59,2025-02-11 11:14:00,17
21612,ORD_21613,7283,Ustraa Beard Growth Oil 35 ml,Warehouse B,61,53,2025-02-11 07:09:00,8
21613,ORD_21614,17529,Kadence Keyboard Sustain Pedal (KAD-KSP-PAD-01),Warehouse B,43,38,2025-02-11 00:33:00,5
21614,ORD_21615,9243,Sunex 100mg Tablet DT,Warehouse C,89,71,2025-02-11 17:08:00,18
21615,ORD_21616,10642,Deodorant Body Spray - Black Musk for Men,Warehouse C,116,99,2025-02-11 22:11:00,17
21616,ORD_21617,5579,Neurolyten-Forte Injection,Warehouse C,106,88,2025-02-11 05:15:00,18
21617,ORD_21618,19800,"Vivo Y56 5G (Black Engine, 8GB RAM, 128GB Storage) with No Cost EMI/Additional Exchange Offers",Warehouse A,63,57,2025-02-11 23:30:00,6
21618,ORD_21619,9643,Colorbar Rosy Red - (002) 1 gm,Warehouse B,44,37,2025-02-11 04:04:00,7
21619,ORD_21620,3873,V-Guard Envibe 12D4 Router UPS | Mini UPS for 12 V Wi-Fi Router | Uninterrupted Internet | 4-5 Hours Backup During Power C...,Warehouse B,74,63,2025-02-11 02:05:00,11
21620,ORD_21621,26467,"Miss Claire Miss Claire Ultra Glow Contour & Highlighter Makeup Palette 1, Multi, 16 Grams, Multicolor, 16 g",Warehouse A,103,93,2025-02-11 05:45:00,10
21621,ORD_21622,26466,"boAt Airdopes 172 True Wireless in Ear Earbuds with Enx Tech, Beast Mode, 35H Playtime, 11mm Drivers, ASAP Charge, IPX4, I...",Warehouse A,47,37,2025-02-11 03:30:00,10
21622,ORD_21623,20172,"Bouncefit Fitness Band Smart Watch- Y68 D20 Water Proof Smart Watches SpO2 Full Touch Smartwatch with Workout Modes, Heart...",Warehouse C,16,6,2025-02-11 12:55:00,10
21623,ORD_21624,18189,My Passion For Her - EDP 30 ml,Warehouse B,36,22,2025-02-11 23:14:00,14
21624,ORD_21625,24050,"Seagate One Touch 2TB External HDD with Password Protection – Light Blue, for Windows and Mac, with 3 yr Data Recovery Ser...",Warehouse B,67,50,2025-02-11 22:42:00,17
21625,ORD_21626,31117,"Fashion Colour 24hr Longwear Liquid Foundation With Skin Care, Ivory 30 gm",Warehouse A,58,40,2025-02-11 17:12:00,18
21626,ORD_21627,22231,"RiaTech (250mm x 210mm x 2mm Speed Type Mouse Pad with Antifray Stitched Embroidery Edges, Non-Slip Rubber Base Mousepad f...",Warehouse A,33,25,2025-02-11 03:03:00,8
21627,ORD_21628,5934,HomeStrap Cotton Canvas Board Medium Grain 5 X 7 Inch - Pack of 6 - White,Warehouse A,84,77,2025-02-11 13:12:00,7
21628,ORD_21629,3919,Fresh Ocean Deodorant - 48h Long lasting Freshness With Fresh Aqua Scent,Warehouse B,23,15,2025-02-11 13:01:00,8
21629,ORD_21630,30130,Aloe Hydro Gel,Warehouse C,36,28,2025-02-11 13:47:00,8
21630,ORD_21631,23989,Sambose GM 2mg/500mg/0.2mg Tablet,Warehouse C,105,86,2025-02-11 19:28:00,19
21631,ORD_21632,23047,Real Products Caboki Hair building fiber is absolutely natural & unnoticeable Black 25gm,Warehouse A,75,59,2025-02-11 08:30:00,16
21632,ORD_21633,18149,Fashionury Shockproof Crystal Clear Poco M4 Pro 4G Back Cover Case | 360 Degree Protection | Protective Design | Transpare...,Warehouse A,37,29,2025-02-11 14:12:00,8
21633,ORD_21634,3912,Wantor 10mg Tablet,Warehouse B,75,67,2025-02-11 02:13:00,8
21634,ORD_21635,30997,Mupizest 2% Cream,Warehouse B,96,84,2025-02-11 03:55:00,12
21635,ORD_21636,19986,Mom-SP Tablet,Warehouse A,32,21,2025-02-11 13:35:00,11
21636,ORD_21637,8261,Rosave-Gold 20mg Capsule,Warehouse B,67,61,2025-02-11 23:55:00,6
21637,ORD_21638,3581,"Redmi 10A (Slate Grey, 4GB RAM, 64GB Storage) | 2 Ghz Octa Core Helio G25 | 5000 mAh Battery | Finger Print Sensor | Upto ...",Warehouse C,36,27,2025-02-11 23:00:00,9
21638,ORD_21639,9649,"Motorola a70 keypad Mobile Dual Sim with Expandable Memory Upto 32GB,Camera, 2.4 inch Screen with 1750 mAh Battery, Rose Gold",Warehouse C,22,12,2025-02-11 21:05:00,10
21639,ORD_21640,24275,"SanDisk Ultra Dual USB Drive 3.1, SDDDC2-256G-I35 256GB, USB 3.1/Type C Reversible Connector, Retractable Design, Type-C O...",Warehouse B,96,88,2025-02-11 21:03:00,8
21640,ORD_21641,20144,XX Revolution press shadow palette xxtrovert 1.2 gm,Warehouse A,41,28,2025-02-11 23:52:00,13
21641,ORD_21642,11008,Osia Osia Rose & Rose 125 gm,Warehouse C,55,44,2025-02-11 23:53:00,11
21642,ORD_21643,10568,Combo Pack - Anti Ageing,Warehouse B,109,93,2025-02-11 07:43:00,16
21643,ORD_21644,3436,"MR.SIGA Steamer for Cold and Cough Nano-Cure Facial Iconic Cleanser with Nano-Ionic Technology, Steam Breath Machine for A...",Warehouse B,103,92,2025-02-11 06:55:00,11
21644,ORD_21645,24061,Loxapac C Liquid,Warehouse B,75,62,2025-02-11 22:55:00,13
21645,ORD_21646,7249,Calcisafe-CT Softgel Capsule,Warehouse B,106,94,2025-02-11 23:36:00,12
21646,ORD_21647,22214,One94Store LCD Writing Digital Drawing Graphics Pen Battery Free Cordless Digital Slate Portable E Writer Educational Tabl...,Warehouse B,88,73,2025-02-11 22:03:00,15
21647,ORD_21648,24085,"FEDUS Cat6 Ethernet Cable, 10 Meter High Speed 550MHZ / 10 Gigabit Speed UTP LAN Cable, Network Cable Internet Cable RJ45 ...",Warehouse B,76,69,2025-02-11 10:31:00,7
21648,ORD_21649,3965,Taft Ultra Wet Gel - Ultra Strong 4,Warehouse A,38,30,2025-02-11 13:55:00,8
21649,ORD_21650,5582,Pantonix L 75mg/40mg Capsule,Warehouse C,88,75,2025-02-11 07:33:00,13
21650,ORD_21651,26395,"Apple Watch SE (GPS + Cellular, 40mm) - Gold Aluminium Case with Starlight Sport Band - Regular",Warehouse B,68,52,2025-02-11 10:20:00,16
21651,ORD_21652,23021,Passion Indulge CLEANSER-ETERNIA 100 ml,Warehouse B,95,82,2025-02-11 23:28:00,13
21652,ORD_21653,20568,"Redgear Cosmo 7,1 Usb Gaming Wired Over Ear Headphones With Mic With Virtual Surround Sound,50Mm Driver, Rgb Leds & Remote...",Warehouse B,41,31,2025-02-11 23:59:00,10
21653,ORD_21654,27551,Ozdipine 10mg Tablet,Warehouse A,53,48,2025-02-11 23:43:00,5
21654,ORD_21655,3437,Ktl-Plus Eye Drops,Warehouse C,37,32,2025-02-11 18:35:00,5
21655,ORD_21656,3978,Newline-P Tablet,Warehouse B,50,31,2025-02-11 00:05:00,19
21656,ORD_21657,3981,Comet Busters Handcrafted Fancy Black Golden and Silver Diamond Dot Bindi For Women (BIN099),Warehouse C,57,42,2025-02-11 05:26:00,15
21657,ORD_21658,11001,Fairness Naturals  Fair & Soft Hair Removal Cream Rose - Sensitive Skin,Warehouse A,37,28,2025-02-11 08:01:00,9
21658,ORD_21659,3424,Kama Ayurveda 3 Step Skincare Gift Box,Warehouse B,101,89,2025-02-11 03:38:00,12
21659,ORD_21660,7227,Acrimol MR Tablet,Warehouse C,71,61,2025-02-11 10:04:00,10
21660,ORD_21661,7220,Keya Seth Aromatherapy Aromatic 100% Natura Liquid Sindoor Maroon 2Pcs & Natural Ayurvedic Aalta 1Pcs With Applicator (Pac...,Warehouse B,107,90,2025-02-11 16:17:00,17
21661,ORD_21662,3984,"MAYCREATE® Nail Files Nail Buffers Set Professional Double Sided Emery Nail Shaper Strips Manicure Tools Kit, 100/180 Grit...",Warehouse C,81,62,2025-02-11 21:01:00,19
21662,ORD_21663,24118,Mamaearth BhringAmla Hair Oil with Bhringraj & Amla – 250ml,Warehouse A,67,58,2025-02-11 06:25:00,9
21663,ORD_21664,9464,Zabesta X 2.5 mg/6.25 mg Tablet,Warehouse B,70,54,2025-02-11 05:33:00,16
21664,ORD_21665,20575,Passion Indulge BATH BAR-SANDALWOOD ( PACK OF 3 ) 1's,Warehouse A,92,85,2025-02-11 03:55:00,7
21665,ORD_21666,26389,Rapowish 20mg Tablet,Warehouse B,60,51,2025-02-11 03:25:00,9
21666,ORD_21667,22177,Nuroscot NT 400mg/10mg Tablet,Warehouse B,101,94,2025-02-11 06:43:00,7
21667,ORD_21668,8328,"Maybelline New York Face Studio Master Chrome Metallic Highlighter, Molten Gold, 6.7g And Maybelline New York Face Studio ...",Warehouse B,19,10,2025-02-11 03:24:00,9
21668,ORD_21669,18338,Essence Long-Lasting Eye Pencil 26 0.28 gm,Warehouse A,24,10,2025-02-11 20:16:00,14
21669,ORD_21670,27600,Telmikind-CT 40 Tablet,Warehouse A,87,72,2025-02-11 16:12:00,15
21670,ORD_21671,27549,Neurodium Injection,Warehouse A,88,70,2025-02-11 04:18:00,18
21671,ORD_21672,29819,Khaas Shampoo Bar - Aloe Hibiscus,Warehouse B,65,58,2025-02-11 18:29:00,7
21672,ORD_21673,10605,"Ethiglo Glutafine Rich Creamy Facewash for Lightening and Brightening, 70g (Pack of 1)",Warehouse C,95,79,2025-02-11 16:56:00,16
21673,ORD_21674,18241,"Titan Talk S with 1.78"" AMOLED Display|Advanced BT Calling|Music Storage with Wireless Audio Connect|100+ Sports Modes|Ani...",Warehouse C,69,51,2025-02-11 06:09:00,18
21674,ORD_21675,29858,MANCODE Tea Tree Scrub 100 gm,Warehouse B,34,23,2025-02-11 10:39:00,11
21675,ORD_21676,7164,"Echo Dot (3rd Gen) - Alexa smart speaker for music, smart home, kids learning & added Bluetooth control",Warehouse B,36,20,2025-02-11 04:06:00,16
21676,ORD_21677,24195,Faber-Castell Triangular Colour Pencils - Pack of 12 (Assorted),Warehouse A,96,91,2025-02-11 14:15:00,5
21677,ORD_21678,22145,ABOUTTHEFIT Faux Leather Lenovo Tab M8 TB-8505 Flip Cover for Tablets Heavy Duty Tri-Fold Hard Kid Proof Cover PU Ultra Sl...,Warehouse C,74,56,2025-02-11 12:11:00,18
21678,ORD_21679,7860,Detcort 6mg Tablet,Warehouse A,31,16,2025-02-11 11:31:00,15
21679,ORD_21680,10689,"ARTBRIZ Brizberry Mouse Pad, Large Printed Premium Waterproof Anti Skid Rubber Base for Desktop Laptop Gaming Professional...",Warehouse B,36,26,2025-02-11 19:25:00,10
21680,ORD_21681,24162,Bactoclav Dds 200 mg/28.5 mg Syrup,Warehouse B,113,97,2025-02-11 06:30:00,16
21681,ORD_21682,29911,Bezole 20mg Tablet,Warehouse C,106,94,2025-02-11 05:19:00,12
21682,ORD_21683,8345,Portronics Adapto 66 POR-1066 2.4A Dual USB Ports Charging Adapter with 1M Micro USB Cable (White),Warehouse B,75,70,2025-02-11 11:58:00,5
21683,ORD_21684,26376,"Lily Dressing Hair Combs For Women, PACk Of 3",Warehouse B,80,65,2025-02-11 13:20:00,15
21684,ORD_21685,18232,Grisomed 500mg Tablet,Warehouse C,71,62,2025-02-11 01:56:00,9
21685,ORD_21686,26884,Spigen Silicone Slim Armor IP Waterproof Cover Case for Airpods Pro 2 | Airpods Pro 1 (2022/2019) - Black,Warehouse B,67,59,2025-02-11 05:50:00,8
21686,ORD_21687,27564,"Fashion Colour Hi Tech Face Powder, Shade 04 10 gm",Warehouse A,83,77,2025-02-11 01:44:00,6
21687,ORD_21688,7132,Zeal EDP Spicy Perfume For Men,Warehouse C,112,93,2025-02-11 08:33:00,19
21688,ORD_21689,31103,"Fashion Colour Kiss Lip No Transfer Lipstick, 72 Light Pink 2.6 gm",Warehouse A,69,56,2025-02-11 16:10:00,13
21689,ORD_21690,18279,Healifty Metal Rotary Tattoo Machine for Tattoo Artists Liner Shader Tattoo Motor Supply (Black),Warehouse C,66,50,2025-02-11 15:39:00,16
21690,ORD_21691,4071,Eveready Heavy Duty 1050 R20 Battery (Pack of 2),Warehouse B,49,39,2025-02-11 19:00:00,10
21691,ORD_21692,29825,Spigen Ultra Hybrid Back Cover Case Compatible with iPhone 14 (TPU + Poly Carbonate | Crystal Clear),Warehouse B,70,63,2025-02-11 04:05:00,7
21692,ORD_21693,18298,Uricheck 100mg Tablet,Warehouse B,18,10,2025-02-11 23:16:00,8
21693,ORD_21694,22966,Aroma NB140 Dhamaal 24 Hours* Playtime | Deep Bass | Made in India | TrueWireless Bluetooth Headset (Black),Warehouse B,91,77,2025-02-11 20:45:00,14
21694,ORD_21695,24246,"PAGARIA Portable FM/AM/SW Radio with 5 Watts Sound, Bluetooth/USB/TF, Earphone Port & Torch",Warehouse A,82,76,2025-02-11 12:09:00,6
21695,ORD_21696,31109,Basil (Tulsi) Essential Oil - 100% Pure & Natural,Warehouse A,90,84,2025-02-11 12:05:00,6
21696,ORD_21697,27172,Duravet 250mg Injection,Warehouse C,71,52,2025-02-11 16:02:00,19
21697,ORD_21698,26373,Symbiotik F 250mg/250mg/60Millionspores Tablet,Warehouse B,82,77,2025-02-11 06:42:00,5
21698,ORD_21699,26366,HALEEZY Syrup - Helps Support Bronchial Health,Warehouse A,33,19,2025-02-11 20:00:00,14
21699,ORD_21700,23791,"Boat Floatpad 300 Qi Certified USB Wireless Charger with 6Mm Transmission Range, Smart Ic Protection Against Damage and 1 ...",Warehouse C,16,11,2025-02-11 09:58:00,5
21700,ORD_21701,23076,Lolish 5mg Tablet,Warehouse C,62,50,2025-02-11 02:49:00,12
21701,ORD_21702,17943,Cefinex CV 81.25mg Dry Syrup,Warehouse B,69,61,2025-02-11 17:11:00,8
21702,ORD_21703,4832,"ZEBRONICS Zeb-County Bluetooth Speaker with Built-in FM Radio, Aux Input and Call Function (Grey)",Warehouse A,85,72,2025-02-11 21:46:00,13
21703,ORD_21704,21154,Cixdop CV 200mg/125mg Tablet,Warehouse C,89,78,2025-02-11 19:27:00,11
21704,ORD_21705,19122,The Man Company Vitamin C Face Serum With Hyaluronic Acid (30 ml (Pack of 1)),Warehouse B,97,92,2025-02-11 05:10:00,5
21705,ORD_21706,25533,M.G.R.J® Tempered Glass Screen Protector for Lenovo Tab M8 HD / M8 (3rd Gen) / Smart Tab M8 / Tab M8 FHD (2019) (TB-8705F/...,Warehouse B,60,53,2025-02-11 16:08:00,7
21706,ORD_21707,5035,Teepro CZ 250 mg/50 mg/325 mg Tablet,Warehouse B,91,81,2025-02-11 03:09:00,10
21707,ORD_21708,5041,Pierre Cardin Paris - Smokey Eyeliner Waterproof,Warehouse C,96,85,2025-02-11 08:18:00,11
21708,ORD_21709,28487,Zenolip 10 Tablet,Warehouse B,42,26,2025-02-11 01:13:00,16
21709,ORD_21710,19361,Sudo Crem Skin Care Cream 60gm,Warehouse B,55,46,2025-02-11 17:09:00,9
21710,ORD_21711,25498,Schizoquit 100mg Tablet SR,Warehouse A,77,64,2025-02-11 10:32:00,13
21711,ORD_21712,25476,Predale 4mg Tablet,Warehouse B,40,34,2025-02-11 07:44:00,6
21712,ORD_21713,19372,"boAt Flash Edition Smartwatch with Activity Tracker,Multiple Sports Modes,Full Touch 3.30 cm (1.3"") Screen,Gesture, Sleep ...",Warehouse B,58,49,2025-02-11 09:18:00,9
21713,ORD_21714,19524,"Nykaa All Day Matte Waterproof, Transfer Proof, Mask Proof, 12H Liquid Lipstick - Dear Doc",Warehouse B,55,45,2025-02-11 09:34:00,10
21714,ORD_21715,25756,WOW IMAGINE Shock Proof Clear Back Case Cover for Samsung Galaxy M33 5G (Hard Hybrid PC + TPU | Full Armour Device & Camer...,Warehouse A,17,5,2025-02-11 12:46:00,12
21715,ORD_21716,25983,Hair Logic Kerafused Conditioner 1's,Warehouse A,80,71,2025-02-11 21:51:00,9
21716,ORD_21717,28919,Junkyard Quotations Vinyl Stickers for laptops Scrapbook and Decorating Other Gadgets (Pack of 50),Warehouse C,45,35,2025-02-11 10:19:00,10
21717,ORD_21718,24537,"POPIO Tempered Glass for Poco F1 (Transparent) Full Screen Coverage (Except Edges), Pack of 2",Warehouse C,53,41,2025-02-11 00:23:00,12
21718,ORD_21719,4298,Lakme Forever Matte Liquid Lip Colour Nude Pink 5.6 Ml,Warehouse A,45,26,2025-02-11 10:22:00,19
21719,ORD_21720,20704,Onsitego 2 Year Extended Warranty for Small Household Appliances from Rs. 8001-9000 (Email Delivery - No Physical Kit),Warehouse C,81,75,2025-02-11 22:39:00,6
21720,ORD_21721,9720,"AmazonBasics Double Braided Nylon USB Type-C to Type-C 2.0 Cable, Charging Adapter, Smartphone 6 feet, Dark Grey",Warehouse C,58,46,2025-02-11 14:43:00,12
21721,ORD_21722,27705,Casio XR-12WE1 Label Printer Tape (Black and White),Warehouse C,31,24,2025-02-11 17:43:00,7
21722,ORD_21723,9151,Beardo Ultra Glow Body Lotion - Men 250 ml,Warehouse C,72,60,2025-02-11 08:05:00,12
21723,ORD_21724,21880,NHT 1088 Prime Series Corded & Cordless Trimmer For Men,Warehouse B,24,7,2025-02-11 10:27:00,17
21724,ORD_21725,4284,Bath & Body Works Eucalyptus Spearmint Concentrated Room Spray 42.5 g,Warehouse C,71,55,2025-02-11 13:06:00,16
21725,ORD_21726,6044,Urban Gabru Hair Serum - with Almond Oil 100 ml,Warehouse A,103,97,2025-02-11 23:38:00,6
21726,ORD_21727,24515,Fura 100mg Tablet MR,Warehouse C,13,1,2025-02-11 00:13:00,12
21727,ORD_21728,24558,Coniset 2% Cream,Warehouse B,84,79,2025-02-11 04:09:00,5
21728,ORD_21729,4275,"Play - Deospray For Men, No Alcohol Deodrant",Warehouse A,94,80,2025-02-11 15:26:00,14
21729,ORD_21730,10018,Nature's Essence Daily De-Tan Night Repair Gel Creme 50 ML,Warehouse B,111,96,2025-02-11 23:18:00,15
21730,ORD_21731,19140,iFFALCON 147 cm (58 inches) 4K Ultra HD Smart LED Google TV iFF58U62 (Black),Warehouse C,34,19,2025-02-11 23:19:00,15
21731,ORD_21732,25834,Airtel HD Set Top Box | 6 Months Entertainment Pack | Recording Feature | Free Installation,Warehouse C,66,51,2025-02-11 18:28:00,15
21732,ORD_21733,25760,Storite UPort 1.8 Meter 3 Pin PC Power Cable IEC Mains Kettle Lead Replacement Cord for Desktop/Monitor/Printer - Black,Warehouse C,77,62,2025-02-11 12:54:00,15
21733,ORD_21734,19301,"20 Sheets Temporary Tattoos Sticker Kids Glow Kids Temporary Tattoos Unicorn Toy ,Waterproof Luminous Tattoo Sticker, Unic...",Warehouse A,30,17,2025-02-11 19:23:00,13
21734,ORD_21735,28249,"WOW IMAGINE Ultra Slim, Soft Rubberised Back Cover for Redmi A1 with Inner Velvet Fabric Lining (Matte Silicone | Black)",Warehouse B,42,29,2025-02-11 08:50:00,13
21735,ORD_21736,19317,Sucrazine-O Oral Suspension,Warehouse A,24,7,2025-02-11 08:11:00,17
21736,ORD_21737,9895,"Scotch Double Sided Heavy Duty Tape(1m holds 4.5Kgs) for indoor hanging applications (Photo frames, Mirrors, Key Holders, ...",Warehouse A,94,81,2025-02-11 11:56:00,13
21737,ORD_21738,5080,Ceftizer 1gm Injection,Warehouse C,50,35,2025-02-11 00:09:00,15
21738,ORD_21739,9009,Wemycin Injection,Warehouse B,62,43,2025-02-11 14:41:00,19
21739,ORD_21740,6240,Fashionury Back Cover for Vivo Y20 / Vivo Y20i | Four Corner Hybrid Soft PC Anti Clear Gel TPU Bumper Case [Shock Proof] [...,Warehouse A,23,10,2025-02-11 07:56:00,13
21740,ORD_21741,19059,CEDO Samsung Tab A 8.0 (2019) Flip Cover | Leather Finish | 360 Degree Rotate Flip Cover | Shockproof Style Back Cover Cas...,Warehouse C,91,74,2025-02-11 07:46:00,17
21741,ORD_21742,9862,Seip DX Syrup,Warehouse C,18,10,2025-02-11 20:05:00,8
21742,ORD_21743,4777,"DIGITEK® (DRL-18RT) Profesional 46cm (18 Inch) LED Ring Light with Remote Control, Runs on AC Power with No Shadow apertur...",Warehouse C,69,61,2025-02-11 11:39:00,8
21743,ORD_21744,8863,Face Wash Roll - Colour May Vary,Warehouse C,110,93,2025-02-11 09:13:00,17
21744,ORD_21745,28523,Clindawel Injection,Warehouse B,71,59,2025-02-11 20:31:00,12
21745,ORD_21746,21236,"Wayona Nylon Braided 6Ft Usb Data Sync And Charging Cable For Iphones, Ipad Air, Ipad Mini, Ipod Nano And Ipod Touch (6Ft,...",Warehouse B,93,74,2025-02-11 15:20:00,19
21746,ORD_21747,25413,"Ambrane 75W USB Charging Hub for Laptop, iPhone & Android with Boosted Speed Quick Charge & Power Delivery, Multiple Layer...",Warehouse B,72,61,2025-02-11 16:19:00,11
21747,ORD_21748,10069,Zekacin 500mg Injection,Warehouse B,58,48,2025-02-11 08:29:00,10
21748,ORD_21749,28024,Spigen Ultra Hybrid 2 Cover Case for Apple Watch 8 / 7 (41mm) [Version 2] - Crystal Clear (Watch not Included),Warehouse C,44,38,2025-02-11 16:02:00,6
21749,ORD_21750,21255,Relanac Plus 50mg/5ml/125mg/5ml Syrup,Warehouse C,91,79,2025-02-11 11:48:00,12
21750,ORD_21751,28540,Gear Vintage2 28L Faux Leather Water Resistant Anti Theft Laptop Bag/Backpack for Men/Women-Navy,Warehouse B,92,75,2025-02-11 04:01:00,17
21751,ORD_21752,4765,"USB-C to Lightning Cable 3.3FT, [Apple MFi Certified] Lightning to Type C Fast Charging Cord Compatible with iPhone 14/13/...",Warehouse C,63,47,2025-02-11 02:28:00,16
21752,ORD_21753,27992,"SWAPKART Bluetooth Remote Controller Shutter Button for Selfie Click & Portable for iOS, Android Devices (Random Colour)",Warehouse B,95,85,2025-02-11 14:29:00,10
21753,ORD_21754,20926,Sri Sri Tattva Ojasvita Malt Powder,Warehouse C,93,77,2025-02-11 14:32:00,16
21754,ORD_21755,21256,Avol 100 mg/500 mg Tablet,Warehouse C,80,67,2025-02-11 18:37:00,13
21755,ORD_21756,25871,All-In-1 Face Wash - Charcoal,Warehouse C,89,72,2025-02-11 11:42:00,17
21756,ORD_21757,28008,(Renewed) Dell Latitude E5470 Intel Core i5 6th Gen.6200u Processor 14.1 Inches HD Screen Notebook Computer (8 GB Ram & 25...,Warehouse B,106,95,2025-02-11 20:20:00,11
21757,ORD_21758,10049,Techworld Body Whitening Sunscreen Concealer Moisturizing BB Cream Spray 20ml,Warehouse A,31,13,2025-02-11 16:19:00,18
21758,ORD_21759,5024,Coldkind Oral Suspension,Warehouse C,23,6,2025-02-11 00:34:00,17
21759,ORD_21760,21895,Idoxine Powder,Warehouse A,97,88,2025-02-11 13:12:00,9
21760,ORD_21761,24507,Petzem DSR Capsule,Warehouse C,88,82,2025-02-11 00:04:00,6
21761,ORD_21762,24504,(Renewed) boAt Stone 180 5W Bluetooth Speaker(Black),Warehouse A,29,21,2025-02-11 14:10:00,8
21762,ORD_21763,24334,Bevert 8mg Tablet,Warehouse A,100,95,2025-02-11 17:20:00,5
21763,ORD_21764,29681,"Amazon Basics 5V-2.1USB Type A Wall Charger for Cellular Phones, Game Consoles, Headphones, MP3 Players, Speakers- Black",Warehouse C,53,36,2025-02-11 20:20:00,17
21764,ORD_21765,24326,Scomik 500mg Injection,Warehouse A,86,79,2025-02-11 19:20:00,7
21765,ORD_21766,22053,Zycef 250mg Injection,Warehouse A,48,40,2025-02-11 14:06:00,8
21766,ORD_21767,29697,Edox CV Dry Syrup,Warehouse C,14,1,2025-02-11 14:46:00,13
21767,ORD_21768,24302,Passion Indulge AR OILS-SANDALWOOD 10 ml,Warehouse A,102,88,2025-02-11 15:40:00,14
21768,ORD_21769,29736,Pace 100mg/500mg Tablet,Warehouse B,68,52,2025-02-11 18:39:00,16
21769,ORD_21770,19709,"MAGBOT Q9 Smart Watch for Men & Women Latest Bluetooth 1.3"" LED with Daily Activity Tracker, Heart Rate Sensor, BP Monito...",Warehouse B,65,46,2025-02-11 03:04:00,19
21770,ORD_21771,29753,Ransod 2mg Tablet MD,Warehouse B,41,23,2025-02-11 20:36:00,18
21771,ORD_21772,26340,ProElite Deer Smart Flip case Cover for Samsung Galaxy Tab S6 Lite 10.4 Inch 2023/2022 SM-P610/P615/P613 with S Pen Holder...,Warehouse A,100,95,2025-02-11 06:44:00,5
21772,ORD_21773,20601,Orthosar GM Tablet,Warehouse B,104,91,2025-02-11 04:00:00,13
21773,ORD_21774,8391,Sucralnate O Syrup,Warehouse C,35,16,2025-02-11 12:46:00,19
21774,ORD_21775,24355,Pramipex 1 Tablet,Warehouse A,69,57,2025-02-11 13:40:00,12
21775,ORD_21776,5287,Angia 250mg Tablet,Warehouse A,71,62,2025-02-11 12:06:00,9
21776,ORD_21777,20654,Ajmal Nightingale And Magnetize For Men & Women And Evoke Silver Edition For Him Deodorants Pack of 3 200 ml,Warehouse C,106,90,2025-02-11 07:35:00,16
21777,ORD_21778,28195,Mitzep 15mg Tablet,Warehouse B,60,53,2025-02-11 02:46:00,7
21778,ORD_21779,6020,"DOODLE Gift of Glee Set of 12 Floral Print Notecards with Envelope - Thank you Cards, Greeting Cards, Notecards for all Oc...",Warehouse B,52,45,2025-02-11 04:40:00,7
21779,ORD_21780,29529,Fantaize - Handcrafted Marigold Cream - Pack of 1 ( 25 Grams ),Warehouse A,92,82,2025-02-11 14:11:00,10
21780,ORD_21781,4226,Ajmal Musk Rose Cp 12 Ml,Warehouse C,105,87,2025-02-11 21:56:00,18
21781,ORD_21782,5273,LMX 500 Capsule,Warehouse B,56,41,2025-02-11 21:42:00,15
21782,ORD_21783,8471,"Vivel Body Wash, Mint & Cucumber Shower Creme , Liquid Refill Pouch, 400 ml",Warehouse A,29,17,2025-02-11 04:17:00,12
21783,ORD_21784,26265,Safecort 0.1% Lotion,Warehouse B,59,44,2025-02-11 03:32:00,15
21784,ORD_21785,18425,Meflus 500mg/325mg Tablet,Warehouse A,37,29,2025-02-11 00:10:00,8
21785,ORD_21786,21982,"L'Oréal Paris Brow Artist Xpert, Retractable Brow Pencil, Natural Looking Results, With Soft Spoolie, 109 Ebony, 0.2g",Warehouse A,74,55,2025-02-11 18:27:00,19
21786,ORD_21787,21930,Patinex 25mg Tablet,Warehouse C,35,20,2025-02-11 19:52:00,15
21787,ORD_21788,5289,"Minimalist SPF 30 Body Lotion, UVA & UVB Protection | Nourishing | Photostable | Acne Safe | Broad Spectrum PA+++ Sunscree...",Warehouse A,81,72,2025-02-11 19:52:00,9
21788,ORD_21789,5288,AEIDESS Brand Tempered Glass Screen Protector Compatible For Nothing Phone 1 with Edge to Edge Coverage and Easy Installat...,Warehouse B,15,3,2025-02-11 13:48:00,12
21789,ORD_21790,18476,Diclocon-P Tablet,Warehouse A,100,89,2025-02-11 08:53:00,11
21790,ORD_21791,20621,Vaadi Herbals 100% Pure Essential Oil - Suramya Beautifying Elixr with Saffron & Gold Leaves 10 ml,Warehouse B,18,4,2025-02-11 15:00:00,14
21791,ORD_21792,29457,Cefrock 100mg Tablet DT,Warehouse C,57,50,2025-02-11 01:22:00,7
21792,ORD_21793,29466,Natural Protein Conditioner,Warehouse B,71,56,2025-02-11 09:05:00,15
21793,ORD_21794,20669,Vega Set Of 5 Brushes (MBS - 05) 63 gm,Warehouse B,33,18,2025-02-11 14:41:00,15
21794,ORD_21795,10384,Shikakai & Honey Hair Conditioner,Warehouse C,70,63,2025-02-11 18:51:00,7
21795,ORD_21796,9148,Zygter 250mg Tablet,Warehouse C,46,40,2025-02-11 20:34:00,6
21796,ORD_21797,4257,Zoxol 0.25mg Tablet,Warehouse C,98,79,2025-02-11 00:26:00,19
21797,ORD_21798,18567,Vitamin E Nourishing Face Moisturiser With Uv Block,Warehouse A,75,58,2025-02-11 14:36:00,17
21798,ORD_21799,24656,Cardibeta AM 2.5mg/25mg Tablet,Warehouse C,28,20,2025-02-11 13:28:00,8
21799,ORD_21800,29286,Epflox 250mg Tablet,Warehouse B,18,3,2025-02-11 08:02:00,15
21800,ORD_21801,29298,Ayurvedic Vitamin C Skin Care Serum,Warehouse A,97,82,2025-02-11 11:21:00,15
21801,ORD_21802,29308,House of Beauty Under Eye Serum 15 ml,Warehouse B,88,73,2025-02-11 19:35:00,15
21802,ORD_21803,24643,"ORO-MAC Beauty Combo Kit Waterproof Matchmaster Foundation,With inflable primer,Pro Longwear Concealer,Red Lipstick,Waterp...",Warehouse A,23,12,2025-02-11 20:26:00,11
21803,ORD_21804,19618,"Wet n Wild, Mega Clear Mascara, Transparent Mascara that Hydrates and Nourishes the Eyelashes for a Natural Effect, Specia...",Warehouse C,26,19,2025-02-11 00:40:00,7
21804,ORD_21805,24642,Seraz D 50mg/10mg Tablet,Warehouse B,48,32,2025-02-11 19:23:00,16
21805,ORD_21806,10363,Zieterb 250mg Tablet,Warehouse B,73,61,2025-02-11 10:24:00,12
21806,ORD_21807,29379,Gracirab-DSR Capsule,Warehouse B,48,35,2025-02-11 22:39:00,13
21807,ORD_21808,10367,Auxiclav 500mg/125mg Tablet,Warehouse C,110,95,2025-02-11 23:39:00,15
21808,ORD_21809,6931,Mesmereyes Retractable Kajal Mek001 0.35 Gm,Warehouse B,50,43,2025-02-11 04:03:00,7
21809,ORD_21810,8528,Fungisave Cream,Warehouse A,23,15,2025-02-11 12:10:00,8
21810,ORD_21811,24626,boAt Bassheads 102 in Ear Wired Earphones with Mic(Charcoal Black),Warehouse C,28,9,2025-02-11 01:22:00,19
21811,ORD_21812,24610,Dermiat 0.1% Lotion,Warehouse C,50,40,2025-02-11 18:15:00,10
21812,ORD_21813,4322,Artis 65Watt Universal Laptop Adapter with 8 Interchangeable Connector pins (Power Cord Included) Compatible with Dell/HP/...,Warehouse A,12,3,2025-02-11 01:23:00,9
21813,ORD_21814,9143,Power Of Seduction Eau De Toilette,Warehouse B,47,29,2025-02-11 11:31:00,18
21814,ORD_21815,24590,"iQOO Z6 44W by vivo (Lumina Blue, 6GB RAM, 128GB Storage) | 6.44"" FHD+ AMOLED Display | 50% Charge in just 27 mins | in-Di...",Warehouse B,72,63,2025-02-11 04:27:00,9
21815,ORD_21816,10421,Scotderm 250mg Tablet,Warehouse C,83,74,2025-02-11 00:44:00,9
21816,ORD_21817,29479,GM 3012 3 Pin Travel Universal Multi-Plug with Surge Protector & Indicator (1),Warehouse B,31,16,2025-02-11 23:28:00,15
21817,ORD_21818,28921,"Solo SP 110 Separator/Divider (Set of 10) A4 - Multi-Color,",Warehouse A,10,5,2025-02-11 04:15:00,5
21818,ORD_21819,7099,Gemblue Biocare Cucumber cream 500 ml,Warehouse C,102,84,2025-02-11 05:15:00,18
21819,ORD_21820,8953,Zynim Plus 100mg/500mg Tablet,Warehouse C,53,44,2025-02-11 03:44:00,9
21820,ORD_21821,10444,"Boult Audio Airbass Q10 Bluetooth Truly Wireless in Ear Earbuds with Mic with 24H Total Playtime, Touch Controls, Ipx5 Wat...",Warehouse A,51,43,2025-02-11 23:59:00,8
21821,ORD_21822,28164,"ULRIC DE VARENS Nomad Giftset for him, 300 ml (Pack of 2)",Warehouse A,45,29,2025-02-11 04:23:00,16
21822,ORD_21823,19406,Dynotrek Vostro 14-15 Inch Laptop Sleeve Case Cover Pouch with Handle Compatible for Mackbook ThinkPad Chromebook Tablet W...,Warehouse A,65,50,2025-02-11 21:46:00,15
21823,ORD_21824,4734,Rezecort 300mg Tablet CR,Warehouse C,66,52,2025-02-11 07:14:00,14
21824,ORD_21825,6509,Redclox LB Capsule,Warehouse A,19,14,2025-02-11 18:37:00,5
21825,ORD_21826,28593,Atnecort 6mg Tablet,Warehouse A,74,57,2025-02-11 06:07:00,17
21826,ORD_21827,6215,Fiama Shower Gel Blackcurrant Bearberry 100ml + Lemongrass Jojoba 100ml,Warehouse B,52,47,2025-02-11 15:47:00,5
21827,ORD_21828,19435,OpenTech® Tempered Glass Screen Protector Compatible for Samsung Galaxy S20 FE 5G with Edge to Edge Coverage and Easy Inst...,Warehouse B,23,16,2025-02-11 18:23:00,7
21828,ORD_21829,20885,Cefiroxx 500mg Injection,Warehouse A,94,79,2025-02-11 01:24:00,15
21829,ORD_21830,4723,Riskof 10mg Tablet,Warehouse B,108,97,2025-02-11 06:13:00,11
21830,ORD_21831,28613,Ozer 50mg Suspension,Warehouse C,36,22,2025-02-11 23:49:00,14
21831,ORD_21832,9831,ENVIE® (AA2100RTU4PL) Infinite AA Rechargeable Batteries | High-Capacity Ni-MH | 2100 mAh | Low Self Discharge | (Pack of 4),Warehouse A,71,58,2025-02-11 11:01:00,13
21832,ORD_21833,28660,Mamaearth Tea Tree Shampoo 250 ml,Warehouse A,40,28,2025-02-11 18:33:00,12
21833,ORD_21834,25343,Flormar Waterproof Lipliner 233 Dramatic Red 1.14 gm,Warehouse B,67,49,2025-02-11 04:45:00,18
21834,ORD_21835,27920,Canflox OZ 200mg/500mg Tablet,Warehouse C,11,5,2025-02-11 10:08:00,6
21835,ORD_21836,20874,Biominic Syrup,Warehouse B,69,50,2025-02-11 12:10:00,19
21836,ORD_21837,6528,Pallavi Cough Syrup,Warehouse A,57,40,2025-02-11 13:25:00,17
21837,ORD_21838,18879,"Portronics KI-PAD Wired Keyboard with Gaming Mode, 104 Keys, 1.5M Cable, Ergonomic Keys, Plug & Play(Black)",Warehouse B,102,96,2025-02-11 20:49:00,6
21838,ORD_21839,4659,Levodiv 500 Tablet,Warehouse A,18,10,2025-02-11 01:23:00,8
21839,ORD_21840,4742,Soycex 100mg Tablet DT,Warehouse A,82,71,2025-02-11 00:28:00,11
21840,ORD_21841,19510,"KimTok Bluetooth Wireless in Ear Neckband Upto 8 Hours Playback time with Mic,Bluetooth Earphones with 10mm Driver,IPX5 Ra...",Warehouse C,50,44,2025-02-11 15:08:00,6
21841,ORD_21842,9777,future pro New Full HD High Focus Spy Magnet Camera Full HD Mini Spy WiFi Magnetic Live Stream IP Wireless 1080P Audio Vid...,Warehouse B,14,1,2025-02-11 00:56:00,13
21842,ORD_21843,6666,Carrot Seed Essential Oil - 100% Pure & Natural,Warehouse C,63,49,2025-02-11 00:12:00,14
21843,ORD_21844,19520,Etozox T Tablet,Warehouse B,64,46,2025-02-11 12:56:00,18
21844,ORD_21845,18806,"ELV Direct Tabletop Vertical Laptop Stand Holder, Desktop Aluminum Lapdesk Laptop Stand with Adjustable Dock Size, Fits Al...",Warehouse A,22,4,2025-02-11 04:31:00,18
21845,ORD_21846,8722,MYVN Compatible Vivo Charging Cable for All VIVO Phones and Android Phones - Only Cable (White),Warehouse A,107,89,2025-02-11 03:10:00,18
21846,ORD_21847,4588,"Wet n Wild Megaglo Contouring Palette (Contour), Dulce De Leche, 12.5g",Warehouse C,60,46,2025-02-11 16:59:00,14
21847,ORD_21848,25097,Maybelline Liquid Lipstick 15 Lover (Matte),Warehouse C,113,96,2025-02-11 00:37:00,17
21848,ORD_21849,21482,Canon Compatible for Canon GI-790 Ink Bottle (Magenta),Warehouse C,41,31,2025-02-11 19:57:00,10
21849,ORD_21850,10183,Nutritivo Pomegranate Radiant Glow Night Cream,Warehouse B,104,92,2025-02-11 21:47:00,12
21850,ORD_21851,4736,"SanDisk Ultra Luxe USB 3.1 Flash Drive 64GB, Upto 150MB/s, All Metal, Metallic Silver",Warehouse B,57,45,2025-02-11 16:13:00,12
21851,ORD_21852,5090,Levoc Syrup,Warehouse C,73,65,2025-02-11 15:25:00,8
21852,ORD_21853,4577,Vizofer 100mg Injection,Warehouse B,37,24,2025-02-11 08:16:00,13
21853,ORD_21854,4728,Fexosep 120 Tablet,Warehouse A,94,89,2025-02-11 20:41:00,5
21854,ORD_21855,23794,Metazol Suspension,Warehouse B,18,8,2025-02-11 03:09:00,10
21855,ORD_21856,25754,Igthro 500mg Tablet,Warehouse A,34,19,2025-02-11 20:19:00,15
21856,ORD_21857,23797,Pullup Pants Style Adult Diapers - L-XL,Warehouse C,96,87,2025-02-11 22:49:00,9
21857,ORD_21858,10735,"Nyx Professional Makeup Ultimate Shadow Palette, Bright's, 13.3g",Warehouse B,24,11,2025-02-11 09:26:00,13
21858,ORD_21859,30357,Yescam Plus 0.5mg/10mg Tablet,Warehouse A,17,11,2025-02-11 02:55:00,6
21859,ORD_21860,6309,boAt BassHeads 220 Wired in Ear Earphones with Inline Mic(Black),Warehouse B,64,59,2025-02-11 09:39:00,5
21860,ORD_21861,29774,Levosim Syrup,Warehouse C,51,34,2025-02-11 23:21:00,17
21861,ORD_21862,25314,"pTron Tangentbeat in-Ear Bluetooth 5.0 Wireless Headphones with Mic, Enhanced Bass, 10mm Drivers, Clear Calls, Fast Chargi...",Warehouse B,49,38,2025-02-11 12:10:00,11
21862,ORD_21863,18903,Pikkme Tempered Glass Screen Protector for Samsung Galaxy F23 5G Edge to Edge Coverage with Easy Installation kit,Warehouse B,48,31,2025-02-11 13:17:00,17
21863,ORD_21864,19450,Etrocab 90 Tablet,Warehouse B,58,52,2025-02-11 03:15:00,6
21864,ORD_21865,6539,mCaffeine Coffee Lip Polishing Oil 10 ml,Warehouse B,32,22,2025-02-11 22:47:00,10
21865,ORD_21866,28679,Wysera-L Capsule SR,Warehouse C,29,22,2025-02-11 17:16:00,7
21866,ORD_21867,9044,Baclonol 10mg Tablet,Warehouse C,26,16,2025-02-11 07:45:00,10
21867,ORD_21868,19453,Hymoxy CV 1000mg/200mg Injection,Warehouse A,103,86,2025-02-11 19:21:00,17
21868,ORD_21869,18891,The Moms Co. Massage Oil 100 ml,Warehouse A,91,72,2025-02-11 22:08:00,19
21869,ORD_21870,18890,Nokia 110 Dual SIM (Black),Warehouse B,35,21,2025-02-11 11:43:00,14
21870,ORD_21871,6551,Tyflox O 200mg/500mg Tablet,Warehouse A,60,42,2025-02-11 20:16:00,18
21871,ORD_21872,8805,"JGD PRODUCTS Male to Male VGA Cable 1 Meter, Support PC/Monitor/LCD/LED, Plasma, Projector, TFT",Warehouse B,50,34,2025-02-11 20:47:00,16
21872,ORD_21873,8790,Ranoplan 500mg Tablet,Warehouse A,115,98,2025-02-11 11:50:00,17
21873,ORD_21874,19456,"L'Oreal Paris Le Blush Bar Matte, 11 Be Fierce 4.5 Gm",Warehouse C,82,72,2025-02-11 12:23:00,10
21874,ORD_21875,21363,"RAEGR RapidLink 1160, 65W GaN Fast Charger Adapter PD+Triple USB Wall Charger|60W USB Type C to C Braided Cable|BIS Certif...",Warehouse A,51,35,2025-02-11 15:05:00,16
21875,ORD_21876,27880,TP-Link Archer C54 AC1200 Dual Band Wi-Fi Router | 1200 Mbps Wireless WiFi Speed | Multi-Mode | 4 Antennas | Parental Cont...,Warehouse B,38,25,2025-02-11 07:07:00,13
21876,ORD_21877,9812,Evaflor Whisky Deodorant 150 ml,Warehouse C,70,52,2025-02-11 22:24:00,18
21877,ORD_21878,9805,Spantra Moroccan Argan Shampoo 300 ml,Warehouse A,44,38,2025-02-11 15:09:00,6
21878,ORD_21879,19446,Atrixone TZ 1125mg Injection,Warehouse B,24,18,2025-02-11 23:38:00,6
21879,ORD_21880,8807,Daily Life Forever52 Small Shader Brush Nx021 1's,Warehouse B,86,67,2025-02-11 13:15:00,19
21880,ORD_21881,28725,Bonjour Paris Metallic Eye Pencil cum Eye Shadow - Waterproof Navy Blue 1.8 gm,Warehouse B,35,16,2025-02-11 05:57:00,19
21881,ORD_21882,9769,Glucodex M 2 Tablet,Warehouse A,60,43,2025-02-11 20:32:00,17
21882,ORD_21883,7410,Faces Canada Weightless Matte Finish Lipstick Chilli Pepper 11 4 Gm,Warehouse A,82,66,2025-02-11 17:42:00,16
21883,ORD_21884,20850,Medimade Caffeine Face Mask (Pack of 2) 1's,Warehouse A,97,84,2025-02-11 21:11:00,13
21884,ORD_21885,8917,Lofen-P Tablet,Warehouse C,95,84,2025-02-11 04:45:00,11
21885,ORD_21886,4990,Candy B Cream,Warehouse C,34,26,2025-02-11 07:58:00,8
21886,ORD_21887,19207,Nutriment Chocolate Scrub All Skin Type 250 gm,Warehouse A,39,33,2025-02-11 09:39:00,6
21887,ORD_21888,19197,Sivanna Colors Natural Megic Color Blush - 03 8.5 gm,Warehouse A,74,67,2025-02-11 05:36:00,7
21888,ORD_21889,25646,Sebtret 10mg Capsule,Warehouse A,99,81,2025-02-11 05:40:00,18
21889,ORD_21890,19190,Belora Paris Serum Superb Skin (Serum Superbe Peau) 20 ml,Warehouse A,106,96,2025-02-11 13:17:00,10
21890,ORD_21891,9983,"Lakmé Liquid Lipstick Pink Glam,Red Carpet (Matte)",Warehouse B,104,86,2025-02-11 20:16:00,18
21891,ORD_21892,6330,Advansed Aloe Vera Enriched Coconut Hair Oil,Warehouse C,54,44,2025-02-11 06:37:00,10
21892,ORD_21893,9985,8.5 inch LCD Writing pad for Kids Tablet Toys for Boys Girls Kid | Writing Tablet | Drawing pad Board | Digital Notepad | ...,Warehouse A,47,30,2025-02-11 21:48:00,17
21893,ORD_21894,28139,Total 10 Activ Naturol Germ Protection Handwash Refill,Warehouse C,41,24,2025-02-11 04:18:00,17
21894,ORD_21895,28126,Cefiwon LB 200mg Tablet,Warehouse C,95,79,2025-02-11 22:18:00,16
21895,ORD_21896,21115,"Clapbox Adjustable Snare Cajon CB50- Oak Wood, (H:50 W:30 L:30) - 3 Internal Snares, black",Warehouse C,59,47,2025-02-11 11:41:00,12
21896,ORD_21897,6277,"Amazfit GTR 2e SmartWatch with Curved Design, 1.39 Always-on AMOLED Display, SpO2 & Stress Monitor, Built-in Alexa,Built-i...",Warehouse B,25,18,2025-02-11 21:56:00,7
21897,ORD_21898,25607,Biolage Smoothproof Smoothing Masque,Warehouse B,99,88,2025-02-11 08:33:00,11
21898,ORD_21899,25595,LG 108 cm (43 inches) 4K Ultra HD Smart LED TV 43UQ7500PSF (Ceramic Black),Warehouse A,43,33,2025-02-11 00:13:00,10
21899,ORD_21900,21105,Levcad 500mg Tablet,Warehouse B,91,78,2025-02-11 20:37:00,13
21900,ORD_21901,28286,Redgear MP44 Control-Type Gaming Mousepad (Black and Red),Warehouse C,69,52,2025-02-11 01:25:00,17
21901,ORD_21902,4989,"BLAST INN USB OTG for iPhone/iPad, Compatible with iOS 14 and Later, USB Female Support Connect USB Flash Drive, Keyboard,...",Warehouse B,97,84,2025-02-11 01:15:00,13
21902,ORD_21903,21130,"legacy storeAdjustable Safe Soft Bathing Baby Shower Hair Wash Cap for Children, Baby Bath Cap Shower Protection for Eyes ...",Warehouse C,25,9,2025-02-11 19:33:00,16
21903,ORD_21904,19292,Gapitas NT 400mg/10mg Tablet,Warehouse B,54,42,2025-02-11 15:31:00,12
21904,ORD_21905,9926,Fighther 150mg Injection,Warehouse A,105,98,2025-02-11 21:08:00,7
21905,ORD_21906,4961,Daily Life Forever52 Waterproof Smoothenin Eye Pencil Onyx F501 1 Gm,Warehouse C,104,91,2025-02-11 09:29:00,13
21906,ORD_21907,28211,Tussmark 20mg Syrup,Warehouse A,60,53,2025-02-11 14:59:00,7
21907,ORD_21908,4950,FM 10mg/120mg Tablet,Warehouse A,7,1,2025-02-11 17:52:00,6
21908,ORD_21909,28177,Schwarzkopf Professional Osis+ Grip Extreme Hold Mousse | For Voluminous Styles | 200 Ml,Warehouse A,46,39,2025-02-11 09:42:00,7
21909,ORD_21910,4948,Apropride 200mg Tablet,Warehouse C,12,6,2025-02-11 19:36:00,6
21910,ORD_21911,28227,Opulus-P Eye Drop,Warehouse A,45,37,2025-02-11 01:38:00,8
21911,ORD_21912,9073,Lightening Pigmentation Gel,Warehouse C,19,9,2025-02-11 10:46:00,10
21912,ORD_21913,21065,Vega Grooming Comb (1267) 37 gm,Warehouse C,33,21,2025-02-11 19:41:00,12
21913,ORD_21914,6319,Skin Fruits Brightening Lemon Face Wash,Warehouse C,68,63,2025-02-11 00:13:00,5
21914,ORD_21915,26961,"boAt Stone 1000 14W Bluetooth Speaker with 8 Hours Playback, Bluetooth v5.0 & IPX5(Black)",Warehouse C,85,68,2025-02-11 07:23:00,17
21915,ORD_21916,21107,Zizi 50mg Dry Syrup,Warehouse B,38,19,2025-02-11 20:39:00,19
21916,ORD_21917,25207,DavaIndia Diclofenac+Paracetamol 50mg/325mg Tablet,Warehouse B,105,96,2025-02-11 16:25:00,9
21917,ORD_21918,21490,SanDisk ® Ultra Curve USB 3.2 32GB 100MB/s R Black,Warehouse C,75,63,2025-02-11 20:48:00,12
21918,ORD_21919,21005,Moxsync 250mg Tablet DT,Warehouse B,21,16,2025-02-11 23:51:00,5
21919,ORD_21920,4600,Keralyte 0.05% Lotion,Warehouse A,66,57,2025-02-11 07:23:00,9
21920,ORD_21921,8730,"Hold Up Dual Purpose 360-Degree Rotating Car Mobile Phone Mount Holder Stand For Windscreen, Dashboard & Ac Vent Compatibl...",Warehouse B,70,60,2025-02-11 14:23:00,10
21921,ORD_21922,5147,Azafran Active Botanicals Neem & Turmeric Skin Clear Bath Bar 100 gm,Warehouse B,42,24,2025-02-11 15:54:00,18
21922,ORD_21923,28896,Flo D 0.4mg/0.5mg Tablet,Warehouse A,47,33,2025-02-11 11:38:00,14
21923,ORD_21924,28768,"Women's & Girl's TYA 6155 Multicolour Makeup Kit and 7 Black Makeup Brushes Set, 3in1 Eyeliner,Mascara,Eyebrow Pencil with...",Warehouse C,23,10,2025-02-11 22:31:00,13
21924,ORD_21925,25222,Absolute Hydra Pro Gel Day Creme,Warehouse B,29,17,2025-02-11 05:08:00,12
21925,ORD_21926,4654,Rejuvenating UBTAN Essential Oil - Lemongrass 10 ml,Warehouse C,75,69,2025-02-11 19:11:00,6
21926,ORD_21927,6597,Hair Line Hair growth Solution,Warehouse B,48,37,2025-02-11 19:51:00,11
21927,ORD_21928,5153,Hoxandil 5mg Tablet,Warehouse B,24,12,2025-02-11 20:38:00,12
21928,ORD_21929,19489,Mecnnial 12 Tablet,Warehouse C,57,52,2025-02-11 22:54:00,5
21929,ORD_21930,6605,"Onsitego 1 year Extended Warranty for Small Appliances (Rs. 10,001-15,000) (Email Delivery - No Physical Kit)",Warehouse B,61,50,2025-02-11 03:03:00,11
21930,ORD_21931,21521,Skin Brightening Rice Water Foaming Face Wash,Warehouse C,24,17,2025-02-11 09:21:00,7
21931,ORD_21932,19491,CEDO iPhone XR Tempered Glass | Screen Protector Full HD Quality Edge to Edge Coverage for iPhone XR (Black),Warehouse C,98,92,2025-02-11 15:41:00,6
21932,ORD_21933,6648,Nandika Beauty Facial Gel - Diamond 1 kg,Warehouse A,98,85,2025-02-11 06:13:00,13
21933,ORD_21934,24282,SanDisk ® Ultra Curve USB 3.2 128GB 100MB/s R Black,Warehouse C,93,85,2025-02-11 12:41:00,8
21934,ORD_21935,27980,Gillette Sensor Excel Comfort Razor Blades10,Warehouse B,48,41,2025-02-11 02:11:00,7
21935,ORD_21936,21399,Vigini Body Massage Cream 100 gm,Warehouse C,57,46,2025-02-11 09:00:00,11
21936,ORD_21937,19001,Impramine 25mg Tablet,Warehouse B,88,80,2025-02-11 01:38:00,8
21937,ORD_21938,8733,Malwin-Forte Tablet,Warehouse B,86,74,2025-02-11 06:33:00,12
21938,ORD_21939,6654,Orthodex Tablet,Warehouse B,105,93,2025-02-11 11:10:00,12
21939,ORD_21940,28902,"POND'S White Beauty BB+ Fairness Cream 01 Original, 18 g And Lakme Complexion Care Face Cream, Beige, 9g",Warehouse A,33,27,2025-02-11 13:20:00,6
21940,ORD_21941,19507,"Urban Gabru Lip Lightening Balm - Vitamin E, Shea Butter & Beeswax 20 gm",Warehouse A,82,67,2025-02-11 14:42:00,15
21941,ORD_21942,25159,Sonata Analog Champagne Dial Women's Watch-NL87018YM01/NP87018YM01,Warehouse B,85,67,2025-02-11 10:12:00,18
21942,ORD_21943,19494,"New iPhone Latest Top up Bluetooth Version Cable for iOS 13 and Later, Audio AUX Converter Cable iOS to 3.5mm Headphone/Ea...",Warehouse A,18,9,2025-02-11 03:41:00,9
21943,ORD_21944,28825,"ProElite Smart Trifold Flip Case Cover for Apple iPad 10.2"" 9th Gen (2021) 8th Gen/7th Gen with Pencil Holder, Soft Flexib...",Warehouse B,90,79,2025-02-11 07:19:00,11
21944,ORD_21945,6630,Ajmal Amber Magic EDP Spicy Aromatic Perfume And Sacred Love Deodorant Floral Musky Fragrance 300 ml,Warehouse A,53,40,2025-02-11 12:18:00,13
21945,ORD_21946,28618,Oflajet R Oral Suspension,Warehouse A,44,39,2025-02-10 19:29:00,5
21946,ORD_21947,28606,"DAHSHA 3.5 mm Audio Stereo Y Splitter Adapter, 3.5mm 1 Male to 2 Port Female For Earphone, Adapter For Smartphone, Tablets...",Warehouse A,83,74,2025-02-10 13:30:00,9
21947,ORD_21948,32790,"Bassoholic 9 Inches (22Cm) Car Radio Receiver Advanced Android System with 2GB/16GB RAM & ROM, IPS Capacitive Touch Panel ...",Warehouse C,56,44,2025-02-10 04:45:00,12
21948,ORD_21949,29278,Newyork Eau De Toilette,Warehouse C,95,81,2025-02-10 04:28:00,14
21949,ORD_21950,16363,"HP 14s, 12th Gen Intel Core i5 16GB RAM/512GB SSD 14-inch(35.6 cm) Micro-Edge, FHD Laptop/Intel Iris Xe Graphics/Alexa/Dua...",Warehouse C,90,84,2025-02-10 06:40:00,6
21950,ORD_21951,3634,Fashion Colour Mulberry Day Cream 50 gm,Warehouse C,80,75,2025-02-10 10:54:00,5
21951,ORD_21952,11480,Kacef S 1000mg/500mg Injection,Warehouse A,44,27,2025-02-10 07:38:00,17
21952,ORD_21953,3222,Gemblue Biocare Chocolate Face and Body cream 500 ml,Warehouse C,93,81,2025-02-10 10:29:00,12
21953,ORD_21954,28673,OpenTech® Military-Grade Tempered Glass Screen Protector Compatible for iPhone 13 Pro Max with Edge to Edge Coverage and E...,Warehouse B,24,5,2025-02-10 12:42:00,19
21954,ORD_21955,16367,Zione 6.25mg Tablet,Warehouse C,26,19,2025-02-10 00:13:00,7
21955,ORD_21956,29896,Gzor MP 2mg/500mg/15mg Tablet,Warehouse A,82,64,2025-02-10 00:17:00,18
21956,ORD_21957,18953,"House of Quirk Self Adhesive Wall Whiteboard Sticker for Dry Erase Wall Paper Message Board for Kids, Office, School and H...",Warehouse A,31,15,2025-02-10 09:56:00,16
21957,ORD_21958,2939,Yves Rocher Repair Anti Breakage Fortifying Serum 100 ml,Warehouse B,22,12,2025-02-10 04:27:00,10
21958,ORD_21959,32769,Tumin C 10mg/250mg Tablet,Warehouse A,37,30,2025-02-10 17:19:00,7
21959,ORD_21960,16388,Tasya Onion & Pea Protein Hair Growth Serum 50 ml,Warehouse A,92,73,2025-02-10 05:52:00,19
21960,ORD_21961,16706,Acnip 10mg Soft Gelatin Capsule,Warehouse B,100,81,2025-02-10 16:40:00,19
21961,ORD_21962,16455,Combihale FB 400 Redicaps,Warehouse A,15,7,2025-02-10 09:26:00,8
21962,ORD_21963,17862,Kaunch Beej Powder - Supports As Nervine Tonic,Warehouse B,108,99,2025-02-10 16:06:00,9
21963,ORD_21964,3983,Abivom 2mg Syrup,Warehouse B,113,95,2025-02-10 10:52:00,18
21964,ORD_21965,11188,Zayn & Myza Cleansing Makeup Remover Balm 15 gm,Warehouse B,60,44,2025-02-10 17:37:00,16
21965,ORD_21966,10321,"cozycase Outlet Wall Mount Hanger Holder for ot 3rd Generation, A SpSPACE-Saving Solution for Your Smart Speakers,Built-in...",Warehouse C,29,20,2025-02-10 19:36:00,9
21966,ORD_21967,32705,Street Wear Playfull Matte Lip Crayon - Flirty Purple 2.9 gm,Warehouse B,21,15,2025-02-10 06:43:00,6
21967,ORD_21968,29981,Papaya & Apricot Anti Tan Scrub,Warehouse B,103,89,2025-02-10 12:45:00,14
21968,ORD_21969,28637,Seritra 100mg Capsule,Warehouse A,38,25,2025-02-10 00:52:00,13
21969,ORD_21970,30554,"Panasonic eneloop AAA Rechargeable Battery, Pack of 2",Warehouse C,100,86,2025-02-10 15:51:00,14
21970,ORD_21971,29221,"Apple 2021 10.2-inch (25.91 cm) iPad with A13 Bionic chip (Wi-Fi, 64GB) - Space Grey (9th Generation)",Warehouse A,70,53,2025-02-10 11:32:00,17
21971,ORD_21972,28723,Momes 0.1% Cream,Warehouse B,15,8,2025-02-10 07:24:00,7
21972,ORD_21973,35575,Pure Aloe Anti Pollution Face Wash,Warehouse C,84,68,2025-02-10 14:12:00,16
21973,ORD_21974,11486,Rive IT 20mg/150mg Capsule SR,Warehouse B,102,86,2025-02-10 08:05:00,16
21974,ORD_21975,31479,C Bac 20mg Tablet,Warehouse B,67,55,2025-02-10 00:13:00,12
21975,ORD_21976,25029,"Beetel M64 Caller Id Landline Phone with 16 Digit and Adjustable LCD Display, 2-Way Adjustable Speaker Phone, 99 Incoming ...",Warehouse A,36,25,2025-02-10 20:12:00,11
21976,ORD_21977,35614,Atinate Plus 40 mg/240 mg Dry Syrup,Warehouse C,15,9,2025-02-10 16:27:00,6
21977,ORD_21978,21501,Aticlav Dry Syrup,Warehouse B,46,34,2025-02-10 23:35:00,12
21978,ORD_21979,21492,"Best Life Keratin Onion Shampoo, Growth Boost, With Red Onion Extract And Kalonji (Nigella Satvia/Black Onion Seed Oil)",Warehouse B,73,60,2025-02-10 03:20:00,13
21979,ORD_21980,904,Organic Harvest Extra Virgin Coconut Oil Cold Pressed 500 ml,Warehouse B,62,48,2025-02-10 17:44:00,14
21980,ORD_21981,6682,"ADS Good Choice India Aloe Non-smudging, Organic & waterproof Lipstick Set Of 12, Matte Finish - Multicolor",Warehouse B,79,73,2025-02-10 22:13:00,6
21981,ORD_21982,21487,Jovees De-Tan Face Scrub - Black Plum & Curcuma 50 gm,Warehouse A,71,57,2025-02-10 15:43:00,14
21982,ORD_21983,21483,Quiny 100mg Tablet,Warehouse C,105,86,2025-02-10 03:47:00,19
21983,ORD_21984,8717,"Lava A1 Josh 21(Blue Silver) -Dual Sim,Call Blink Notification,Military Grade Certified with 4 Day Battery Backup, Keypad ...",Warehouse B,20,7,2025-02-10 14:55:00,13
21984,ORD_21985,14402,Motion Plus 500mg/5mg Tablet,Warehouse C,23,11,2025-02-10 15:44:00,12
21985,ORD_21986,908,Faces Canada Splash Nail Enamel Ebony 142 8 Ml,Warehouse C,43,36,2025-02-10 02:04:00,7
21986,ORD_21987,8724,JBL Tune 130NC True Wireless in Ear Earbuds Active Noise Cancellation (Upto 40dB) Adjust EQ for Extra Bass Massive 40Hrs P...,Warehouse B,49,39,2025-02-10 01:00:00,10
21987,ORD_21988,25112,Tkuf A Syrup,Warehouse C,18,9,2025-02-10 13:56:00,9
21988,ORD_21989,12769,POPIO Bluetooth Remote Controller Shutter Button for Selfie Stick Widely Compatible with All Devices,Warehouse C,10,3,2025-02-10 22:33:00,7
21989,ORD_21990,25126,Loxocam P 8mg/325mg Tablet,Warehouse A,91,78,2025-02-10 22:41:00,13
21990,ORD_21991,21456,Beauty People Sheer Color Lipstick - 407 3.8 gm,Warehouse C,93,85,2025-02-10 12:04:00,8
21991,ORD_21992,28161,"Loofah/Sponge Scrubber/Body Bath - Dual Side, Hangable, Blue & White, BH-07",Warehouse B,103,89,2025-02-10 04:07:00,14
21992,ORD_21993,15475,Lelock M 5mg/10mg Tablet,Warehouse B,19,9,2025-02-10 20:49:00,10
21993,ORD_21994,3913,Sloane Highlighter and Contour 8 Shades Concealer Palette,Warehouse A,52,44,2025-02-10 08:20:00,8
21994,ORD_21995,17785,AVP Eladi Coconut Oil Balm | An Ayurvedic Multipurpose Skincare | for Smooth and Glowing Skin | Even Skin Tone and Texture...,Warehouse A,9,1,2025-02-10 15:22:00,8
21995,ORD_21996,4016,"Redgear Pro Series Wired Gamepad with Integrated Force Feedback, Illuminated ABXY Keys, Ergonomically Design, 1.8m USB Cab...",Warehouse C,61,48,2025-02-10 02:30:00,13
21996,ORD_21997,29953,Mach3 - Start Mens Razor,Warehouse B,117,98,2025-02-10 02:30:00,19
21997,ORD_21998,17799,"Sky Edeal Mi Remote Control with Netflix & Prime Video Button Compatible for Mi 4K LED Smart TV 4A Remote Control (32""/4...",Warehouse B,56,46,2025-02-10 12:38:00,10
21998,ORD_21999,18222,Bioxim CV 200mg/125mg Tablet,Warehouse A,91,86,2025-02-10 00:53:00,5
21999,ORD_22000,11165,Lift 50mg Tablet,Warehouse C,48,37,2025-02-10 12:45:00,11
22000,ORD_22001,4693,Zupiflex TH Tablet,Warehouse B,29,10,2025-02-10 04:36:00,19
22001,ORD_22002,3667,"Dates, Apricot & Cane Sugar Exfoliating Fruit Scrub",Warehouse A,58,48,2025-02-10 00:09:00,10
22002,ORD_22003,16379,TheGiftKart Tough Armor Bumper Back Cover Case for Mi Redmi K20 / K20 Pro | Ring Holder & Kickstand in-Built | 360 Degree ...,Warehouse A,99,82,2025-02-10 21:33:00,17
22003,ORD_22004,30565,Erazol 0.5mg Tablet,Warehouse B,109,90,2025-02-10 14:36:00,19
22004,ORD_22005,29818,"TP-Link AC1300 USB WiFi Adapter (Archer T3U) - 2.4G/5G Dual Band Mini Wireless Network Adapter for PC Desktop, MU-MIMO Wi-...",Warehouse A,30,15,2025-02-10 04:00:00,15
22005,ORD_22006,17807,Shreyans (SRS58B) Thermal Receipt Printer (Bluetooth Printer),Warehouse A,84,68,2025-02-10 13:32:00,16
22006,ORD_22007,3303,LA Girl Inspiring eyebrow tin Dark 5.5 gm,Warehouse C,32,18,2025-02-10 04:12:00,14
22007,ORD_22008,2403,"(Renewed) Boult Drift Bluetooth Calling, 1.69inch HD Display Smartwatch (Blue Strap, Free Size)",Warehouse B,92,86,2025-02-10 15:05:00,6
22008,ORD_22009,28480,F Gear Luxur Olive Green 25 liter Laptop Backpack (3110),Warehouse A,21,14,2025-02-10 07:43:00,7
22009,ORD_22010,19076,Nugliptin 50 Tablet,Warehouse A,77,69,2025-02-10 03:40:00,8
22010,ORD_22011,4776,Superdrug Micellar Water Facial Wipes Pulls 25's,Warehouse B,26,7,2025-02-10 08:20:00,19
22011,ORD_22012,18538,"Fashion Colour Non - Transfer Matt Waterproof Lipstick, 15 Scarlet 2.6 gm",Warehouse B,49,38,2025-02-10 07:00:00,11
22012,ORD_22013,10847,"iQOO 11 5G (Legend, 8GB RAM, 256 GB Storage) | Snapdragon ® 8 Gen 2 Mobile Platform | 2K E6 AMOLED Display | V2 Intelligen...",Warehouse B,103,95,2025-02-10 20:53:00,8
22013,ORD_22014,11706,Zypine 7.5mg Tablet,Warehouse B,105,90,2025-02-10 23:45:00,15
22014,ORD_22015,32807,SWARG Multicolour Waterproof Elastic Band Plastic Reusable Shower Caps for Women's - 3 Pieces,Warehouse C,64,54,2025-02-10 23:04:00,10
22015,ORD_22016,17326,"Wings Phantom 700 Wireless Earphones, Earbuds with Low Latency 40 ms, Gaming Designed Case, Multicolour LED Lights, Blueto...",Warehouse C,28,19,2025-02-10 13:13:00,9
22016,ORD_22017,18553,Brustan 400 mg/325 mg Tablet,Warehouse C,14,8,2025-02-10 04:07:00,6
22017,ORD_22018,10855,Parker Beta Neo Ball Pen + Parker Notebook Gift Set (Black),Warehouse C,49,37,2025-02-10 03:37:00,12
22018,ORD_22019,4750,"Amozo Tough Rugged Shockproof TPU Cover Case Compatible with AirPods Pro 2 / AirPods Pro GEN-2 (2022) - (Carbon Texture, T...",Warehouse A,60,48,2025-02-10 06:56:00,12
22019,ORD_22020,28558,Acetamol-SP Tablet,Warehouse B,67,55,2025-02-10 06:31:00,12
22020,ORD_22021,4757,Odeon Whitening Papaya Body Lotion 100 ml,Warehouse C,30,19,2025-02-10 00:16:00,11
22021,ORD_22022,31376,DUO BLENDS WITH BLACK OR BROWN LASHES DARK TONE STRIPLASH ADHESIVE 7g,Warehouse C,87,72,2025-02-10 00:17:00,15
22022,ORD_22023,17332,Xfactor Syrup,Warehouse B,26,19,2025-02-10 07:52:00,7
22023,ORD_22024,2427,Beauty People Velvet Matte Nail Polish Matte - Me - Remix - 1009 9.9 ml,Warehouse B,65,50,2025-02-10 21:04:00,15
22024,ORD_22025,32246,JetLife Universal Mobile Holder/Pouch-Bag for All Scooters Scooty Activa Jupiter EV's | X1 Model (Navy Blue),Warehouse A,11,2,2025-02-10 11:35:00,9
22025,ORD_22026,11707,Nature's Essence Daily De-Tan Face Wash 65 ml,Warehouse C,98,89,2025-02-10 05:33:00,9
22026,ORD_22027,18542,G Xime 100mg Tablet,Warehouse C,107,89,2025-02-10 17:27:00,18
22027,ORD_22028,10359,Maryaj Wild Speed EDP Citrus Spicy Perfume And Ajmal Wisal Dhahab Deodorant Fruity Floral Fragrance 300 ml,Warehouse C,83,66,2025-02-10 03:28:00,17
22028,ORD_22029,3598,"SKYCELL Universal Mobile Holder for Scooty , Bike Mobile Stand Holder Metal Body",Warehouse A,85,76,2025-02-10 14:33:00,9
22029,ORD_22030,19031,Spinmox 250mg Capsule,Warehouse B,102,92,2025-02-10 21:37:00,10
22030,ORD_22031,18540,Street Wear Lip2Last Matte Liquid Lipstick - Mood Nude 5 ml,Warehouse C,104,98,2025-02-10 14:55:00,6
22031,ORD_22032,29341,Genericart Nifedipine 10mg Tablet SR,Warehouse B,72,54,2025-02-10 16:30:00,18
22032,ORD_22033,32832,"Portronics Dynamo 5W POR-737 Bluetooth 5.0 Portable Stereo Speaker with TWS, USB Music & FM Music and Clear Bass Sound (Blue)",Warehouse B,51,38,2025-02-10 16:40:00,13
22033,ORD_22034,17340,Jagquin 40mg Injection,Warehouse C,49,30,2025-02-10 19:39:00,19
22034,ORD_22035,30795,Tromarax P 50mg/325mg Tablet,Warehouse B,23,14,2025-02-10 06:07:00,9
22035,ORD_22036,31273,Nyoderm Cream,Warehouse A,25,9,2025-02-10 09:45:00,16
22036,ORD_22037,2494,Fashion Colour Magic Kajal 0.28 gm,Warehouse A,18,2,2025-02-10 17:55:00,16
22037,ORD_22038,2410,"KINGONE Upgraded Stylus Pen, iPad Pencil, Ultra High Precision & Sensitivity, Palm Rejection, Prevents False ON/OFF Touch,...",Warehouse B,27,9,2025-02-10 02:46:00,18
22038,ORD_22039,11178,Flamicort 6 Tablet,Warehouse B,28,23,2025-02-10 17:32:00,5
22039,ORD_22040,30573,"Fashion Colour Pro Matte Liquid Foundation, Natural 30 ml",Warehouse A,30,24,2025-02-10 16:53:00,6
22040,ORD_22041,29239,"Dell S2421HN-Grey 24"" FHD 1920 x 1080 @75 Hz |Minimalistic Design | IPS Panel |Brightness: 250 cd/m²|Colour Gamut: 99% sRG...",Warehouse B,29,18,2025-02-10 22:29:00,11
22041,ORD_22042,30590,Coconut Almond Body Lotion - With Milk & Honey,Warehouse A,84,74,2025-02-10 17:45:00,10
22042,ORD_22043,29966,Zigaf 250mg Tablet,Warehouse A,42,27,2025-02-10 14:04:00,15
22043,ORD_22044,2477,Onsitego 1 year Extended Warranty for Small Appliances up to Rs 5000 (Email Delivery - No Physical Kit),Warehouse B,36,25,2025-02-10 05:51:00,11
22044,ORD_22045,10334,OneAssist 2 Years Extended Warranty Plan for Headphones 2001 to 3000 - Email Delivery Within 2 Hours,Warehouse A,25,16,2025-02-10 13:04:00,9
22045,ORD_22046,4676,Clopizen Gold 75mg/10mg/75mg Capsule,Warehouse C,71,62,2025-02-10 13:01:00,9
22046,ORD_22047,32748,Spigen AlignMaster Tempered Glass Screen Guard Protector for Galaxy S21 FE 5G - 2 Pack,Warehouse A,75,67,2025-02-10 14:11:00,8
22047,ORD_22048,16404,Slayisha Pastel Wet Split Eyeliner 6 Colors,Warehouse C,48,37,2025-02-10 10:37:00,11
22048,ORD_22049,18996,Allure Classic Mascara brush & eye Groomer combo 1's,Warehouse B,92,79,2025-02-10 11:29:00,13
22049,ORD_22050,28580,Mefalgin 250mg Tablet,Warehouse A,39,24,2025-02-10 14:08:00,15
22050,ORD_22051,3569,Mtlev 5mg/10mg Tablet,Warehouse C,74,65,2025-02-10 16:23:00,9
22051,ORD_22052,28520,"IFB 6 Kg 5 Star Front Load Washing Machine 2X Power Steam (DIVA AQUA BXS 6008, White & Black, In-built Heater, 4 years Com...",Warehouse C,98,92,2025-02-10 01:21:00,6
22052,ORD_22053,31297,Classic White Eau De Toilette For Men,Warehouse B,80,61,2025-02-10 16:28:00,19
22053,ORD_22054,3286,Titu Ki Baatein 50 PCS Cute Vintage Stickers - Vinyl Kids Stickers for Water Bottle Laptop Skateboard Phone - Wateproof Re...,Warehouse C,90,75,2025-02-10 23:26:00,15
22054,ORD_22055,16948,"IFB 7 Kg 5 Star Front Load Washing Machine 2X Power Steam (NEO DIVA BXS 7010, White & Black, In-built Heater, 4 years Comp...",Warehouse A,33,21,2025-02-10 19:06:00,12
22055,ORD_22056,29345,cosmac Professional Combo Face Primer With Waterproof Foundation And Makeup Blender (Set Of 3),Warehouse C,74,60,2025-02-10 02:17:00,14
22056,ORD_22057,3289,"Hair Brush Comb - Small Bristles, Golden, BB1203",Warehouse C,34,23,2025-02-10 12:50:00,11
22057,ORD_22058,17710,Bella Voste Liquid Dip Eyeliner Glossy Gold (05) 4 Ml,Warehouse C,91,86,2025-02-10 23:43:00,5
22058,ORD_22059,31289,Belora Paris World Matte Vit C Popsicles - 006 Peru Purple 4.2 gm,Warehouse A,63,53,2025-02-10 15:03:00,10
22059,ORD_22060,2760,"SanDisk Ultra Shift USB Flash Drive USB 3.0, 100MB/s R, 128GB",Warehouse B,40,30,2025-02-10 22:17:00,10
22060,ORD_22061,29824,"Dyazo 2 Way Capacitive Stylus Pen Aluminium fine Point Compatible with All Touch Screen iOS , Android Phones & Tables,with...",Warehouse B,36,24,2025-02-10 07:55:00,12
22061,ORD_22062,31944,"Faces Ultime Pro Perfecting Primer, 30ml",Warehouse A,64,52,2025-02-10 12:23:00,12
22062,ORD_22063,17689,Linicef OZ 200mg/500mg Tablet,Warehouse C,53,45,2025-02-10 06:15:00,8
22063,ORD_22064,18303,"MyGlamm Total Makeover FF Matte Cream Foundation Palette with SPF 30 & Skin Tone Corrector (Honey, Beige, 5 gm)",Warehouse C,45,31,2025-02-10 08:20:00,14
22064,ORD_22065,4078,VARS LONDON Matte and Shimmer eye shadow combo palette| eye shadow combo palette| shimmer eye shadow combo palette| makeup...,Warehouse B,15,5,2025-02-10 13:38:00,10
22065,ORD_22066,31971,Tusnov-D Syrup,Warehouse A,21,15,2025-02-10 10:02:00,6
22066,ORD_22067,849,Cadyce USB to Serial (RS-232) Converter (Supports for Mac O/S),Warehouse A,44,27,2025-02-10 03:23:00,17
22067,ORD_22068,35640,ALLIMITY BN59-01259E Remote fit for Samsung 4K Curved Smart TV K5570 UA32K5570AULXL UA32K5570AUMXL UA40K5570AULXL UA40K557...,Warehouse C,30,18,2025-02-10 23:54:00,12
22068,ORD_22069,21633,Betaone 100mg Tablet XL,Warehouse A,78,61,2025-02-10 12:51:00,17
22069,ORD_22070,25913,Ostease Plus 50 mg/750 mg Tablet,Warehouse A,49,34,2025-02-10 19:01:00,15
22070,ORD_22071,20862,Asthelite PD Syrup,Warehouse A,54,43,2025-02-10 01:08:00,11
22071,ORD_22072,20781,NOTE ULTRA RICH COLOR EYE PENCIL 03 1.1 gm,Warehouse B,51,43,2025-02-10 23:01:00,8
22072,ORD_22073,20859,DOMS Pencil Smart Kit,Warehouse C,110,97,2025-02-10 08:36:00,13
22073,ORD_22074,14989,Lime Soap 100 gm Buy 4 Get 1 Free + Deodorant Soap- Cool 100 gm Buy 4 Get 1 Free,Warehouse C,12,7,2025-02-10 11:32:00,5
22074,ORD_22075,25968,Faber-Castell Creative Tack-It(Multicolor),Warehouse A,29,21,2025-02-10 07:00:00,8
22075,ORD_22076,20826,OpenTech® Tempered Glass Screen Protector Compatible for OnePlus Nord CE 5G (2021) / OnePlus Nord 2 5G (2021) with Edge to...,Warehouse C,31,18,2025-02-10 10:14:00,13
22076,ORD_22077,1368,Super Ultra Mini Boost Wireless Portable Bluetooth Speaker Built-in Mic High Bass Selfie Remote Control Button Low Harmoni...,Warehouse C,99,86,2025-02-10 21:53:00,13
22077,ORD_22078,34741,"Zayn & Myza Transfer - Proof Power Matte Lipstick, Blushing Beauty 3.2 gm",Warehouse A,64,53,2025-02-10 20:20:00,11
22078,ORD_22079,34730,"Be Bodywise Rosemary Hair Growth Oil | 90 Days Miracle Hair Oil | With 0.1% Rosemary Oil, Redensyl, Castor Oil, Olive Oil...",Warehouse A,77,65,2025-02-10 09:20:00,12
22079,ORD_22080,9086,Pre Shave Gel Fusion - Hydra Gel Sensitive,Warehouse A,96,86,2025-02-10 21:26:00,10
22080,ORD_22081,1378,Zapcase Thermoplastic Polyurethane Back Case Cover for iPhone 11 Pro | Compatible for iPhone 11 Pro Back Case Cover | Scra...,Warehouse A,72,63,2025-02-10 02:45:00,9
22081,ORD_22082,25368,Novamox AX 500 mg/60 mg Tablet,Warehouse B,67,48,2025-02-10 23:12:00,19
22082,ORD_22083,1043,Zorox 150mg Tablet,Warehouse B,43,37,2025-02-10 10:10:00,6
22083,ORD_22084,8629,"Redgear Shadow Spear Gaming Wired On Ear Headphones with Mic, 50Mm Drivers, Over-Ear Design, Omnidirectional and Breathing...",Warehouse A,105,86,2025-02-10 22:53:00,19
22084,ORD_22085,24845,"Garnier Hydra Bomb Eye Serum Mask, Orange, 6 g and Garnier Skin Naturals, Hydra Bomb, Face Serum Sheet Mask (Blue), 32g/28...",Warehouse C,24,19,2025-02-10 00:14:00,5
22085,ORD_22086,21707,Lomox Capsule,Warehouse C,102,85,2025-02-10 08:17:00,17
22086,ORD_22087,21691,Bonjour Paris Photo Match Mousse Foundation - Sandy Beige 30 ml,Warehouse C,38,26,2025-02-10 17:00:00,12
22087,ORD_22088,24856,Lansop 30mg Capsule,Warehouse C,44,26,2025-02-10 05:42:00,18
22088,ORD_22089,14282,Dial OD 750 Tablet ER,Warehouse A,37,32,2025-02-10 12:51:00,5
22089,ORD_22090,21680,Deeply Nourishing Body Wash,Warehouse B,55,41,2025-02-10 15:41:00,14
22090,ORD_22091,35746,AEIDESS Tempered Glass Screen Protector Compatible For Google Pixel 6A with Edge to Edge Coverage and Easy Installation Kit,Warehouse C,97,83,2025-02-10 01:29:00,14
22091,ORD_22092,24871,Cantras 150mg Tablet,Warehouse A,84,65,2025-02-10 00:01:00,19
22092,ORD_22093,35712,Everycom Tripod Phone Smartphone Mount Adapter Clip Holder Adjustable Bracket for Mini & Professional Tripod (Black),Warehouse C,95,85,2025-02-10 09:31:00,10
22093,ORD_22094,8596,"MYVN 5V Type C VOOC Flash Charging Cable Compatible for Oppo Reno/2/2Z/2F/Reno 10x Zoom/k3, Laptops(C Type Cable Charger)-...",Warehouse C,44,35,2025-02-10 10:41:00,9
22094,ORD_22095,12490,Curenin 100mg Injection,Warehouse B,60,41,2025-02-10 10:16:00,19
22095,ORD_22096,9037,Action Pro Helmet 3M Chin Mount Strap Compatible with All Smartphones GoPro Hero 11 10 9 8 7 6 5 4 SJCAM DJI Osmo and All ...,Warehouse C,85,69,2025-02-10 14:29:00,16
22096,ORD_22097,14937,Edoxim-CV 50mg/28.5mg Tablet,Warehouse A,77,70,2025-02-10 02:00:00,7
22097,ORD_22098,26205,MAYCREATE® Tattoo Practice Pad Lip Tattoo Practice Silicone Pad 3D Fake Skin for Lips Permanent Makeup Tattoo Skin Silicon...,Warehouse C,31,12,2025-02-10 00:29:00,19
22098,ORD_22099,20754,Pure Neem Skin Purifying Face Wash,Warehouse C,47,40,2025-02-10 23:54:00,7
22099,ORD_22100,30741,"Kid's Toothpaste - 6-9 Years, Natural Strawberry Mint Flavour, 0% Artificial",Warehouse B,75,66,2025-02-10 06:04:00,9
22100,ORD_22101,6101,Monotis-LM Tablet,Warehouse B,58,42,2025-02-10 04:28:00,16
22101,ORD_22102,26132,Vilano 20 Tablet,Warehouse C,55,46,2025-02-10 22:07:00,9
22102,ORD_22103,20731,"Logitech K380 Wireless Multi-Device Keyboard For Windows, Apple Ios, Apple Tv Android Or Chrome, Bluetooth, Compact Space-...",Warehouse C,96,90,2025-02-10 22:53:00,6
22103,ORD_22104,6086,Bowiemall Multipurpose Hand Wrist Strap Lanyard 5 Pcs Adjustable Nylon Wristlet Straps Keychain String for Cell Phone Case...,Warehouse A,27,10,2025-02-10 06:58:00,17
22104,ORD_22105,26139,OnePlus Type-C to 3.5mm Auxiliary Adapter (White),Warehouse C,39,21,2025-02-10 10:30:00,18
22105,ORD_22106,1419,Street Wear Playfull Matte Lip Crayon - Savage Pink 2.9 gm,Warehouse C,68,55,2025-02-10 00:29:00,13
22106,ORD_22107,26074,Deodorant Body Spray - Blue Desire EDT,Warehouse A,111,92,2025-02-10 21:14:00,19
22107,ORD_22108,12422,Myvn 33W Cellular Phones Fast Flash Charger 2.0 Fast Charging Type C Usb Charge Cable Compatible With Vivo V19 V20 Se V20 ...,Warehouse C,75,64,2025-02-10 17:27:00,11
22108,ORD_22109,6069,Ac Remote Compatible for hitachi Split ac with Back Light,Warehouse C,77,62,2025-02-10 22:48:00,15
22109,ORD_22110,1437,Zealpam EZ 0.5mg Tablet,Warehouse A,33,23,2025-02-10 14:50:00,10
22110,ORD_22111,26198,K-Con 200 Tablet,Warehouse C,37,31,2025-02-10 04:27:00,6
22111,ORD_22112,20662,Campilox 250mg/250mg Injection,Warehouse A,20,13,2025-02-10 00:31:00,7
22112,ORD_22113,6220,Akshara Castor Oil,Warehouse C,29,16,2025-02-10 21:27:00,13
22113,ORD_22114,6029,Metos Cream,Warehouse A,31,20,2025-02-10 09:51:00,11
22114,ORD_22115,26250,"SanDisk 1TB Portable SSD, 520MB/s R, USB 3.2 Gen 2, Rugged SSD with Upto 2 Meter Drop Protection, Type-C to Type-A Cable, ...",Warehouse C,116,99,2025-02-10 20:23:00,17
22115,ORD_22116,1471,"ROZIA Pro comb brush for women Boar Bristles Round Hair Brush, Thermal Ceramic & Ionic Tech & Anti-Static, Roller Hairbrus...",Warehouse A,78,60,2025-02-10 06:53:00,18
22116,ORD_22117,1481,"Syvo S-410 (52 inch) Tripod for Smartphones & Cameras with Mobile Holder and Carry Bag, Load Capacity-3 Kg, Lightweight & ...",Warehouse B,58,51,2025-02-10 02:30:00,7
22117,ORD_22118,34685,MI Lithium Ion Xiaomi Wireless Power Bank 10000mAh | 22.5W Fast Charging (USB-A) | 10W Wireless Charging | Two-Way Fast Ch...,Warehouse B,58,50,2025-02-10 04:16:00,8
22118,ORD_22119,6124,Lenoc 75 mg/5 mg/10 mg Capsule XL,Warehouse A,32,25,2025-02-10 07:07:00,7
22119,ORD_22120,14900,"Canon imageCLASS LBP6030W Wi-Fi Mono Printer, Windows, Mac and Linux Support",Warehouse C,29,18,2025-02-10 03:33:00,11
22120,ORD_22121,9053,"Beclina Screen Cleaning Towel (Grey, Set of 3) | 30 x 30 cm | 200 GSM Microfiber Glass Cleaning Towel | Scratch Proof Towe...",Warehouse A,47,30,2025-02-10 14:55:00,17
22121,ORD_22122,9010,OpenTech® Tempered Glass Screen Protector Compatible for Samsung Galaxy M33 / F23 / M23 / A23 / M13 4G with Edge to Edge C...,Warehouse B,85,71,2025-02-10 11:52:00,14
22122,ORD_22123,12511,SanDisk ® Ultra Curve USB 3.2 32GB 100MB/s R Navy Blue,Warehouse C,65,51,2025-02-10 17:24:00,14
22123,ORD_22124,34831,Gemer V2 Tablet,Warehouse A,63,47,2025-02-10 09:19:00,16
22124,ORD_22125,20911,Nishflam-P Tablet,Warehouse B,23,17,2025-02-10 09:49:00,6
22125,ORD_22126,6223,"Mysore Sandal Purest Sandalwood Soap (Gold, 125 Grams Per Unit, Pack of 4)",Warehouse C,81,70,2025-02-10 14:42:00,11
22126,ORD_22127,841,Generic 2 Pcs Studio Microphone Foam Mic Shield Cover Black,Warehouse B,16,7,2025-02-10 05:59:00,9
22127,ORD_22128,14314,Spigen Thin Fit Back Cover Case Compatible for Google Pixel 7 (TPU + Polycarbonate | Black),Warehouse B,32,23,2025-02-10 09:53:00,9
22128,ORD_22129,21555,Defiz 6mg Tablet,Warehouse A,24,7,2025-02-10 11:34:00,17
22129,ORD_22130,14317,"HUMBLE MI Band 3/ MI Band 4 Strap, Band for MI Band 3/ MI Band 4 Smartwatch (Fitness Tracker) Wristbands Silicone Straps f...",Warehouse B,34,28,2025-02-10 00:32:00,6
22130,ORD_22131,14374,Mefpra Syrup,Warehouse C,98,92,2025-02-10 02:44:00,6
22131,ORD_22132,35651,Fragrance Body Spray For Men (1000 sprays) - Ultimate,Warehouse B,56,37,2025-02-10 05:12:00,19
22132,ORD_22133,14495,Parker Frontier Stainless Steel Roller Ball Pen (Ink - Blue),Warehouse A,91,78,2025-02-10 10:07:00,13
22133,ORD_22134,25179,Atovib 40 Tablet,Warehouse C,100,81,2025-02-10 06:52:00,19
22134,ORD_22135,21403,Organic Virgin Coconut Oil - Pure Coldpressed & Undiluted Oil,Warehouse B,9,1,2025-02-10 12:55:00,8
22135,ORD_22136,25220,100% Organic Cotton Biodegradable Tampons - Super,Warehouse C,86,67,2025-02-10 11:55:00,19
22136,ORD_22137,14455,Body Deodorant - Red,Warehouse C,34,28,2025-02-10 08:08:00,6
22137,ORD_22138,14457,Activ Beaute Anti Pollution Detox Face Wash 100 ml,Warehouse C,20,2,2025-02-10 09:34:00,18
22138,ORD_22139,14466,"Ma Gayatri Traders Long Lasting Crazy Lip Balm, Multicolor",Warehouse B,93,84,2025-02-10 10:30:00,9
22139,ORD_22140,35488,AND Eternal Radiance Eau De Parfum 50ML & Serene Bliss Body Mist 200ML Pack of 2 for Women Crafted by Ajmal,Warehouse B,25,16,2025-02-10 03:33:00,9
22140,ORD_22141,14474,Zomax 250mg Tablet,Warehouse C,85,66,2025-02-10 05:54:00,19
22141,ORD_22142,25287,"Lavender Bath Salt For Rejuvenation, Relaxation & Pain Relief",Warehouse A,57,42,2025-02-10 08:29:00,15
22142,ORD_22143,12731,"MorningVale Generic-ID116Bluetooth Smart Fitness Band Watch with Heart Rate Activity Tracker, Step and Calorie Counter, Bl...",Warehouse A,25,9,2025-02-10 23:49:00,16
22143,ORD_22144,21343,Spigen Liquid Air Back Cover Compatible for Samsung Galaxy A73 5G (TPU | Matte Black),Warehouse A,33,14,2025-02-10 01:22:00,19
22144,ORD_22145,21559,Silicone Camel Toe Concealer Reusable Traceless Invisible Adhesive for Women Leggings Swimwear Waterproof Cover Pad,Warehouse A,40,25,2025-02-10 15:25:00,15
22145,ORD_22146,21328,"ampragrhd Smart Multipurpose Foldable Laptop Table with Cup Holder, Study Table, Bed Table, Breakfast Table, Foldable and ...",Warehouse B,109,91,2025-02-10 03:13:00,18
22146,ORD_22147,25320,Amotic Tablet,Warehouse A,40,23,2025-02-10 08:00:00,17
22147,ORD_22148,1007,Aglox 500mg Tablet,Warehouse B,96,90,2025-02-10 12:32:00,6
22148,ORD_22149,21312,AND EtherlD EDP & PrettyV Mist Pack of 2 250 ml,Warehouse A,67,48,2025-02-10 16:05:00,19
22149,ORD_22150,35366,"Stbotanica Japanese Cherry Blossom Hand Wash, No Parabens, Sls - With Shea Butter 250 ml",Warehouse B,101,84,2025-02-10 02:37:00,17
22150,ORD_22151,21309,"LOVERIGHT Professional Makeup Combo kit 3 IN 1 Waterproof Eyeliner, Liquid Mascara, Eyebrow Pencil, Waterproof Black Kaja...",Warehouse C,77,71,2025-02-10 11:21:00,6
22151,ORD_22152,1040,"Angelie Nylon Bristle Makeup Cosmetic Brush- Natural White, 1 Piece",Warehouse A,95,79,2025-02-10 09:31:00,16
22152,ORD_22153,25353,GOLD BINDI Red Color/Sticker Bindi/Circle Round for women/ladies for daily us/official/regular/party/wedding waterproof an...,Warehouse C,108,94,2025-02-10 04:55:00,14
22153,ORD_22154,14566,"ESR Camera Lens Protectors, Compatible with Samsung Galaxy S23 Ultra (2023), Individual Lens Protectors, Scratch-Resistant...",Warehouse C,109,92,2025-02-10 11:15:00,17
22154,ORD_22155,21415,Cartiform Forte Tablet,Warehouse B,20,12,2025-02-10 12:42:00,8
22155,ORD_22156,35572,"Canon imageCLASS LBP6030B Single-Function Laser Monochrome Printer (Black), Standard",Warehouse A,47,38,2025-02-10 17:24:00,9
22156,ORD_22157,939,MG Care Plus 1mg/1000mg Tablet,Warehouse C,76,58,2025-02-10 18:36:00,18
22157,ORD_22158,21449,"QZ USB 3.1 Type C OTG Adapter, Type C to USB Connector, USB to Type C Adapter OTG [Thunderbolt-3 Compatible]",Warehouse B,100,93,2025-02-10 13:38:00,7
22158,ORD_22159,6737,"AirCase Office Sling Messenger Bag fits upto 14.1"" Laptop/Macbook, Detachable Shoulder Strap, Waterproof, Shockproof, Carr...",Warehouse C,82,73,2025-02-10 23:33:00,9
22159,ORD_22160,21760,"Sanitary Pads - Secure Xl Ultra-Thin, with Wings",Warehouse A,26,18,2025-02-10 20:31:00,8
22160,ORD_22161,35815,Nokia 105 Single SIM (Black),Warehouse B,69,59,2025-02-10 19:49:00,10
22161,ORD_22162,35692,LINLO Tempered Glass Screen Protector Compatible for iQoo Neo 6 SE 5G / iQoo Neo 6 5G / iQoo 9 SE 5G / iQoo 7 5G / iQoo 7 ...,Warehouse A,41,32,2025-02-10 22:37:00,9
22162,ORD_22163,24935,Cefma 100mg Tablet,Warehouse B,110,93,2025-02-10 13:17:00,17
22163,ORD_22164,35665,Ucolit 300mg Tablet,Warehouse B,25,18,2025-02-10 23:46:00,7
22164,ORD_22165,6754,"SHOW BEAUTY lipsticks for women combo Set Pack of 5Pcs Liquid lipstick Must Have Shades, Matte Finish, Long lasting, Water...",Warehouse C,82,63,2025-02-10 10:39:00,19
22165,ORD_22166,24963,Fextric Oral Suspension,Warehouse A,7,1,2025-02-10 22:12:00,6
22166,ORD_22167,35749,ZAVERI PEARLS Gold Tone Kundan & Pearls Traditional Earring & Maangtikka Set For Women-ZPFK8541,Warehouse C,44,31,2025-02-10 00:29:00,13
22167,ORD_22168,35786,Trianom 1gm Injection,Warehouse B,67,55,2025-02-10 01:39:00,12
22168,ORD_22169,21293,Chubs Professional Dual Side Blade Scissor Cutting Trimmer Comb for Slim Haircuts,Warehouse B,53,38,2025-02-10 17:37:00,15
22169,ORD_22170,35877,Oxy Dihydrate LA Infusion,Warehouse A,44,28,2025-02-10 07:41:00,16
22170,ORD_22171,14176,"Maybelline New York Face Studio Master Chrome Metallic Highlighter, Molten Rose Gold, 6.7g and Maybelline New York Hypercu...",Warehouse C,82,70,2025-02-10 15:28:00,12
22171,ORD_22172,715,"TeQuiero Matte Vinyl Sticker Paper Self Adhesive Photo Paper for Inkjet, Waterproof, Instant Dry, Tear Resistant A4 Size S...",Warehouse B,19,6,2025-02-10 13:04:00,13
22172,ORD_22173,24607,Amozo Back Case Cover for iPhone 12 / iPhone 12 Pro (Silicone|Transparent),Warehouse C,88,77,2025-02-10 08:38:00,11
22173,ORD_22174,6940,Pentogra 40mg Tablet,Warehouse C,90,72,2025-02-10 02:05:00,18
22174,ORD_22175,35935,Seridic 50mg Tablet,Warehouse A,86,67,2025-02-10 09:19:00,19
22175,ORD_22176,14241,Lifof 200mg Tablet,Warehouse A,62,48,2025-02-10 19:51:00,14
22176,ORD_22177,14189,Olage 5mg Tablet MD,Warehouse A,79,70,2025-02-10 02:49:00,9
22177,ORD_22178,35912,Uber 500mg Tablet,Warehouse C,89,78,2025-02-10 17:12:00,11
22178,ORD_22179,6904,Portronics Adapto ONE POR-1104 3A Fast Charging Adapter with 1M Type C Cable (White),Warehouse B,75,65,2025-02-10 22:19:00,10
22179,ORD_22180,14224,Rking 20mg Tablet,Warehouse B,74,69,2025-02-10 19:01:00,5
22180,ORD_22181,14257,"Kinsound Headphone Splitter, 3.5mm Audio Stereo Y Splitter Cable Male to Female Dual Headphone Jack Adapter with 2 Mic & A...",Warehouse B,108,94,2025-02-10 14:25:00,14
22181,ORD_22182,35855,Xanthalin 100mg Capsule,Warehouse B,48,32,2025-02-10 14:15:00,16
22182,ORD_22183,14239,"Portronics Pixel 2 Wireless Bluetooth Portable Speaker with Micro SD, 3.5mm Aux, 3W Output, Retro Volume Knob(Black)",Warehouse C,104,89,2025-02-10 10:20:00,15
22183,ORD_22184,24718,Organic - Aloe Anti Dandruff Shampoo,Warehouse C,39,30,2025-02-10 14:18:00,9
22184,ORD_22185,24730,"RAEGR RapidLink 600, 35W GaN Fast Charger PD Adapter Powered by TAGORE TrustedGaN Technology, Type-C PD+USB-A Dual Port Wa...",Warehouse A,100,81,2025-02-10 03:58:00,19
22185,ORD_22186,24733,Pregsafe 100mg Soft Gelatin Capsule,Warehouse C,79,71,2025-02-10 14:21:00,8
22186,ORD_22187,14240,Riotra 100 Capsule,Warehouse A,113,97,2025-02-10 10:48:00,16
22187,ORD_22188,19042,Rest M Trio 0.2mg/500mg/80mg Tablet SR,Warehouse A,8,2,2025-02-10 23:34:00,6
22188,ORD_22189,16803,GB 29 Semi 50mg Capsule,Warehouse A,42,36,2025-02-10 07:44:00,6
22189,ORD_22190,18262,Suncef 1000mg Injection,Warehouse C,77,61,2025-02-10 08:54:00,16
22190,ORD_22191,4150,"Ant Esports MP290 Gaming Mouse Pad-L- Large with Stitched Edges, Waterproof Non-Slip Base for Gaming & Office – Black",Warehouse B,47,38,2025-02-10 06:07:00,9
22191,ORD_22192,4160,Megazid 125mg Injection,Warehouse B,63,45,2025-02-10 07:19:00,18
22192,ORD_22193,31188,"NiTHO NX120 STEREO Wired GAMING On Ear HEADSET with Foldable Microphone, Compatible with PS4/Xbox One/Switch/Phone",Warehouse C,82,74,2025-02-10 12:23:00,8
22193,ORD_22194,10966,Sensitive Plus Toothpaste - Anticavity,Warehouse B,39,20,2025-02-10 20:56:00,19
22194,ORD_22195,18397,Losris 50mg Tablet,Warehouse A,12,5,2025-02-10 05:55:00,7
22195,ORD_22196,3360,Cephonip 200mg Tablet,Warehouse C,57,49,2025-02-10 06:38:00,8
22196,ORD_22197,32054,Osrica-M Capsule,Warehouse C,73,68,2025-02-10 01:35:00,5
22197,ORD_22198,2859,Betty Barclay Woman No.2 Shower Gel 150 ml,Warehouse C,73,59,2025-02-10 09:41:00,14
22198,ORD_22199,31175,Declon 25mg Injection,Warehouse C,44,34,2025-02-10 06:17:00,10
22199,ORD_22200,33007,"Samsung Galaxy S23 5G (Green, 8GB, 256GB Storage)",Warehouse A,44,36,2025-02-10 03:56:00,8
22200,ORD_22201,33130,Wooum® Gadget Organizer Bag - Portable Bag and Mobile Power Bank Bag Electronic Accessory Storage Bag USB Cable Storage Ba...,Warehouse B,24,9,2025-02-10 19:48:00,15
22201,ORD_22202,4906,Ant Esports H1100 Pro RGB Wired Over Ear Gaming Headphones for PC / PS4 / PS5 / Xbox One / Switch1 with mic Frost White,Warehouse A,98,89,2025-02-10 08:30:00,9
22202,ORD_22203,3461,TheGiftKart Rugged Carbon Fibre Armor Back Cover Case for Google Pixel 6A | Shockproof & Protective | Stunning Minimalist ...,Warehouse C,72,64,2025-02-10 11:12:00,8
22203,ORD_22204,3362,Flazid 6mg Oral Suspension,Warehouse B,84,74,2025-02-10 11:01:00,10
22204,ORD_22205,16887,HP 430 Multi-Device Bluetooth Wireless Mouse with 4 Programmable Buttons/ 800 DPI - 4000 DPI/Fast Scrolling/Compatibility ...,Warehouse C,78,66,2025-02-10 03:07:00,12
22205,ORD_22206,17426,Rejuvenating UBTAN Essential Oil - Rosemary 10 ml,Warehouse B,77,69,2025-02-10 18:56:00,8
22206,ORD_22207,19201,Lotus Herbals Baby+ Eternal Love Baby Massage Oil 100 Ml,Warehouse C,83,75,2025-02-10 13:40:00,8
22207,ORD_22208,18478,Tamandro 0.4mg Tablet,Warehouse C,6,1,2025-02-10 08:19:00,5
22208,ORD_22209,28306,Innisfree Super Volcanic Pore Clay Mask 2x- Mini (20 ml),Warehouse B,101,93,2025-02-10 01:58:00,8
22209,ORD_22210,17528,Ledadryl Syrup,Warehouse B,59,45,2025-02-10 01:38:00,14
22210,ORD_22211,11386,Total Repair 5 Shampoo 640 ml + Total Repair 5 Conditioner 175 ml,Warehouse C,67,56,2025-02-10 01:52:00,11
22211,ORD_22212,17445,Bacirom 250mg Injection,Warehouse C,25,6,2025-02-10 13:24:00,19
22212,ORD_22213,10986,Ajmal Deep Earth Edt Of 2 & Persuade Deodorant Deodorant Pack of 2 450 ml,Warehouse A,57,50,2025-02-10 06:50:00,7
22213,ORD_22214,4148,"ABOUTTHEFIT 20W USB-C Power Adapter Fast Charger Compatible for iPhone 12, iPhone 11, iPad Pro 2020,Samsung S20, Note 10 P...",Warehouse C,98,90,2025-02-10 18:52:00,8
22214,ORD_22215,4928,Vircyclo 400mg Tablet,Warehouse C,72,54,2025-02-10 21:37:00,18
22215,ORD_22216,16173,Original Deodorant For Women,Warehouse A,36,19,2025-02-10 03:40:00,17
22216,ORD_22217,10467,Ridecort 12 Tablet,Warehouse C,41,22,2025-02-10 21:34:00,19
22217,ORD_22218,2873,Oanmelt 5mg Tablet,Warehouse A,56,50,2025-02-10 15:28:00,6
22218,ORD_22219,10473,"UNIGEN UNIPAD Wireless Charger Pad [Original] Qi Certified | 15W Type-C PD | for iPhone 14/13/12/11/XS/X/8/SE, Galaxy S2...",Warehouse A,24,15,2025-02-10 14:49:00,9
22219,ORD_22220,30962,"Storite 60cm Super Speed USB 3.0 Type A Cable - Male to Male USB Cord Short Cable for Hard Drive Enclosures, Laptop Coolin...",Warehouse A,82,74,2025-02-10 14:25:00,8
22220,ORD_22221,11804,Flucret Syrup,Warehouse A,64,57,2025-02-10 08:38:00,7
22221,ORD_22222,2876,Salex D Syrup,Warehouse C,41,27,2025-02-10 07:22:00,14
22222,ORD_22223,17589,Fashionury Shockproof Crystal Clear Back Cover Case for Vivo Y16| 360 Degree Protection | Protective Design | Transparent ...,Warehouse A,93,84,2025-02-10 04:52:00,9
22223,ORD_22224,28384,PP Block 20mg Tablet,Warehouse C,66,60,2025-02-10 14:34:00,6
22224,ORD_22225,2788,Triple Blade Disposable Razor With Comfort Grip For Men,Warehouse C,17,3,2025-02-10 00:25:00,14
22225,ORD_22226,30885,Jaguar For Men Deodorant Spray 150 ml,Warehouse B,47,31,2025-02-10 13:56:00,16
22226,ORD_22227,16134,Novotel 40mg Tablet,Warehouse C,20,9,2025-02-10 10:00:00,11
22227,ORD_22228,16121,Briclox 250mg/250mg Tablet,Warehouse C,19,8,2025-02-10 09:12:00,11
22228,ORD_22229,18498,Olina 5mg Tablet,Warehouse A,32,14,2025-02-10 05:46:00,18
22229,ORD_22230,32006,"(Renewed) Fire-Boltt Tank 1.85"" Bluetooth Calling Smart Watch, 123 Sports Mode, 8 UI Interactions, Built in Speaker & Mic,...",Warehouse A,90,78,2025-02-10 04:33:00,12
22230,ORD_22231,11805,Keyzol D 10mg/20mg Capsule,Warehouse B,47,33,2025-02-10 18:33:00,14
22231,ORD_22232,28214,Threpro 10 mg/75 mg/2.5 mg Capsule,Warehouse A,41,34,2025-02-10 23:01:00,7
22232,ORD_22233,30896,Sizonex 50mg Dry Syrup,Warehouse B,50,45,2025-02-10 02:43:00,5
22233,ORD_22234,18450,Parker Moments Vector Timecheck Gold Trim Roller Ball Pen (Black),Warehouse B,30,13,2025-02-10 05:59:00,17
22234,ORD_22235,11408,Arzin 10mg Tablet,Warehouse B,66,48,2025-02-10 15:09:00,18
22235,ORD_22236,32961,Robustrion Tempered Glass Screen Protector for iPad Air 5 / iPad Air 4 10.9 inch/iPad Air 5 / iPad Air 4 10.9 inch/iPad Pr...,Warehouse A,37,22,2025-02-10 13:20:00,15
22236,ORD_22237,31236,Montipel-LC Tablet,Warehouse C,106,87,2025-02-10 13:45:00,19
22237,ORD_22238,31035,Wayona USB Type C 65W Fast Charging 2M/6Ft Long Flash Charge Cable 3A QC 3.0 Data Cable Compatible with Samsung Galaxy S21...,Warehouse A,74,68,2025-02-10 00:59:00,6
22238,ORD_22239,19173,AND EtherlD EDP & DaintyG Mist Pack of 2 250 ml,Warehouse C,47,31,2025-02-10 12:55:00,16
22239,ORD_22240,17454,Rabedure D 30mg/20mg Capsule SR,Warehouse C,71,65,2025-02-10 15:02:00,6
22240,ORD_22241,19260,Tough Lee (Pack of 2 Tempered Glass Screen Guard for Samsung Galaxy F04 / M04 / M13 / M13 5G / M33 5G / M42 5G / M12 / M02...,Warehouse C,91,81,2025-02-10 11:54:00,10
22241,ORD_22242,10000,Gabrica Capsule SR,Warehouse C,37,32,2025-02-10 10:24:00,5
22242,ORD_22243,32202,Dabur Erand Tail Pure Cold Pressed Castor Oil Provides Effective Relief From Constipation - 100 Ml,Warehouse C,106,87,2025-02-10 15:37:00,19
22243,ORD_22244,2839,Teliride CT 40/12.5 Tablet,Warehouse A,35,20,2025-02-10 13:49:00,15
22244,ORD_22245,31224,"Redmi 11 Prime 5G (Thunder Black, 4GB RAM, 64GB Storage) | Prime Design | MTK Dimensity 700 | 50 MP Dual Cam | 5000mAh | 7...",Warehouse B,13,6,2025-02-10 12:00:00,7
22245,ORD_22246,31017,Mars Kohl Of Fame Kajal | Deep Black Kajal Pencil | Matte Finish | Smudge Proof & Waterproof | With Sharpener,Warehouse B,29,23,2025-02-10 09:24:00,6
22246,ORD_22247,31205,"Lip Balm - Bio Almond Repair, Bxl Cellular",Warehouse B,25,15,2025-02-10 10:31:00,10
22247,ORD_22248,3352,"REVLON Super Lustrous Lipstick, Black Cherry (Opaque)",Warehouse B,104,86,2025-02-10 09:11:00,18
22248,ORD_22249,29474,"UNIGEN 20W Dual Port USB & Type C PD Fast Charger Adapter | USB 18W QC 3.0 Block for iPhone 14/13/12/11Pro/Pro Max/Mini, S...",Warehouse B,17,7,2025-02-10 04:23:00,10
22249,ORD_22250,16819,Nodycin 250mg Tablet,Warehouse B,95,83,2025-02-10 21:52:00,12
22250,ORD_22251,31143,Vega D'zyner Beauty Set (BS - 01) 73 gm,Warehouse A,97,90,2025-02-10 05:53:00,7
22251,ORD_22252,29683,Cekrast Tablet,Warehouse B,42,28,2025-02-10 21:09:00,14
22252,ORD_22253,29393,Esiloc 40mg Tablet,Warehouse C,106,99,2025-02-10 06:49:00,7
22253,ORD_22254,11371,Akio OZ 200mg/500mg Tablet,Warehouse C,87,81,2025-02-10 10:40:00,6
22254,ORD_22255,17470,"truke Buds S2 Lite True Wireless in Ear Earbuds with MEMS Quad-Mic ENC, 48H Playtime, 10mm Real Titanium Speaker, Gaming M...",Warehouse A,16,3,2025-02-10 08:54:00,13
22255,ORD_22256,11014,"CEDO 65W OnePlus Dash Warp Charge Cable, USB A to Type C Data Sync Fast Charging Cable Compatible with One Plus 3 /3T /5 /...",Warehouse C,100,95,2025-02-10 18:05:00,5
22256,ORD_22257,3539,Passion Indulge ROSE WATER - (pack of 2) 1's,Warehouse B,38,28,2025-02-10 11:01:00,10
22257,ORD_22258,28191,"uni-Ball NBGK - 07 Refill (0.7mm, Blue Ink), Pack of 12, Usable for Click Gel",Warehouse B,21,4,2025-02-10 23:27:00,17
22258,ORD_22259,17647,Axacuf-L Syrup,Warehouse B,80,69,2025-02-10 08:31:00,11
22259,ORD_22260,11375,Afderm-MX Cream,Warehouse B,63,53,2025-02-10 17:20:00,10
22260,ORD_22261,4214,"G S Goldstein Star J8 New Version-Car Phone Holder Mount, Rearview Mirror Phone Holder for Car, 360°Rotatable and Car Phon...",Warehouse B,61,52,2025-02-10 01:06:00,9
22261,ORD_22262,3386,Herbogro - Herbal Hair Growth and Anti-Hairfall,Warehouse A,15,7,2025-02-10 19:34:00,8
22262,ORD_22263,18347,LOHAYA Compatible HAIER TV Remote Control and Replacement of Original HTR-U27E Suitable for All Model of HAIER Smart 4K An...,Warehouse B,110,92,2025-02-10 02:04:00,18
22263,ORD_22264,2897,POPIO Tempered Glass Screen Protector Compatible for Redmi Note 10 / Redmi Note 10s With Full Screen Coverage (except edge...,Warehouse A,29,20,2025-02-10 14:30:00,9
22264,ORD_22265,3324,"Fashion Colour Terra Cotta Blusher, Shade 28 8 gm",Warehouse C,52,41,2025-02-10 15:18:00,11
22265,ORD_22266,32895,TheGiftKart Shockproof Crystal Clear Back Cover Case for Samsung Galaxy S23 5G | 360 Degree Protection | Protective Design...,Warehouse C,80,73,2025-02-10 16:01:00,7
22266,ORD_22267,31996,"HUMBLE® Universal Mobile Holder for Car Windshield/Dashboard with One Touch Technology Phone Stand for Car, Extendable Arm...",Warehouse C,20,6,2025-02-10 21:09:00,14
22267,ORD_22268,32900,Faber-Castell Connector Pen Set - Pack of 15 (Assorted),Warehouse A,97,91,2025-02-10 03:00:00,6
22268,ORD_22269,2372,NOTE ULTRA RICH COLOR EYE PENCIL 09 1.1 gm,Warehouse C,44,27,2025-02-10 14:50:00,17
22269,ORD_22270,11084,Azirom 100mg Tablet,Warehouse A,62,48,2025-02-10 22:53:00,14
22270,ORD_22271,32224,Hair Fall Rescue Shampoo,Warehouse B,14,4,2025-02-10 15:52:00,10
22271,ORD_22272,4979,Rafftor Tablet,Warehouse C,75,58,2025-02-10 09:24:00,17
22272,ORD_22273,10927,"Natural Body Spray & Fragrance Booster - Ice Dive, Developed With Athletes",Warehouse C,36,23,2025-02-10 22:07:00,13
22273,ORD_22274,4811,"AKADO 5 in 1 Waterproof Matte Lipstick set mackup cosmetic moisturize long lasting colorful lipstick, Matte Finish (5-colo...",Warehouse A,65,49,2025-02-10 14:44:00,16
22274,ORD_22275,10393,Faces Canada Eye Pigment Silver 01 1.8 Gm,Warehouse B,81,67,2025-02-10 13:09:00,14
22275,ORD_22276,19144,"Medimix Ayurvedic Softening Lotion for Very Dry Skin with Water Lily, Coconut Milk and Argan Oil, Unisex, Vegan, Long last...",Warehouse B,18,9,2025-02-10 05:35:00,9
22276,ORD_22277,32116,Eyetex Dazller Nail Glitter - DMA1 (Claret) 12 ml,Warehouse A,28,11,2025-02-10 13:41:00,17
22277,ORD_22278,9112,"Energy - Deostick For Men, Cream Based Deodorant",Warehouse C,75,67,2025-02-10 23:40:00,8
22278,ORD_22279,18427,Thyrox 25 Tablet,Warehouse A,79,71,2025-02-10 20:16:00,8
22279,ORD_22280,18511,Amozo Easy Fit Tempered Glass Screen Protector Guard for iPhone 14 / iPhone 13 / iPhone 13 Pro (with easy applicator) - Pa...,Warehouse B,75,66,2025-02-10 03:25:00,9
22280,ORD_22281,29517,Grufen 75mg Injection,Warehouse A,61,45,2025-02-10 01:53:00,16
22281,ORD_22282,17654,Original Talc,Warehouse B,45,38,2025-02-10 11:10:00,7
22282,ORD_22283,18408,Oflex ON 200mg/500mg Tablet,Warehouse B,67,50,2025-02-10 21:29:00,17
22283,ORD_22284,16149,Charcoal Detox Over Night Repair Face Cream,Warehouse C,48,31,2025-02-10 11:13:00,17
22284,ORD_22285,17573,Coco Soul Cold Pressed Natural Virgin Coconut Oil 1000ml,Warehouse C,9,4,2025-02-10 08:55:00,5
22285,ORD_22286,28303,Body Perfume - Power,Warehouse C,23,7,2025-02-10 04:47:00,16
22286,ORD_22287,16221,Blusid 1% Cream,Warehouse A,68,59,2025-02-10 23:09:00,9
22287,ORD_22288,18451,Moisturzing Cream - Intense,Warehouse B,101,89,2025-02-10 09:20:00,12
22288,ORD_22289,9930,Levomox-M Tablet,Warehouse A,11,3,2025-02-10 01:57:00,8
22289,ORD_22290,18336,Chakaash - Chyawanprash Toffee,Warehouse B,105,92,2025-02-10 16:30:00,13
22290,ORD_22291,31255,Extcef S 1000mg/500mg Injection,Warehouse A,76,62,2025-02-10 12:52:00,14
22291,ORD_22292,29802,Lowfe Noise_Colorfit Smart Watch Charger 2 Pin USB Fast Charger Magnetic Charging Cable Adapter (Smart Watch Charger 2 pin),Warehouse A,30,16,2025-02-10 13:04:00,14
22292,ORD_22293,29577,Apple iPhone 14 (128 GB) - Yellow,Warehouse A,67,53,2025-02-10 02:19:00,14
22293,ORD_22294,32935,Organic Cotton Applicator Tampon - Regular,Warehouse C,110,92,2025-02-10 09:17:00,18
22294,ORD_22295,29489,Clear Complexion Brightening Face Wash,Warehouse A,19,10,2025-02-10 23:24:00,9
22295,ORD_22296,3413,Telmis 40mg Tablet,Warehouse A,78,61,2025-02-10 21:33:00,17
22296,ORD_22297,16240,S Cold Tablet,Warehouse A,53,37,2025-02-10 11:25:00,16
22297,ORD_22298,33119,Motorola T201I Digital Cordless Landline Phone (Black),Warehouse C,64,54,2025-02-10 00:51:00,10
22298,ORD_22299,30843,Daily Use Hair Conditioner - For Men,Warehouse C,98,83,2025-02-10 01:23:00,15
22299,ORD_22300,10449,Santrax 500mg Injection,Warehouse A,33,15,2025-02-10 10:39:00,18
22300,ORD_22301,30838,BB Blemish Cream Nutritious Soft & Gentle to Skin Aloe Vera Moisture,Warehouse C,32,18,2025-02-10 22:16:00,14
22301,ORD_22302,31991,Povaril Ointment,Warehouse A,48,33,2025-02-10 05:47:00,15
22302,ORD_22303,2390,FACTOR NOTES Notebooks Pack of 3: B6 Sized | 90 GSM | Plain Journal Diary (Kraft),Warehouse B,58,50,2025-02-10 13:57:00,8
22303,ORD_22304,4302,Panasonic KX-TG3411SX 2.4 GHz Digital Cordless Phone (Black),Warehouse B,97,89,2025-02-10 05:05:00,8
22304,ORD_22305,32084,Levoglin 250mg Tablet,Warehouse A,86,71,2025-02-10 04:09:00,15
22305,ORD_22306,4212,"boAt Wave Lite Smartwatch with 1.69 Inches(4.29cm) HD Display, Heart Rate & SpO2 Level Monitor, Multiple Watch Faces, Acti...",Warehouse A,55,43,2025-02-10 06:45:00,12
22306,ORD_22307,3313,CEDO OnePlus Nord CE 2 5G Back Cover | Matte Soft Silicon Flexible | Camera Bump Protection | All Side Shock Proof Rubberi...,Warehouse B,62,57,2025-02-10 18:52:00,5
22307,ORD_22308,4962,Active Charcoal Peel Off Mask,Warehouse A,31,16,2025-02-10 03:16:00,15
22308,ORD_22309,32080,Droxylan 250mg Tablet,Warehouse A,10,4,2025-02-10 06:24:00,6
22309,ORD_22310,29483,"KABEER ART Set of 6 Different Sizes Synthetic Flat Paint Brush for Nail Brush Art, Artist Acrylic Painting(Synthetic Hair;...",Warehouse B,84,79,2025-02-10 21:39:00,5
22310,ORD_22311,18597,Anti-Ageing Sheet Mask (Pack of 6),Warehouse A,95,84,2025-02-10 18:10:00,11
22311,ORD_22312,3936,Ashwagandha - Veg,Warehouse B,19,1,2025-02-10 08:51:00,18
22312,ORD_22313,4506,Rednisol 8 Tablet,Warehouse C,54,46,2025-02-10 06:36:00,8
22313,ORD_22314,10674,Gemblue Biocare Coffee Gel Scrub 500 ml,Warehouse A,85,76,2025-02-10 13:16:00,9
22314,ORD_22315,30271,Lemongrass Leaves Powder - Supports Refreshment & Detoxification,Warehouse B,65,57,2025-02-10 03:06:00,8
22315,ORD_22316,30252,Vega Dressing Comb (HMSC - 42) 61 gm,Warehouse C,62,50,2025-02-10 12:47:00,12
22316,ORD_22317,17084,"Fashion Colour Soft Lip Mousse, 11 Nude Pink 8 gm",Warehouse A,103,87,2025-02-10 18:41:00,16
22317,ORD_22318,3049,Soap Bar - Lemon & Tea Tree Oil,Warehouse C,54,43,2025-02-10 16:23:00,11
22318,ORD_22319,29014,"Brother DCP-L2541DW Multi-Function Monochrome Laser Printer with Wi-Fi, Network & Auto Duplex Printing",Warehouse B,80,70,2025-02-10 10:23:00,10
22319,ORD_22320,17091,Onsitego 2 Year Extended Warranty for Small Household Appliances from Rs. 1501-2000 (Email Delivery - No Physical Kit),Warehouse A,64,52,2025-02-10 03:33:00,12
22320,ORD_22321,2624,Acmetel-LN Tablet,Warehouse C,79,73,2025-02-10 15:01:00,6
22321,ORD_22322,32491,"Schwarzkopf Professional Bc Keratin Smooth Perfect Conditioner and Shampoo Set, Purple",Warehouse C,30,23,2025-02-10 16:54:00,7
22322,ORD_22323,28978,NOTE GEL LOOK NAIL ENAMEL 16 9 ml,Warehouse B,80,61,2025-02-10 03:28:00,19
22323,ORD_22324,3870,GEAR GUARD - GIVE LIFE TO YOUR DEVICE Android 9inch Car Accessories Navigation or Music System Stereo Touch Screen Guard (...,Warehouse B,27,15,2025-02-10 09:39:00,12
22324,ORD_22325,18083,"Dyazo Tabletop Laptop Stand with 8 Angles View Height Adjustable Foldable Design Compatible for MacBook Air / Pro, Dell, H...",Warehouse B,113,97,2025-02-10 23:56:00,16
22325,ORD_22326,18716,Faces Canada Weightless Matte Finish Lipstick Divine Mauve 17 4 Gm,Warehouse A,89,77,2025-02-10 02:33:00,12
22326,ORD_22327,31727,Zoxinace TH 100mg/4mg Tablet,Warehouse A,80,63,2025-02-10 02:22:00,17
22327,ORD_22328,3075,Biotake 500mg Tablet,Warehouse C,74,64,2025-02-10 15:53:00,10
22328,ORD_22329,3012,Ajmal Classic Oud Concentrated Perfume Oil Woody Oudh And Shadow Homme Deodorant Citrus Woody Fragrance 210 ml,Warehouse B,43,30,2025-02-10 14:03:00,13
22329,ORD_22330,29052,"Amozo Polycarbonate Designed for Nothing Phone 1 Cover, Ultra Hybrid Crystal Clear Camera Protection | Nothing Phone 1 Bac...",Warehouse A,24,8,2025-02-10 07:42:00,16
22330,ORD_22331,18751,Garnier Ultra Hair Color Golden Brown (55ml + 50g) + Loreal Paris Shampoo 75ml,Warehouse A,102,91,2025-02-10 13:02:00,11
22331,ORD_22332,28972,"Crucial Basics 8GB DDR4 1.2v 2666Mhz CL19 SODIMM RAM Memory Module for Laptops and Notebooks, Green",Warehouse B,59,50,2025-02-10 00:38:00,9
22332,ORD_22333,17144,Peach Shine Lip Care,Warehouse B,64,57,2025-02-10 22:47:00,7
22333,ORD_22334,18015,REDTECH Noise Pulse Go Buzz SmartWatch Charger 2 Pin USB Fast Charger Magnetic Charging Cable Adapter (Smart Watch Charger...,Warehouse A,34,21,2025-02-10 09:15:00,13
22334,ORD_22335,3010,Rakcet Syrup,Warehouse B,57,50,2025-02-10 22:56:00,7
22335,ORD_22336,10617,EZVIZ by Hikvision|C1C-B WiFi Indoor Home Smart Security Camera| 2 Way Talk 1080p Full HDl Privacy Protection| Night Visio...,Warehouse A,25,10,2025-02-10 15:56:00,15
22336,ORD_22337,17952,"Waterman 50 ml Bottled Liquid Fountain Pen Ink, Serenity Blue (S0110720)",Warehouse B,53,47,2025-02-10 21:28:00,6
22337,ORD_22338,17175,Telminik H 40mg/12.5mg Tablet,Warehouse A,36,20,2025-02-10 02:25:00,16
22338,ORD_22339,2701,"OnePlus Nord Wired Earphones with mic, 3.5mm Audio Jack, Enhanced bass with 9.2mm Dynamic Drivers, in-Ear Wired Earphone -...",Warehouse B,100,90,2025-02-10 22:39:00,10
22339,ORD_22340,30099,Oflason 200mg Tablet,Warehouse B,64,53,2025-02-10 07:33:00,11
22340,ORD_22341,31595,Ufibate Cream,Warehouse C,97,86,2025-02-10 22:36:00,11
22341,ORD_22342,3850,"Artistix Avian Unisex Water Repellent Anti Theft Travel Backpack with USB Port (Black, 32 L)",Warehouse C,18,11,2025-02-10 00:07:00,7
22342,ORD_22343,31736,Ondarex 2mg Injection,Warehouse A,51,39,2025-02-10 08:28:00,12
22343,ORD_22344,31904,Hoxadic MR 500mg/50mg/325mg Tablet,Warehouse C,80,66,2025-02-10 11:56:00,14
22344,ORD_22345,17982,Nims SP 100mg/500mg/10mg Tablet,Warehouse B,82,71,2025-02-10 20:14:00,11
22345,ORD_22346,16457,"KABEER ART Set of Mechanical Lead Pencil, 12 Black Leads And 12 Color Leads",Warehouse B,102,94,2025-02-10 00:02:00,8
22346,ORD_22347,3710,Maast 10mg Tablet,Warehouse B,52,37,2025-02-10 20:47:00,15
22347,ORD_22348,2655,Amizec 500mg Injection,Warehouse C,61,55,2025-02-10 03:48:00,6
22348,ORD_22349,11239,Disnek Plus Tablet,Warehouse B,83,73,2025-02-10 17:12:00,10
22349,ORD_22350,32542,Brahmi Bhringaraj Taila - Anti Graying,Warehouse C,76,65,2025-02-10 11:35:00,11
22350,ORD_22351,3087,"Caveman Naturals Deodorant | India's 1st Made Safe Certified Natural Deodorant, 50g (Alpine) for Men and Women",Warehouse C,44,36,2025-02-10 12:48:00,8
22351,ORD_22352,16564,Equiline Tablet,Warehouse A,74,68,2025-02-10 04:21:00,6
22352,ORD_22353,16555,Edikacin 500mg Injection,Warehouse A,58,43,2025-02-10 08:43:00,15
22353,ORD_22354,16627,Wiz 200 LB Tablet,Warehouse B,101,83,2025-02-10 00:29:00,18
22354,ORD_22355,4483,Nebicard-V Tablet,Warehouse A,67,55,2025-02-10 02:03:00,12
22355,ORD_22356,4479,"COSLUXE UCANBE KALEiDOSCOPE Highlighter Powder Makeup Palette, High Pigment Holographic Duo-chrome Shimmer Highlighting Br...",Warehouse A,71,60,2025-02-10 07:01:00,11
22356,ORD_22357,4558,Essasin 200mg Tablet,Warehouse A,18,5,2025-02-10 22:13:00,13
22357,ORD_22358,16544, Dot & Key Depuffing Eye Cream Concentrate - Coffee Cherry & Rosehip Oil 35 ml,Warehouse A,43,26,2025-02-10 16:00:00,17
22358,ORD_22359,32548,Prodot KB-207s Wired USB Standard Keyboard (Black),Warehouse B,80,65,2025-02-10 16:59:00,15
22359,ORD_22360,3804,"APC Back-UPS BX1100C-IN 1100VA / 660W, 230V, UPS System, An ideal Power Backup & Protection for Home Office, Desktop PC & ...",Warehouse B,30,19,2025-02-10 17:19:00,11
22360,ORD_22361,31697,Rediclox LB 250mg/250mg Capsule,Warehouse A,116,98,2025-02-10 06:55:00,18
22361,ORD_22362,30188,Nitroquick 2.6 Tablet CR,Warehouse C,103,94,2025-02-10 23:36:00,9
22362,ORD_22363,32421,Setral 50 Tablet,Warehouse A,16,11,2025-02-10 02:22:00,5
22363,ORD_22364,16654,Cosmo Girl - Eau De Parfum,Warehouse B,47,34,2025-02-10 08:35:00,13
22364,ORD_22365,16533,Allextreme EXMUH02 Mobile Phone Holder with USB Charger Waterproof Easy Adjustable Rear View Mirror Mount Solid Metal Crad...,Warehouse C,53,43,2025-02-10 00:51:00,10
22365,ORD_22366,32573,Genericart Aspirin+Rosuvastatin+Clopidogrel 75mg/10mg/75mg Capsule IR,Warehouse C,69,50,2025-02-10 23:24:00,19
22366,ORD_22367,32589,Zebronics Wired Keyboard and Mouse Combo with 104 Keys and a USB Mouse with 1200 DPI - JUDWAA 750,Warehouse A,67,59,2025-02-10 10:51:00,8
22367,ORD_22368,32381,Euroglic 40mg Tablet,Warehouse B,52,36,2025-02-10 08:35:00,16
22368,ORD_22369,31831,"Physicians Formula Super BB All-in-1 Beauty Balm Compact Cream SPF 30, Light/Medium, 0.28 Ounce",Warehouse A,73,57,2025-02-10 22:18:00,16
22369,ORD_22370,3775,Glimmer Premium Nail Enamel Hot Red 10 ml,Warehouse A,105,97,2025-02-10 04:26:00,8
22370,ORD_22371,18663,Univia N 40IU/ml Injection,Warehouse C,103,91,2025-02-10 10:57:00,12
22371,ORD_22372,4547,Azomid 500 Tablet,Warehouse C,53,45,2025-02-10 06:05:00,8
22372,ORD_22373,29150,Acepanac-MR Tablet,Warehouse B,18,5,2025-02-10 12:10:00,13
22373,ORD_22374,9991,"ZEISS Lens Wipes - Pre-Moistened Lens Cleaning Wipes | Multi Purpose, Easy To Carry, On-The-Go and Individually Packed Wip...",Warehouse C,106,93,2025-02-10 20:46:00,13
22374,ORD_22375,28806,Hedosat 10mg Syrup,Warehouse C,89,83,2025-02-10 13:29:00,6
22375,ORD_22376,31855,Duralone 16mg Tablet,Warehouse C,22,4,2025-02-10 23:22:00,18
22376,ORD_22377,30106,Deep Clean Foaming Cleanser,Warehouse A,72,59,2025-02-10 23:46:00,13
22377,ORD_22378,30456,"Jabra Elite 4 Active in-Ear Bluetooth Earbuds - True Wireless Ear Buds with Secure Active Fit, 4 Built-in Microphones, Act...",Warehouse C,101,94,2025-02-10 04:14:00,7
22378,ORD_22379,17931,Domperon Paed 1mg/ml Drop,Warehouse A,47,37,2025-02-10 01:01:00,10
22379,ORD_22380,10181,Vega Angular Blender Brush (MBP - 08) 15 gm,Warehouse A,82,73,2025-02-10 19:25:00,9
22380,ORD_22381,30460,Levofresh 250mg Tablet,Warehouse C,82,70,2025-02-10 12:55:00,12
22381,ORD_22382,30464,"POND'S Magic Freshness Talcum Powder, Acacia Honey, Pack of 100 g",Warehouse A,101,84,2025-02-10 06:56:00,17
22382,ORD_22383,10180,Gemblue Biocare Cucumber Face and Body Gel 500 ml,Warehouse C,72,54,2025-02-10 04:18:00,18
22383,ORD_22384,28855,Cesal 1000mg/500mg Injection,Warehouse A,41,30,2025-02-10 16:37:00,11
22384,ORD_22385,3933,Uniball Air Micro Pen Combo Set (2 Black + 2 Blue Pens) - (UBA 188 M),Warehouse B,38,26,2025-02-10 15:56:00,12
22385,ORD_22386,16671,Waterproof Flower Lipstick Jelly Flower Transparent Color Changing Lipstick Flower Jelly Lipstick (PACK OF 3),Warehouse B,74,59,2025-02-10 17:55:00,15
22386,ORD_22387,28830,"Sensitive Toothbrush - Ultra Soft Bristles, Colour May Vary",Warehouse B,85,66,2025-02-10 15:42:00,19
22387,ORD_22388,18821,Vega Flat Brush (E11 - FB) 96 gm,Warehouse B,82,65,2025-02-10 09:35:00,17
22388,ORD_22389,4081,"Noise Newly Launched Buds Connect Truly Wireless in Ear Earbuds with 50H Playtime, Quad Mic with ENC, Instacharge(10 min=1...",Warehouse A,102,96,2025-02-10 22:27:00,6
22389,ORD_22390,30715,Maryaj Tuxedo EDP Spicy Woody Perfume And Ajmal Evoke Silver Edition Him Deodorant Spicy Floral Fragrance 300 ml,Warehouse B,39,32,2025-02-10 01:48:00,7
22390,ORD_22391,10668,"Mobilife Bluetooth Extendable Selfie Stick with Tripod Stand and Wireless Remote,3-in-1 Multifunctional Selfie Stick Tripo...",Warehouse A,70,51,2025-02-10 12:52:00,19
22391,ORD_22392,31221,Nebinex 5mg Tablet,Warehouse B,67,53,2025-02-10 06:14:00,14
22392,ORD_22393,9997,Maryaj Lilas EDP Citrus Floral Perfume And Ajmal Sacred Love Deodorant Floral Musky Fragrance 300 ml,Warehouse A,10,5,2025-02-10 08:04:00,5
22393,ORD_22394,28382,Betmet-N Cream,Warehouse B,64,45,2025-02-10 21:02:00,19
22394,ORD_22395,33084,Flormar Nail Enamel 495 Firecracker 11 ml,Warehouse C,64,51,2025-02-10 21:03:00,13
22395,ORD_22396,31214,Dahsha Stainless Steel Modern Thumb Slide Out Pocket Business Visiting Card Holder (100 x 62 x 8 mm),Warehouse C,66,52,2025-02-10 23:10:00,14
22396,ORD_22397,9994,Nillkin TPU CamShield Pro with Slide Camera Cover for Samsung S22 Ultra 5g case 6.8'' - Black,Warehouse C,76,66,2025-02-10 22:05:00,10
22397,ORD_22398,31207,Jasnic Cream,Warehouse A,54,40,2025-02-10 03:29:00,14
22398,ORD_22399,10946,Plv Injection,Warehouse A,83,75,2025-02-10 10:29:00,8
22399,ORD_22400,30913,Soulflower Tea Tree Scalp and Anti Dandruff Hair Oil 120 ml,Warehouse B,87,74,2025-02-10 07:41:00,13
22400,ORD_22401,18420,La Roche-Posay Cicaplast Baume B5 Soothing Repairing Balm 40ml,Warehouse A,72,54,2025-02-10 07:24:00,18
22401,ORD_22402,4944,Clonza 2mg Tablet,Warehouse C,28,21,2025-02-10 03:07:00,7
22402,ORD_22403,28366,Doenac A 100mg/600mg Tablet,Warehouse C,22,12,2025-02-10 00:44:00,10
22403,ORD_22404,4599,OJ Golden Moti Stone Bindi Fancy Designer Tikali Kumkum Sticker Bindiya Tikka Giftable Forehead Skin Friendly Glue Traditi...,Warehouse A,102,84,2025-02-10 13:49:00,18
22404,ORD_22405,31616,Medikast FX 10mg/120mg Tablet,Warehouse A,35,30,2025-02-10 16:33:00,5
22405,ORD_22406,32677,Nourishing Body Lotion,Warehouse B,17,3,2025-02-10 02:45:00,14
22406,ORD_22407,10170,"MYVN 65W Super Vooc Charge, Data Sync Fast Charging Type-C Cable Compatible for Realme XT, Realme XT 730G, Realme X2, Real...",Warehouse C,82,75,2025-02-10 16:18:00,7
22407,ORD_22408,32639,Trixia 10 mg/1 mg Tablet,Warehouse C,86,67,2025-02-10 14:50:00,19
22408,ORD_22409,29181,Pleorose 20mg Tablet,Warehouse B,32,15,2025-02-10 16:11:00,17
22409,ORD_22410,29192,Stbotanica Pure Tea Tree Essential Oil 15 ml,Warehouse B,59,54,2025-02-10 18:11:00,5
22410,ORD_22411,30069,Generic 11 Pcs Portable Makeup Powder Brushes Set Blush Cosmetic Bamboo Bag,Warehouse C,61,53,2025-02-10 06:02:00,8
22411,ORD_22412,28788,OpenTech® Tempered Glass Screen Protector Compatible for Samsung Galaxy F41 / M21 / M31 / M30s / M30 / A30 / A50 / A50s Ed...,Warehouse C,35,20,2025-02-10 18:57:00,15
22412,ORD_22413,3105,"Tizum Multi-Angle Foldable Portable Laptop Tabletop Stand With Dual Mobile Holder, Air Vents For Cooling & Anti-Slip Silic...",Warehouse C,62,44,2025-02-10 14:48:00,18
22413,ORD_22414,10163,"Tenda N301 RJ45 Wireless-N300 Mbps Single_Band Easy Setup Router (White, Not a Modem)",Warehouse B,37,21,2025-02-10 02:32:00,16
22414,ORD_22415,30515,Desert Rose EDP Perfume For Women,Warehouse A,49,42,2025-02-10 23:30:00,7
22415,ORD_22416,4634,"Boltove® 8x12 Ft. Green Screen Backdrop Background Curtain Rod Pocket for Photography, Photoshoot, Product Photography, Li...",Warehouse A,49,42,2025-02-10 23:51:00,7
22416,ORD_22417,30518,Vega Tail Comb (HMBC - 307) 16 gm,Warehouse A,47,36,2025-02-10 22:46:00,11
22417,ORD_22418,10314,PureSense Macadamia Nourishing Lip Balm 5gm,Warehouse C,77,58,2025-02-10 12:28:00,19
22418,ORD_22419,30028,Essential Oil - Ylang Ylang,Warehouse B,56,41,2025-02-10 00:50:00,15
22419,ORD_22420,32611,"L'Oréal Paris Eyebrow Kit, Pigmented Wax and Eyebrow Powder, For Brow Shaping and Filling, 12 Hours of Wear, Brow Artist G...",Warehouse B,75,59,2025-02-10 09:01:00,16
22420,ORD_22421,28764,Saregama Carvaan Mini Hanuman - Music Player with Bluetooth/FM/AM/AUX (Devotional Orange),Warehouse A,79,60,2025-02-10 15:28:00,19
22421,ORD_22422,10779,Dhanwantharam Kwath,Warehouse C,8,1,2025-02-10 09:11:00,7
22422,ORD_22423,4431,SupCares Edge to Edge Tempered Glass for iPhone 12 and 12 Pro (6.1 Inch) with Easy Self Installation Kit | Black,Warehouse C,37,31,2025-02-10 12:42:00,6
22423,ORD_22424,17921,Faces Canada Powder Brush 1'S,Warehouse C,98,92,2025-02-10 19:14:00,6
22424,ORD_22425,29146,"Revlon Cream PhotoReady Airbrush Effect Makeup Luminous, Shell",Warehouse A,108,94,2025-02-10 13:20:00,14
22425,ORD_22426,18639,mCaffeine Exfoliation & Tan Removal Combo 200 gm,Warehouse B,44,29,2025-02-10 07:27:00,15
22426,ORD_22427,3106,BEAUTRISTRO 3PC Satin silk Scrunchies | 3 Pcs Standard Size Scrunchies - Silk Satin Scrunchies for Hair - Jumbo Scrunchies...,Warehouse B,79,69,2025-02-10 04:06:00,10
22427,ORD_22428,18661,Bathing Soap - Ayurvedic,Warehouse A,83,77,2025-02-10 03:34:00,6
22428,ORD_22429,11222,New MISS DOLL FiiME POWDER Pore-less Oil Control Compact Powder- All Matte Finish Face -Fit Me Matte-Pore-less Liquid Tube...,Warehouse A,31,23,2025-02-10 11:10:00,8
22429,ORD_22430,29111,Skin Cottage Shower Gel (Lemon) 1000 ml,Warehouse A,32,13,2025-02-10 19:39:00,19
22430,ORD_22431,31633,"ASUS VivoBook 14 (2021), Intel Core i5-1035G1 10th Gen, 14-inch (35.56 cms) FHD Thin and Light Laptop (8GB/512GB SSD/Offic...",Warehouse C,56,45,2025-02-10 14:52:00,11
22431,ORD_22432,2555,"IONIX USB Bluetooth Adapter for PC, Car Accessories, Bluetooth Receiver, 4.0 Bluetooth USB Dongle Receiver Support Windows...",Warehouse A,89,78,2025-02-10 01:10:00,11
22432,ORD_22433,34669,Faces Canada Longstay Liquid Matte Lipstick Make Me Maroon 10 6 Ml,Warehouse B,38,29,2025-02-10 23:45:00,9
22433,ORD_22434,13366,Bio Thyme Volume Conditioner 75 Ml,Warehouse B,67,60,2025-02-10 04:39:00,7
22434,ORD_22435,6111,Regenerist Whip,Warehouse B,82,66,2025-02-10 16:47:00,16
22435,ORD_22436,11913,Coolkrit-A Syrup,Warehouse B,22,14,2025-02-10 16:23:00,8
22436,ORD_22437,2036,YOUTH MOBI Tempered Glass Screen Protector For Apple Watch Ultra (49mm) With Easy Installation Kit; Transparent - Pack of 1,Warehouse A,22,6,2025-02-10 15:06:00,16
22437,ORD_22438,27088,"3-in-1 USB 3.0 Card Reader USB C, Micro USB Card Reader SD, Micro SD, SDXC, SDHC, Micro SDHC, Micro SDXC Memory Card Reade...",Warehouse C,98,91,2025-02-10 05:22:00,7
22438,ORD_22439,27625,Tenrite Tablet,Warehouse B,85,70,2025-02-10 13:18:00,15
22439,ORD_22440,33570,Banco 400mg Tablet,Warehouse C,28,23,2025-02-10 21:53:00,5
22440,ORD_22441,27069,Qubo Outdoor Security Camera (Black) from Hero Group | Made in India | IP65 All-Weather | 2MP 1080p Full HD | CCTV Wi-Fi C...,Warehouse B,26,16,2025-02-10 07:33:00,10
22441,ORD_22442,9488,K2-Zole LD Solution,Warehouse A,76,57,2025-02-10 21:14:00,19
22442,ORD_22443,1752,HS04 Laptop Battery Compatible for HP 240 G4 G5 245 G4 G5 246 G4 G5 250 G4 G5 255 G4 G5 256 G4 G5 340 G3 346 G3 348 G3 348...,Warehouse A,41,28,2025-02-10 23:28:00,13
22443,ORD_22444,34035,Amdoxy Capsule,Warehouse B,77,58,2025-02-10 00:15:00,19
22444,ORD_22445,11983,Betacillin 500mg Capsule,Warehouse C,71,54,2025-02-10 13:21:00,17
22445,ORD_22446,27055,MI Power Bank Hypersonic 20000mAh 50W Lithium Polymer Supports Laptop Charging 50W Mobile Charging | Power Delivery 3.0 Fa...,Warehouse A,105,91,2025-02-10 09:00:00,14
22446,ORD_22447,1766,Lifepen 40mg Injection,Warehouse B,40,25,2025-02-10 15:06:00,15
22447,ORD_22448,34066,"HIK's® Round Earphone case Earphone Pouch | Earphones case | Headphone Pouch |Earphone Cover, Carrying Case for Earphones,...",Warehouse C,65,57,2025-02-10 01:23:00,8
22448,ORD_22449,33573,Linotril 0.5mg Tablet,Warehouse B,103,94,2025-02-10 04:22:00,9
22449,ORD_22450,9472,Qubo Mini UPS Plus from Hero Group | Uninterrupted Power Backup for WiFi Routers | Upto 4 Hours Power Backup | Voltage Reg...,Warehouse C,95,88,2025-02-10 01:09:00,7
22450,ORD_22451,1818,Snigdha Skin Whitening Face Wash,Warehouse B,91,81,2025-02-10 06:25:00,10
22451,ORD_22452,9470,Charmacy Milano Cheek Enhancer 1 4 gm,Warehouse C,28,17,2025-02-10 10:03:00,11
22452,ORD_22453,11977,CEDO Nothing Phone (1) Back Cover | Matte Soft Silicon Flexible | Camera Bump Protection | All Side Shock Proof Rubberised...,Warehouse B,95,89,2025-02-10 01:41:00,6
22453,ORD_22454,20141,Thioultra Tablet,Warehouse C,69,64,2025-02-10 00:55:00,5
22454,ORD_22455,33924,"W26 Smart Watch Charger Magnetic, Charging Cable for Boat Xtend, Noise ColorFit Pulse, Colorfit Ultra/Ultra 2, Color Fit P...",Warehouse A,72,58,2025-02-10 11:24:00,14
22455,ORD_22456,19722,Gracimol 250mg Oral Suspension,Warehouse A,26,12,2025-02-10 13:44:00,14
22456,ORD_22457,20236,Remove Ointment,Warehouse C,41,23,2025-02-10 18:26:00,18
22457,ORD_22458,5825,"Zinq UPS for Router Mini UPS for 12V WiFi Router, Fiber Routers and Broadband Modem with Upto 4 Hours Power Backup, Upto 2...",Warehouse C,46,38,2025-02-10 00:40:00,8
22458,ORD_22459,5748,"Caprigo Heavy Duty TV Wall Mount Bracket for 17 to 32 inch LED/HD/Smart TV’s, Swivel Rotatable Universal TV Wall Mount Sta...",Warehouse C,66,60,2025-02-10 14:28:00,6
22459,ORD_22460,26708,Perfect Radiance Intense Brightening Face Wash,Warehouse C,42,26,2025-02-10 23:50:00,16
22460,ORD_22461,5772,Tombow Zero Pen Type Eraser Round Shape 2.3 mm Tip Mono-Shade with Extra Refill Pack (White),Warehouse A,38,29,2025-02-10 22:03:00,9
22461,ORD_22462,27795,Fluzest 100mg Capsule,Warehouse B,40,24,2025-02-10 15:50:00,16
22462,ORD_22463,20335,Nadrol 50mg Injection,Warehouse B,42,36,2025-02-10 14:07:00,6
22463,ORD_22464,5260,Etorby 90mg Tablet,Warehouse A,90,75,2025-02-10 15:29:00,15
22464,ORD_22465,5561,Pregalyf 75mg Tablet SR,Warehouse C,82,70,2025-02-10 22:34:00,12
22465,ORD_22466,11955,Moment  0.1% Cream,Warehouse B,49,34,2025-02-10 15:35:00,15
22466,ORD_22467,15477,Gemblue Biocare Diamond Radiance Face Wash 150 ml,Warehouse B,102,88,2025-02-10 17:59:00,14
22467,ORD_22468,20167,Zenebend 400mg Tablet,Warehouse B,36,29,2025-02-10 21:10:00,7
22468,ORD_22469,19989,MOMCARE Beauty Care Makeup Cotton Pad Applicator and Puff Combo Brand:,Warehouse C,27,15,2025-02-10 03:02:00,12
22469,ORD_22470,15442,Tineptin M 500mg/20mg Tablet,Warehouse C,81,62,2025-02-10 08:28:00,19
22470,ORD_22471,19588,Kasclav 625 Tablet,Warehouse C,64,54,2025-02-10 23:25:00,10
22471,ORD_22472,9744,Amazon Brand - Solimo Soft & Flexible Back Cover for OnePlus 6T (Transparent),Warehouse C,91,86,2025-02-10 02:58:00,5
22472,ORD_22473,9678,Faces Canada Ultime Pro Longstay Liquid Matte Lipstick Ravishing Wine 18 6 gm,Warehouse A,103,86,2025-02-10 11:44:00,17
22473,ORD_22474,26925,Pantor 40 Tablet,Warehouse C,35,21,2025-02-10 22:57:00,14
22474,ORD_22475,9424,Coxifact Plus 60mg/4mg Tablet,Warehouse A,102,94,2025-02-10 19:14:00,8
22475,ORD_22476,15584,AVNISH Women's Polycotton Facial Facial Spa Makeup Cleansing Elastic Headband with Face Pack Brush Reusable Face Cleaning ...,Warehouse C,84,65,2025-02-10 20:06:00,19
22476,ORD_22477,5659,Conivog M 500mg/0.2mg Tablet,Warehouse A,64,47,2025-02-10 17:34:00,17
22477,ORD_22478,19715,Candizole B Cream,Warehouse A,32,13,2025-02-10 03:13:00,19
22478,ORD_22479,5261,"Ambrane 10000 mAh Lithium Polymer Stylo-10k Power Bank with 20 Watt Fast Charging, 1 USB and Type C Port,Blue",Warehouse A,25,18,2025-02-10 04:23:00,7
22479,ORD_22480,15418,Melose 2% Eye Gel,Warehouse A,65,46,2025-02-10 17:34:00,19
22480,ORD_22481,20228,Beardo Beard Wash Gel - The Irish Royale 100 ml,Warehouse C,81,73,2025-02-10 00:11:00,8
22481,ORD_22482,33417,ZORBES® Hard Drive Storage Bag for SanDisk 500GB/ 250GB/ 1TB/ 2TB/ 4TB Portable SSD- SDSSDE61/ SDSSDE60-Black,Warehouse A,116,98,2025-02-10 14:58:00,18
22482,ORD_22483,20233,Polinzer DSR 30mg/40mg Capsule,Warehouse C,58,46,2025-02-10 06:00:00,12
22483,ORD_22484,33915,Rutobest D Tablet,Warehouse B,85,68,2025-02-10 16:07:00,17
22484,ORD_22485,34114,HSR 3 Socket LED Voltage Display Dual USB Car Charger on/Off Switches 12V Car Splitter Adapter for Samsung (Black),Warehouse B,83,72,2025-02-10 07:44:00,11
22485,ORD_22486,15839,Ajmal Carbon Carbon Raindrops Deodorant Spray (Pack of 3) 200 ml,Warehouse B,102,83,2025-02-10 22:00:00,19
22486,ORD_22487,9506,Flormar Contour Stick 02 Medium 10 gm,Warehouse B,57,41,2025-02-10 10:06:00,16
22487,ORD_22488,19684,"AmazonBasics Dual Monitor Stand - Height-Adjustable Arm Mount, Steel",Warehouse C,92,76,2025-02-10 23:37:00,16
22488,ORD_22489,15524,Necphen-SP Tablet,Warehouse C,69,58,2025-02-10 18:25:00,11
22489,ORD_22490,2152,Aynagesic-AQ Injection,Warehouse A,77,69,2025-02-10 04:41:00,8
22490,ORD_22491,1627,Flucin Cream,Warehouse A,89,80,2025-02-10 11:23:00,9
22491,ORD_22492,1674,Lakme Enrich Matte Lipstick Shade Rm15 4.7 Gm,Warehouse B,97,80,2025-02-10 14:55:00,17
22492,ORD_22493,34260,Rumirab-DSR Capsule,Warehouse A,45,40,2025-02-10 07:30:00,5
22493,ORD_22494,19554,NEOLAYR Fruit Face Wash Combo (Neolayr Natural Lemon Oil Clear Face Wash 50ml+Neolayr Natural Orange Tan Removal Face Wash...,Warehouse C,44,39,2025-02-10 20:58:00,5
22494,ORD_22495,19973,Lenovo Everyday Laptop Backpack B515 15.6-inch Water Repellent Black,Warehouse B,61,51,2025-02-10 18:31:00,10
22495,ORD_22496,27756,Vega Cushion Brush (E14 - CB) 137 gm,Warehouse C,90,74,2025-02-10 04:49:00,16
22496,ORD_22497,27585,Alkof AP Plus Syrup,Warehouse C,108,95,2025-02-10 03:17:00,13
22497,ORD_22498,11932,Hello Zone Exclusive Matte Finish Soft Back Case Cover for Xiaomi Mi Redmi Note 8 Pro - Black,Warehouse B,109,95,2025-02-10 19:26:00,14
22498,ORD_22499,20276,Papaya Kit,Warehouse B,25,15,2025-02-10 15:45:00,10
22499,ORD_22500,19545,Lirin 250mg Capsule,Warehouse A,88,78,2025-02-10 02:55:00,10
22500,ORD_22501,5695,Snail Moisture Mask Sheet,Warehouse B,101,82,2025-02-10 09:29:00,19
22501,ORD_22502,9371,Faces Canada Foundation Brush 1'S,Warehouse A,89,74,2025-02-10 19:16:00,15
22502,ORD_22503,9389,Basil & Parsley Body Cleanser,Warehouse B,15,3,2025-02-10 22:19:00,12
22503,ORD_22504,9665,"FUR JADEN 40L Weekender Travel Laptop Backpack with Anti Theft Pocket, Organizer, 15.6 Inch Padded Laptop Sleeve and Dual ...",Warehouse A,76,60,2025-02-10 18:00:00,16
22504,ORD_22505,26831,Revlon Nail Enamel - White Star 8 Ml,Warehouse A,98,93,2025-02-10 16:34:00,5
22505,ORD_22506,34289,Dermiwin KT 5 Cream,Warehouse B,65,51,2025-02-10 17:03:00,14
22506,ORD_22507,12251,XSPEED KIKU Plastic Multipurpose Big Size Jumbo Spiderman Magnetic Dual Side Spacious Art Plastic Pencil Box (Blue),Warehouse A,42,37,2025-02-10 18:29:00,5
22507,ORD_22508,27767,Itranox 100 Capsule,Warehouse B,38,21,2025-02-10 01:26:00,17
22508,ORD_22509,27234,Onramol-MD 4mg Tablet,Warehouse B,99,90,2025-02-10 07:57:00,9
22509,ORD_22510,20285,Sivanna Gina Glam Double Wear Stay In Matte Foundation SPF - 15 10 30ML,Warehouse A,42,27,2025-02-10 04:02:00,15
22510,ORD_22511,2145,"Tensea for iPhone 13 Pro Max Camera Lens Protector, 9H Tempered Glass, Ring for iPhone 13Pro 6.1 inch iPhone 13 ProMax 6.7...",Warehouse B,20,8,2025-02-10 18:05:00,12
22511,ORD_22512,5195,TheGiftKart Flip Back Cover Case for Samsung Galaxy A23 4G / A23 5G | Dual-Color Leather Finish | Inbuilt Stand & Pockets...,Warehouse B,102,84,2025-02-10 08:56:00,18
22512,ORD_22513,5716,Faces Canada Splash Nail Enamel Periwinkle 151 8 Ml,Warehouse C,108,97,2025-02-10 23:25:00,11
22513,ORD_22514,1650,TheGiftKart Liquid TPU Shockproof Back Cover Case for Samsung Galaxy A23 4G / A23 5G | 10 Airbags 360 Degree Protection De...,Warehouse C,60,51,2025-02-10 21:48:00,9
22514,ORD_22515,1649,Moxykil D 250mg/250mg Capsule,Warehouse A,105,98,2025-02-10 08:32:00,7
22515,ORD_22516,12070,Passion Indulge FACE OIL-ETERNIA 10 ml,Warehouse B,83,78,2025-02-10 22:51:00,5
22516,ORD_22517,6012,Taxifa S 1.5gm Injection,Warehouse C,19,13,2025-02-10 08:58:00,6
22517,ORD_22518,464,"Makeup Palette, Faigy 6x4inch Stainless Steel 5-well Cosmetic Artist Mixing Palette with Spatula Tool for Nail Art Eye Sha...",Warehouse B,25,10,2025-02-10 06:06:00,15
22518,ORD_22519,9610,Repon 0.5 Tablet,Warehouse A,47,33,2025-02-10 21:30:00,14
22519,ORD_22520,12125,Fluster Cream,Warehouse A,95,78,2025-02-10 05:52:00,17
22520,ORD_22521,20242,Sea Minerals Liquid Handwash Refill,Warehouse B,23,5,2025-02-10 04:26:00,18
22521,ORD_22522,9782,Protect & Care Shaving Gel,Warehouse B,29,11,2025-02-10 16:38:00,18
22522,ORD_22523,9661,Pikkme Mi A3 Back Cover Soft Matte Liquid Silicone TPU | Camera Protection | Shockproof Slim Back Case for Mi A3 (Black),Warehouse B,52,42,2025-02-10 12:59:00,10
22523,ORD_22524,1641,Moxluv Eye Drop,Warehouse C,47,40,2025-02-10 19:40:00,7
22524,ORD_22525,27790,Cazithro 500mg Tablet,Warehouse C,31,16,2025-02-10 15:49:00,15
22525,ORD_22526,5487,Montlevo Tablet,Warehouse C,76,59,2025-02-10 11:51:00,17
22526,ORD_22527,15353,Pregabatinax D 50mg/20mg Tablet,Warehouse A,78,70,2025-02-10 16:36:00,8
22527,ORD_22528,19762,"Pidilite Fevicryl Acrylic Painting Color (Lemon Yellow, 500ml)",Warehouse B,64,50,2025-02-10 10:25:00,14
22528,ORD_22529,15351,Parawax Ear Drop,Warehouse A,79,72,2025-02-10 04:01:00,7
22529,ORD_22530,5788,Hair Fiber Wax - Strong Hold With Gloss Finish,Warehouse B,99,89,2025-02-10 04:05:00,10
22530,ORD_22531,5336,Cefcin-TJ 1gm/0.125gm Injection,Warehouse A,113,98,2025-02-10 05:45:00,15
22531,ORD_22532,26683,Pore Shrinking Face Pack,Warehouse C,107,95,2025-02-10 03:58:00,12
22532,ORD_22533,12036,Nik case 7 in 1 Electronic Cleaning Kit for Phone Cleaning kit | Laptop Cleaning kit| Monitor Keyboard Screen Dust Brush I...,Warehouse C,88,78,2025-02-10 08:51:00,10
22533,ORD_22534,19975,Rejunate 300mg Capsule,Warehouse A,95,76,2025-02-10 19:28:00,19
22534,ORD_22535,19502,Licona 1% Cream,Warehouse C,93,75,2025-02-10 01:28:00,18
22535,ORD_22536,20389,Pbren M 750mcg/150mg Capsule,Warehouse B,116,97,2025-02-10 12:16:00,19
22536,ORD_22537,20058,Terbifin Spray,Warehouse A,61,55,2025-02-10 11:30:00,6
22537,ORD_22538,27852,Meligad 4mg Tablet,Warehouse A,110,95,2025-02-10 18:35:00,15
22538,ORD_22539,33314,"Matrix 128GB 3D NAND Flash SATA 6GB/s 2.5 Inches Internal Solid State Drive (SSD), Read Up to 550MB/s, Write Up to 500MB/...",Warehouse B,81,71,2025-02-10 07:09:00,10
22539,ORD_22540,26629,Ajmal Avid Aurum Deodorants (Pack of 2) 200 ml,Warehouse B,13,4,2025-02-10 11:11:00,9
22540,ORD_22541,20428,"Ambrane Fast 100W Output Cable with Type-C to Type-C for Mobile, Laptop, Macbook & Table Charging, 480mbps Data Sync Spee...",Warehouse B,32,18,2025-02-10 00:18:00,14
22541,ORD_22542,26626,Verap 80mg Tablet,Warehouse A,69,51,2025-02-10 01:46:00,18
22542,ORD_22543,33321,Lenphor Nail Tint Purple Rage 84 12 Ml,Warehouse A,34,19,2025-02-10 22:10:00,15
22543,ORD_22544,33333,Vexilate Plus 250mg/250mg Tablet,Warehouse C,102,89,2025-02-10 04:49:00,13
22544,ORD_22545,9369,Levonil 500mg Tablet,Warehouse C,72,67,2025-02-10 13:34:00,5
22545,ORD_22546,19543,Comet Busters Maroon Oval Velvet Bindis With Stone (8 mm) (BV1400),Warehouse A,52,33,2025-02-10 21:30:00,19
22546,ORD_22547,26885,"Fashion Colour Jersy Girl Kiss Proof No Transfer Lipstick, 23 Masquerade 2 gm",Warehouse C,17,2,2025-02-10 01:50:00,15
22547,ORD_22548,9449,Glipsov M 20/500 Tablet SR,Warehouse C,87,74,2025-02-10 23:33:00,13
22548,ORD_22549,19607,Belora Paris World Matte Vit C Popsicles - 018 Delhi Diva 4.2 gm,Warehouse B,107,99,2025-02-10 15:28:00,8
22549,ORD_22550,36336,AROPANA USB 2IN1 Audio Adapter External Sound Card USB to Audio 3.5mm Microphone Jack CTIA TRRS [NOT for TV or Car] Stereo...,Warehouse A,9,3,2025-02-10 18:33:00,6
22550,ORD_22551,5981,"AUNO Foldable Laptop Lap Desk, Portable Computer Bed Table Tray with Phone Stand and Cup Holder for Bed/Couch/Sofa Workin...",Warehouse B,41,36,2025-02-10 16:05:00,5
22551,ORD_22552,9289,Casitra 100mg Capsule,Warehouse C,20,7,2025-02-10 22:25:00,13
22552,ORD_22553,33241,Tiflam MR Tablet,Warehouse B,20,4,2025-02-10 01:27:00,16
22553,ORD_22554,15287,Hand Sanitiser Spray,Warehouse A,98,88,2025-02-10 16:03:00,10
22554,ORD_22555,27533,Creative Pebble 2.0 USB-Powered Desktop Speakers with Far-Field Drivers and Passive Radiators for PCs and Laptops (Black),Warehouse C,53,46,2025-02-10 20:35:00,7
22555,ORD_22556,2209,Crucial BX500 480GB 3D NAND SATA 6.35 cm (2.5-inch) SSD (CT480BX500SSD1),Warehouse B,98,79,2025-02-10 08:35:00,19
22556,ORD_22557,15265,Panasonic CR-123AW/1BE Lithium Coin Battery - Pack of 1,Warehouse C,81,69,2025-02-10 16:09:00,12
22557,ORD_22558,27528,GLYSOLID Glycerin Skin Cream 125*2 ml (Pack Of 2),Warehouse A,24,5,2025-02-10 08:31:00,19
22558,ORD_22559,33839,Phy The Shield Pollution Protect Face + Beard Wash 120 Ml,Warehouse C,96,91,2025-02-10 09:57:00,5
22559,ORD_22560,33650,Podoxim 100mg Tablet DT,Warehouse A,25,18,2025-02-10 17:51:00,7
22560,ORD_22561,27913,Zeffcon® - Combo Pack of 10 Pc BNC Connector with Copper Wire Moulded - 18CM and 10 Pc DC Power Pigtail Male Cables with ...,Warehouse B,51,39,2025-02-10 11:20:00,12
22561,ORD_22562,27284,"Ant Esports GM320 Pro Optical Wireless Gaming Mouse with RGB LED Backlit Lighting, 3200 DPI Optical Sensor, Type- C Chargi...",Warehouse A,93,81,2025-02-10 04:43:00,12
22562,ORD_22563,19409,EZVIZ by HIKVISION |2K/4MP QHD Resolution Indoor Smart WiFi Baby/Pet Monitor Camera |Smart Night Vision |360 Visual Covera...,Warehouse C,59,47,2025-02-10 00:58:00,12
22563,ORD_22564,27297,Lenphor Nail Tint Wine-Li-Cious 24 12 Ml,Warehouse B,72,59,2025-02-10 20:21:00,13
22564,ORD_22565,15617,Mxc-LT Eye Drop,Warehouse A,116,97,2025-02-10 12:50:00,19
22565,ORD_22566,26497,SanDisk Ultra Flair 32 GB USB 3.0 Pen Drive (Silver),Warehouse B,52,43,2025-02-10 20:52:00,9
22566,ORD_22567,33974,Ciflox 250mg Tablet,Warehouse A,111,98,2025-02-10 06:18:00,13
22567,ORD_22568,27995,Verolof 100mg Tablet,Warehouse A,38,31,2025-02-10 11:09:00,7
22568,ORD_22569,12377,"WeCool S4 Selfie Stick, Bluetooth Selfie Stick with Light 6 Shades (3 colors and 2 tones), Capture your Photos and Videos ...",Warehouse A,92,85,2025-02-10 13:51:00,7
22569,ORD_22570,5961,Hand Rescue Cream,Warehouse B,16,1,2025-02-10 15:27:00,15
22570,ORD_22571,26374,Faces Canada Ultime Pro Hd Matte Brilliance Pressed Powder Absolute Ivory 01 8 Gm,Warehouse B,28,19,2025-02-10 22:59:00,9
22571,ORD_22572,1509,Odeon Strawberry & Aloe Vera Face And Body Scrub 300 ml,Warehouse A,17,1,2025-02-10 02:42:00,16
22572,ORD_22573,26360,Vu 139 cm (55 inches) The Masterpiece Glo Series 4K Ultra HD Smart Android QLED TV 55QMP (Armani Gold) (2022 Model) | Buil...,Warehouse B,70,60,2025-02-10 03:51:00,10
22573,ORD_22574,27446,Brexcef-AZ Tablet,Warehouse B,20,1,2025-02-10 02:43:00,19
22574,ORD_22575,5972,Robustrion Smart Flexible Trifold Flip Stand Case Cover for iPad Air 5th Generation Cover/iPad Air 4th Generation iPad Air...,Warehouse B,22,16,2025-02-10 02:40:00,6
22575,ORD_22576,12366,Daparay M 10mg/500mg Tablet,Warehouse C,70,54,2025-02-10 05:24:00,16
22576,ORD_22577,15157,TheGiftKart Tough Armor Bumper Back Case Cover for Realme 10 Pro Plus 5G | Ring Holder & Kickstand in-Built | 360 Degree P...,Warehouse A,112,98,2025-02-10 08:12:00,14
22577,ORD_22578,33203,Rabesole 20mg Tablet,Warehouse B,105,99,2025-02-10 07:25:00,6
22578,ORD_22579,5976,Comet Busters Multicolor Round Velvet Bindis With Silver Stones (7mm) (BV1383),Warehouse A,44,33,2025-02-10 04:17:00,11
22579,ORD_22580,26577,Yamipride 50 Tablet,Warehouse A,112,94,2025-02-10 18:08:00,18
22580,ORD_22581,15610,"Rylan Multi-Purpose Sofa Side Height-Adjustable Laptop Table with Docking for Tablet, Study Table, Portable, Ideal for Wor...",Warehouse A,38,27,2025-02-10 11:01:00,11
22581,ORD_22582,5070,Inteworm 200mg Oral Suspension,Warehouse B,79,62,2025-02-10 16:50:00,17
22582,ORD_22583,26538,Secold Syrup,Warehouse B,71,62,2025-02-10 01:12:00,9
22583,ORD_22584,16012,Megarest 5mg Injection,Warehouse C,36,23,2025-02-10 10:11:00,13
22584,ORD_22585,19933,Envie Infinite Plus AA High Capacity (2800mAh) Ni-MH Rechargeable Ready to Use Battery Pack of 2,Warehouse A,75,62,2025-02-10 19:42:00,13
22585,ORD_22586,19393,Night Cream - Helichrysum & Sage Oil,Warehouse B,82,63,2025-02-10 23:14:00,19
22586,ORD_22587,33652,Dclevo Tablet,Warehouse A,49,43,2025-02-10 23:29:00,6
22587,ORD_22588,27324,Amlojack 2.5mg Tablet,Warehouse B,58,50,2025-02-10 22:01:00,8
22588,ORD_22589,16018,RAEGR RapidGear X70 USB Gaming Keyboard and Mouse Set | Made of Aluminium Body | 4 Choices of Adjustable DPI | 3 Rainbow L...,Warehouse B,103,86,2025-02-10 03:10:00,17
22589,ORD_22590,20526,Mefsap D Tablet,Warehouse A,68,57,2025-02-10 21:37:00,11
22590,ORD_22591,34422,Volcanic Green Clay Face Wash,Warehouse C,100,91,2025-02-10 17:34:00,9
22591,ORD_22592,19388,Fast C-Type Charger for OPPO F17 Pro Charger Original Adapter Like Wall Charger | Mobile Charger | Qualcomm QC 3.0 Quick C...,Warehouse B,66,49,2025-02-10 21:06:00,17
22592,ORD_22593,27318,Spurge Tablet,Warehouse A,57,46,2025-02-10 10:47:00,11
22593,ORD_22594,15239,Casapred 4mg Tablet,Warehouse A,24,18,2025-02-10 11:38:00,6
22594,ORD_22595,15294,"Airtel DigitalTV AMF-311WW 150Mbps Single_Band Data Card (Black), 4g Hotspot Support with 2300 Mah Battery",Warehouse B,68,60,2025-02-10 14:02:00,8
22595,ORD_22596,12327,Ofsmith 200mg Tablet,Warehouse B,74,58,2025-02-10 15:49:00,16
22596,ORD_22597,9858,MAYCREATE® 2 Pairs Reusable 3D False Eyelashes Long Natural Look Self-Adhesive Eyelashes Magnetic and Waterproof Fake Eyel...,Warehouse C,68,49,2025-02-10 10:00:00,19
22597,ORD_22598,5072,"Adult Pants Overnight, Extra Large",Warehouse C,63,48,2025-02-10 02:05:00,15
22598,ORD_22599,12310,"pTron Bassbuds Plus True Wireless Bluetooth 5.0 in Ear Earbuds with, Deep Bass, IPX4 Water/Sweat Resistant, Passive Noise ...",Warehouse A,14,4,2025-02-10 19:22:00,10
22599,ORD_22600,19934,"ESR Orbit Hybrid Case with HaloLock Compatible with AirPods Pro (2nd Generation), MagSafe Ready, Hybrid Drop Protection fo...",Warehouse C,66,48,2025-02-10 07:37:00,18
22600,ORD_22601,2185,Cefcon 1000mg Injection,Warehouse B,19,13,2025-02-10 09:22:00,6
22601,ORD_22602,5145,Emeetel H 40mg/12.5mg Tablet,Warehouse A,95,80,2025-02-10 08:28:00,15
22602,ORD_22603,33862,Tolosar-H Tablet,Warehouse A,28,10,2025-02-10 05:41:00,18
22603,ORD_22604,19473,OpenTech® Tempered Glass Screen Protector Compatible for iPhone 12 Mini with Edge to Edge Coverage and Easy Installation kit,Warehouse A,16,10,2025-02-10 10:03:00,6
22604,ORD_22605,33859,Wei International Silicone Band Strap Belt for Realme Smart Band RMA183 (Tracker Not Included),Warehouse A,30,15,2025-02-10 09:11:00,15
22605,ORD_22606,5844,Morniff 10mg/10mg Tablet,Warehouse C,99,94,2025-02-10 12:40:00,5
22606,ORD_22607,2181,"Duracell Ultra Alkaline AAA Battery, 12 Pcs",Warehouse C,78,61,2025-02-10 14:21:00,17
22607,ORD_22608,33202,Ajmal Nightingale & Distraction & Persuade Deo & Ascend EDP Pack of 3 20 ml,Warehouse C,48,29,2025-02-10 02:55:00,19
22608,ORD_22609,9522,Amozo Ultra Hybrid Camera Protection Matte Back Case Cover for iPhone 11 6.1 (Poly Carbonate TPU|Black),Warehouse B,50,31,2025-02-10 21:29:00,19
22609,ORD_22610,5997,Spigen Ultra Hybrid Back Cover Case Compatible with iPhone 14 (TPU + Poly Carbonate | Sierra Blue),Warehouse A,111,97,2025-02-10 12:28:00,14
22610,ORD_22611,26447,Glygard M 80 mg/500 mg Tablet,Warehouse C,22,3,2025-02-10 22:26:00,19
22611,ORD_22612,12057,New Edition i7 Pro Max All in One Series 7 Smart Watch with Fitness Tracker Heart Monitor Men Women Smart Watch Black,Warehouse B,80,71,2025-02-10 11:37:00,9
22612,ORD_22613,19837,Pierre Cardin Paris - Porcelain Edition Blush On 760-Mocha,Warehouse A,90,79,2025-02-10 22:20:00,11
22613,ORD_22614,26445,"QOCXRRIN USB Type C OTG Adapter USB Mouse, Pendrive Connector & 2in1 OTG Adapter, USB 3.0 Female to Micro-USBConnector Alu...",Warehouse B,77,68,2025-02-10 14:34:00,9
22614,ORD_22615,33785,Amazon Brand - Solimo Back Cover for iphone 12 Mini (TPU | Transparent),Warehouse C,99,80,2025-02-10 03:32:00,19
22615,ORD_22616,15195,Febuxat 80mg Tablet,Warehouse C,54,35,2025-02-10 03:19:00,19
22616,ORD_22617,34455,Hair Oil For Dandruff Free Hair,Warehouse A,96,79,2025-02-10 12:56:00,17
22617,ORD_22618,33211,Caten 250mg Capsule,Warehouse A,90,79,2025-02-10 01:44:00,11
22618,ORD_22619,5942,Fexonem 30mg Oral Suspension,Warehouse C,74,68,2025-02-10 11:22:00,6
22619,ORD_22620,5047,"FUR JADEN 15.6 Inch Smart Laptop Backpack Bag With USB Charging Port, Anti Theft Pocket and Accessories Organiser for Men ...",Warehouse B,103,86,2025-02-10 03:27:00,17
22620,ORD_22621,9585,Fibocold Oral Suspension,Warehouse A,106,98,2025-02-10 22:17:00,8
22621,ORD_22622,9586,TheGiftKart Shockproof Crystal Clear Back Cover Case for Redmi Note 8 Pro | 360 Degree Protection | Protective Design | Tr...,Warehouse B,105,96,2025-02-10 02:31:00,9
22622,ORD_22623,28035,Voglian 0.3mg Tablet,Warehouse C,98,89,2025-02-10 00:12:00,9
22623,ORD_22624,34492,Beauty People Pure Matte Lipstick - Pop - Pink - 405 3.8 gm,Warehouse B,22,9,2025-02-10 17:26:00,13
22624,ORD_22625,27450,Mothercare Quick Absorb Diaper Pants (S) 74's,Warehouse A,91,84,2025-02-10 18:00:00,7
22625,ORD_22626,26377,Fashion Colour Intense Blue Revolving Kajal 0.35 gm,Warehouse A,95,80,2025-02-10 13:18:00,15
22626,ORD_22627,11848,Ajmal Persuade & Nightingale Deo & Neea EDP Of Pack of 3 20 ml,Warehouse A,93,77,2025-02-10 02:33:00,16
22627,ORD_22628,15321,Azis Suspension,Warehouse C,36,30,2025-02-10 05:35:00,6
22628,ORD_22629,11909,Nimlodi 200mg Tablet,Warehouse A,65,54,2025-02-10 00:23:00,11
22629,ORD_22630,11902,"Saifsmart Outlet Wall Mount Hanger Holder for Dot 3rd Gen, Compact Bracket Case Plug and Built-in Cable Management for Kit...",Warehouse B,62,54,2025-02-10 15:45:00,8
22630,ORD_22631,20180,"SARA Oxy D-TAN® Scrub For Instant Tan Removal and dead skin remover For Women, Men (175 gm) | De-Tan For All Skin Types",Warehouse B,28,14,2025-02-10 09:59:00,14
22631,ORD_22632,19596,Acno Fight Pimple Clearing Whitening Cream,Warehouse B,109,91,2025-02-10 06:10:00,18
22632,ORD_22633,20199,Team Office Replacement Cable for Fingerprint Scanner - Morpho MSO 1300 e/e2/e3(USB) - Black,Warehouse A,15,9,2025-02-10 18:45:00,6
22633,ORD_22634,5647,Sounce Shutter Remote Control with Bluetooth Wireless Technology - Create Amazing Photos and Videos Hands-Free - Works wit...,Warehouse C,24,19,2025-02-10 07:00:00,5
22634,ORD_22635,2080,Super Immuno Amla & Vitamin-C Immunity Booster Gummies For Kids,Warehouse C,38,24,2025-02-10 10:24:00,14
22635,ORD_22636,26088,XX Revolutionfine micro brow pencil deep black 0.1 gm,Warehouse B,61,50,2025-02-10 20:11:00,11
22636,ORD_22637,15865,"Portronics AUTO 17 in-Car Bluetooth Receiver for Handsfree Calling, Music System, Supports All Smartphones (Black)",Warehouse A,97,89,2025-02-10 01:19:00,8
22637,ORD_22638,19731,Xonmed 250mg Injection,Warehouse A,41,30,2025-02-10 04:57:00,11
22638,ORD_22639,15204,"2.Oh! Lightning Kit: At-Home Hair Bleach Kit with Plex, Argan Oil & Comfort Fragrance Technology that helps Prevents Hair ...",Warehouse B,97,80,2025-02-10 05:31:00,17
22639,ORD_22640,5827,Lakme True Wear Nail Color Shade D415 9 Ml,Warehouse A,90,84,2025-02-10 16:06:00,6
22640,ORD_22641,11859,Fujifilm Instax Mini 9 Instant Camera (Smokey White),Warehouse B,48,40,2025-02-10 11:02:00,8
22641,ORD_22642,27410,"HP w200 HD 720P 30 FPS Digital Webcam with Built-in Mic, Plug and Play Setup, Wide-Angle View for Video Calling on Skype, ...",Warehouse C,29,17,2025-02-10 07:56:00,12
22642,ORD_22643,19338,Xoclave 625 Tablet,Warehouse C,96,77,2025-02-10 23:31:00,19
22643,ORD_22644,20545,Para 250mg/5ml Syrup,Warehouse B,98,83,2025-02-10 08:42:00,15
22644,ORD_22645,33710,Rice Water Bright Light Cleansing Oil,Warehouse B,11,3,2025-02-10 12:24:00,8
22645,ORD_22646,33750,"Foot Pumice Paddle - Rose Pink, Colour May Vary",Warehouse C,78,61,2025-02-10 22:45:00,17
22646,ORD_22647,2245,Nolcer-D 10mg/20mg Capsule,Warehouse C,101,96,2025-02-10 16:51:00,5
22647,ORD_22648,26295,"Clensta Lush Lip, Cheek & Eye Tint – Candy Cane| 5 gm| With Red Aloe Vera and Jojoba Oil| Better Lip Tone and Soft Textur...",Warehouse C,13,5,2025-02-10 12:50:00,8
22648,ORD_22649,1927,Ajmal Blu Dreams & Maryaj Directioneast Bundle Of 2 EDP 200 ml,Warehouse A,35,26,2025-02-10 09:16:00,9
22649,ORD_22650,26293,Perfume Body Spray - Storm,Warehouse C,46,33,2025-02-10 20:28:00,13
22650,ORD_22651,12065,Fixty 40mg Tablet,Warehouse B,75,65,2025-02-10 17:44:00,10
22651,ORD_22652,15130,Vosnac SP 50mg/325mg/15mg Tablet,Warehouse C,12,3,2025-02-10 08:17:00,9
22652,ORD_22653,15676,"Fashion Colour Kiss Lip No Transfer Lipstick, 83 Conch Shell 2.6 gm",Warehouse C,59,54,2025-02-10 17:45:00,5
22653,ORD_22654,6008,Miss Claire Eyebrow Stix - Brown 1.14 Gm,Warehouse C,81,66,2025-02-10 04:00:00,15
22654,ORD_22655,9186,Zocare 400mg Tablet,Warehouse C,113,99,2025-02-10 19:41:00,14
22655,ORD_22656,26280,Kcef 1000mg Injection,Warehouse B,27,13,2025-02-10 01:11:00,14
22656,ORD_22657,12338,Hello Zone Exclusive Matte Finish Soft Back Case Cover for Motorola Moto G72 - Black,Warehouse B,15,2,2025-02-10 13:39:00,13
22657,ORD_22658,33716,Ajmal 2 Nightingale & Persuade Deodorant Pack of 3 Deodorants 200 ml,Warehouse B,83,72,2025-02-10 05:56:00,11
22658,ORD_22659,28037,Luka 5mg/10mg Tablet,Warehouse C,25,17,2025-02-10 20:56:00,8
22659,ORD_22660,1951,Spigen Liquid Air Back Cover Case for Samsung Galaxy S23 (TPU | Matte Black),Warehouse C,60,49,2025-02-10 22:17:00,11
22660,ORD_22661,5959,Revolution Pro Supreme Pigment Dip Eyeliner-Black 3 ml,Warehouse B,94,89,2025-02-10 19:33:00,5
22661,ORD_22662,12087,Glypar PM 1mg/500mg/15mg Tablet,Warehouse A,98,87,2025-02-10 19:21:00,11
22662,ORD_22663,33656,"Duracell Micro USB 3A Braided Sync & Fast Charging Cable, 3.9 Feet (1.2M). Supports QC 2.0/3.0 Charging, High Speed Data T...",Warehouse C,24,10,2025-02-10 02:09:00,14
22663,ORD_22664,9866,Deximon P Eye Ointment,Warehouse A,11,3,2025-02-10 18:06:00,8
22664,ORD_22665,1560,Ajmal Prose EDP & Distraction Deodorant Pack of 2 300 ml,Warehouse B,106,94,2025-02-10 18:47:00,12
22665,ORD_22666,33794,Nandika Beauty Facial Gel - Papaya 500 gm,Warehouse B,43,37,2025-02-10 20:34:00,6
22666,ORD_22667,27484,Redmi Note 12 5G Matte Black 4GB RAM 128GB ROM | 1st Phone with 120Hz Super AMOLED and Snapdragon® 4 Gen 1 | 48MP AI Tripl...,Warehouse C,34,16,2025-02-10 00:03:00,18
22667,ORD_22668,27997,Omnes D 10mg/20mg Capsule,Warehouse B,68,50,2025-02-10 23:50:00,18
22668,ORD_22669,28001,"Miss rose Full Cover Eye Dark Circle Brighten Liquid Concealer, beige, 7 ml",Warehouse C,50,37,2025-02-10 14:50:00,13
22669,ORD_22670,1899,Bella Voste Liquid Dip Eyeliner Soft Snow (02) 4 Ml,Warehouse B,98,91,2025-02-10 07:47:00,7
22670,ORD_22671,13861,Tattoo Gizmo Inkless Blank Practice Skin- Small(Pack of 10),Warehouse A,57,44,2025-02-10 11:18:00,13
22671,ORD_22672,34144,"EDYELL ENC C9 Wireless Earbuds Noise Cancellation with 4-Mic Clear Call,13mm Powerful Bass Drivers, 48+ Hours of Playtime,...",Warehouse B,16,9,2025-02-10 20:14:00,7
22672,ORD_22673,23995,Regdol P 100mg/325mg Tablet,Warehouse C,21,9,2025-02-10 10:45:00,12
22673,ORD_22674,13223,Zunix 100mg Dry Syrup,Warehouse A,78,71,2025-02-10 17:13:00,7
22674,ORD_22675,293,Jasvast 20mg Tablet,Warehouse B,33,25,2025-02-10 04:47:00,8
22675,ORD_22676,13206,"Kera XL Hair Growth Serum, 60 ml, Strengthens, Protects and Anchors Hair",Warehouse B,109,99,2025-02-10 04:34:00,10
22676,ORD_22677,23739,T Gad 20mg Tablet,Warehouse A,103,92,2025-02-10 06:43:00,11
22677,ORD_22678,36565,RUSHIL WERE Wall Holder with Mobile Charging Point/Stationary Storage/Bathroom qacceceries/Remote Holder/makup Brush Holde...,Warehouse B,50,34,2025-02-10 01:08:00,16
22678,ORD_22679,36556,Maryaj M White For Her EDP Floral Fruity Perfume And Ajmal Wisal Deodorant Floral Musky Fragrance 290 ml,Warehouse A,53,40,2025-02-10 02:27:00,13
22679,ORD_22680,22487,Menac Plus 100mg/500mg/15mg Tablet,Warehouse A,78,73,2025-02-10 05:43:00,5
22680,ORD_22681,304,Ronyglim 1mg Tablet,Warehouse A,111,96,2025-02-10 09:17:00,15
22681,ORD_22682,329,Amazon Brand - Solimo Back Cover Case for Samsung Galaxy M51 | Compatible for Samsung Galaxy M51 Back Cover Case | 360 Deg...,Warehouse C,55,39,2025-02-10 11:06:00,16
22682,ORD_22683,13160,Speraflox 250mg Tablet,Warehouse C,79,63,2025-02-10 18:33:00,16
22683,ORD_22684,36505,Allure Buffer Brush ( Stippling Brush C-25) 1's,Warehouse A,87,71,2025-02-10 20:52:00,16
22684,ORD_22685,22457,Reequil Vitamin C Face Toner 100 ml,Warehouse A,63,47,2025-02-10 22:28:00,16
22685,ORD_22686,36709,Redgear A-20 Wired Gaming Mouse with RGB and Upto 4800 dpi for Windows PC Gamers.,Warehouse B,12,4,2025-02-10 23:50:00,8
22686,ORD_22687,228,Knowrab D 30mg/20mg Capsule SR,Warehouse A,33,19,2025-02-10 13:47:00,14
22687,ORD_22688,23433,Oflin TZ 200mg/600mg Tablet,Warehouse C,64,54,2025-02-10 05:24:00,10
22688,ORD_22689,13619,Ajmal Sacred Love & Raindrops & Wisal Deo & Ascend EDP Pack of 3 20 ml,Warehouse A,106,90,2025-02-10 21:23:00,16
22689,ORD_22690,7607,Taloswift-Lite 0.25mg/10mg Tablet,Warehouse A,25,14,2025-02-10 15:12:00,11
22690,ORD_22691,146,Purearth Rose & Seabuck Replenishing Face Cream - (15 ml),Warehouse B,102,96,2025-02-10 22:26:00,6
22691,ORD_22692,13259,Halixim 200mg Tablet,Warehouse B,86,77,2025-02-10 10:20:00,9
22692,ORD_22693,151,"Zorbes ® Charging Adapter 2.5Mm Jack Cable Usb To Dc 2.5Mm To Usb Charging Cable For Toy, Beauty Product, Magic Mate, White",Warehouse A,77,67,2025-02-10 16:18:00,10
22693,ORD_22694,23475,CASEOLOGY by Spigen Skyfall Back Cover Case Compatible For iPhone 14 (TPU and Polycarbonate|Sky Blue),Warehouse C,92,86,2025-02-10 10:46:00,6
22694,ORD_22695,23494,Multivitamin Glowing Skin Soap,Warehouse B,16,11,2025-02-10 02:37:00,5
22695,ORD_22696,7576,Neurobion Plus Injection,Warehouse B,46,36,2025-02-10 16:50:00,10
22696,ORD_22697,22638,"Blue Heaven 2X intense Kajal, Black Shock 0.35 gm",Warehouse B,87,79,2025-02-10 03:17:00,8
22697,ORD_22698,155,"Storite 1.5M 90 Degree L Shape 3 Pin PC Power Cable IEC Mains Kettle Lead Replacement Cord for Desktop, Monitor & Printer...",Warehouse A,80,70,2025-02-10 20:10:00,10
22698,ORD_22699,23576,Soulflower Essential Oil Turmeric 15 ml,Warehouse A,18,13,2025-02-10 18:30:00,5
22699,ORD_22700,8109,"Noise_Replacement USB Charging Cable for Noise ColorFit Pro 3 / Pro 2 / Pro 2 Oxy/Pulse/Ultra/Nav, Nav+ / Brio/NoiseFit Ac...",Warehouse A,79,68,2025-02-10 19:08:00,11
22700,ORD_22701,8082,Ajmal 2 Shadow Him And 2 Distraction Deodorants Pack of 4 200 ml,Warehouse C,68,58,2025-02-10 20:27:00,10
22701,ORD_22702,36602,"SYSKA Power Bank 10000mah | 6 Months Warranty | Powerbank, Battery Bank, Quick Charging 18W P1029J Power Bank with High-En...",Warehouse A,52,39,2025-02-10 05:33:00,13
22702,ORD_22703,36616,Casio HL-815L Portable Calculator,Warehouse B,12,1,2025-02-10 05:42:00,11
22703,ORD_22704,262,42k Deodorant Roll On,Warehouse B,65,54,2025-02-10 17:35:00,11
22704,ORD_22705,23144,"EvoFox Elite Ops Wireless Gamepad for Android TV, PC (X Input) and PS3 | 8+ Hours of Play Time | Zero Lag Connectivity Upt...",Warehouse A,76,66,2025-02-10 15:20:00,10
22705,ORD_22706,7895,"BenQ GW2480T 24 inch (60cm) 1920 X 1080 Pixels IPS Full HD Ultra-Slim Bezel Monitor- Height Adjustment, Eye Care, Anti-Gla...",Warehouse A,104,96,2025-02-10 13:06:00,8
22706,ORD_22707,23051,Olumpil OZ Oral Suspension,Warehouse C,54,41,2025-02-10 01:06:00,13
22707,ORD_22708,37089,"Colorbar Cosmetics Sindoor, Maroon, 3.8 ml",Warehouse B,47,33,2025-02-10 13:04:00,14
22708,ORD_22709,13419,EDT Do It,Warehouse A,40,27,2025-02-10 05:39:00,13
22709,ORD_22710,23072,SupCares Edge to Edge Tempered Glass for Google Pixel 7 (6.3 Inch) with Easy Self Installation Kit | Black,Warehouse B,42,24,2025-02-10 11:40:00,18
22710,ORD_22711,38,Xdine 120mg Tablet,Warehouse A,26,20,2025-02-10 19:29:00,6
22711,ORD_22712,36983,"Portronics Auto 20 Smart Audio Connector with Mobile Charger(Type C + QC 3.0), Latest Bluetooth 5.1, 30W Output, Handsfree...",Warehouse B,22,3,2025-02-10 05:52:00,19
22712,ORD_22713,37086,Neem Tulsi & Aloe Vera Soap,Warehouse B,103,97,2025-02-10 04:51:00,6
22713,ORD_22714,37082,OJOS M2 Chip Anti Scratch & Fingerprint-Proof Screen Guard Film Matte Screen Protector Compatible for 2016-2022 MacBook Pr...,Warehouse A,71,54,2025-02-10 00:30:00,17
22714,ORD_22715,13334,Ajmal 2 Aurum & 2 Wisal Dhahab Deo & Neea EDP Pack of 5 20 ml,Warehouse B,72,53,2025-02-10 21:34:00,19
22715,ORD_22716,23140,Clindacript C 300mg Capsule,Warehouse C,98,86,2025-02-10 21:50:00,12
22716,ORD_22717,23699,Storite 3.5mm Jack 1 Male to 2 Female Stereo Headphone Earphone Jack Y Splitter Audio Auxiliary Adapter Cable (Black),Warehouse A,43,25,2025-02-10 10:36:00,18
22717,ORD_22718,7945,Elpam Injection,Warehouse B,74,63,2025-02-10 15:12:00,11
22718,ORD_22719,7947,Nails On Board Handmade Press On Gel Nails- Holographic Pink Free size 50 gm,Warehouse C,104,99,2025-02-10 15:48:00,5
22719,ORD_22720,13473,"Maybelline New York Dream Matte Mousse Foundation, Classic Ivory, 18g",Warehouse B,34,17,2025-02-10 08:33:00,17
22720,ORD_22721,7639,"Triphala - 500 mg, Potent Extracts",Warehouse B,50,40,2025-02-10 16:12:00,10
22721,ORD_22722,36872,"Samsung 24-inch (60.46cm) 1920 X 1080 Pixels FHD Monitor, IPS, 75 Hz, Bezel Less Design, AMD FreeSync, Flicker Free, HDMI,...",Warehouse A,67,54,2025-02-10 06:41:00,13
22722,ORD_22723,340,Vector Plus - Manual Shaving Razor,Warehouse A,87,73,2025-02-10 11:24:00,14
22723,ORD_22724,23719,Amazon Brand - Solimo Thermoplastic Polyurethane Back Cover For Realme XT (Transparent),Warehouse A,91,72,2025-02-10 23:43:00,19
22724,ORD_22725,13682,Stress Relief Essential Oil,Warehouse A,40,34,2025-02-10 18:32:00,6
22725,ORD_22726,23668,Serenit 20mg Tablet,Warehouse B,54,42,2025-02-10 04:01:00,12
22726,ORD_22727,7481,"ProElite Slim Trifold Flip case Cover for Xiaomi Mi Pad 5 11"" Tablet, Hippy",Warehouse C,53,48,2025-02-10 19:38:00,5
22727,ORD_22728,23685,Cloterite Cream,Warehouse C,35,26,2025-02-10 17:04:00,9
22728,ORD_22729,23689,Miss Claire Ultimate Wear Foundation - 21 Cream Beige,Warehouse B,39,20,2025-02-10 23:30:00,19
22729,ORD_22730,186,cablebasket Mobile Charger for Android Phones 3 USB 3.1a Amper Smart ic USB Universal Compatible Mobile Wall Charger Adapt...,Warehouse B,118,99,2025-02-10 23:04:00,19
22730,ORD_22731,8092,"Fashion Colour Non - Transfer Matt Waterproof Lipstick, 58 Fuchsia 2.6 gm",Warehouse A,28,20,2025-02-10 23:10:00,8
22731,ORD_22732,17,Newtap 50mg Tablet,Warehouse B,83,74,2025-02-10 12:29:00,9
22732,ORD_22733,13653,Metarub Lotion,Warehouse C,51,43,2025-02-10 04:29:00,8
22733,ORD_22734,12528,Vega Deer Foot (PB - 12) 22 gm,Warehouse C,46,27,2025-02-10 12:31:00,19
22734,ORD_22735,21203,Mamaearth Onion Hair Mask 200 gm,Warehouse A,105,91,2025-02-10 21:16:00,14
22735,ORD_22736,6492,Fogg Fragrance Deo Wm Essence 150 Ml,Warehouse A,20,7,2025-02-10 01:17:00,13
22736,ORD_22737,14597,"Deborah Milano Nail Gel Effect, Cherry Tree, 8.5ml",Warehouse B,60,44,2025-02-10 05:52:00,16
22737,ORD_22738,14621,Cetley 2.5mg Syrup,Warehouse C,37,28,2025-02-10 13:37:00,9
22738,ORD_22739,1089,NOTE LUMINOUS SILK QUATTRO EYESHADOW 03 6 gm,Warehouse B,55,41,2025-02-10 22:29:00,14
22739,ORD_22740,35252,Ibuprom-MF Oral Suspension,Warehouse C,95,84,2025-02-10 00:07:00,11
22740,ORD_22741,1097,MAYCREATE® Makeup Brush Holder Bag Portable Travel Makeup Organizer Bag Foldable Zipper Cosmetic Makeup Brush Pouch Storag...,Warehouse B,47,28,2025-02-10 13:10:00,19
22741,ORD_22742,35215,"Nokia C12 Android 12 (Go Edition) Smartphone, All-Day Battery, 4GB RAM (2GB RAM + 2GB Virtual RAM) + 64GB Capacity | Charcoal",Warehouse B,8,2,2025-02-10 13:48:00,6
22742,ORD_22743,12654,Daily Life Forever52 Velvet Rose Matte Lipstick Rs020 2.5 gm,Warehouse C,31,25,2025-02-10 11:51:00,6
22743,ORD_22744,21218,"SUGAR Cosmetics - Aquaholic Clarifying Spot Gel - Tackles Spots and Blemishes, Prevents Acne",Warehouse A,106,93,2025-02-10 15:45:00,13
22744,ORD_22745,8870,Nutriment Wine and Beer Cream All Skin Type 250 gm,Warehouse B,77,71,2025-02-10 19:16:00,6
22745,ORD_22746,25480,"Tukzer (Imported) Laptop Tabletop Stand Notebook Riser, 6 Level Height Angle Adjustment, 2X Stronger M-Shape Aluminum, Sil...",Warehouse C,28,17,2025-02-10 21:17:00,11
22746,ORD_22747,6422,"QZ USB 3.1 Type C Hub, USB C Hub, USB Type C to Ethernet Adapter, Type C to LAN RJ45, USB C to Ethernet Adapter [Thunderbo...",Warehouse C,73,57,2025-02-10 10:02:00,16
22747,ORD_22748,25489,Aesicef 1000mg/500mg Injection,Warehouse A,107,98,2025-02-10 15:30:00,9
22748,ORD_22749,6418,Storax 250mg Injection,Warehouse A,64,47,2025-02-10 07:35:00,17
22749,ORD_22750,8896,Clovell 0.25mg Tablet,Warehouse A,40,24,2025-02-10 01:25:00,16
22750,ORD_22751,35144,Ajmal Zeal EDP Aquatic Woody Perfume And Blu Dreams EDP Citurs Fruity Perfume 200 ml,Warehouse C,83,78,2025-02-10 16:53:00,5
22751,ORD_22752,8899,Oriflame COLOURBOX Semi-Matte Lipstick Caramel Burst,Warehouse A,20,10,2025-02-10 03:14:00,10
22752,ORD_22753,6395,Zefax 100mg Tablet,Warehouse A,20,2,2025-02-10 01:25:00,18
22753,ORD_22754,8903,KABEER ART Set of 15 Paint Brushes of Various Sizes and Varieties for Painting – Bristle Brushes and Foam Brushes,Warehouse A,100,92,2025-02-10 05:07:00,8
22754,ORD_22755,35128,Effibol 25mg Injection,Warehouse B,110,96,2025-02-10 20:55:00,14
22755,ORD_22756,25561,Frackson Combo U-Shape Nose up & Purple Nose Up Clip Shaping Lifting Bridge Straightening Nose Up Beauty Clip High Lifting...,Warehouse C,105,88,2025-02-10 05:44:00,17
22756,ORD_22757,34896,"Fashion Colour Professional Makeup Kit, 977 - 15 - 3 29.4 gm",Warehouse A,77,72,2025-02-10 07:53:00,5
22757,ORD_22758,14898,Ajmal Amber Magic EDP Spicy Aromatic Perfume 100ml for Men and Raindrops EDP Floral Chypre Perfume 50ml for Women +1 Perfu...,Warehouse C,65,58,2025-02-10 23:18:00,7
22758,ORD_22759,35977,"Wayona Type C to Lightning MFI Certified 20W Fast charging Nylon Braided USB C Cable for iPhone 14 Pro,14 Pro Max,14,14 Pl...",Warehouse B,65,59,2025-02-10 11:25:00,6
22759,ORD_22760,6081,Cinz 100mg Injection,Warehouse B,12,5,2025-02-10 17:14:00,7
22760,ORD_22761,22275,Clavsar 500mg/125mg Tablet,Warehouse A,55,37,2025-02-10 17:46:00,18
22761,ORD_22762,4983,Dove Rose Soothing And Aloe Vera Body Wash 1000ml,Warehouse B,82,72,2025-02-10 23:15:00,10
22762,ORD_22763,14705,Favonix 200mg Tablet,Warehouse A,22,16,2025-02-10 15:04:00,6
22763,ORD_22764,8998,"boAt A 350 Type C Cable for Personal Computer, 1.5m (Black)",Warehouse C,91,85,2025-02-10 07:20:00,6
22764,ORD_22765,21090,Skin Gel - Under Eye,Warehouse C,33,25,2025-02-10 10:52:00,8
22765,ORD_22766,36740,Comet Busters Handcrafted Red and Maroon Velvet Tilak Bindis (30mm) (BV1810),Warehouse C,96,86,2025-02-10 04:13:00,10
22766,ORD_22767,217,Portronics Auto 16 Bluetooth 5.1 Smart Audio Connector/Transmitter 3.5mm for TV/Desktop with Type-C Charging(Black),Warehouse A,34,22,2025-02-10 14:14:00,12
22767,ORD_22768,7509,"Body Bath Loofah/Sponge/Scrubber - Dual Sided, Hangable, BB1427, Cream",Warehouse A,96,88,2025-02-10 01:48:00,8
22768,ORD_22769,13211,"Aromatique Rosemary Essential Oil For Hair Growth,Skin and Body 100% Pure and Natural Therapeutic Grade (30ml)",Warehouse A,19,4,2025-02-10 07:05:00,15
22769,ORD_22770,36000,"boAt Xtend/Xtend RTL Smartwatch with Alexa Built-in, 1.69” HD Display, Multiple Watch Faces, Stress Monitor, Heart & SpO2 ...",Warehouse C,45,26,2025-02-10 23:49:00,19
22770,ORD_22771,8500,Ajmal Shadow Homme & Sacrificeiihim & Carbon & Avid Deo & Prose EDP Pack of 5 20 ml,Warehouse A,57,47,2025-02-10 05:20:00,10
22771,ORD_22772,35990,Vision Perfume Deodorant For Men,Warehouse C,51,44,2025-02-10 04:41:00,7
22772,ORD_22773,1232,Tommy Hilfiger Joshua 15 inch 21 Ltrs Light Grey Laptop Backpack (TH/JOSHUALAP07),Warehouse B,29,13,2025-02-10 12:11:00,16
22773,ORD_22774,35049,St. Ives Pink Lemon & Mandarin Orange Exfoliating Body Wash 16 Fl Ounces,Warehouse C,81,63,2025-02-10 05:03:00,18
22774,ORD_22775,12604,AirCase AP-HDC External Hard Drive Case for 2.5-Inch Hard Drive (Gray),Warehouse A,36,28,2025-02-10 19:49:00,8
22775,ORD_22776,1213,Face Wash - Bio White Advanced Fairnessface Wash,Warehouse B,107,98,2025-02-10 03:48:00,9
22776,ORD_22777,14773,"Boult Audio Truebuds with 30H Playtime, IPX7 Waterproof, Made in India, Type C Fast Charging (10Min=100Mins), Rich Bass, P...",Warehouse A,101,95,2025-02-10 08:42:00,6
22777,ORD_22778,14860,Syga Portable Small Photo Studio Light Box Folding Photography Lighting Tent Kit With Backdrops 23cm*23cm*23cm,Warehouse C,44,30,2025-02-10 08:18:00,14
22778,ORD_22779,25725,Zenesta 2 Tablet SR,Warehouse C,41,27,2025-02-10 13:56:00,14
22779,ORD_22780,25726,Fujifilm Instax Mini 9 Instant Camera (Ice Blue) & Fujifilm Instax Mini Single Pack 10 Sheets Instant Film for Fuji Instan...,Warehouse B,23,9,2025-02-10 10:10:00,14
22780,ORD_22781,14787,Rosicon 4mg Tablet,Warehouse C,69,61,2025-02-10 13:45:00,8
22781,ORD_22782,14811,Atovib 20 Tablet,Warehouse A,110,94,2025-02-10 20:20:00,16
22782,ORD_22783,6366,Manish Malhotra Antimicrobial Sanitizing Spray 200 Ml,Warehouse A,82,75,2025-02-10 15:51:00,7
22783,ORD_22784,25741,SeCro Type-C USB 3.1 Super Speed Multi Function Card Reader [Black],Warehouse C,72,54,2025-02-10 05:00:00,18
22784,ORD_22785,8959,Easevert 24 Tablet,Warehouse B,55,44,2025-02-10 08:26:00,11
22785,ORD_22786,21039,Cipol 250mg Tablet,Warehouse B,58,48,2025-02-10 04:19:00,10
22786,ORD_22787,34959,Revolution Skincare Pink Glitter Face Off Mask 50 ml,Warehouse A,50,41,2025-02-10 02:44:00,9
22787,ORD_22788,34954,Vega Set Of 6 Comb (HCS - 03) 161 gm,Warehouse B,108,97,2025-02-10 07:11:00,11
22788,ORD_22789,8977,WOW IMAGINE Shock Proof Flip Cover Back Case Cover Compatible with Apple iPhone 7 Plus | 8 Plus (Flexible | Leather Finish...,Warehouse B,13,2,2025-02-10 01:05:00,11
22789,ORD_22790,25796,"Creative Pebble Plus 2.1 USB-Powered Desktop Speakers with Powerful Down-Firing Subwoofer and Far-Field Drivers, 8W RMS wi...",Warehouse A,80,62,2025-02-10 13:08:00,18
22790,ORD_22791,20965,Xoneden SB 250mg/125mg Injection,Warehouse A,48,32,2025-02-10 15:13:00,16
22791,ORD_22792,23604,"Zayn & Myza Transfer - Proof Power Matte Lip Color, Candid Coral 6 ml",Warehouse C,70,64,2025-02-10 01:53:00,6
22792,ORD_22793,23001,Ajmal Silver Shade EDP Citrus Woody Perfume And Wisal Dhahab Deodorant Fruity Floral Fragrance 300 ml,Warehouse C,77,59,2025-02-10 21:10:00,18
22793,ORD_22794,653,Dexolam 0.25mg Tablet,Warehouse B,69,63,2025-02-10 11:16:00,6
22794,ORD_22795,36438,"M.G.R.J® Tempered Glass Screen Protector for Lenovo Tab M10 HD 2nd Gen (TB-X306F / X306X) (10.1"" inch)",Warehouse A,89,71,2025-02-10 22:26:00,18
22795,ORD_22796,7312,Codoric 4 mg/10 mg Syrup,Warehouse B,90,74,2025-02-10 05:44:00,16
22796,ORD_22797,8219,Metlife 500mg Tablet SR,Warehouse B,14,6,2025-02-10 13:50:00,8
22797,ORD_22798,23895,"RAS Luxury Oils Lush Lips Hydrating & Nourishing Lip Mask | Cocoa Butter & Shea Butter | Nourish, Heal & soften Lips | Red...",Warehouse B,100,93,2025-02-10 15:05:00,7
22798,ORD_22799,7353,Nzm 5mg Tablet,Warehouse C,79,66,2025-02-10 01:55:00,13
22799,ORD_22800,13831,Ciprodal-TZ 500mg/600mg Tablet,Warehouse A,91,77,2025-02-10 16:44:00,14
22800,ORD_22801,23920,Stanflox OZ 200 mg/200 mg Tablet,Warehouse A,55,39,2025-02-10 20:39:00,16
22801,ORD_22802,8237,Ajmal 2 Evoke Silver Edition For Him And 2 Magnetize Deodorants Pack of 4 200 ml,Warehouse B,99,82,2025-02-10 08:48:00,17
22802,ORD_22803,23931,Tabelito® Basic Laptop Bag Sleeve Case Cover Padded Pouch for 13-14 Inches laptops Multi Pocket Accessories MacBook/Dell/L...,Warehouse B,89,83,2025-02-10 16:25:00,6
22803,ORD_22804,23939,"ADS Green Tea Matte Lipstick Set of 12 (Multicolour), Ads Non-Smudging Green Tea Set Of 12 Lipstick For Girls And Women, A...",Warehouse B,12,7,2025-02-10 00:36:00,5
22804,ORD_22805,13850,Acer 109 cm (43 inches) H Series 4K Ultra HD Android Smart LED TV AR43AR2851UDPRO (Black),Warehouse B,76,62,2025-02-10 05:29:00,14
22805,ORD_22806,22188,Tono FX 10mg/120mg Tablet,Warehouse A,54,41,2025-02-10 11:23:00,13
22806,ORD_22807,13048,Mepride 3mg Tablet,Warehouse C,47,33,2025-02-10 00:10:00,14
22807,ORD_22808,36483,Oboe Silicone Full Wrap RMF-TX520P Remote Case for Sony Smart Tv Voice Remote A80J X80J X85J X90J X95J Shockproof Protecti...,Warehouse A,64,50,2025-02-10 01:57:00,14
22808,ORD_22809,24450,Genericart Telmisartan 40mg Tablet,Warehouse A,102,87,2025-02-10 20:19:00,15
22809,ORD_22810,36091,OJOS Screen Protector Film for MacBook Air 13 Model A2337 M1 A2179 A1932 A2337 MacBook Pro 13 Inch A2338 A2289 A2251 A2159...,Warehouse A,103,95,2025-02-10 09:34:00,8
22810,ORD_22811,36090,"Mi Extended Warranty (1year) - Brand Authorised Plan for Mi TV Between 13999-19999(Email Delivery, No Physical Kit)",Warehouse A,13,3,2025-02-10 11:12:00,10
22811,ORD_22812,7066,"Safari Crew Overnighter Backpack, 40 Ltr Water Resistant Travel Laptop Bag, Black Polyester Backpack for Men and Women, Sp...",Warehouse C,21,16,2025-02-10 23:11:00,5
22812,ORD_22813,12974,Baclodon 10mg Tablet,Warehouse A,42,24,2025-02-10 18:00:00,18
22813,ORD_22814,8446,Cetsab 10mg Tablet,Warehouse C,99,88,2025-02-10 15:39:00,11
22814,ORD_22815,24433,Eatan G Cream,Warehouse B,38,26,2025-02-10 19:58:00,12
22815,ORD_22816,36069,ELEPHANTBOAT® Portable Protector Case Cover Storage Carry Travel Hard Case for Logitech MX Master/Master 2S Wireless Bluet...,Warehouse A,36,24,2025-02-10 07:42:00,12
22816,ORD_22817,7022,Dapazee 10 Tablet,Warehouse B,64,48,2025-02-10 20:10:00,16
22817,ORD_22818,24448,Pro 4 Shaving Blades - For Men,Warehouse C,80,70,2025-02-10 00:22:00,10
22818,ORD_22819,14105,AmazonBasics Adjustable Silicone Strap Band for Xiaomi Mi Band 3/Mi Band 4 Watch - Black,Warehouse C,70,53,2025-02-10 20:37:00,17
22819,ORD_22820,633,Classmate Archimedes Geometry Box | Die- Cast Compass | Mechanical Pencil | Double sided tray,Warehouse A,31,20,2025-02-10 11:48:00,11
22820,ORD_22821,13801,Mobwill Charging Cable for Fire-Boltt Ninja/Ninja Pro/Ninja Pro Max/Ninja Call 2 / Beam Smartwatches,Warehouse C,79,68,2025-02-10 17:05:00,11
22821,ORD_22822,22378,"Shaving Cream With Tea Tree Oil, Aloe Vera & Menthol Extracts",Warehouse A,62,45,2025-02-10 16:46:00,17
22822,ORD_22823,369,Pancef 1g Injection,Warehouse C,89,75,2025-02-10 15:26:00,14
22823,ORD_22824,13914,"Nyle Naturals Volume Enhance Anti Hairfall Shampoo, With Reetha And Blackberry, Gentle and soft shampoo, PH balanced and P...",Warehouse A,12,6,2025-02-10 18:34:00,6
22824,ORD_22825,8273,Rosiynx 10 Tablet,Warehouse A,57,46,2025-02-10 02:43:00,11
22825,ORD_22826,23073,wipro Ns9400 9-Watt B22D Wifi Smart Led Bulb With Music Sync Compatible With Amazon Alexa And Google Assistant ( Warm Whit...,Warehouse C,36,31,2025-02-10 04:41:00,5
22826,ORD_22827,13892,Febupen 40mg Tablet,Warehouse C,41,31,2025-02-10 16:56:00,10
22827,ORD_22828,8282,Annoxy 250mg Capsule,Warehouse C,22,3,2025-02-10 17:31:00,19
22828,ORD_22829,36303,Rozstyl 20mg Tablet,Warehouse C,33,24,2025-02-10 23:55:00,9
22829,ORD_22830,24030,"Easyfone Udaan2 - Senior Friendly Keypad Phone with Features Like Loud Sound, Photo Speed dial, Simple menu, SOS, Incoming...",Warehouse A,25,9,2025-02-10 01:34:00,16
22830,ORD_22831,7264,Revolution Superdewy Liquid Highlighter Bronze Truffle Ultra Smooth Shine Waterproof Face And Body Highlighter 3D glow shi...,Warehouse C,27,12,2025-02-10 12:58:00,15
22831,ORD_22832,22228,Protecta The Professional Laptop Bag Briefcase for Laptops with Screen Size Up to 15.6 Inch (Black & Indian Geometric Print),Warehouse C,111,96,2025-02-10 22:46:00,15
22832,ORD_22833,8256,Monceclo 100mg Tablet,Warehouse A,36,18,2025-02-10 03:52:00,18
22833,ORD_22834,8298,Achetiva Capsule SR,Warehouse A,48,42,2025-02-10 07:55:00,6
22834,ORD_22835,24058,Rose Body Wash Soap,Warehouse A,57,51,2025-02-10 15:18:00,6
22835,ORD_22836,24077,"Lenovo IdeaPad Slim 5 Intel Core i5 11th Gen 15.6"" (39.62cm) FHD IPS Thin & Light Laptop (16GB/512GB SSD/Windows 11/Office...",Warehouse A,61,44,2025-02-10 17:53:00,17
22836,ORD_22837,24079,Ventakort 6mg Tablet,Warehouse C,17,12,2025-02-10 15:02:00,5
22837,ORD_22838,8203,Cold Processed Skin Lavender Handmade Soap,Warehouse A,100,89,2025-02-10 11:01:00,11
22838,ORD_22839,13924,Online Shopo Kart Kid's Glitter Tattoos (Multicolour),Warehouse A,96,84,2025-02-10 04:46:00,12
22839,ORD_22840,36270,Curispas-M Tablet,Warehouse A,61,50,2025-02-10 13:26:00,11
22840,ORD_22841,24108,Azopip 1.125gm Injection,Warehouse A,87,70,2025-02-10 19:31:00,17
22841,ORD_22842,8322,7SEVEN® Compatible Fire Tv Stick Remote Original Suitable for 2nd generation model remote control only with Bluetooth Voic...,Warehouse C,91,79,2025-02-10 13:31:00,12
22842,ORD_22843,8257,Pro Super Soft Reusable FDA Approved Menstrual Cup With Medical Grade Silicon - Large,Warehouse C,51,45,2025-02-10 04:49:00,6
22843,ORD_22844,23969,Emallee Galaxy Watch 4 Charger EMallee Charging Dock for Samsung Galaxy Watch4 Classic Watch 3 Active & Active 2 Accessori...,Warehouse C,60,42,2025-02-10 02:17:00,18
22844,ORD_22845,36267,Glimmer Premium Nail Enamel Pastel Olive 10 ml,Warehouse B,37,23,2025-02-10 04:19:00,14
22845,ORD_22846,373,Unipep 40mg Tablet,Warehouse B,86,76,2025-02-10 09:18:00,10
22846,ORD_22847,13145,"LEPOSE Camera Wall Mount, CCTV DVR Rack/NVR/Server/Network Rack, CCTV Camera Server Rack, dvr Box, dvr Rack, dvr Box Wall ...",Warehouse A,63,49,2025-02-10 02:12:00,14
22847,ORD_22848,7403,Organics - Ultra Rich Hydrating Body Butter,Warehouse C,34,17,2025-02-10 03:04:00,17
22848,ORD_22849,13777,"Tizum 2.4 GHz Retro Wireless Keyboard & Optical Mouse Combo with Single Nano Receiver, Power Saving Auto-Sleep, Typewriter...",Warehouse C,92,84,2025-02-10 23:55:00,8
22849,ORD_22850,23823,VMPS 1 Year Warranty AC Remote Compatible for Lloyd Voltas Onida Godrej Videocon Gree Electrolux Ac Remote 1.5 Ton,Warehouse B,65,58,2025-02-10 06:28:00,7
22850,ORD_22851,13135,"Ambrane 18W BoostedSpeed™ Charger with USB Port & Quick Charge, Made in India, Multi-Layer Protection, iPhone & Android Co...",Warehouse B,18,6,2025-02-10 12:29:00,12
22851,ORD_22852,639,Acnebold Gel,Warehouse B,40,24,2025-02-10 03:04:00,16
22852,ORD_22853,23850,PrettyKrafts Cosmetic Travel Toiletry Bag Makeup Organiser - Black - Set of 3 Pieces,Warehouse B,37,21,2025-02-10 15:41:00,16
22853,ORD_22854,22761,Divarus 125mg Tablet ER,Warehouse B,48,31,2025-02-10 11:13:00,17
22854,ORD_22855,24294,Pachino D 30mg/40mg Capsule,Warehouse B,80,72,2025-02-10 17:14:00,8
22855,ORD_22856,36151,Dapaglyn 10 Tablet,Warehouse A,26,7,2025-02-10 04:33:00,19
22856,ORD_22857,22435,Beauty People Pure Matte Lipstick - Super - Neutral - 416 3.8 gm,Warehouse A,15,6,2025-02-10 07:30:00,9
22857,ORD_22858,13767,Doms Fsc 24 Colour Pencil Flat Tin,Warehouse B,45,33,2025-02-10 08:40:00,12
22858,ORD_22859,34556,Drosafe 250mg Tablet,Warehouse B,27,13,2025-02-10 00:16:00,14
22859,ORD_22860,7674,Inoxwell P 60mg/325mg Tablet,Warehouse C,105,93,2025-02-10 15:32:00,12
22860,ORD_22861,7981,"HP CS10 Wireless Multi-Device Bluetooth Keyboard and Mouse Set, USB Plug and Play with 2.4 GHz Wireless Connection,800/120...",Warehouse C,33,14,2025-02-10 03:15:00,19
22861,ORD_22862,7983,Faces Canada Eye Shadow Brush 1'S,Warehouse B,35,25,2025-02-10 13:23:00,10
22862,ORD_22863,13496,Remo 100mg Tablet,Warehouse B,88,82,2025-02-10 18:04:00,6
22863,ORD_22864,23264,"Ultralights Highlighting Kit - Coffee Collection, Hazel Brown",Warehouse A,41,24,2025-02-10 05:55:00,17
22864,ORD_22865,23272,"Body Lotion for Very Dry Skin, Nourishing Body Milk with 2x Almond Oil, For Men & Women, 400 ml",Warehouse B,57,46,2025-02-10 05:37:00,11
22865,ORD_22866,23274,Fastrack Hip Hop Analog White Dial Women's Watch-NL9827PP01/NP9827PP01,Warehouse B,42,30,2025-02-10 17:09:00,12
22866,ORD_22867,13285,"Nivea Women Shower Gel, Lemon & Oil Body Wash, 125 ml, Transparent",Warehouse C,37,21,2025-02-10 17:23:00,16
22867,ORD_22868,23328,CASEOLOGY by Spigen Athlex Back Cover Case Compatible with Samsung Galaxy S23 Ultra (TPU and PC | Active Black),Warehouse B,70,53,2025-02-10 10:59:00,17
22868,ORD_22869,7728,"Kaya Clinic Soothing Cleansing Gel Soap Free & Gentle Face Wash with Niacinamide for Daily Use for All Skin Types, 100ml",Warehouse B,99,94,2025-02-10 15:04:00,5
22869,ORD_22870,13515,Papaya & Coconut Bathing Soap,Warehouse B,53,48,2025-02-10 22:13:00,5
22870,ORD_22871,23333,Fragrance Body Spray - Marco,Warehouse B,46,36,2025-02-10 18:54:00,10
22871,ORD_22872,22735,"EGOTUDE Ultra Hybrid Matte Frosted Translucent Back Cover Case for iPhone 13 (Frost Black, TPU+Polycarbonate)",Warehouse A,69,53,2025-02-10 00:12:00,16
22872,ORD_22873,7660,"Fire-Boltt 360 SpO2 Full Touch Large Display Round Smartwatch with in-Built Games, 8 Days Battery Life, IP67 Water Resista...",Warehouse A,71,57,2025-02-10 19:24:00,14
22873,ORD_22874,23381,Cado Suspension,Warehouse C,76,57,2025-02-10 03:30:00,19
22874,ORD_22875,8022,St.Botanica Body Wash - Sour Candy 250 ml,Warehouse C,62,47,2025-02-10 01:51:00,15
22875,ORD_22876,23383,Superdrug Tea Tree & Grapefruit Wash 150 ml,Warehouse C,85,76,2025-02-10 20:06:00,9
22876,ORD_22877,23384,Apple 30W USB-C Power Adapter,Warehouse B,14,5,2025-02-10 09:44:00,9
22877,ORD_22878,36899,Glimetrol 1mg Tablet,Warehouse A,92,86,2025-02-10 15:07:00,6
22878,ORD_22879,36955,Vobil 0.3mg Tablet,Warehouse B,97,89,2025-02-10 05:39:00,8
22879,ORD_22880,8470,"AmazonBasics New Release Nylon USB-A to Lightning Cable Cord, Fast Charging MFi Certified Charger for Apple iPhone, iPad (...",Warehouse C,76,59,2025-02-10 08:40:00,17
22880,ORD_22881,36958,"Reequil Under Eye Cream For Dark Circles, Wrinkles And Puffy Eyes 20 gm",Warehouse B,36,19,2025-02-10 19:09:00,17
22881,ORD_22882,7637,Faces Canada Glam On Perfect Noir Eyeliner Black 3.8 Ml,Warehouse C,111,94,2025-02-10 14:05:00,17
22882,ORD_22883,565,Mofla O Syrup,Warehouse C,28,18,2025-02-10 03:22:00,10
22883,ORD_22884,7977,Relaxsu 10mg Tablet,Warehouse B,30,20,2025-02-10 20:57:00,10
22884,ORD_22885,24185,TheGiftKart Back Cover Case for OnePlus 8T (Shockproof | Hybrid TPU & PC | Transparent | Black Bumper),Warehouse A,70,51,2025-02-10 09:00:00,19
22885,ORD_22886,670,Kri Esol 40mg Tablet,Warehouse B,75,63,2025-02-10 16:21:00,12
22886,ORD_22887,24492,"TP-Link TL-WA855RE N300 Mbps Single Band Universal Wireless Range Extender, Broadband/WiFi Extender with 1 Ethernet Port a...",Warehouse A,32,14,2025-02-10 15:11:00,18
22887,ORD_22888,8487,Gemblue Biocare Honey Face Wash 150 ml,Warehouse B,63,58,2025-02-10 14:45:00,5
22888,ORD_22889,6975,Ketoford Soap,Warehouse C,56,43,2025-02-10 06:37:00,13
22889,ORD_22890,24332,Iogat 400mg Tablet,Warehouse B,20,13,2025-02-10 16:32:00,7
22890,ORD_22891,24125,"Miss Claire Miss Claire Ultra Glow Eyeshadow Palette 1, Multi, 16 grams, Multicolor, 16 g",Warehouse C,54,41,2025-02-10 18:51:00,13
22891,ORD_22892,24287,"Sh. huda Synthetic Bristle Makeup Brushes Sets With Leather Storage Pouch- Pink, Set of 24",Warehouse B,69,52,2025-02-10 02:52:00,17
22892,ORD_22893,22168,NEW Superdrug Skin Rescue Clay Honey Mask Kit 12 ml,Warehouse A,102,94,2025-02-10 11:25:00,8
22893,ORD_22894,22160,"Cosmic Byte C3070W Nebula 2.4G Wireless Gamepad for PC/PS3 supports Windows XP/7/8/10, Rubberized Texture (Camo Red)",Warehouse A,35,21,2025-02-10 01:56:00,14
22894,ORD_22895,7188,Jymef D 80mg/250mg Tablet,Warehouse B,43,27,2025-02-10 04:08:00,16
22895,ORD_22896,36220,DavaIndia Amlodipine+Atenolol 5mg/50mg Tablet,Warehouse B,115,96,2025-02-10 12:42:00,19
22896,ORD_22897,22150,"MASTADI Professional Makeup Brush Set, Everyday Essentials Real Techniques Blush, Foundation, Shadow, Highlighter, Conceal...",Warehouse B,25,16,2025-02-10 22:29:00,9
22897,ORD_22898,8353,Deep Conditioning Masque,Warehouse B,41,36,2025-02-10 02:16:00,5
22898,ORD_22899,22102,Lormoto 8mg Tablet,Warehouse C,102,92,2025-02-10 17:28:00,10
22899,ORD_22900,14011,Makeup Revolution Colour Play Blushed Duo Kindness 5.8 gm,Warehouse A,54,44,2025-02-10 19:51:00,10
22900,ORD_22901,548,"Tarkan Stud Foldable Wooden Finish Mini Desk for Couch, Sofa Bed, Study Tray Table Stand for Writing (Beige)",Warehouse A,51,34,2025-02-10 15:40:00,17
22901,ORD_22902,36182,Accuzon Plus 250 mg/125 mg Injection,Warehouse B,29,18,2025-02-10 15:32:00,11
22902,ORD_22903,7116,DKNY Myny Eau de Parfum 50ml,Warehouse C,112,95,2025-02-10 00:55:00,17
22903,ORD_22904,13983,Elecsera Nail Polish Remover Pads Wet Wipes Pack of 6 (192 ml),Warehouse B,36,27,2025-02-10 05:13:00,9
22904,ORD_22905,667,Linctus Codeinae CO Syrup,Warehouse C,87,70,2025-02-10 19:55:00,17
22905,ORD_22906,8413,Sounce Soft TPU Front Protection Case Cover for Amazfit GTS 2 Mini/ BIP U /Bip U Pro/ BIP Lite/Bip S/Bip S Lite Smart Watc...,Warehouse B,88,74,2025-02-10 20:24:00,14
22906,ORD_22907,22120,"Samsung Galaxy M13 5G (Aqua Green, 4GB, 64GB Storage) | 5000mAh Battery | Upto 8GB RAM with RAM Plus",Warehouse A,96,90,2025-02-10 02:43:00,6
22907,ORD_22908,22127,Skyflox 500mg Tablet,Warehouse C,28,16,2025-02-10 16:12:00,12
22908,ORD_22909,22139,Ustraa Cologne for Men - Base Camp 100 ml,Warehouse A,95,76,2025-02-10 11:00:00,19
22909,ORD_22910,28533,Winble Back Case Cover for OnePlus 9 Back Cover Slim Crystal Clear Camera Protection Airbag Shockproof Anti-Slip Grip PC T...,Warehouse B,65,54,2025-02-09 00:32:00,11
22910,ORD_22911,34309,VARS; LONDON HD Suede white kohl kajal | white kajal pencil pack of 3 | white kajal combo pack,Warehouse A,64,48,2025-02-09 23:46:00,16
22911,ORD_22912,20300,"BOB BLESSED OBSESSED Liquid Eyeliner, Colour eyeliner, Waterproof eyeliner long lasting, Smudgeproof|green eyeliner, blue ...",Warehouse A,112,99,2025-02-09 19:51:00,13
22912,ORD_22913,18762,Witanthyl 100mg Tablet,Warehouse C,46,36,2025-02-09 07:49:00,10
22913,ORD_22914,28936,Xondase Forte 20mg Tablet,Warehouse A,100,94,2025-02-09 08:13:00,6
22914,ORD_22915,32606,Ajmal Nightingale And Persuade For Men & Women And Blu Homme Deodorants Pack of 3 200 ml,Warehouse B,111,93,2025-02-09 22:24:00,18
22915,ORD_22916,33404,Orientals Oud Rose Perfum De Toilette For Unisex,Warehouse C,69,56,2025-02-09 11:47:00,13
22916,ORD_22917,15770,"Pilot V7 Liquid Ink Roller Ball Pen (1 Blue + 1 Black + 1 Red), (9000014717)",Warehouse A,87,76,2025-02-09 14:21:00,11
22917,ORD_22918,32614,"Samsung Galaxy A23 Blue, 8GB RAM, 128GB Storage with No Cost EMI/Additional Exchange Offers",Warehouse C,115,98,2025-02-09 02:10:00,17
22918,ORD_22919,19182,Davlevo 500mg Tablet,Warehouse A,29,11,2025-02-09 02:37:00,18
22919,ORD_22920,28446,"Amazon Brand - Solimo Thermoplastic Polyurethane Mobile Cover, Soft and Flexible Shockproof Back Cover with Cushioned Edge...",Warehouse C,64,45,2025-02-09 15:22:00,19
22920,ORD_22921,2051,Gl PG 750mcg/75mg Capsule,Warehouse C,33,14,2025-02-09 10:32:00,19
22921,ORD_22922,2596,AMOXINAT 500MG CAPSULE,Warehouse A,64,57,2025-02-09 00:49:00,7
22922,ORD_22923,5317,Ritodine 10mg Tablet,Warehouse A,90,77,2025-02-09 17:52:00,13
22923,ORD_22924,33324,Dystorva 10mg Tablet,Warehouse C,83,65,2025-02-09 17:33:00,18
22924,ORD_22925,20213,"Simply Inked Explore Love Change Temporary Tattoo, Quotes Tattoo Design for Girls Boys Men Women waterproof Sticker Size: ...",Warehouse A,76,63,2025-02-09 03:40:00,13
22925,ORD_22926,26803,Cosel Syrup,Warehouse A,108,91,2025-02-09 15:42:00,17
22926,ORD_22927,1704,"Phy Daily Skin Defense Sunscreen SPF 45 | Protects from sun damage | Niacinamide Cream | Great for daily use, Suitable for...",Warehouse B,93,87,2025-02-09 20:11:00,6
22927,ORD_22928,26794,"Mi Xiaomi 120W HyperCharge Adapter Combo|Laptops, Tablets & Mobile Charger|(Adapter + USB to Superfast 6A Type C Cable)|Co...",Warehouse A,54,40,2025-02-09 21:53:00,14
22928,ORD_22929,28503,Mamaearth Naturally Matte Lip Combo For 12-Hour Long Stay - Berrydict Magenta & Pink Daffodil (3 ml + 3 ml),Warehouse B,35,28,2025-02-09 03:16:00,7
22929,ORD_22930,12021,Ajmal Blu Carbon Sacred Love Deodorant Spray (Pack of 3) 200 ml,Warehouse C,59,52,2025-02-09 12:41:00,7
22930,ORD_22931,5310,Nasiwar D Syrup,Warehouse C,68,55,2025-02-09 01:06:00,13
22931,ORD_22932,16283,Ceftriasafe 250mg Injection,Warehouse A,76,66,2025-02-09 19:15:00,10
22932,ORD_22933,5741,Winpert 10000IU Capsule,Warehouse A,79,64,2025-02-09 04:52:00,15
22933,ORD_22934,10226,"Biotique Bio Kelp Protein Shampoo for Falling Hair Intensive Hair Regrowth Treatment, 800ml",Warehouse C,42,23,2025-02-09 02:27:00,19
22934,ORD_22935,5743,Allure Classic Eye Liner Makeup Brush 1's,Warehouse C,46,39,2025-02-09 04:57:00,7
22935,ORD_22936,26950,Hazpan 40mg Injection,Warehouse A,105,88,2025-02-09 01:36:00,17
22936,ORD_22937,18598,"Crucial Basics 16GB DDR4 1.2v 2666Mhz CL19 SODIMM RAM Memory Module for Laptops and Notebooks, Green",Warehouse A,40,29,2025-02-09 06:59:00,11
22937,ORD_22938,32854,Telglow H 40mg/12.5mg Tablet,Warehouse C,100,89,2025-02-09 05:51:00,11
22938,ORD_22939,12373,"Makeup Sponge Set Beauty Blender with Egg Case, Soft Sponge For Liquid Foundation, Creams, and Powders, Latex Free Wet and...",Warehouse B,31,17,2025-02-09 02:39:00,14
22939,ORD_22940,9781,Fripod CV Dry Syrup,Warehouse C,77,60,2025-02-09 19:20:00,17
22940,ORD_22941,1789,Ajmal Prose EDP & Mercurial Thunder EDT Pack of 2 350 ml,Warehouse A,40,27,2025-02-09 14:35:00,13
22941,ORD_22942,5218,Cefkim 200mg Tablet DT,Warehouse C,87,72,2025-02-09 18:59:00,15
22942,ORD_22943,2597,Go Fresh Moisture Bathing Bar Soap,Warehouse B,30,13,2025-02-09 13:39:00,17
22943,ORD_22944,29258,Ajmal CD 99 Mukhallat Concentrated Perfume Oil Floral Oriental And Raindrops Femme Deodorant Floral Chypre Fragrance 214 ml,Warehouse A,86,70,2025-02-09 21:53:00,16
22944,ORD_22945,9778,"Arata Natural Hydrating Hair Shampoo With Ginkgo, Ginger & Indian Gooseberry 75 ml",Warehouse A,59,44,2025-02-09 23:35:00,15
22945,ORD_22946,2130,Gardenia Essential Oil,Warehouse A,103,95,2025-02-09 04:04:00,8
22946,ORD_22947,2355,House Of Makeup Nail Lacquer - Little Tutu 12 ml,Warehouse B,63,44,2025-02-09 10:24:00,19
22947,ORD_22948,12176,"SupCares Edge to Edge Tempered Glass for OnePlus Nord 2T 5G, OnePlus Nord CE 5G, OnePlus Nord 2 (6.43 Inch) with Easy Self...",Warehouse A,25,13,2025-02-09 22:31:00,12
22948,ORD_22949,2691,Flormar Nail Enamel 483 Queen Zenobia 11 ml,Warehouse B,105,92,2025-02-09 09:11:00,13
22949,ORD_22950,5938,Nimexa P 100mg/325mg Tablet,Warehouse C,99,91,2025-02-09 20:38:00,8
22950,ORD_22951,26419,Apple Cider Vinegar - 10 Gummies,Warehouse C,56,42,2025-02-09 09:28:00,14
22951,ORD_22952,32353,TP-Link Tapo 360° 3MP 2304 Full HD 1296P Video Pan/Tilt Smart Wi-Fi Security Camera | Alexa Enabled | 2-Way Audio| Night V...,Warehouse A,42,30,2025-02-09 16:00:00,12
22952,ORD_22953,34471,Keticon Cream,Warehouse A,83,78,2025-02-09 08:29:00,5
22953,ORD_22954,34486,"ELV Aluminum Adjustable Mobile Phone Foldable Tabletop Stand Dock Mount for All Smartphones, Tabs, Kindle, iPad (Black)",Warehouse C,23,11,2025-02-09 03:30:00,12
22954,ORD_22955,34491,Acemove-ATP Tablet,Warehouse B,94,86,2025-02-09 16:32:00,8
22955,ORD_22956,11521,Classmate Invento Geometry Box | Self Centering Die-Cast Compass | Rust resistant instruments,Warehouse C,20,8,2025-02-09 01:02:00,12
22956,ORD_22957,15675,"Zitel® Charger Stand Compatible with Apple Watch Series 7/6/SE/5/4/3/2/1 (45mm, 44mm, 42mm, 41mm, 40mm, 38mm) Nightstand M...",Warehouse C,42,37,2025-02-09 00:18:00,5
22957,ORD_22958,29159,Cetmet Cold Tablet,Warehouse C,15,6,2025-02-09 15:45:00,9
22958,ORD_22959,15509,Neurociti 250mg Injection,Warehouse C,39,21,2025-02-09 10:26:00,18
22959,ORD_22960,4412,"Women Deodorant, Protect & Care, Non-Irritating & 48h Protection With Creme Fragrance",Warehouse B,88,77,2025-02-09 12:28:00,11
22960,ORD_22961,20615,Tough Lee UV Tempered Glass Screen Guard for Samsung Galaxy S23 Ultra / S22 Ultra 5G (Transparent) Advanced Border Less Ed...,Warehouse A,53,38,2025-02-09 17:02:00,15
22961,ORD_22962,10009,Suminat 100 Tablet,Warehouse B,23,7,2025-02-09 11:35:00,16
22962,ORD_22963,15165,Rabic-DSR Capsule,Warehouse B,22,5,2025-02-09 00:47:00,17
22963,ORD_22964,5577,"Lakmé Insta Eye Liner, Black, 9ml And Lakmé Perfecting Liquid Foundation, Marble, 27ml",Warehouse A,23,9,2025-02-09 18:52:00,14
22964,ORD_22965,29193,Prazol-DSR Capsule,Warehouse B,7,1,2025-02-09 22:14:00,6
22965,ORD_22966,34033,Dianora 1mg Injection,Warehouse C,32,16,2025-02-09 16:52:00,16
22966,ORD_22967,2703,Nafsafe 100mg/50mg Tablet,Warehouse B,52,35,2025-02-09 00:10:00,17
22967,ORD_22968,28393,Birju Mahavir Arjun ki Chaal - Terminalia Arjuna 400 Gr,Warehouse C,47,40,2025-02-09 00:07:00,7
22968,ORD_22969,32616,"POCO M4 Pro (Cool Blue, 6GB RAM 128GB Storage)",Warehouse A,92,79,2025-02-09 07:16:00,13
22969,ORD_22970,28974,Albazen 400mg Tablet,Warehouse C,68,53,2025-02-09 08:54:00,15
22970,ORD_22971,4806,"Eveready Ultima AAA Alkaline Battery, Pack of 6",Warehouse C,61,43,2025-02-09 19:58:00,18
22971,ORD_22972,32480,Glaaddo suhag Sticker Kumkum Spiral Book Bindi Multicolor,Warehouse C,108,89,2025-02-09 17:32:00,19
22972,ORD_22973,26609,"Trust edge USB Type C USB to Lightening, Fast Charging & Data Sync USB Type Cable [USB Type C to 8 Pin] Compatible for iPh...",Warehouse B,77,62,2025-02-09 12:38:00,15
22973,ORD_22974,26647,"JBL Cinema SB241, Dolby Digital Soundbar with Wired Subwoofer for Extra Deep Bass, 2.1 Channel Home Theatre with Remote, H...",Warehouse C,21,10,2025-02-09 11:34:00,11
22974,ORD_22975,20408,"realme narzo 50A Prime (Flash Black, 4GB RAM+128GB Storage) FHD+ Display | 50MP AI Triple Camera | Charger Included",Warehouse A,108,97,2025-02-09 10:05:00,11
22975,ORD_22976,5621,"Wella Professionals Invigo Color Brilliance Hair Mask for Coloured Hair | 150 ml | Colour Protecting Treatment for Fine, N...",Warehouse C,71,57,2025-02-09 14:26:00,14
22976,ORD_22977,2542,Rabovil 20 Tablet,Warehouse A,54,38,2025-02-09 00:14:00,16
22977,ORD_22978,15327,Ryfate O Oral Suspension,Warehouse A,27,22,2025-02-09 09:09:00,5
22978,ORD_22979,29033,Sacrifice Ii Perfume Deodorant For Men,Warehouse A,27,13,2025-02-09 10:50:00,14
22979,ORD_22980,20418,"Lakmé Lip Love Chapstick, Spf15, Cherry, 4.5 g And Lakmé Lip Love Chapstick, Apricot, 4.5 g",Warehouse A,66,51,2025-02-09 14:37:00,15
22980,ORD_22981,33561,"Beetel X90 Cordless 2.4Ghz Landline Phone with Caller ID Display, Stores 50 Contacts, Upto 8Hrs of Talk time, Solid Build ...",Warehouse A,44,33,2025-02-09 23:46:00,11
22981,ORD_22982,27463,"Note Italy Nail Enamel 67, Blue, 9ml",Warehouse C,20,1,2025-02-09 21:18:00,19
22982,ORD_22983,32509,Ucifix 100mg Tablet,Warehouse A,26,13,2025-02-09 07:09:00,13
22983,ORD_22984,28466,Relax Syrup,Warehouse C,98,80,2025-02-09 18:24:00,18
22984,ORD_22985,29045,Moca Soft Neoprene Bag Sleeve Cover For Macbook Pro 13 Inch 13.3 / Macbook Air 13 Inch 13.3 / Macbook Pro With Retina 13 I...,Warehouse C,80,69,2025-02-09 15:13:00,11
22985,ORD_22986,9630,Eecoxib 90mg Tablet,Warehouse C,88,70,2025-02-09 16:20:00,18
22986,ORD_22987,5806,Opidol P 500mg/50mg Tablet,Warehouse C,24,17,2025-02-09 03:26:00,7
22987,ORD_22988,2538,Homoglim M 1mg/1000mg Tablet SR,Warehouse A,65,59,2025-02-09 19:48:00,6
22988,ORD_22989,5268,Mecwor Plus Injection,Warehouse B,37,24,2025-02-09 05:58:00,13
22989,ORD_22990,2623,SKADIOO multiplug | three pin plug socket | 3-in-1 Universal Travel Adapter Multi-Plug with Individual Switch Socket with ...,Warehouse B,86,80,2025-02-09 13:47:00,6
22990,ORD_22991,15313,Dularo 20mg Tablet,Warehouse C,10,2,2025-02-09 08:14:00,8
22991,ORD_22992,27008,Zenfate Oral Suspension Orange Sugar Free,Warehouse B,84,66,2025-02-09 02:17:00,18
22992,ORD_22993,5286,Sadhev Depigmentation & Detanning Bathing Bar - Goat Milk and Jojoba Butter 125 gm,Warehouse A,75,65,2025-02-09 07:20:00,10
22993,ORD_22994,15298,"UrbanBotanics Tea Tree, Neem & Basil Face Scrub For Women & Men - Deep Cleansing, Tan Removal, Glowing Skin - 100g",Warehouse A,29,22,2025-02-09 12:19:00,7
22994,ORD_22995,28449,"Sounce Cat6 Ethernet Cable 10 Meter/ 550 MHz Outdoor & Indoor, Upto 10 Gbps Support Cat6 Network, Heavy Duty Flat LAN Inte...",Warehouse A,31,14,2025-02-09 06:15:00,17
22995,ORD_22996,32917,Biolage Advance Fiber Strong Strengthening Shampoo,Warehouse C,22,6,2025-02-09 06:21:00,16
22996,ORD_22997,9297,Half Moon 35 L Waterproof Laptop College School Office Bag Backpack for Men Women Boys Girls with 15.6 inch Padded Laptop ...,Warehouse A,95,86,2025-02-09 10:01:00,9
22997,ORD_22998,33551,Sixime O Dry Syrup,Warehouse B,16,9,2025-02-09 01:15:00,7
22998,ORD_22999,32276,Ant Esports GM60 USB Optical Gaming Mouse,Warehouse B,29,10,2025-02-09 16:16:00,19
22999,ORD_23000,15777,InkTree Back Cover for Samsung Galaxy S23 5G Back Cover | Slim Soft Back Case for Samsung Galaxy S23 5G (Transparent),Warehouse C,21,14,2025-02-09 07:17:00,7
23000,ORD_23001,9384,YAMAHA PSR-E273 PORTABLE KEYBOARD WITH 61 KEYS,Warehouse B,88,75,2025-02-09 04:24:00,13
23001,ORD_23002,27587,"Gizga Essentials Professional 3-in-1 Cleaning Kit for Camera, Lens, Binocular, Laptop, TV, Monitor, Smartphone, Tablet (In...",Warehouse C,71,57,2025-02-09 06:43:00,14
23002,ORD_23003,5334,Axcef 250mg Injection,Warehouse A,65,56,2025-02-09 14:23:00,9
23003,ORD_23004,32544,Insight Cosmetics 2X Cover Master Concealer - Rich Tan 6 ml,Warehouse B,73,66,2025-02-09 00:28:00,7
23004,ORD_23005,16510,Atocor 5 Tablet,Warehouse B,101,95,2025-02-09 08:32:00,6
23005,ORD_23006,20340,"Dell Original 65W USB Type-C Adapter for Laptop, Latitude 5289 5290 7389 7390 7400 - Black",Warehouse C,35,24,2025-02-09 12:24:00,11
23006,ORD_23007,29553,MorningVale Wireless Bluetooth Portable Speaker (Multicolour),Warehouse C,62,56,2025-02-09 02:58:00,6
23007,ORD_23008,33647,SupCares Tempered Glass Screen Protector for Samsung Galaxy Watch 4 Classic (46 mm) with Easy Self Installation Kit | Pack...,Warehouse B,46,36,2025-02-09 20:55:00,10
23008,ORD_23009,1983,Pevicet-M Tablet,Warehouse A,88,72,2025-02-09 17:41:00,16
23009,ORD_23010,12041,Clavmox 500mg/125mg Tablet,Warehouse A,85,70,2025-02-09 08:24:00,15
23010,ORD_23011,16524,Kacetam 800mg Tablet,Warehouse B,26,16,2025-02-09 02:32:00,10
23011,ORD_23012,10203,Tea Tree Pure Aroma Essential Oil,Warehouse B,14,1,2025-02-09 20:19:00,13
23012,ORD_23013,15399,Zisper 2mg Tablet,Warehouse C,23,14,2025-02-09 01:22:00,9
23013,ORD_23014,34197,Juvitill-G Tablet,Warehouse A,84,78,2025-02-09 05:14:00,6
23014,ORD_23015,34256,"Fashion Colour Hair Colour Spray, Green 150 ml",Warehouse A,28,11,2025-02-09 01:11:00,17
23015,ORD_23016,28516,Aceprole 20mg Capsule,Warehouse A,71,65,2025-02-09 13:36:00,6
23016,ORD_23017,5682,Fogg Fresh Woody Deo 120 Ml,Warehouse A,90,74,2025-02-09 03:47:00,16
23017,ORD_23018,27556,HUDA BB Eyeshadow Palette (18 shades in 1 kit) Professional Eye Make Up High Pigmented Mattes and Shimmers with mirror (Ro...,Warehouse C,68,57,2025-02-09 21:39:00,11
23018,ORD_23019,26866,Etos 60 Tablet,Warehouse A,35,25,2025-02-09 12:38:00,10
23019,ORD_23020,26916,Pacinova DS 250mg Suspension,Warehouse A,94,78,2025-02-09 00:19:00,16
23020,ORD_23021,27557,"Wild Stone Sensual and Hydra Energy Talcum Powder, 100g - Pack of 2",Warehouse B,25,6,2025-02-09 15:32:00,19
23021,ORD_23022,34262,Acukold Syrup,Warehouse A,101,83,2025-02-09 13:47:00,18
23022,ORD_23023,1999,Miss Rose 24 Color Matte Eyeshadow Palette 7001 - 071 MT02 26 gm,Warehouse B,57,39,2025-02-09 20:27:00,18
23023,ORD_23024,12243,Tidoxyl CX 250 mg/250 mg Capsule,Warehouse B,31,15,2025-02-09 02:10:00,16
23024,ORD_23025,11591,Esixim 200mg Tablet,Warehouse A,83,68,2025-02-09 23:02:00,15
23025,ORD_23026,18801,"Sanitary Pads - Extra Large Wings, Ultra",Warehouse A,93,77,2025-02-09 00:25:00,16
23026,ORD_23027,19758,"iQOO Z6 Lite 5G by vivo (Stellar Green, 4GB RAM, 64GB Storage) | World's First Snapdragon 4 Gen 1 | 120Hz Refresh Rate | 5...",Warehouse B,68,61,2025-02-09 01:58:00,7
23027,ORD_23028,15724,Dinum AP 100mg/325mg Tablet,Warehouse B,80,70,2025-02-09 01:34:00,10
23028,ORD_23029,16541,Oloptz DS Eye Drop,Warehouse B,26,10,2025-02-09 19:17:00,16
23029,ORD_23030,26839,Azulix MV 1mg/500mg/0.3mg Tablet SR,Warehouse A,61,52,2025-02-09 09:05:00,9
23030,ORD_23031,28923,"Ambrane Mobile Holding Tabletop Stand, 180 Degree View, Premium Metal Body, Wide Compatibility, Multipurpose, Anti-Skid De...",Warehouse C,61,55,2025-02-09 09:07:00,6
23031,ORD_23032,27789,POPIO Tempered Glass Screen Protector Compatible for Motorola Moto G60 / Motorola Moto G40 Fusion (Black) with Edge to Edg...,Warehouse C,107,88,2025-02-09 02:57:00,19
23032,ORD_23033,518,Portronics Modesk Plus POR-1196 Universal Mobile Phone Stand with Card Holder (Black),Warehouse A,70,56,2025-02-09 12:59:00,14
23033,ORD_23034,20645,Portronics Power PRO Lithium Polymer 20K 20000 mAh Power Bank with Dual Output and Dual Input Fast Charging Delivery (Black),Warehouse B,102,94,2025-02-09 01:10:00,8
23034,ORD_23035,17216,"BITZAG Smart Watch D116 for Xiaomi Mi Note 9 Smart Watch Bluetooth SmartWatch with Activity Tracker, Heart Rate Sensor, Sl...",Warehouse B,73,60,2025-02-09 21:42:00,13
23035,ORD_23036,476,Fegra M 10mg/120mg Tablet,Warehouse C,89,77,2025-02-09 08:45:00,12
23036,ORD_23037,8318,Car-Race H 2.5mg/12.5mg Tablet,Warehouse C,55,46,2025-02-09 16:19:00,9
23037,ORD_23038,31535,Makeup Revolution Illuminating Fixing Spray 100 ml,Warehouse C,57,48,2025-02-09 16:05:00,9
23038,ORD_23039,3164,Plaros F 160mg/10mg Tablet,Warehouse B,35,20,2025-02-09 15:50:00,15
23039,ORD_23040,24110,Faber-Castell Fine Multi-Marker - Pack of 4 (Assorted),Warehouse B,91,73,2025-02-09 23:48:00,18
23040,ORD_23041,31543,"POND'S BB+ Cream, Instant Spot Coverage + Natural Glow, 01 Original 30 g",Warehouse C,33,28,2025-02-09 22:26:00,5
23041,ORD_23042,22182,"COSLUXE IMAGIC Pro Chalice 36 Color Eyeshadow Palette, 30.8g Eyeshadow Matte Shimmer Finish Make up Palette Highly Pigment...",Warehouse A,116,97,2025-02-09 04:33:00,19
23042,ORD_23043,30530,Praper D Tablet,Warehouse C,83,76,2025-02-09 00:37:00,7
23043,ORD_23044,32099,Pitocin 10IU Injection,Warehouse B,65,47,2025-02-09 12:17:00,18
23044,ORD_23045,1140,Fixamp 50mg Dry Syrup,Warehouse B,74,67,2025-02-09 10:46:00,7
23045,ORD_23046,2829,GB Mox 0.5% Eye Drop,Warehouse A,67,53,2025-02-09 16:47:00,14
23046,ORD_23047,16342,Lavilevo 5mg Tablet,Warehouse B,81,68,2025-02-09 16:21:00,13
23047,ORD_23048,15238,Body Wash and shower Gel - Revitalize,Warehouse A,91,80,2025-02-09 02:59:00,11
23048,ORD_23049,5882,TheGiftKart Ultra Clear Back Cover Case for Samsung Galaxy S23 Ultra 5G | Slim & Protective Design | Inbuilt Dust Plugs & ...,Warehouse A,51,39,2025-02-09 13:29:00,12
23049,ORD_23050,24097,"VOYEE Wired Headphone with Mic, 3.5 mm Audio Jack Headset with Microphone for Laptop/Office/Skype/Home/Online (Black)",Warehouse C,108,97,2025-02-09 02:53:00,11
23050,ORD_23051,1570,Global Desi Cosmic Charm 100ML & Mythical Bloom 50ML Eau De Parfum for Women Crafted by Ajmal,Warehouse A,59,44,2025-02-09 22:02:00,15
23051,ORD_23052,11539,Miliom 20mg Capsule,Warehouse C,29,10,2025-02-09 06:55:00,19
23052,ORD_23053,20534,Art 80mg Injection,Warehouse C,74,55,2025-02-09 19:54:00,19
23053,ORD_23054,10277,Tifther 150mg Injection,Warehouse A,82,72,2025-02-09 15:36:00,10
23054,ORD_23055,34075,Electvision Compatible for Samsung Smart 4K Ultra HD TV Monitor Remote Control Replacement of Original Samsung TV Remote f...,Warehouse C,40,27,2025-02-09 06:39:00,13
23055,ORD_23056,32379,LOHAYA Air Conditioner Remote Compatible for Lloyd Split AC Remote Control (AC-233),Warehouse A,98,90,2025-02-09 22:47:00,8
23056,ORD_23057,27048,"Wayona 3in1 Nylon Braided 66W USB Fast Charging Cable with Type C, Lightening and Micro USB Port, Compatible with iPhone, ...",Warehouse B,83,76,2025-02-09 04:31:00,7
23057,ORD_23058,27718,AmazonBasics AA Performance Alkaline Non-Rechargeable Batteries (20-Pack) - Appearance May Vary,Warehouse C,60,55,2025-02-09 19:05:00,5
23058,ORD_23059,16480,Two Blades Pack,Warehouse C,98,81,2025-02-09 01:56:00,17
23059,ORD_23060,26500,MahadealzDesign Mobile Phone Dustproof Net Stickers Speaker Mesh Anti Dust Proof Self Adhesive Protector for Universal Pho...,Warehouse B,78,69,2025-02-09 20:47:00,9
23060,ORD_23061,33448,Blenior Hair Removal Cream Sensitive 100 ml,Warehouse A,97,86,2025-02-09 00:39:00,11
23061,ORD_23062,9269,Acepar Plus Tablet,Warehouse C,86,76,2025-02-09 21:50:00,10
23062,ORD_23063,5230,Biosoft Lemon Pre Wax Gel 500 ml,Warehouse C,24,10,2025-02-09 11:53:00,14
23063,ORD_23064,20538,Cefidel-LB 200 Tablet DT,Warehouse A,79,71,2025-02-09 05:42:00,8
23064,ORD_23065,8314,Spigen Ultra Hybrid Back Cover Case for iPhone 13 Pro (TPU + Poly Carbonate | Crystal Clear),Warehouse A,14,5,2025-02-09 21:37:00,9
23065,ORD_23066,30539,Puna Store® 4 Piece Oval Brush Set - Black,Warehouse B,27,19,2025-02-09 01:03:00,8
23066,ORD_23067,18852,VAHFLAM 20 MG/500 MG TABLET,Warehouse B,21,9,2025-02-09 12:21:00,12
23067,ORD_23068,3142,Oxy-Infusion Night Cream,Warehouse C,29,14,2025-02-09 11:09:00,15
23068,ORD_23069,465,MAONO AU-A04 Condenser Microphone Kit (Black),Warehouse B,67,56,2025-02-09 03:32:00,11
23069,ORD_23070,13029,Essential Oil - Thyme,Warehouse A,71,55,2025-02-09 14:31:00,16
23070,ORD_23071,13069,Sery Colorflirt Nail Paint Glazing Pink 10 ml,Warehouse A,96,85,2025-02-09 01:20:00,11
23071,ORD_23072,36242,Luxor 1852 Chisel Highlighter - Assorted Colors - Set of 5,Warehouse A,110,96,2025-02-09 05:23:00,14
23072,ORD_23073,7193,Dimas MR 250mg/50mg/325mg Tablet,Warehouse A,62,51,2025-02-09 03:24:00,11
23073,ORD_23074,3150,Myglamm Lit Matte Nail Enamel - Twerk 7 ML,Warehouse C,88,69,2025-02-09 12:27:00,19
23074,ORD_23075,3730,Reltuss Dcp SF Syrup,Warehouse A,77,69,2025-02-09 02:54:00,8
23075,ORD_23076,3732,Tamolide 100mg/325mg Tablet,Warehouse B,82,72,2025-02-09 21:03:00,10
23076,ORD_23077,10766,"Dyazo 12 W 3 Port USB Car Charger Adapter with Smart ic Compatible for Oppo, Vivo, Redmi,iPhone, Samsung and All Other Sma...",Warehouse B,75,62,2025-02-09 23:07:00,13
23077,ORD_23078,17901,Hub Man Eau De Toilette,Warehouse B,60,43,2025-02-09 11:28:00,17
23078,ORD_23079,7150,Aelcef 500mg Injection,Warehouse A,52,36,2025-02-09 03:49:00,16
23079,ORD_23080,17206,Nised 50mg Syrup,Warehouse C,21,2,2025-02-09 13:44:00,19
23080,ORD_23081,3739,Ajmal Neutron EDP Citrus Fruity Perfume 100ml for Men and Shine EDP Floral Powdery Perfume 75ml for Women +1 Perfume Teste...,Warehouse C,27,15,2025-02-09 20:35:00,12
23081,ORD_23082,3741,Streax Ultralights Highlighting Kit for Women & Men | Contains Walnut & Argan Oil | Shine On Conditioner | Longer Lasting ...,Warehouse C,38,33,2025-02-09 16:27:00,5
23082,ORD_23083,11187,Chambor Twin Sharpner 1 ml,Warehouse A,20,12,2025-02-09 06:26:00,8
23083,ORD_23084,31584,"Olivia Instant Waterproof Makeup Stick Pack of 3 Shades - Natural 03, Linning Yellow 07, Pearl White 007 15g Each, SPF 12 ...",Warehouse C,81,69,2025-02-09 09:34:00,12
23084,ORD_23085,13974,100% Natural Classic multi color Color Change Matte gel Lipstick,Warehouse B,83,77,2025-02-09 20:34:00,6
23085,ORD_23086,8368,D95 Safe Face Mask With Valve - White,Warehouse B,57,47,2025-02-09 11:05:00,10
23086,ORD_23087,7133,Olay Total Effect Anti Aging Moisturizing Skin Cream,Warehouse A,40,22,2025-02-09 12:47:00,18
23087,ORD_23088,13030,SpinBot BattleMods NinjaX | Electric Edition | Automatic Burst Mode Gaming Trigger | 5X Faster with Capacitive Conduction...,Warehouse C,21,6,2025-02-09 12:59:00,15
23088,ORD_23089,11203,"JBL Commercial CSHM10 Handheld Dynamic XLR Unidirectional Microphone With On/Off Switch (Cable Not Included) Black, Medium",Warehouse A,20,14,2025-02-09 07:59:00,6
23089,ORD_23090,22161,Orcox 120mg Tablet,Warehouse C,78,60,2025-02-09 22:01:00,18
23090,ORD_23091,22165,"Caprigo Heavy Duty TV Wall Mount Bracket for 14 to 32 Inch LED/HD/Smart TV’s, Universal Fixed TV Wall Mount Stand (M452)",Warehouse C,20,5,2025-02-09 13:24:00,15
23091,ORD_23092,24098,"Foriox® Acrylic Reusable Practice Mehendi Design Reusable Hand Practice (White, 16 Inch ) - Pack of 2",Warehouse B,14,6,2025-02-09 06:53:00,8
23092,ORD_23093,36292,Dicjem-MR Tablet,Warehouse B,34,29,2025-02-09 11:11:00,5
23093,ORD_23094,7251,Cool Fire - Body Spray,Warehouse C,79,63,2025-02-09 00:45:00,16
23094,ORD_23095,13912,Pain Relief - Oil,Warehouse C,91,81,2025-02-09 00:51:00,10
23095,ORD_23096,3701,Fruit Lep,Warehouse A,21,10,2025-02-09 18:37:00,11
23096,ORD_23097,27416,"Wolpin Laptop Table Foldable Desk with Notebook Holder & Cup Holder Multipurpose Study Table, Breakfast Table, Foldable an...",Warehouse A,20,9,2025-02-09 08:07:00,11
23097,ORD_23098,19869,Mefset-P Tablet,Warehouse C,75,66,2025-02-09 06:46:00,9
23098,ORD_23099,15684,Neurolac 1500mcg Tablet MD,Warehouse B,100,94,2025-02-09 08:08:00,6
23099,ORD_23100,26300,Exler M Oral Suspension,Warehouse B,87,70,2025-02-09 17:14:00,17
23100,ORD_23101,18689,Ajmal Nightingale And Distraction For Men & Women And Wisal Dhahab Deodorants Pack of 3 200 ml,Warehouse C,18,10,2025-02-09 20:17:00,8
23101,ORD_23102,32451,Amal 150mg Injection,Warehouse B,46,31,2025-02-09 03:50:00,15
23102,ORD_23103,32934,"Portronics Konnect L 1.2Mtr, Fast Charging 3A Micro USB Cable with Charge & Sync Function (Grey)",Warehouse B,104,93,2025-02-09 11:26:00,11
23103,ORD_23104,33476,Mannitol 20% Infusion,Warehouse B,39,25,2025-02-09 11:55:00,14
23104,ORD_23105,15263,"Nokia 8210 4G Volte keypad Phone with Dual SIM, Big Display, inbuilt MP3 Player & Wireless FM Radio | Blue",Warehouse C,24,8,2025-02-09 04:19:00,16
23105,ORD_23106,20133,11 Color Kumkum Bindi Liquid Bindi Tikli Sindoor Beautiful Traditional Singar For Women & Girl,Warehouse B,88,80,2025-02-09 23:38:00,8
23106,ORD_23107,33737,"Pinnaclz Original Combo of 2 USB Type C Fast Charging Cable, USB C Data Cable for Charging and Data Transfer Smart Phones ...",Warehouse B,21,5,2025-02-09 15:07:00,16
23107,ORD_23108,29057,Moxycon-D 250mg/250mg Capsule,Warehouse C,93,84,2025-02-09 02:47:00,9
23108,ORD_23109,15941,"SAEMPIRE OnePlus Nord Watch Screen Guard Screen Protector Compatible For OnePlus Nord Watch 1.78"" Smart Watch -Flexible TP...",Warehouse A,93,74,2025-02-09 00:54:00,19
23109,ORD_23110,26304,URBN 20000 mAh 20W Super Fast Charging Metal Power Bank | Type C PD (Input& Output) | QC 3.0 Dual USB Output | Two-Way Fas...,Warehouse C,91,73,2025-02-09 20:17:00,18
23110,ORD_23111,16696,"ESR (2-Pack) Paper-Feel Screen Protector for iPad Air 4 2020 /iPad Pro 11 2020 & 2018, [Supports Apple Pencil] [Write & Dr...",Warehouse A,29,11,2025-02-09 05:42:00,18
23111,ORD_23112,10001,Volix 0.3mg Tablet,Warehouse A,111,97,2025-02-09 22:09:00,14
23112,ORD_23113,16474,Avox O 200mg/500mg Tablet,Warehouse A,112,98,2025-02-09 07:41:00,14
23113,ORD_23114,16698,Acejn T 100mg/4mg Tablet,Warehouse B,74,61,2025-02-09 07:20:00,13
23114,ORD_23115,26491,"Wayona Nylon Braided (2 Pack) Long Lightning To Usb A Syncing And Fast Charging Data Cable For Iphone, Ipad Tablet (3Ft+6F...",Warehouse C,29,16,2025-02-09 02:29:00,13
23115,ORD_23116,10320,Saffron Skin-Whitening Massage Cream,Warehouse A,21,8,2025-02-09 00:52:00,13
23116,ORD_23117,34541,Fresh Mint Toothpaste - For Sensitive Teeth,Warehouse C,42,27,2025-02-09 08:03:00,15
23117,ORD_23118,5418,"HP 14s, 5th Gen AMD Ryzen 3- 8GB RAM/512GB SSD 14 inches(35cm) Laptop, FHD IPS Micro-Edge Display/ Backlit Keyboard/Alexa/...",Warehouse A,90,75,2025-02-09 07:27:00,15
23118,ORD_23119,11930,Dark Wave - Body Spray,Warehouse A,64,55,2025-02-09 06:57:00,9
23119,ORD_23120,33368,Neoall 300mg Tablet,Warehouse C,37,19,2025-02-09 14:08:00,18
23120,ORD_23121,33360,"Eyebrow Drawing Palette 3 Shades With 1 Brush, Waterproof Non–Transfer Smudgeproof Eyebrow Palette, Ultimate Brow Kit, Eye...",Warehouse A,112,94,2025-02-09 18:13:00,18
23121,ORD_23122,20637,"Archer Tech Lab Typhon Max Dual Fan Phone Cooler for Instant Cooling, Buckles for Better Compatibility, Display Screen for...",Warehouse B,89,78,2025-02-09 16:54:00,11
23122,ORD_23123,20640,"Kokuyo Camlin Artist Acrylic colors - 18 Shades, 20ml,Multicolor",Warehouse C,35,18,2025-02-09 23:20:00,17
23123,ORD_23124,19516,Core i5 3570K 3rd Generation Processor 3.40 Ghz for LGA 1155 Socket Excellent Performance Processor (Silver),Warehouse C,40,26,2025-02-09 01:56:00,14
23124,ORD_23125,34212,ASTRID Women's 17'' Black and White Textured Laptop Bag With Accessory Pouch,Warehouse C,50,32,2025-02-09 17:18:00,18
23125,ORD_23126,5869,Wet N Wild Mega Slicks Balm Stain See If I Carrot! 3 gm,Warehouse A,55,50,2025-02-09 10:02:00,5
23126,ORD_23127,27423,Daomide Tablet,Warehouse B,106,88,2025-02-09 01:13:00,18
23127,ORD_23128,15284,"VMT Stock OnePlus 11 5G Back Cover | Transparent Crystal Clear Hard PC Back Case with TPU Bumper, Drop Protection Case Cov...",Warehouse B,27,16,2025-02-09 20:36:00,11
23128,ORD_23129,18657,Lakme Absolute Matte Ultimate Lip Color With Argan Oil Rani Pink 3.4 Gm,Warehouse A,84,76,2025-02-09 14:44:00,8
23129,ORD_23130,34049,Soulflower Cold Pressed Olive Oil 120 ml,Warehouse B,62,44,2025-02-09 23:40:00,18
23130,ORD_23131,2676,Pantoking 40mg Tablet,Warehouse B,50,43,2025-02-09 23:24:00,7
23131,ORD_23132,15212,Faces Canada Weightless Matte Finish Lipstick Wine Rouge 30 4.5 Gm,Warehouse B,92,82,2025-02-09 06:44:00,10
23132,ORD_23133,28425,Agrosin 200 Oral Suspension,Warehouse C,96,82,2025-02-09 23:33:00,14
23133,ORD_23134,9739,Triben- B Lotion,Warehouse A,44,28,2025-02-09 17:16:00,16
23134,ORD_23135,19012,Allure Makeup Blender Sponge - Cut Drop Purple 1's,Warehouse B,76,57,2025-02-09 14:23:00,19
23135,ORD_23136,27714,TheGiftKart Ultra-Hybrid Crystal Clear Back Case Cover for Samsung Galaxy M33 5G | Shockproof Design | Camera Protection B...,Warehouse A,44,31,2025-02-09 14:57:00,13
23136,ORD_23137,20558,"Bharat's Original Nusqa E Arabia, 500ml",Warehouse B,29,19,2025-02-09 12:30:00,10
23137,ORD_23138,20499,"Acko 1-year Total Damage Protection Plan for Phones between INR 20,001-25,000",Warehouse B,47,37,2025-02-09 16:40:00,10
23138,ORD_23139,16325,Bisprol 5mg Tablet,Warehouse B,12,7,2025-02-09 08:44:00,5
23139,ORD_23140,34382,"Eveready Alkaline Batteries - Red AA, 10 Battery Pack",Warehouse C,91,80,2025-02-09 20:06:00,11
23140,ORD_23141,34104,"PunnkFunnk D115 Smart Band, Activity Tracker Fitness Band, Sleep Monitor, Step Tracking, Heart Rate Sensor, Kids Smart Wat...",Warehouse C,29,19,2025-02-09 22:51:00,10
23141,ORD_23142,11747,SanDisk Extreme SD UHS I 128GB Card for 4K Video for DSLR and Mirrorless Cameras 180MB/s Read & 90MB/s Write,Warehouse A,103,88,2025-02-09 01:19:00,15
23142,ORD_23143,10260,AND Chic Connect & Chic Connect Pack of 2 Body Mist 400 ml,Warehouse B,33,25,2025-02-09 16:53:00,8
23143,ORD_23144,28816,Global Desi Cosmic Charm Eau De Parfum 50ML & Magical Maze Body Mist 200ML Pack of 2 for Women Crafted by Ajmal,Warehouse A,109,90,2025-02-09 01:19:00,19
23144,ORD_23145,27037,Vertap 16mg Tablet,Warehouse C,26,14,2025-02-09 09:11:00,12
23145,ORD_23146,28438,GLYNO INFOTEL Camera Lens Protector for iPhone 14 PRO/ 14 PRO MAX [Case-Friendly] [Anti-Scratch] [Metal Finish] - (Purple),Warehouse B,33,21,2025-02-09 23:11:00,12
23146,ORD_23147,28437,Purifying Toner,Warehouse C,32,14,2025-02-09 21:28:00,18
23147,ORD_23148,9721,Rabetex 20mg Tablet,Warehouse A,53,44,2025-02-09 16:26:00,9
23148,ORD_23149,20495,Artmon L 80mg/480mg Tablet,Warehouse B,66,53,2025-02-09 08:52:00,13
23149,ORD_23150,34091,Clarford 250mg Tablet,Warehouse B,100,94,2025-02-09 23:16:00,6
23150,ORD_23151,16647,Scornac MR 100mg/325mg/250mg Tablet,Warehouse C,24,10,2025-02-09 20:46:00,14
23151,ORD_23152,10024,"SanDisk Ultra Dual Drive Go USB Type C Pendrive for Mobile, Navy Blue, 64GB, 5Y Warranty",Warehouse A,69,61,2025-02-09 02:11:00,8
23152,ORD_23153,28429,Metanorm G 1 mg/500 mg Tablet,Warehouse A,109,96,2025-02-09 17:11:00,13
23153,ORD_23154,5595,Dipiglo L 5mg/5mg Tablet,Warehouse B,105,86,2025-02-09 18:52:00,19
23154,ORD_23155,5605,"Blaupunkt SBA20 Party 20W Wireless Soundbar with 2000 mAh Battery I Karaoke Ready with Party RGB Lights I Bluetooth, USB &...",Warehouse B,23,10,2025-02-09 00:31:00,13
23155,ORD_23156,30877,Bio Henna Leaf Hair Cleanser Shampoo & Conditioner 340 Ml,Warehouse C,83,71,2025-02-09 18:22:00,12
23156,ORD_23157,12003,Ajmal Asher Concentrated Perfume Oil Oriental And Raindrops Femme Deodorant Floral Chypre Fragrance 212 ml,Warehouse A,55,42,2025-02-09 19:45:00,13
23157,ORD_23158,18862,Gabof M 300mg/500mcg Tablet,Warehouse C,17,7,2025-02-09 20:21:00,10
23158,ORD_23159,20728,Pikkme Mi Redmi Note 10 / Note 10s / Note 11 SE Flip Cover| PU Leather Finish | 360 Protection | Wallet & Stand | Strong M...,Warehouse C,17,4,2025-02-09 01:14:00,13
23159,ORD_23160,28743,Apple iPhone 12 (64GB) - Blue,Warehouse C,70,64,2025-02-09 23:18:00,6
23160,ORD_23161,19490,Aripaso 10mg Tablet,Warehouse C,42,36,2025-02-09 21:13:00,6
23161,ORD_23162,27121,Antiseptic Liquid 550 ml + Laundry Sanitizer- Spring Blossom 480 ml,Warehouse C,43,33,2025-02-09 13:41:00,10
23162,ORD_23163,15540,Perfumed Deo - Livewire,Warehouse B,80,66,2025-02-09 02:04:00,14
23163,ORD_23164,5139,Rawpril 5mg Tablet,Warehouse A,17,7,2025-02-09 09:35:00,10
23164,ORD_23165,1407,"KAVANA (3 pcs) Type G, Universal Flat Pin 3Pin Travel Power Plug Converter Adapter Compatible in UK Countries, England, Sc...",Warehouse A,89,78,2025-02-09 12:42:00,11
23165,ORD_23166,16764,Wipetri Plus Tablet,Warehouse B,65,58,2025-02-09 18:31:00,7
23166,ORD_23167,19470,Ease-TH Tablet,Warehouse B,78,73,2025-02-09 16:54:00,5
23167,ORD_23168,26107,Candeol Cream,Warehouse B,87,82,2025-02-09 00:28:00,5
23168,ORD_23169,18537,Vega Mini Flat Brush (R7 - FB) 75 gm,Warehouse C,65,57,2025-02-09 05:57:00,8
23169,ORD_23170,5112,Ekorab D 30mg/20mg Capsule SR,Warehouse C,112,96,2025-02-09 11:30:00,16
23170,ORD_23171,10365,Yantralay Silicone Lanyard Sleeve Protective Cover + 6PCS Tempered Glass Screen Guard with Silicone Lens Cover Compatible ...,Warehouse A,55,36,2025-02-09 19:17:00,19
23171,ORD_23172,2175,"Google Pixel 6a 5G (Charcoal, 6GB RAM, 128GB Storage)",Warehouse A,53,37,2025-02-09 10:51:00,16
23172,ORD_23173,2167,Kingston Q500 240GB SATA3 2.5 SSD (SQ500S37/240G),Warehouse A,33,19,2025-02-09 23:22:00,14
23173,ORD_23174,27882,"SupCares Selfie Stick, Extendable Selfie Stick with Wireless Remote and Tripod Stand, Portable, Lightweight, Compatible wi...",Warehouse A,33,21,2025-02-09 03:15:00,12
23174,ORD_23175,34623,Edox 100mg Tablet DT,Warehouse C,21,14,2025-02-09 17:17:00,7
23175,ORD_23176,19196,Clazact 2.250 Injection,Warehouse B,51,38,2025-02-09 19:10:00,13
23176,ORD_23177,5135,Generic ESP8266 Nodemcu Esp8266 Lua Amica Wifi Internet of Things Development Board Cp2102 Iot,Warehouse B,113,96,2025-02-09 04:07:00,17
23177,ORD_23178,29279,"Honor MagicBook 14, AMD Ryzen 5 5500U 14""(35.56 cm)FHD IPS Anti-Glare T&L Laptop(8GB/512GB PCIe SSD/Win11/Fingerprint Logi...",Warehouse B,54,36,2025-02-09 11:32:00,18
23178,ORD_23179,32271,CASEOLOGY by Spigen Vault Back Cover Case for iPhone 13 (TPU | Matte Black | Rugged Sandstone Textured),Warehouse B,21,3,2025-02-09 04:25:00,18
23179,ORD_23180,9987,"Lightning to 3.5 mm Headphone Jack Adapter for iOS 13 and Later, Audio AUX Converter Cable iOS to 3.5mm Headphone/Earphone...",Warehouse B,28,23,2025-02-09 15:13:00,5
23180,ORD_23181,28357,"Sery Stay On Matte Liquid Lipstick Hot Damn, Pink (LSO - 12) 5 ml",Warehouse C,85,73,2025-02-09 05:32:00,12
23181,ORD_23182,26228,Myglamm Lit - Ph Lip Balm - Bite Me 2 Gm,Warehouse C,112,97,2025-02-09 11:24:00,15
23182,ORD_23183,20665,Atogold CV 10mg/75mg Tablet,Warehouse A,29,17,2025-02-09 20:45:00,12
23183,ORD_23184,27794,Moxylong SS 250 mg/250 mg Tablet,Warehouse C,74,64,2025-02-09 12:11:00,10
23184,ORD_23185,15112,CEDO Samsung M33 (5G) Case Back Cover Shockproof Bumper Crystal Clear | 360 Degree Protection TPU+PC | Camera Protection |...,Warehouse C,53,39,2025-02-09 23:13:00,14
23185,ORD_23186,32974,TheGiftKart Ultra-Hybrid Crystal Clear Back Case Cover for Samsung Galaxy A33 5G | Shockproof Design | Camera Protection B...,Warehouse A,69,52,2025-02-09 00:57:00,17
23186,ORD_23187,26145,For Men Set - Eau De Toilette + Deodorant,Warehouse A,43,37,2025-02-09 10:47:00,6
23187,ORD_23188,12405,Nicoquine Suspension,Warehouse B,56,39,2025-02-09 01:54:00,17
23188,ORD_23189,19282,"iQOO Neo 6 5G (Cyber Rage, 12GB RAM,256GB Storage) | Only Snapdragon 870 in The Segment | 50% Charge in Just 12 Mins | 90 ...",Warehouse B,66,51,2025-02-09 21:29:00,15
23189,ORD_23190,5034,Silagress 50mg Tablet,Warehouse A,96,81,2025-02-09 07:56:00,15
23190,ORD_23191,12522,Yantralay School Of Gadgets 360 Degree Rotatable J-Hook Buckle Base Vertical Surface Mount Adapter Compatible with Gopro H...,Warehouse B,36,28,2025-02-09 14:04:00,8
23191,ORD_23192,28702,Soulflower Aroma Oil - Rajnigandha 30 ml,Warehouse B,84,76,2025-02-09 08:01:00,8
23192,ORD_23193,27325,Sunarte 50mg Tablet,Warehouse B,99,81,2025-02-09 21:41:00,18
23193,ORD_23194,28700,Bathing Soap - Basil Scrub,Warehouse A,27,20,2025-02-09 02:39:00,7
23194,ORD_23195,16816,LRIPL Compatible Sony Bravia LCD/led Remote Works with Almost All Sony led/LCD tv's,Warehouse A,89,76,2025-02-09 17:08:00,13
23195,ORD_23196,32168,"Nivea Deodorant, Protect & Care for Women, 150ml",Warehouse B,96,85,2025-02-09 02:30:00,11
23196,ORD_23197,6243,Rolod Tablet MR,Warehouse A,18,11,2025-02-09 10:34:00,7
23197,ORD_23198,33101,Zayn & Myza Hymn No Alcohol Body Spray For Men 120 ml,Warehouse B,12,7,2025-02-09 23:25:00,5
23198,ORD_23199,27227,REVLON ColorStay Look Book Eye Shadow Palette - Rocker (1S10330B01183006),Warehouse C,84,72,2025-02-09 13:30:00,12
23199,ORD_23200,28630,Nimidol 100mg/325mg Tablet,Warehouse C,50,40,2025-02-09 09:41:00,10
23200,ORD_23201,1269,"Teen Teen Color Life Non Transfer Lipstick, Red, 2 g",Warehouse B,21,11,2025-02-09 08:39:00,10
23201,ORD_23202,5460,Alicia Souza | The Ultimate 2023 Hardbound Planner | Pocket Planner | A Wonderful Big Book of Stickers | Habit & Budget Tr...,Warehouse A,76,62,2025-02-09 12:19:00,14
23202,ORD_23203,14875,Nature - Germ Protection Handwash Refill,Warehouse C,90,76,2025-02-09 05:23:00,14
23203,ORD_23204,25820,Doubledicestore Tempered Glass Screen Protector Compatible for Samsung Galaxy S20 FE 5G/4G with Edge to Edge Coverage and ...,Warehouse C,49,35,2025-02-09 19:19:00,14
23204,ORD_23205,19963,"Ant Esports GM40 Wired Optical Gaming Mouse with RGB LED, Lightweight and Ergonomic Design, DPI Upto 2400, Compatible with...",Warehouse B,38,25,2025-02-09 12:01:00,13
23205,ORD_23206,16075,Chaste Noir Eau De Toilette For Men,Warehouse C,12,7,2025-02-09 17:54:00,5
23206,ORD_23207,6264,"QUBO 10A Smart Plug from Hero Group |Energy Monitoring, Suitable for small devices like TVs, Air purifiers, Kettles, Mobil...",Warehouse B,29,11,2025-02-09 19:21:00,18
23207,ORD_23208,19218,PS Mite 5% Cream,Warehouse A,15,8,2025-02-09 15:23:00,7
23208,ORD_23209,12228,Pure Hands Deep Cleansing Hand Wash - Tulsi & Lemon,Warehouse B,28,23,2025-02-09 20:09:00,5
23209,ORD_23210,4293,"ONE ASSIST Live Uninterrupted 1 Year Extended Warranty Plan for Air Cooler, Email Delivery Within 2 Hours, No Physical Kit...",Warehouse A,27,15,2025-02-09 14:05:00,12
23210,ORD_23211,26126,"Mobilife Long Selfie Stick Tripod,110cm Selfie Stick with Upgrated Tripod Stand Custom Bluetooth Remote Aluminum Selfie Tr...",Warehouse A,51,40,2025-02-09 20:37:00,11
23211,ORD_23212,2748,Zencylin CV Dry Syrup,Warehouse C,65,60,2025-02-09 08:43:00,5
23212,ORD_23213,9975,"Fashion Colour Soft Lip Mousse, 19 Vibrant Violet 8 gm",Warehouse B,28,15,2025-02-09 19:15:00,13
23213,ORD_23214,26159,Windox 100mg Tablet,Warehouse C,74,67,2025-02-09 20:28:00,7
23214,ORD_23215,32249,Tampons Easy Twist - Super Plus,Warehouse B,56,46,2025-02-09 23:07:00,10
23215,ORD_23216,5434,Faces Canada Ultime Pro Lip Definer Red 01 0.35 Gm,Warehouse C,64,54,2025-02-09 15:41:00,10
23216,ORD_23217,15968,Vega Round Brush (E17 - RB) 93 gm,Warehouse A,93,77,2025-02-09 18:50:00,16
23217,ORD_23218,29317,Robiflam 400mg Tablet,Warehouse C,28,15,2025-02-09 17:51:00,13
23218,ORD_23219,2442,"AmazonBasics Extended Gaming Mouse Pad,Black",Warehouse C,59,52,2025-02-09 08:16:00,7
23219,ORD_23220,20681,"Parker Vector Camouflage Gift Set - Roller Ball Pen & Parker Logo Keychain (Black Body, Blue Ink), 2 Piece Set",Warehouse B,103,89,2025-02-09 15:57:00,14
23220,ORD_23221,34686,ADS Good Choice India 36 Color Shiner Eyeshadow A8336,Warehouse A,90,83,2025-02-09 11:11:00,7
23221,ORD_23222,11458,Robustrion Anti-Scratch & Smudge Proof Premium Tempered Glass Screen Protector for Samsung Galaxy Tab S8 Plus / S7 Plus / ...,Warehouse B,30,19,2025-02-09 08:27:00,11
23222,ORD_23223,16006,Ayurvedic Karela Powder,Warehouse C,76,58,2025-02-09 03:36:00,18
23223,ORD_23224,11457,"COSMAC PROFESSIONAL BB CREAM, BLUSHER & BEAUTIFUL EYELASHES. COMBO (PACK OF 3)",Warehouse A,54,44,2025-02-09 10:55:00,10
23224,ORD_23225,15019,Aloe Aqua Face Wash + Makeup Remover,Warehouse C,31,25,2025-02-09 21:03:00,6
23225,ORD_23226,15015,"NIHARA Smart Multipurpose Foldable Laptop Table with Cup Holder, Study Table, Bed Table, Breakfast Table, Foldable and Por...",Warehouse B,46,29,2025-02-09 22:28:00,17
23226,ORD_23227,11684,Tyzone S 500mg/500mg Injection,Warehouse C,80,73,2025-02-09 13:06:00,7
23227,ORD_23228,14999,"Brustro Artists Sketch Book Wiro Bound A5 Size ( 14.8 CM x 21 CM ), 116 Pages,160 GSM (Acid Free)",Warehouse C,103,88,2025-02-09 12:33:00,15
23228,ORD_23229,25977,DOROFEY PROFESSIONAL Detox Botox Sulfate- free shampoo 300ml,Warehouse B,98,83,2025-02-09 05:22:00,15
23229,ORD_23230,4300,Goben 100mg Tablet,Warehouse B,80,75,2025-02-09 11:41:00,5
23230,ORD_23231,18506,"Samsung Guru Music 2 315 (GT-B315, Blue) (SM-B315EZBDINS)",Warehouse A,86,68,2025-02-09 19:10:00,18
23231,ORD_23232,20846,"Redmi 10 Power (Power Black, 8GB RAM, 128GB Storage)",Warehouse C,23,5,2025-02-09 01:51:00,18
23232,ORD_23233,33252,EVM EnSave 512GB Smallest Portable External SSD with 3D NAND Flash Technology Speed of 550/R 500/W MB/s IP55 Rated- Compat...,Warehouse C,69,56,2025-02-09 16:02:00,13
23233,ORD_23234,1381,Artistry Cartridge Tattoo Needle (1007RL),Warehouse A,74,59,2025-02-09 18:59:00,15
23234,ORD_23235,19441,Vanilla Lip Balm,Warehouse A,28,19,2025-02-09 07:55:00,9
23235,ORD_23236,26062,Maxivog 0.3mg Tablet,Warehouse A,60,43,2025-02-09 04:29:00,17
23236,ORD_23237,4314,TheGiftKart Shockproof Crystal Clear Back Cover Case for OnePlus 7T | 360 Degree Protection | Protective Design | Transpar...,Warehouse A,54,39,2025-02-09 11:12:00,15
23237,ORD_23238,15988,Lactodor Syrup,Warehouse C,76,61,2025-02-09 04:49:00,15
23238,ORD_23239,34692,Pantociin-DSR Capsule,Warehouse B,107,89,2025-02-09 10:24:00,18
23239,ORD_23240,15989,Jovees Skin Toner - Rose 100 ml,Warehouse C,73,66,2025-02-09 05:10:00,7
23240,ORD_23241,9964,Paraspapermart PPM Rubber Band - Fluorescent Color 2 inch Pack of 50 Grams - for Office/Home and Kitchen Use,Warehouse B,62,57,2025-02-09 22:40:00,5
23241,ORD_23242,34709,Neuromec Plus Injection,Warehouse A,65,52,2025-02-09 21:23:00,13
23242,ORD_23243,28590,Bonmycin 250 Tablet,Warehouse C,109,94,2025-02-09 12:52:00,15
23243,ORD_23244,10370,"boAt Bassheads 192 Wired in Ear Earphones Signature Sound, Metallic Buds, Superior Cable & Ergonomic Fit with Mic (Active ...",Warehouse C,33,18,2025-02-09 10:50:00,15
23244,ORD_23245,10143,Camlin Elegante Fountain Pen - Black/Blue/Red,Warehouse B,64,58,2025-02-09 03:07:00,6
23245,ORD_23246,1823,Dubact 5mg Tablet,Warehouse B,32,22,2025-02-09 23:45:00,10
23246,ORD_23247,20787,TP-Link Archer T2UB Nano AC600 USB 2.0 Wi-Fi Bluetooth 4.2 USB Adapter | Dual Band Wireless 600 Mbps| Plug and Play | Supp...,Warehouse C,94,80,2025-02-09 09:52:00,14
23247,ORD_23248,1384,Lenphor Nail Tint Orange Bar 08 12 Ml,Warehouse C,39,22,2025-02-09 17:04:00,17
23248,ORD_23249,16767,Mesahenz 800 Tablet,Warehouse A,90,77,2025-02-09 18:42:00,13
23249,ORD_23250,20036,Kamflox-OZ 200mg/500mg Tablet,Warehouse B,83,69,2025-02-09 01:58:00,14
23250,ORD_23251,36382,Soulflower Sweet Rose Soap 150 gm,Warehouse A,83,72,2025-02-09 12:38:00,11
23251,ORD_23252,34729,Mumzole D 10mg/20mg Capsule,Warehouse B,65,52,2025-02-09 16:05:00,13
23252,ORD_23253,6158,OneAssist 2 Years Extended Warranty Plan for Headphones 1001 to 2000 - Email Delivery Within 2 Hours,Warehouse C,87,76,2025-02-09 10:32:00,11
23253,ORD_23254,16747,Daily Shine Conditioner,Warehouse A,80,63,2025-02-09 15:12:00,17
23254,ORD_23255,32262,Babymoon (Set of 2) Baby Angel Feather Wings with Tiara) Best Costume/Photography Props/Photoshoot/Baby Shower Gift (White),Warehouse C,33,15,2025-02-09 09:49:00,18
23255,ORD_23256,26181,URBN 10000 mAh Lithium_Polymer 15W Super Fast Charging Wireless Power Bank with 22.5W Type C PD (Input& Output) and QC 3.0...,Warehouse B,63,56,2025-02-09 23:06:00,7
23256,ORD_23257,1923,ENIVO Women's & Girl's Multipurpose 7 Pink Makeup Brushes Set with 1 White Fan Brush - (Pack of 8),Warehouse B,51,39,2025-02-09 09:03:00,12
23257,ORD_23258,20697,Vitamin C & Zinc Effervescent Tablets,Warehouse C,88,74,2025-02-09 21:14:00,14
23258,ORD_23259,27826,Zondal 400mg Tablet,Warehouse A,78,64,2025-02-09 12:20:00,14
23259,ORD_23260,6056,Telinam Tablet,Warehouse B,81,73,2025-02-09 10:08:00,8
23260,ORD_23261,5168,"Spigen Liquid Air Cover Case Designed for Galaxy Watch 4 (44mm) (Samsung Galaxy Watch 5 / 4 (44mm), Military Green) (Watch...",Warehouse A,70,52,2025-02-09 05:03:00,18
23261,ORD_23262,15098,Elcef LB Tablet,Warehouse C,96,81,2025-02-09 00:54:00,15
23262,ORD_23263,34609,Triacute 40 Injection,Warehouse A,44,25,2025-02-09 05:10:00,19
23263,ORD_23264,5164,"Fashion Colour Lip Crayon, Waterproof, Long Lasting, 21 Coffee Break 2.8 gm",Warehouse B,104,94,2025-02-09 11:11:00,10
23264,ORD_23265,27104,"Gadget Wagon 32 to 55 Inch led TV Wall Mount Movable Swivel Corner Bracket P4, Swivel and Tilt Corner, Full Motion",Warehouse A,72,58,2025-02-09 17:59:00,14
23265,ORD_23266,32982,"Ahuja NBA-15 Portable Rechargeable Speaker with 1 No Neckband Microphone, Black, 340GMS",Warehouse B,88,79,2025-02-09 19:29:00,9
23266,ORD_23267,10152,Itanz 100mg Capsule,Warehouse C,70,55,2025-02-09 22:46:00,15
23267,ORD_23268,5156,Telmisat 80H Tablet,Warehouse B,60,50,2025-02-09 06:59:00,10
23268,ORD_23269,11896,"Ambrane 2 in 1 Type-C & Micro USB Cable with 60W / 3A Fast Charging, 480 mbps High Data, PD Technology & Quick Charge 3.0,...",Warehouse A,19,5,2025-02-09 03:17:00,14
23269,ORD_23270,32217,Celovan 500mg Injection,Warehouse C,107,94,2025-02-09 19:42:00,13
23270,ORD_23271,15074,Anaspas 25mg Injection,Warehouse C,48,41,2025-02-09 14:45:00,7
23271,ORD_23272,34682,Fixab AZ 200mg/250mg Tablet,Warehouse B,95,78,2025-02-09 09:01:00,17
23272,ORD_23273,4902,"Lapster Fast iphone charger cable & Data Sync USB Cable Compatible for iPhone 6/6S/7/7+/8/8+/10/11, ipad charger for iPad ...",Warehouse A,27,19,2025-02-09 12:43:00,8
23273,ORD_23274,15044,"Redragon ARES H120 Gaming Headset with Microphone for PC, Wired Over Ear PC Gaming Headphone with Mic Built-in Noise Reduc...",Warehouse C,55,44,2025-02-09 05:23:00,11
23274,ORD_23275,32233,AGARO AG Blaze Micro to USB Type C Adapter,Warehouse B,77,64,2025-02-09 04:33:00,13
23275,ORD_23276,6146,Antop-LSR Capsule,Warehouse B,101,89,2025-02-09 13:48:00,12
23276,ORD_23277,28287,"Acer EK240YC 23.8 Inch (60.4cm) Full HD (1920x1080) Pixels VA Panel LCD Monitor with LED Back Light I 250 Nits I HDMI, VGA...",Warehouse A,91,78,2025-02-09 08:57:00,13
23277,ORD_23278,16002,"Samsung Galaxy S21 FE 5G (Lavender, 8GB, 128GB Storage)",Warehouse C,23,9,2025-02-09 16:31:00,14
23278,ORD_23279,16003,The Moms Co. Baby Hair Oil 100 ml,Warehouse B,21,15,2025-02-09 21:05:00,6
23279,ORD_23280,26012,HP 678 Black Ink Advantage Cartridge (CZ107AA),Warehouse C,9,4,2025-02-09 11:28:00,5
23280,ORD_23281,9087,"Itel MagicX Pro 4G (Wi-Fi Hotspot Tethering, 2500mAh Big Battery, 2.4inch QVGA 3D Curved Display, 1.3 MP Rear Camera with ...",Warehouse A,96,86,2025-02-09 22:59:00,10
23281,ORD_23282,27924,Loliflam 100mg/325mg Tablet,Warehouse A,116,98,2025-02-09 01:31:00,18
23282,ORD_23283,5115,Aegte Under Eye Gel For Men & Women 15 ml,Warehouse A,72,67,2025-02-09 15:03:00,5
23283,ORD_23284,19436,"Infinity (JBL) Swing 320 by Harman 19 Hours of Playtime, Dual Equalizers, Dual Connect, Bluetooth 5.0, Type C & Voice Assi...",Warehouse B,28,23,2025-02-09 07:14:00,5
23284,ORD_23285,1304,Amazon Brand - Solimo Acrylic 360 Protection Border Back Cover for LG G8X ThinQ (Black),Warehouse B,76,65,2025-02-09 11:00:00,11
23285,ORD_23286,32738,"ESR Screen Protector Compatible with iPad Pro 11 Inch (2022/2021/2020/2018) and iPad Air 5/4 (2022/2020, 10.9 Inch), Tempe...",Warehouse B,71,66,2025-02-09 03:07:00,5
23286,ORD_23287,34862,Thiaplex 200mg Injection,Warehouse A,32,13,2025-02-09 11:01:00,19
23287,ORD_23288,5450,"Face Mask with Reflective Logo - Adjustable, Medium, Green & Peach",Warehouse C,104,93,2025-02-09 00:32:00,11
23288,ORD_23289,28598,Omesung-D Capsule,Warehouse C,46,28,2025-02-09 16:14:00,18
23289,ORD_23290,20880,Nalpamaradi Keram,Warehouse B,103,84,2025-02-09 09:58:00,19
23290,ORD_23291,16138,Wevert 16 Tablet,Warehouse B,52,45,2025-02-09 05:04:00,7
23291,ORD_23292,19237,Prostagard 8 Capsule,Warehouse C,80,67,2025-02-09 10:43:00,13
23292,ORD_23293,32706,Herbal Hair Oil,Warehouse A,19,11,2025-02-09 15:49:00,8
23293,ORD_23294,14944,Bacend 250 Tablet,Warehouse B,89,83,2025-02-09 01:58:00,6
23294,ORD_23295,27204,"OnePlus 11R 5G (Sonic Black, 16GB RAM, 256GB Storage)",Warehouse A,111,93,2025-02-09 00:12:00,18
23295,ORD_23296,28237,Maryaj Blaze EDP Citrus Aromatic Perfume And Ajmal Silver Shade Homme Deodorant Citrus Woody Fragrance 300 ml,Warehouse C,91,79,2025-02-09 17:01:00,12
23296,ORD_23297,18487,Ulfaz 1gm Injection,Warehouse A,24,18,2025-02-09 02:32:00,6
23297,ORD_23298,16032,"Face Mask  - Pro Tech 95, 6 layered, Medium, MK18004",Warehouse B,106,96,2025-02-09 13:35:00,10
23298,ORD_23299,9864,Stuffcool PB9018W 10000mAH Magnetic Wireless Powerbank for iPhone 12/13/14 Series (Grey),Warehouse C,61,47,2025-02-09 10:31:00,14
23299,ORD_23300,25893,Syska EBS-0401 Essential 4-Socket Surge Protector with 2M Wire Length (White),Warehouse B,30,25,2025-02-09 02:39:00,5
23300,ORD_23301,34828,Faberge Brut Classic EDT - 100 ml,Warehouse B,26,18,2025-02-09 17:41:00,8
23301,ORD_23302,4663,"Gizga Essentials 2-in-1 Professional Cleaning Kit (XL -170ML) for Camera, Lens, Binocular, Laptop, TV, Monitor,Smartphone,...",Warehouse B,75,63,2025-02-09 18:43:00,12
23302,ORD_23303,33089,NOTE SMOKEY EYE PENCIL 05 1.2 gm,Warehouse A,16,10,2025-02-09 00:32:00,6
23303,ORD_23304,29446,Qcan Mouth Paint,Warehouse B,98,88,2025-02-09 23:18:00,10
23304,ORD_23305,6221,Belkin Essential Series 4-Socket Surge Protector Universal Socket with 5ft Heavy Duty Cable (Grey),Warehouse C,84,74,2025-02-09 07:51:00,10
23305,ORD_23306,9528,Sukafete 1gm Oral Suspension,Warehouse C,65,59,2025-02-09 15:53:00,6
23306,ORD_23307,11440,Rostar 5 Tablet,Warehouse C,89,79,2025-02-09 22:05:00,10
23307,ORD_23308,9023,Ondistat 4mg Tablet,Warehouse C,76,70,2025-02-09 21:01:00,6
23308,ORD_23309,27335,"Fashion Colour Non - Transfer Matt Waterproof Lipstick, 21 Vermilion 2.6 gm",Warehouse C,65,54,2025-02-09 18:48:00,11
23309,ORD_23310,5507,BabyChakra Nourishing Lip Balm Duo Pack - 2 1's,Warehouse A,44,30,2025-02-09 08:14:00,14
23310,ORD_23311,11652,XP-PEN Deco Mini 7 Graphics Tablet 17.78 cm x 11.09 cm (7 x 4.37 inches) Pen Tablet with 8192 Levels Pressure Sensitivity ...,Warehouse A,103,92,2025-02-09 00:49:00,11
23311,ORD_23312,1844,"Deborah Milano Fluid Velvet Mat Lip Stick, Fire Red, 1.3g",Warehouse C,62,45,2025-02-09 08:24:00,17
23312,ORD_23313,34836,"LAKMÉ Face It Compact, Pearl, 9 g",Warehouse A,89,81,2025-02-09 02:37:00,8
23313,ORD_23314,16057,Global Desi Cosmic Charm Eau De Parfum 100ML & Magical Maze Body Mist 200ML Pack of 2 for Women Crafted by Ajmal,Warehouse A,71,54,2025-02-09 07:00:00,17
23314,ORD_23315,29450,Haldi Chandan Soap,Warehouse A,31,18,2025-02-09 17:41:00,13
23315,ORD_23316,27174,Neurozide 2500mcg Injection,Warehouse B,48,37,2025-02-09 18:35:00,11
23316,ORD_23317,34810,Sony Bravia 80 cm (32 inches) HD Ready Smart LED Google TV KD-32W820K (Black) (2022 Model) | with Alexa Compatibility,Warehouse C,20,14,2025-02-09 23:08:00,6
23317,ORD_23318,20873,"MX Universal Conversion Multiplug with Individual Switch - 3 PIN 3 Way Plug for Home, Office and Industrial Uses ( Any Col...",Warehouse C,80,71,2025-02-09 19:13:00,9
23318,ORD_23319,25904,"CrossBeats Orbit Infiniti 2.0 1.43-Inch 454×454 PXL AMOLED Screen Smartwatch, Calling+Connect with TWS, Always on Display,...",Warehouse B,33,21,2025-02-09 16:17:00,12
23319,ORD_23320,20867,"realme narzo 50 5G (Hyper Blue, 6GB RAM+128GB Storage) Dimensity 810 5G Processor | 48MP Ultra HD Camera",Warehouse A,105,97,2025-02-09 04:42:00,8
23320,ORD_23321,16059,"Arata Natural Hair Styling Combo with Hair Gel(50 Ml) & Hair Cream(50 Ml) Nourishing ,Styling & Strong Hold 100 ml",Warehouse C,88,80,2025-02-09 03:39:00,8
23321,ORD_23322,26988,"iQOO Neo 7 5G (Interstellar Black, 8GB RAM, 128GB Storage) | Dimensity 8200, only 4nm Processor in The Segment| 50% Charge...",Warehouse C,25,17,2025-02-09 17:20:00,8
23322,ORD_23323,34143,"realme narzo 50 (Speed Blue, 4GB RAM+64GB Storage) 120Hz Full HD+ Display | 50MP AI Triple Camera | Helio G96 Powerful Gam...",Warehouse A,66,51,2025-02-09 02:32:00,15
23323,ORD_23324,4533,"Amkette Ergo Fold Alloy Portable Laptop Stand, Aluminium Alloy stand with 7 Adjustable Levels and Riveted Joints, Anti Sli...",Warehouse B,23,15,2025-02-09 10:30:00,8
23324,ORD_23325,26743,Ajmal Blu Perfume Deodorant 200ml Body Spray Gift For men,Warehouse B,24,6,2025-02-09 08:52:00,18
23325,ORD_23326,33659,Cixdop 100 LB Dry Syrup,Warehouse A,71,60,2025-02-09 23:25:00,11
23326,ORD_23327,34151,Elvicet M 5mg/10mg Tablet,Warehouse C,52,40,2025-02-09 02:13:00,12
23327,ORD_23328,10235,"Wella Professionals SP Sp Hydrate Regime For Dry Hair - Shampoo 250ml, Conditioner 200ml, Mask 200ml Set, 3 Pieces",Warehouse C,32,19,2025-02-09 00:04:00,13
23328,ORD_23329,10182,Elect 12mg Tablet DT,Warehouse C,93,79,2025-02-09 18:15:00,14
23329,ORD_23330,2027,Tisol 400mg Tablet,Warehouse B,51,42,2025-02-09 22:26:00,9
23330,ORD_23331,34344,Portronics Konnect L 1.2M Fast Charging 3A Micro USB Cable with Charge & Sync Function (White),Warehouse C,14,6,2025-02-09 02:31:00,8
23331,ORD_23332,20370,Exilam Beta Tablet,Warehouse B,49,41,2025-02-09 10:00:00,8
23332,ORD_23333,26687,Xeeline 100mg Dry Syrup,Warehouse A,100,94,2025-02-09 07:00:00,6
23333,ORD_23334,32874,VIB 12 1000mcg Injection,Warehouse B,104,87,2025-02-09 13:39:00,17
23334,ORD_23335,1738,Aldase D 50mg/10mg Tablet,Warehouse B,84,70,2025-02-09 14:28:00,14
23335,ORD_23336,28377,"Caprigo Heavy Duty TV Wall Mount Stand for 12 to 27 Inch LED/LCD/Monitor Screen’s, Full Motion Rotatable Universal TV & Mo...",Warehouse C,89,78,2025-02-09 01:22:00,11
23336,ORD_23337,26680,"LIRAMARK Webcam Cover Slide, Ultra Thin Laptop Camera Cover Slide Blocker for Computer MacBook Pro iMac PC Tablet (Pack of 3)",Warehouse C,68,52,2025-02-09 04:30:00,16
23337,ORD_23338,34348,Letrova 2.5mg Tablet,Warehouse C,110,91,2025-02-09 18:44:00,19
23338,ORD_23339,1728,Trivofid 2 Tablet,Warehouse C,36,19,2025-02-09 05:53:00,17
23339,ORD_23340,27613,Sounce Pack 3 Silicone Bands for Fitbit Charge 4 / Fitbit Charge 3 / Charge 3 SE Replacement Wristbands for Women and Men ...,Warehouse B,90,84,2025-02-09 23:16:00,6
23340,ORD_23341,27619,HP 46 Ink Cartridge (Black),Warehouse C,42,23,2025-02-09 20:57:00,19
23341,ORD_23342,5802,Tamslar-D Tablet,Warehouse B,46,36,2025-02-09 11:07:00,10
23342,ORD_23343,15714,Alnim P 100 mg/500 mg Tablet,Warehouse A,60,51,2025-02-09 09:56:00,9
23343,ORD_23344,12198,Oflocom OZ Tablet,Warehouse A,87,68,2025-02-09 05:44:00,19
23344,ORD_23345,2402,Amtax 250mg Injection,Warehouse A,16,4,2025-02-09 00:22:00,12
23345,ORD_23346,28833,Alzot 0.5mg Tablet SR,Warehouse A,90,73,2025-02-09 21:38:00,17
23346,ORD_23347,26654,"Panasonic Evolta AAA Alkaline Advanced Power, Extra Power Formula, no Mercury add, Anti-Leak Seal, Protects Power for up t...",Warehouse A,94,86,2025-02-09 14:38:00,8
23347,ORD_23348,12006,Zycet M 5mg/10mg Tablet,Warehouse C,46,28,2025-02-09 17:01:00,18
23348,ORD_23349,4376,"Panasonic AAA eneloop Ni‐MH Rechargeable Batteries,low self discharge for multi use up to 800 mAh capacity,storage life ho...",Warehouse A,94,76,2025-02-09 03:29:00,18
23349,ORD_23350,14945,VITRO I AM NATURAL Aloe Vera Gel (Pack of 2) 200 gm,Warehouse B,32,16,2025-02-09 22:17:00,16
23350,ORD_23351,25955,boAt BassHeads 900 On-Ear Wired Headphone with Mic,Warehouse C,20,7,2025-02-09 02:15:00,13
23351,ORD_23352,34761,Invastin 20 Tablet,Warehouse C,96,88,2025-02-09 13:36:00,8
23352,ORD_23353,21011,"LAKMÉ Absolute Argan Oil Serum Foundation with SPF 45, Ivory Cream/Warm Creme, 15ml, Dewy & Radiant Finish",Warehouse A,36,17,2025-02-09 16:10:00,19
23353,ORD_23354,1253,Welzin M 2.5mg/4mg Syrup,Warehouse A,75,57,2025-02-09 05:38:00,18
23354,ORD_23355,12550,Dhathri Dheedhi Daily Herbal Shampoo | Mild Shampoo for daily use - 100ml (Pack of 2),Warehouse B,52,42,2025-02-09 03:12:00,10
23355,ORD_23356,28143,Rotovas Gold 10mg/75mg Tablet,Warehouse A,77,66,2025-02-09 06:13:00,11
23356,ORD_23357,4248,Manish Malhotra Nail Lacquer - Champagne Rush 12 Ml,Warehouse C,118,99,2025-02-09 10:20:00,19
23357,ORD_23358,15606,Nandika Beauty Peel Off Face Mask - Charcoal 100 ml,Warehouse C,19,12,2025-02-09 08:44:00,7
23358,ORD_23359,28663,Cudine M 10mg/120mg Tablet,Warehouse A,98,91,2025-02-09 07:28:00,7
23359,ORD_23360,14838,Vega Flat Brush (R11 - FB) 97 gm,Warehouse C,100,81,2025-02-09 21:29:00,19
23360,ORD_23361,18918,TRONI Foldable Bed Study Table Portable Wood Multifunction Laptop-Table Lapdesk for Children Bed Foldabe Table Work Office...,Warehouse A,35,19,2025-02-09 11:04:00,16
23361,ORD_23362,12113,Revolution Blusher Reloaded Rose Kiss 7.5 gm,Warehouse C,51,39,2025-02-09 12:05:00,12
23362,ORD_23363,9918,"boAt Newly Launched Aavante Bar Mystiq Soundbar with 100W RMS Signature Sound, 2.1 CH,Multi-Connectivity Modes,BT v5.3,Wir...",Warehouse C,99,82,2025-02-09 05:35:00,17
23363,ORD_23364,28171,MAONO AU-400 Lavalier Auxiliary Omnidirectional Microphone (Black),Warehouse A,85,74,2025-02-09 03:40:00,11
23364,ORD_23365,2268,Forpan 40 Tablet,Warehouse B,81,69,2025-02-09 17:37:00,12
23365,ORD_23366,12560,"SanDisk Extreme microSD UHS I Card 512GB for 4K Video on Smartphones,Action Cams,Drones 190MB/s Read,130MB/s Write",Warehouse A,101,85,2025-02-09 14:49:00,16
23366,ORD_23367,34767,"Amazon Brand - Solimo Mira Multi-Purpose Laptop Table With Cup Holder (Brown, Wood, Pack Of 1)",Warehouse C,43,29,2025-02-09 03:27:00,14
23367,ORD_23368,21030,HUDA GIRL BEAUTY Wet Iconic Highlighter and Wild Illuminating Chrome Metallic For Natural Makeup,Warehouse B,50,31,2025-02-09 20:22:00,19
23368,ORD_23369,2456,"LG Ultragear - 32Gn650 Qhd 32 Inch(80 Cm) 2560 X 1440 Pixels, 165 Hz 1Ms, Nvidia G-Sync Compatible, Freesync Premium, HDR ...",Warehouse B,101,91,2025-02-09 08:12:00,10
23369,ORD_23370,28155,Monosone 0.1% Cream,Warehouse B,51,42,2025-02-09 03:48:00,9
23370,ORD_23371,21034,Berina A14 Dark Brown Violet Hair Color Cream 60 gm,Warehouse B,75,60,2025-02-09 15:02:00,15
23371,ORD_23372,25752,Bio Apricot Body Wash 800 Ml,Warehouse B,32,14,2025-02-09 12:48:00,18
23372,ORD_23373,25812,"pTron Newly Launched Bassbuds Zen in-Ear Wireless TWS Earbuds with Quad ENC Mic & TruTalk 50Hrs Playtime, BT5.3 Headphones...",Warehouse A,33,24,2025-02-09 19:31:00,9
23373,ORD_23374,34947,Uldix 0.5mg Tablet,Warehouse A,37,29,2025-02-09 18:09:00,8
23374,ORD_23375,9536,"ProElite Smart Deer Flip case Cover for Amazon Kindle Paperwhite 6.8"" 11th Generation, Wine Red [Fits Signature Edition Also]",Warehouse C,32,17,2025-02-09 17:57:00,15
23375,ORD_23376,5011,Achicid-D 30mg/20mg Capsule,Warehouse A,60,47,2025-02-09 13:43:00,13
23376,ORD_23377,6236,"ZEBRONICS 150Hb 4 Port USB Hub with Dedicated On/Off Switch, Led Indicators, 45Cm Cable Length, Optional Power Input Port,...",Warehouse B,93,77,2025-02-09 05:49:00,16
23377,ORD_23378,1893,"Oraimo 20W Type C Fast Charger PD 3.0 USB C Wall Adapter with USB Type C Cable Compatible for iPhone Charger14,13/13 Mini/...",Warehouse B,37,29,2025-02-09 15:39:00,8
23378,ORD_23379,33894,KAPAVER® for iPhone 13 Back Case [Anti-Fingerprints ][Anti-Scratch] Frosted Translucent Shockproof Slim Cover 6.1 inches (...,Warehouse A,19,13,2025-02-09 13:55:00,6
23379,ORD_23380,25854,"Rapidotzz Band Straps - 2 Pcs (Black, Unisex) | Removable Straps ONLY for Amazfit Bip ,Bip 2, GTS, GTS 2 , Bip U , Galaxy ...",Warehouse B,106,91,2025-02-09 18:43:00,15
23380,ORD_23381,18937,Ace Files Cardboard Lever Arch Box File Ruby 107 (Pack of 8),Warehouse B,88,74,2025-02-09 19:22:00,14
23381,ORD_23382,1254,INSHINE ORIGINALS MicroDot Makeup Fixer | Long Lasting Oil Free Makeup fixer,Warehouse B,52,34,2025-02-09 21:37:00,18
23382,ORD_23383,19956,"Zebronics Zeb-Pluto 2.0 Multimedia Speaker with Aux Connectivity,USB Powered and Volume Control",Warehouse C,58,46,2025-02-09 09:13:00,12
23383,ORD_23384,19958,Fairness Facial Serum - Vitamin C Rich,Warehouse C,44,27,2025-02-09 11:36:00,17
23384,ORD_23385,27947,"Mushroom Head Air Cushion CC Cream, BB Cream, Moisturizing Concealer, Moisturizing BB Cream Makeup Base Long Lasting with ...",Warehouse C,40,23,2025-02-09 06:26:00,17
23385,ORD_23386,27948,SERY Lash Laminate Mascara - Charcoal 15 gm,Warehouse A,106,94,2025-02-09 04:28:00,12
23386,ORD_23387,4911,Levobest 500mg Tablet,Warehouse B,31,24,2025-02-09 14:26:00,7
23387,ORD_23388,4290,VOLITRA S  TABLET 50 MG/10 MG,Warehouse C,20,10,2025-02-09 14:25:00,10
23388,ORD_23389,33767,Gabatol M 300 mg/750 mcg Capsule,Warehouse B,80,68,2025-02-09 13:02:00,12
23389,ORD_23390,33043,Zoftax 500mg Injection,Warehouse B,42,34,2025-02-09 13:02:00,8
23390,ORD_23391,2444,"Aroma® Studio 1 Raftaar 10W Bluetooth Speaker Hi-fi Stereo Sound Surround Upto 10 Hours Playback, Best for Mobile, Laptop/...",Warehouse B,70,57,2025-02-09 10:27:00,13
23391,ORD_23392,2506,Rticlav 400mg/5ml/57mg/5ml Dry Syrup,Warehouse A,43,26,2025-02-09 01:06:00,17
23392,ORD_23393,16147,Murab-DSR Capsule,Warehouse C,50,45,2025-02-09 13:13:00,5
23393,ORD_23394,27965,"Nair Hair Remover Cream Upper Lip Kit, 20 ml || Enriched With Natural Argan Oil || For Dry & Sensitive Skin",Warehouse B,109,93,2025-02-09 03:49:00,16
23394,ORD_23395,34791,Aegte Rice Ubtan Exfoliating Face Wash 100 ml,Warehouse C,81,76,2025-02-09 18:45:00,5
23395,ORD_23396,16371,"Hello Kitty Mini Brush Set- Pink, 7 Pieces",Warehouse A,15,1,2025-02-09 19:31:00,14
23396,ORD_23397,18874,Etzo 0.5mg Tablet,Warehouse A,97,88,2025-02-09 11:45:00,9
23397,ORD_23398,2200,OJOS Ultra Thin Keyboard Cover for 2020-2022 MacBook Pro 13 inch A2338 M2 M1 A2289 A2251 & 2020 2019 New MacBook Pro 16 in...,Warehouse C,105,97,2025-02-09 01:51:00,8
23398,ORD_23399,2202,"CASE PLUS USB Type C to 3.5 mm Jack Audio Connector, Noise Cancelling Headphones Jack Converter Audio Adapter for OnePlus ...",Warehouse C,60,52,2025-02-09 11:03:00,8
23399,ORD_23400,33070,"Verilux® 6 in 1 USB C Hub,Type C Hub with 4K HDMI Output, 55W PD Charging Port,100M Ethernet Hub,1 USB 3.0, 2 USB 2.0 USB ...",Warehouse C,70,57,2025-02-09 23:50:00,13
23400,ORD_23401,25919,Ozip 10mg Tablet,Warehouse B,81,75,2025-02-09 09:50:00,6
23401,ORD_23402,19998,Digital Shoppy 8pcs Magnetic Eyelashes With 2 Magnets Handmade 3D/6D Magnetic Lashes Natural False Eyelashes Magnet Lashes...,Warehouse C,45,29,2025-02-09 15:26:00,16
23402,ORD_23403,25914,Trikatu Capsules,Warehouse B,59,45,2025-02-09 12:11:00,14
23403,ORD_23404,11869,Noldy 50mg Injection,Warehouse A,90,83,2025-02-09 04:25:00,7
23404,ORD_23405,33909,SH. HUDA Matte Me Liquid Beauty Lipstick Pack Of 6pc Multicolor,Warehouse C,102,90,2025-02-09 21:02:00,12
23405,ORD_23406,6209,Renocare 500mg/150mg Tablet,Warehouse C,19,9,2025-02-09 18:28:00,10
23406,ORD_23407,32188,POPIO Tempered Glass Screen Protector Compatible for Samsung Galaxy A53 5G (Black) with Edge to Edge Coverage and Easy Ins...,Warehouse B,63,45,2025-02-09 17:16:00,18
23407,ORD_23408,9535,"Faber-Castell Tri-Grip Brush - Round, Pack of 13 (Assorted)",Warehouse B,57,48,2025-02-09 16:10:00,9
23408,ORD_23409,1311,"Turron Index Flash Cards Tray - 200 GSM, 150 Cards, 3x5 inch, Blank White - with Free Binder Rings for Short Notes, cue Ca...",Warehouse B,58,52,2025-02-09 04:38:00,6
23409,ORD_23410,2281,INEFABLE Oneplus Band Strap and Oppo Band Strap Soft Silicone Adjustable Band Strap - Device Not Included - Black - Pack of 1,Warehouse A,82,76,2025-02-09 16:17:00,6
23410,ORD_23411,28122,Ghungroo India 25 + 25 Cotton String 1.6cm (White),Warehouse C,79,65,2025-02-09 00:37:00,14
23411,ORD_23412,33171,OpenTech® Tempered Glass Screen Protector Compatible for Xiaomi Poco F3 / Poco F3 GT/Poco F4 / Poco F4 GT/Poco X3 / Poco X...,Warehouse A,92,80,2025-02-09 20:11:00,12
23412,ORD_23413,11177,Arblos 25mg Tablet,Warehouse C,44,29,2025-02-09 17:46:00,15
23413,ORD_23414,35152,Sony Bravia 139 cm (55 inches) 4K Ultra HD Smart LED Google TV KD-55X74K (Black),Warehouse A,22,13,2025-02-09 23:52:00,9
23414,ORD_23415,7325,Windapa 10mg Tablet,Warehouse A,75,62,2025-02-09 17:25:00,13
23415,ORD_23416,24904,Calopan-D Tablet,Warehouse B,43,37,2025-02-09 07:55:00,6
23416,ORD_23417,21578,Captiva LD 75mg/40mg Capsule SR,Warehouse C,78,69,2025-02-09 19:22:00,9
23417,ORD_23418,12803,NYKAA Glamoreyes Eyeliner Pencil 1.2g (Blue Hex -01),Warehouse A,39,23,2025-02-09 05:45:00,16
23418,ORD_23419,12646,"HP Smart Tank 670 All-in-One Wireless Integrated Ink Tank Colour Printer, Scanner, Copier with Auto-Duplex, High Capacity ...",Warehouse B,49,38,2025-02-09 00:46:00,11
23419,ORD_23420,21598,B Coxi 90mg Tablet,Warehouse A,68,54,2025-02-09 08:31:00,14
23420,ORD_23421,18197,ARJUNIN Capsules -The Cardiac Tonic,Warehouse C,90,77,2025-02-09 10:25:00,13
23421,ORD_23422,854,Pancient-DSR Capsule,Warehouse B,72,58,2025-02-09 08:40:00,14
23422,ORD_23423,30042,"Shower Sponge - Orange & White, Colour May Vary",Warehouse B,93,87,2025-02-09 19:18:00,6
23423,ORD_23424,29679,OpenTech Screen Protector for Redmi Note 9 Pro/Note 9 Pro Max/Note 10 Pro/Note 10 Pro Max/K40/K40 Pro/K40 Pro Plus/11x/11x...,Warehouse C,63,53,2025-02-09 09:12:00,10
23424,ORD_23425,4162,Repraz 20mg Tablet,Warehouse A,70,53,2025-02-09 00:39:00,17
23425,ORD_23426,850,Gpanta Tablet,Warehouse A,47,31,2025-02-09 16:59:00,16
23426,ORD_23427,3942,Charcoal & Clay Shampoo - Cleansing & Oil Control,Warehouse B,57,41,2025-02-09 19:16:00,16
23427,ORD_23428,24905,Nazodox Oral Suspension,Warehouse A,49,30,2025-02-09 05:23:00,19
23428,ORD_23429,6417,Nishflam SP 100mg/325mg/10mg Tablet,Warehouse C,89,76,2025-02-09 19:21:00,13
23429,ORD_23430,35661,Roarx Samsung Galaxy F23 5G Charger PD [Compatible] with Samsung Galaxy F23 / Samsung Galaxy F23 5G Fast Charger Original ...,Warehouse C,80,68,2025-02-09 09:37:00,12
23430,ORD_23431,25503,mCaffeine Naked Detox Hydrating Green Tea Face Serum 40 ml,Warehouse C,53,44,2025-02-09 21:45:00,9
23431,ORD_23432,21619,Rosufit-F 5/160 Tablet,Warehouse B,18,5,2025-02-09 17:18:00,13
23432,ORD_23433,18194,"Panasonic Evolta AA Alkaline Batteries,20 Times Longer Lasting Than Standard zinc Carbon Batteries,Anti-Leak Seal,Protects...",Warehouse C,44,38,2025-02-09 13:16:00,6
23433,ORD_23434,12802,"Crucial X6 500GB Portable SSD Up to 540MB/s USB 3.2 External Solid State Drive, USB-C - CT500X6SSD9, Black, 39 Grams",Warehouse B,45,31,2025-02-09 13:55:00,14
23434,ORD_23435,14372,"TP-Link Tapo C225 4MP 2K QHD 1440p Pan/Tilt WiFi SecuritySmart AI Camera, Indoor CCTV, Starlight Sensor, Night Vision, Ale...",Warehouse A,106,87,2025-02-09 20:56:00,19
23435,ORD_23436,18226,Iondase AQ 75mg Injection,Warehouse C,111,98,2025-02-09 02:32:00,13
23436,ORD_23437,8849,Cold Pressed Avocado Carrier Oil,Warehouse B,91,73,2025-02-09 12:02:00,18
23437,ORD_23438,21533,Clonithem 100 Tablet,Warehouse B,83,78,2025-02-09 01:08:00,5
23438,ORD_23439,891,Zydiclo 75mg Injection 1ml,Warehouse B,66,54,2025-02-09 13:44:00,12
23439,ORD_23440,25044,Cobistar P 750mcg/75mg Capsule,Warehouse B,87,70,2025-02-09 20:40:00,17
23440,ORD_23441,6691,Cefomol 100mg Tablet DT,Warehouse B,47,40,2025-02-09 07:45:00,7
23441,ORD_23442,1083,Fastac 50 mg/650 mg Tablet,Warehouse C,79,71,2025-02-09 10:50:00,8
23442,ORD_23443,6685,"Amazon Brand - Solimo Thermoplastic Polyurethane Back Cover For Samsung Galaxy M21, M30s (Transparent)",Warehouse C,52,41,2025-02-09 16:52:00,11
23443,ORD_23444,35286,Faber-Castell Connector Pen Set - Pack of 25 (Assorted),Warehouse C,114,95,2025-02-09 01:22:00,19
23444,ORD_23445,29687,"Basesailor for Mi Smart LED TV 4A Remote Control (32""/43"")",Warehouse A,31,18,2025-02-09 23:45:00,13
23445,ORD_23446,25169,Rinizide Forte DT Tablet,Warehouse A,77,63,2025-02-09 10:07:00,14
23446,ORD_23447,35449,MAXXLITE Pack of 5 Travel Empty Lip Gloss Growth Oil Bottle Cosmetic Container Tube Eyelashes,Warehouse C,31,23,2025-02-09 21:30:00,8
23447,ORD_23448,12714,Serra 20mg Tablet,Warehouse B,106,95,2025-02-09 08:33:00,11
23448,ORD_23449,25200,Daymeth 750mcg/150mg Capsule,Warehouse A,29,20,2025-02-09 23:45:00,9
23449,ORD_23450,10546,"CQLEK® 2022 New Version-Car Phone Holder Mount, Rearview Mirror Phone Holder for Car, 360°Rotatable and Retractable Car Ph...",Warehouse A,12,3,2025-02-09 15:09:00,9
23450,ORD_23451,35417,Artebest-L Tablet,Warehouse C,52,47,2025-02-09 06:03:00,5
23451,ORD_23452,12709,Spigen EZ Fit Tempered Glass Screen Guard for iPhone 12 Pro Max - 2 Pack,Warehouse B,85,69,2025-02-09 19:07:00,16
23452,ORD_23453,14442,Zacome P 750mcg/75mg Soft Gelatin Capsule,Warehouse B,70,63,2025-02-09 18:43:00,7
23453,ORD_23454,31949,Es Plus 0.5mg/10mg Tablet,Warehouse A,53,38,2025-02-09 22:44:00,15
23454,ORD_23455,25324,"AmazonBasics 20W Phone Charger | Type C Adapter, Fast Charging for Cellular Phones (White)",Warehouse C,85,69,2025-02-09 15:42:00,16
23455,ORD_23456,21413,Gabacap 100mg Capsule,Warehouse A,101,85,2025-02-09 20:40:00,16
23456,ORD_23457,18264,Azisal 500 Tablet,Warehouse C,66,49,2025-02-09 12:15:00,17
23457,ORD_23458,6533,Gemblue Biocare Basil Mint Hair Oil 200 ml,Warehouse B,66,60,2025-02-09 06:44:00,6
23458,ORD_23459,6747,Tromy 50mg Injection,Warehouse A,105,98,2025-02-09 23:54:00,7
23459,ORD_23460,25326,"INOVERA World Map Anti-Slip Extended Desk Mat Gaming Rubber Stitched Mouse Pad for Laptop and Computer, 600L x 300B mm (Bl...",Warehouse C,93,86,2025-02-09 09:53:00,7
23460,ORD_23461,29779,Biolage Colorlast Orchid Colour Protecting Conditioner,Warehouse C,16,2,2025-02-09 02:47:00,14
23461,ORD_23462,18228,Cepoxin 250mg Tablet DT,Warehouse A,80,73,2025-02-09 07:53:00,7
23462,ORD_23463,6679,"Spacekart for Oneplus 11R 5G Case,Oneplus 11R 5G Phone Case Clear Transparent Reinforced Corners TPU Shock-Absorption Flex...",Warehouse C,22,9,2025-02-09 22:17:00,13
23463,ORD_23464,2944,Goxim CV Dry Syrup,Warehouse B,79,68,2025-02-09 02:06:00,11
23464,ORD_23465,2865,Amlan S 2.5mg  Tablet,Warehouse B,21,5,2025-02-09 03:42:00,16
23465,ORD_23466,18383,Inventis 5V 1.2W Portable Flexible USB LED Light Lamp (Colors may vary),Warehouse B,25,8,2025-02-09 03:51:00,17
23466,ORD_23467,11328,Easkof-LA Syrup,Warehouse C,35,21,2025-02-09 09:28:00,14
23467,ORD_23468,21191,Natural Vitamin C + Zinc Effervescent Tablet - Orange Flavour,Warehouse C,91,79,2025-02-09 15:58:00,12
23468,ORD_23469,8665,Mantor F 10mg/120mg Tablet,Warehouse C,67,56,2025-02-09 07:15:00,11
23469,ORD_23470,6753,"Crynn SupraColor Foundation Cream Palette 12 Color ( Delhi-1 ) Foundation, Natural Finish (Delhi 1, 40ml)",Warehouse B,42,23,2025-02-09 17:44:00,19
23470,ORD_23471,6751,Fungiderm Cream,Warehouse A,15,9,2025-02-09 16:14:00,6
23471,ORD_23472,6750,TP Cin 500mg Injection,Warehouse A,68,50,2025-02-09 00:48:00,18
23472,ORD_23473,8683,"Lotus Herbals Radiance Boost Ubtan Face Wash | Turmeric, Sandalwood and Rose Water | Glowing Skin |Reducing Dark Spots | P...",Warehouse A,66,52,2025-02-09 01:47:00,14
23473,ORD_23474,1100,Avudox CV 100mg/125mg Tablet,Warehouse B,74,68,2025-02-09 08:32:00,6
23474,ORD_23475,21503,Tesflo 0.4mg Tablet,Warehouse C,42,37,2025-02-09 21:01:00,5
23475,ORD_23476,23397,Desire Series - Dotted Condoms,Warehouse C,41,24,2025-02-09 03:06:00,17
23476,ORD_23477,8099,Parker Vector Standard Chrome Trim Ball Pen (Ink - Black),Warehouse A,71,52,2025-02-09 22:54:00,19
23477,ORD_23478,7516,Redmi 139 cm (55 inches) 4K Ultra HD Android Smart LED TV X55 | L55M6-RA (Black),Warehouse B,36,21,2025-02-09 21:09:00,15
23478,ORD_23479,36720,TRESemme Keratin Smooth Shampoo 1L + Conditioner 335ml | with Keratin and Argan Oil | For salon smooth hair at home | Used...,Warehouse B,45,27,2025-02-09 00:08:00,18
23479,ORD_23480,13670,"Wayona Nylon Braided Lightning USB Data Sync & 3A Charging Cable For iPhones, iPad Air, iPad mini, iPod Nano and iPod Touc...",Warehouse C,97,81,2025-02-09 17:04:00,16
23480,ORD_23481,30807,"ESR Classic Hybrid Magnetic Case with HaloLock, Compatible with iPhone 14 and iPhone 13, Compatible with MagSafe, TPU,Shoc...",Warehouse A,92,86,2025-02-09 03:07:00,6
23481,ORD_23482,8112,Leafclav 250mg/125mg Tablet,Warehouse C,7,2,2025-02-09 04:49:00,5
23482,ORD_23483,31258,Face Wash - Lemon Honey,Warehouse B,52,41,2025-02-09 17:50:00,11
23483,ORD_23484,36706,Omentum 40mg Injection,Warehouse A,31,21,2025-02-09 19:57:00,10
23484,ORD_23485,23656,TheGiftKart Crystal Clear Back Cover Case for Google Pixel 6A | 360 Degree Protection | Shockproof & Protective Design | T...,Warehouse B,17,1,2025-02-09 03:31:00,16
23485,ORD_23486,17636,"GM Facial Steamer with Hot Steam, Cool Steam & Adjustable Steam Nozzle, Large Tank Capacity, Best for Skin care & Effectiv...",Warehouse A,30,13,2025-02-09 13:54:00,17
23486,ORD_23487,23579,Cijofer-XT Tablet,Warehouse C,53,43,2025-02-09 17:30:00,10
23487,ORD_23488,18061,"Sunscreen - For Oily Skin, SPF 60",Warehouse C,99,90,2025-02-09 21:11:00,9
23488,ORD_23489,137,"Eloxee Steamer - Eloxee Steamer For Cold And Cough Nano-Cure Facial Iconic Cleanser Funko Pop With Nano-Ionic Technology, ...",Warehouse B,44,28,2025-02-09 11:33:00,16
23489,ORD_23490,16979,Moxsi 0.5% Eye Drop,Warehouse B,38,27,2025-02-09 09:57:00,11
23490,ORD_23491,23411,Uthyrox 100mcg Tablet,Warehouse C,44,29,2025-02-09 23:08:00,15
23491,ORD_23492,7621,"Duracell Alkaline AAA Batteries, Pack of 10",Warehouse A,84,79,2025-02-09 11:49:00,5
23492,ORD_23493,22680,Soulflower Herbal Night Transformation Creme with Evening Primrose 60 gm,Warehouse A,59,54,2025-02-09 09:20:00,5
23493,ORD_23494,17607,"Mattlook Studio Fix Powder Plus Foundation 2 Way Compact, Concealer, Moisturizing , Oil Control, Face Makeup, Give Me Sun...",Warehouse A,25,17,2025-02-09 18:22:00,8
23494,ORD_23495,7608,"Amazfit Bip U Pro NYSE Listed Smart Watch with SpO2, Built-in GPS, Built-in Alexa, Sleep, Stress Monitor, 1.43""(36cm) Colo...",Warehouse C,18,8,2025-02-09 21:24:00,10
23495,ORD_23496,17608,Bella Voste Hidefinition Liquid Concealer Shade Lc - 09 4 ml,Warehouse B,84,79,2025-02-09 19:19:00,5
23496,ORD_23497,23439,Adoflox OZ 250mg/500mg Tablet,Warehouse A,29,16,2025-02-09 12:53:00,13
23497,ORD_23498,17620,Socob P 750mcg/75mg Tablet,Warehouse B,56,37,2025-02-09 06:44:00,19
23498,ORD_23499,31241,Mycsense P 750mcg/75mg Capsule,Warehouse A,73,56,2025-02-09 21:42:00,17
23499,ORD_23500,23516,Reimpulse 2mg/500mg Tablet,Warehouse B,91,86,2025-02-09 15:51:00,5
23500,ORD_23501,31244,Ajmal Khofooq Concentrated Perfume Oil Woody Oudhy And Wisal Deodorant Floral Musky Fragrance 218 ml,Warehouse B,31,20,2025-02-09 16:12:00,11
23501,ORD_23502,160,ProElite Smart Case for iPad Pro 11 inch 2022/2021 4th/3rd Generation [Auto Sleep/Wake Cover] [Pencil Holder] [Soft Flexib...,Warehouse B,100,89,2025-02-09 16:10:00,11
23502,ORD_23503,23528,Mefmark Plus Syrup,Warehouse A,62,49,2025-02-09 17:40:00,13
23503,ORD_23504,7522,Floxitril 50mg Syrup,Warehouse A,62,57,2025-02-09 06:30:00,5
23504,ORD_23505,30815,TheGiftKart Crystal Clear Back Cover Case for Vivo T1 5G / Vivo Y75 5G / iQOO Z6 5G | 360 Degree Protection | Shock Proof ...,Warehouse B,94,88,2025-02-09 19:35:00,6
23505,ORD_23506,10910,Nimind 50mg Suspension,Warehouse B,58,41,2025-02-09 14:14:00,17
23506,ORD_23507,17644,Global Desi Mythical Bloom - 100ML and 50ML Eau De Parfum for Women Crafted by Ajmal,Warehouse A,91,83,2025-02-09 14:12:00,8
23507,ORD_23508,21261,Face Wash - Strawberry Creme,Warehouse C,61,47,2025-02-09 10:27:00,14
23508,ORD_23509,16976,GM 3011 2 Pin Travel Universal Multi-Plug with Surge Protector & Indicator,Warehouse A,89,81,2025-02-09 16:40:00,8
23509,ORD_23510,12792,Sirona FDA Approved Non-Applicator Tampon - Medium Flow 12's,Warehouse B,86,78,2025-02-09 21:32:00,8
23510,ORD_23511,6698,Beauty Glazed Soft And Natural Eyebrow Makeup Cake For Women And Girls,Warehouse C,20,13,2025-02-09 16:23:00,7
23511,ORD_23512,35631,Dorcef 200mg Tablet,Warehouse C,50,41,2025-02-09 14:46:00,9
23512,ORD_23513,14380,Risperdal 2mg Tablet,Warehouse A,85,67,2025-02-09 05:05:00,18
23513,ORD_23514,25407,Ajmal Impress Concentrated Perfume Oil Citrus And Maryaj Deuce Homme EDP Spicy Woody Perfume 110 ml,Warehouse B,109,97,2025-02-09 01:22:00,12
23514,ORD_23515,25408,PiBOX India USB C to HDMI Adapter HDCP SUPPORT Aluminium Type C USB hub 3.1 to HDMI 4K/USB 3.0/USB C 3 in 1 Converter Cabl...,Warehouse A,51,43,2025-02-09 23:37:00,8
23515,ORD_23516,29971,Mobivax smartwatches id116 Fit Watch for Man Women: Android iOS Sleep Heart Rate Blood Oxygen Weather Breath Training IP68...,Warehouse B,20,1,2025-02-09 04:30:00,19
23516,ORD_23517,25013,Ajmal Colaba Mukhallat Concentrated Perfume Oil Floral Oriental Attar And Aura Concentrated Perfume Oil Floral Fruity Attar 24 ml,Warehouse C,94,81,2025-02-09 09:05:00,13
23517,ORD_23518,25008,Nature's Essence Protecting Neem & Aloe Face Scrub 65 ml,Warehouse A,98,90,2025-02-09 20:04:00,8
23518,ORD_23519,29724,Opticol Eye Drop,Warehouse C,80,69,2025-02-09 15:36:00,11
23519,ORD_23520,21232,Insight Cosmetics Matte Lipstick - Selfie Red 4.2 gm,Warehouse A,57,38,2025-02-09 23:12:00,19
23520,ORD_23521,6459,Ajmal Majmua Concentrated Perfume Oil Oriental And Shadow Homme Deodorant Citrus Woody Fragrance 210 ml,Warehouse C,42,25,2025-02-09 01:41:00,17
23521,ORD_23522,29997,Ajmal Nightingale & Distraction & Magnetize Deo & Prose EDP Pack of 3 20 ml,Warehouse A,48,29,2025-02-09 03:20:00,19
23522,ORD_23523,31914,Camel Canvas Board - 20cm x 25cm,Warehouse B,52,36,2025-02-09 22:58:00,16
23523,ORD_23524,29698,Flormar Jelly Look Nail Enamel JL32 Maple Truffle 11 ml,Warehouse C,84,65,2025-02-09 06:19:00,19
23524,ORD_23525,2947,Casio Youth-Digital Grey Dial Men's Watch-W-96H-1AVDF (D031),Warehouse A,96,86,2025-02-09 16:03:00,10
23525,ORD_23526,24976,"Cosmic Byte Stardust Wired On Ear Headphones with Mic Flexible for PS4, Xbox One, Laptop, PC, iPhone and Android Phones (B...",Warehouse C,39,22,2025-02-09 14:21:00,17
23526,ORD_23527,556,"Apple 2022 iPad Air M1 Chip (10.9-inch/27.69 cm, Wi-Fi, 256GB) - Space Gray (5th Generation)",Warehouse B,46,39,2025-02-09 03:36:00,7
23527,ORD_23528,31783,Ajmal Mukhallat Al Wafa CP & Wisal Dhahab Deo & Aretha EDP Pack of 3 20 ml,Warehouse B,101,94,2025-02-09 09:57:00,7
23528,ORD_23529,11091,Elm 0.25mg Tablet,Warehouse C,105,91,2025-02-09 09:39:00,14
23529,ORD_23530,36788,"Stbotanica Green Tea And Cucumber Hand Wash, No Parabens, Sls - With Shea Butter 250 ml",Warehouse B,55,40,2025-02-09 07:09:00,15
23530,ORD_23531,30826,"ADS Matte Lipstick, Waterproof Set of 24 for Women And Girls, Matte Finish - MultiColor",Warehouse B,49,40,2025-02-09 09:00:00,9
23531,ORD_23532,30824,Bio Vitamin Therapeutic Body Massage Oil,Warehouse B,16,7,2025-02-09 11:43:00,9
23532,ORD_23533,35444,Himalaya Gentle Exfoliating Apricot Scrub 100 gm,Warehouse B,83,73,2025-02-09 09:07:00,10
23533,ORD_23534,35443,Relihexy 2mg Tablet,Warehouse B,78,70,2025-02-09 04:13:00,8
23534,ORD_23535,7557,JGD PRODUCTS for Samsung Galaxy S21 FE 5G Premium Transparent Hybrid Soft Slim Dust Proof Back Case Cover with Camera Prot...,Warehouse B,16,1,2025-02-09 05:22:00,15
23535,ORD_23536,17044,Amazon Brand - Solimo Plastic Soft & Flexible Back Cover for Oppo F19 Pro Plus (Transparent),Warehouse C,39,26,2025-02-09 10:58:00,13
23536,ORD_23537,35756,Insight Cosmetics Pastel Color Nail Polish - 28 9 ml,Warehouse A,77,61,2025-02-09 20:17:00,16
23537,ORD_23538,35030,Parasyp M DS Oral Suspension,Warehouse B,45,26,2025-02-09 10:20:00,19
23538,ORD_23539,30193,Tombow Fudenosuke Brush Pen 2 Pens Set,Warehouse C,37,25,2025-02-09 20:33:00,12
23539,ORD_23540,2997,"Gaiatop Mini Portable Fan, Powerful Hand Fan Dual Motors Personal Small Handheld Fan with Base, Cute Design 3 Speed Lightw...",Warehouse B,109,92,2025-02-09 00:31:00,17
23540,ORD_23541,3009,Vault UK 100C 24 inch Arched Back Concert Ukulele With Gig Bag (Natural),Warehouse B,52,39,2025-02-09 22:11:00,13
23541,ORD_23542,18128,"Amkette Evo Gamepad Pro 4 for Android | Instant Play | Bluetooth 4.0 | Extendable Smartphone Clamp | Works with COD, Mobil...",Warehouse A,9,2,2025-02-09 12:51:00,7
23542,ORD_23543,29612,Renewal Eye Cream,Warehouse C,60,42,2025-02-09 22:50:00,18
23543,ORD_23544,30096,"Kiro Botanico Super Shield Mascara - Carbon Black 01, Waterproof, Vegan, 9 g",Warehouse A,72,60,2025-02-09 07:15:00,12
23544,ORD_23545,777,"Classmate Soft Cover 6 Subject Spiral Binding Notebook, Unruled, 300 Pages",Warehouse C,67,60,2025-02-09 21:22:00,7
23545,ORD_23546,8592,Amazon Brand - Solimo Back Cover for Samsung Galaxy A50s / Samsung Galaxy A50 / Samsung Galaxy A30s (Transparent),Warehouse C,58,47,2025-02-09 03:03:00,11
23546,ORD_23547,35033,Global Mythical Bloom Eau De Parfum 100ML & Cosmic Dreamer Body Mist 200ML Pack of 2 for Women Crafted by Ajmal,Warehouse A,76,66,2025-02-09 01:17:00,10
23547,ORD_23548,8591,Betnecip 0.5mg Tablet,Warehouse A,91,76,2025-02-09 13:22:00,15
23548,ORD_23549,30217,Sigpar 12.5mg Tablet,Warehouse A,95,76,2025-02-09 16:50:00,19
23549,ORD_23550,30209,"Tizum USB C to USB 3.0 OTG Adapter/ Connector, Thunderbolt 3, Fast Charging/ Data Transfer, Speed upto 4.8 GBPS, Compatibl...",Warehouse B,94,83,2025-02-09 07:48:00,11
23550,ORD_23551,35035,Medimade Olive And Macadamia Shampoo 300 ml,Warehouse C,47,35,2025-02-09 07:32:00,12
23551,ORD_23552,10616,"Toothbrush - Milk Teeth, Light Blue",Warehouse A,8,1,2025-02-09 00:19:00,7
23552,ORD_23553,8931,"Parker Vector Gold Fountain Pen, 1 Count (Pack of 1) (9000014375)",Warehouse C,54,48,2025-02-09 01:59:00,6
23553,ORD_23554,21730,Binoclox 500mg Injection,Warehouse B,49,43,2025-02-09 09:51:00,6
23554,ORD_23555,3875,Clotrim V Cream,Warehouse C,28,16,2025-02-09 14:47:00,12
23555,ORD_23556,24797,"Noise Sense Bluetooth Wireless in Ear Earphones, Neckband Earphones with Fast Charging, Up to 25H Playback, Powerful Bass,...",Warehouse C,69,50,2025-02-09 14:32:00,19
23556,ORD_23557,11295,Human Mixtard 70/30 Suspension for Injection 40IU/ml,Warehouse B,57,45,2025-02-09 03:29:00,12
23557,ORD_23558,24794,Acvilda 50mg Tablet,Warehouse C,45,40,2025-02-09 07:43:00,5
23558,ORD_23559,29596,"ASUS MD100 Marshmallow/Silent, Adj. DPI, Multi-Mode, with Solar Cover Wireless Optical Mouse (2.4GHz Wireless, Bluetooth, ...",Warehouse B,44,38,2025-02-09 06:56:00,6
23559,ORD_23560,18099,"BROLAVIYA Overhead Video Mobile Stand, Metal Long Arm,1/4"" Ball Head Male for Camera,Gopro Webcams,Mobile Bracket for Vide...",Warehouse A,68,56,2025-02-09 15:50:00,12
23560,ORD_23561,2836,ONSITEGO 1 Year Extended Warranty for Smartwatches,Warehouse B,43,28,2025-02-09 04:36:00,15
23561,ORD_23562,30156,"SoundTech LCD Writing Tablet for Kids Writing pad for Study, Drawing Tablet, Slate Board, 8.5 inch/21.5 cm - E-Note Pad, R...",Warehouse B,37,27,2025-02-09 19:39:00,10
23562,ORD_23563,35859,Roxitec 300mg Tablet,Warehouse A,48,38,2025-02-09 04:39:00,10
23563,ORD_23564,35072,Clomax B Cream,Warehouse A,50,35,2025-02-09 04:08:00,15
23564,ORD_23565,1224,House of Aroma Essential Oil - Patchouli 10 ml,Warehouse C,67,51,2025-02-09 08:13:00,16
23565,ORD_23566,35742,"Ambrane 40000mAh Lithium Polymer Power Bank, 65W Fast Charging, MacBook & Type C Laptops Charging, Triple Output, Type-C P...",Warehouse C,48,31,2025-02-09 18:01:00,17
23566,ORD_23567,35834,De Fabulous Get Closer Scalp Aid Shampoo and Conditioner – 250ml| Sulphate Free | pH Balanced | (Combo Set),Warehouse C,102,92,2025-02-09 03:14:00,10
23567,ORD_23568,25727,Dvlox-OD 500 Tablet ER,Warehouse A,110,92,2025-02-09 10:44:00,18
23568,ORD_23569,18309,Calcium Sandoz Injection,Warehouse A,96,90,2025-02-09 12:28:00,6
23569,ORD_23570,24665,APPUCOCO MS Metal Bookend for Office - 2 Per Pack (Black),Warehouse B,78,64,2025-02-09 19:10:00,14
23570,ORD_23571,13844,"(Renewed) Noise Evolve 3, 1.43"" AMOLED AOD, 466*466px, 500 nits, BT calling,Tru Sync Technology Smartwatch (Black Strap, R...",Warehouse A,60,54,2025-02-09 15:34:00,6
23571,ORD_23572,3860,Spasmol 20mg Drops,Warehouse A,82,74,2025-02-09 00:53:00,8
23572,ORD_23573,25517,"Amkette MultiPort Type C 3 in 1 Hub with 4K HDMI Output to Monitors, TVs & Projectors for MacBook, Chromebook and More (Me...",Warehouse A,94,79,2025-02-09 15:24:00,15
23573,ORD_23574,735,"Rapidotzz Mi Band Straps - Pack of 1 (Black, Unisex) | Removable Straps ONLY for MI Band 3 and 4 | MultiColour | Free Size...",Warehouse A,45,37,2025-02-09 15:11:00,8
23574,ORD_23575,12835,Skynote Fd1 S_S L21 Air-Port Waterproof Stereo Bluetooth Truly Wireless In Ear Earbuds With Mic (Black),Warehouse C,94,78,2025-02-09 17:21:00,16
23575,ORD_23576,6914,Herbal Neem & Tulsi Face Wash,Warehouse B,48,38,2025-02-09 02:53:00,10
23576,ORD_23577,3859,"Nokia G11 Android 12 Smartphone, Dual SIM, 3-Day Battery Life, 4GB RAM + 64GB Storage, 50MP Dual AI Camera | Charcoal Grey",Warehouse B,13,6,2025-02-09 11:25:00,7
23577,ORD_23578,35899,Elle 18 Lipstick Flashing Pink (Matte),Warehouse B,79,72,2025-02-09 02:25:00,7
23578,ORD_23579,30248,Wet N Wild Ultimate Brow Kit - Ash Brown 2.5 gm,Warehouse C,67,51,2025-02-09 14:26:00,16
23579,ORD_23580,10475,AEIDESS Edge to Edge Tempered Glass for iQOO Neo 6 5G / iQOO Neo 6 SE 5G / iQOO 9 SE 5G / iQOO 7 5G / iQOO 7 Legend 5G (6....,Warehouse A,38,20,2025-02-09 21:24:00,18
23580,ORD_23581,30259,Organic Harvest Hair Spa for Dry and Damaged Hair Oil 200 ml,Warehouse A,98,80,2025-02-09 18:00:00,18
23581,ORD_23582,3862,Fen-X 50mg Tablet,Warehouse A,31,12,2025-02-09 17:06:00,19
23582,ORD_23583,8951,Maryaj Goldie EDP Fruity Floral Perfume And Maryaj Cosmo Girl EDP Floral Powdery Perfume 200 ml,Warehouse B,27,9,2025-02-09 21:49:00,18
23583,ORD_23584,14700,Arip 5mg Tablet,Warehouse C,80,72,2025-02-09 22:26:00,8
23584,ORD_23585,29617,Brustro Artists Acrylic 120ml Titanium White ( more colours available ),Warehouse A,82,63,2025-02-09 03:25:00,19
23585,ORD_23586,14291,"M.G.R.J® Tempered Glass Screen Protector for Canon EOS 200D II, 200D, M50 M100 M6 M6ii, 2 Mini Mirrorless Camera (Transpar...",Warehouse A,66,47,2025-02-09 12:36:00,19
23586,ORD_23587,35124,"Crucial P3 1TB PCIe 3.0 3D NAND NVMe M.2 SSD, up to 3500MB/s - CT1000P3SSD8",Warehouse C,109,93,2025-02-09 21:55:00,16
23587,ORD_23588,21637,"ONE ASSIST Live Uninterrupted 1 Year Extended Warranty Plan for Air Cooler 10001 to 15000 - Email Delivery, No Physical Kit",Warehouse A,53,46,2025-02-09 05:04:00,7
23588,ORD_23589,12838,Cool & Fresh Aloe Vera Soap,Warehouse C,21,13,2025-02-09 04:52:00,8
23589,ORD_23590,21155,"Ajmal 1 Shadow Homme, 1 Wisal, 1 Nightingale And 1 Persuade Deodorants Pack of 4 200 ml",Warehouse C,18,12,2025-02-09 22:03:00,6
23590,ORD_23591,14794,Neem Oil,Warehouse A,70,59,2025-02-09 13:02:00,11
23591,ORD_23592,1167,"Fashion Colour Eyebrow Pencil, EB04 1.3 gm",Warehouse C,17,9,2025-02-09 13:11:00,8
23592,ORD_23593,10472,Bella Voste Sand Holo Nail Paints Rose Gold - 408 10 ml,Warehouse B,63,51,2025-02-09 13:34:00,12
23593,ORD_23594,4213,Spantra Methi Seed Shampoo 300 ml,Warehouse B,75,68,2025-02-09 16:41:00,7
23594,ORD_23595,831,TheGiftKart Shockproof Crystal Clear Back Cover Case for Redmi A1 | 360 Degree Protection | Protective Design | Transparen...,Warehouse B,27,13,2025-02-09 07:43:00,14
23595,ORD_23596,14203,Trimci 40mg Injection,Warehouse C,111,94,2025-02-09 13:30:00,17
23596,ORD_23597,24886,Sirona Adult Diaper Disposal Bags (Pack 2 x 10's),Warehouse A,69,64,2025-02-09 18:24:00,5
23597,ORD_23598,6380,Farraige® USB 3.0 All in one Card Reader with OTG SD/Micro SD Card Reader Type c Mobile Phone high Speed Card Reader - 1 Y...,Warehouse B,79,74,2025-02-09 13:53:00,5
23598,ORD_23599,8627,"L'Occitane Cleansing Milk Facial Make-Up Remover, 200ml",Warehouse A,75,56,2025-02-09 00:52:00,19
23599,ORD_23600,12880,"realme Buds Q2 Bluetooth Truly Wireless in Ear Earbuds with Mic, Fast Charging & Up to 28Hrs Playtime (Active Black)",Warehouse B,17,7,2025-02-09 20:16:00,10
23600,ORD_23601,24862,Brustro Calligraphy Pen Set of 12,Warehouse C,100,85,2025-02-09 06:32:00,15
23601,ORD_23602,21801,Plum Grape Seed & Sea Buckthorn Nutri-plenish Face Mist 100 ml,Warehouse C,101,83,2025-02-09 19:13:00,18
23602,ORD_23603,4039,"Logitech H390 Wired On Ear Headset for PC/Laptop, Stereo Headphones with Noise Cancelling Microphone, USB-A, In-Line Contr...",Warehouse C,14,9,2025-02-09 14:19:00,5
23603,ORD_23604,6650,Taft Looks V12 Power Gel Speed Hold 12,Warehouse C,15,4,2025-02-09 23:33:00,11
23604,ORD_23605,35695,ETI Cello Tape 1 Inch 65M (Transparent),Warehouse A,99,82,2025-02-09 23:31:00,17
23605,ORD_23606,14579,Osonim 100mg Tablet DT,Warehouse A,95,89,2025-02-09 12:16:00,6
23606,ORD_23607,14590,Gludotac 50mg/750mg/250mg Tablet,Warehouse B,48,31,2025-02-09 16:53:00,17
23607,ORD_23608,31919,L'Occitane After Shave Balm 30ml,Warehouse A,87,68,2025-02-09 01:23:00,19
23608,ORD_23609,4124,Bergamot & Cedarwood Luxury Shower Gel,Warehouse B,54,37,2025-02-09 04:16:00,17
23609,ORD_23610,29936,CEDO Back Cover Redmi Note 10 Pro/Note 10 Pro Max | Matte Soft Silicon Flexible | Camera Bump Protection | All Side Shock ...,Warehouse A,86,76,2025-02-09 23:38:00,10
23610,ORD_23611,2938,Oxyglow Facial Kit - Charcoal 50 gm,Warehouse B,101,96,2025-02-09 14:21:00,5
23611,ORD_23612,14411,"Kids Toothpaste - 2-5yrs, Bubble Fruit, Motu-Patlu, With Colgate Toothbrush, Super Junior, 0-2 Yrs",Warehouse C,32,14,2025-02-09 23:47:00,18
23612,ORD_23613,10564,Garitel H 40mg/12.5mg Tablet,Warehouse A,91,83,2025-02-09 00:17:00,8
23613,ORD_23614,14434,Kingston DataTraveler Exodia DTX/64 GB Pen Drive USB 3.2 Gen 1 (Multicolor),Warehouse A,41,28,2025-02-09 07:17:00,13
23614,ORD_23615,29908,Men Expert White Activ Charcoal Brightening Foam Facewash,Warehouse C,33,17,2025-02-09 03:31:00,16
23615,ORD_23616,924,"Newlike Silicone Bumper Exclusive - Back Cover Thin Case for Google Pixel 6, Transparent",Warehouse B,101,84,2025-02-09 12:50:00,17
23616,ORD_23617,11310,Z Cof Syrup,Warehouse C,104,91,2025-02-09 05:30:00,13
23617,ORD_23618,12765,"Oriflame Giordani Gold Long Wear Mineral Lotion Foundation SPF 15,Light Rose(30ml) Matte Finish",Warehouse C,12,2,2025-02-09 22:18:00,10
23618,ORD_23619,35364,Wedding Backdrop Cloth for all Festivals/House hold functions/Haldi Function/Ceremonies Banana Leaf Design(Aaritaku) Desig...,Warehouse C,57,51,2025-02-09 13:36:00,6
23619,ORD_23620,8749,CASEOLOGY by Spigen Skyfall Back Cover Case Compatible with iPhone 14 Pro Max (TPU and Polycarbonate | Purple),Warehouse C,19,4,2025-02-09 06:01:00,15
23620,ORD_23621,21307,Epiphen 30 mg/100 mg Tablet,Warehouse A,104,91,2025-02-09 10:09:00,13
23621,ORD_23622,25269,Vega Flat Brush (E6 - FB) 136 gm,Warehouse A,113,94,2025-02-09 09:52:00,19
23622,ORD_23623,14453,Nimustop P 100mg/325mg Tablet,Warehouse A,79,60,2025-02-09 00:18:00,19
23623,ORD_23624,8770,"WE CLEVER Heavy duty Dual monitor stand Mount, Height Adjustable desk C clamps & Mounting holes, Full motion Tilt & Swivel...",Warehouse C,71,54,2025-02-09 20:32:00,17
23624,ORD_23625,2916,Goldineuron Tablet,Warehouse B,83,67,2025-02-09 22:10:00,16
23625,ORD_23626,31957,Quess Care Extended Warranty Plan for 2 Year for TV 30001 to 40000 (Email Delivery),Warehouse B,14,9,2025-02-09 18:11:00,5
23626,ORD_23627,21325,Looks cosmetics Highlighter Brush lac106,Warehouse B,81,64,2025-02-09 23:47:00,17
23627,ORD_23628,35470,Sunscreen Cream - Sunblock Water Proof SPF UV 40,Warehouse A,67,58,2025-02-09 17:27:00,9
23628,ORD_23629,29822,Amla Tablets,Warehouse A,16,11,2025-02-09 18:11:00,5
23629,ORD_23630,6647,boAt Bassheads 102 Wired in Ear Earphones with Mic (Mint Orange),Warehouse C,76,61,2025-02-09 17:39:00,15
23630,ORD_23631,21435,Clovia Botaniqa Anti Acne Face Mask 50 gm,Warehouse C,70,62,2025-02-09 22:49:00,8
23631,ORD_23632,25337,"Mobilife Selfie Stick,Selfie Stick with Tripod Stand Selfie Stick Tripod for Mobile Phone 4 in 1 Selfie Stick Bluetooth Se...",Warehouse C,89,77,2025-02-09 17:40:00,12
23632,ORD_23633,3866,Trapzol 37.5mg/325mg Tablet,Warehouse A,67,59,2025-02-09 19:58:00,8
23633,ORD_23634,24735,Medmont LC 5mg/10mg Tablet,Warehouse C,96,88,2025-02-09 08:05:00,8
23634,ORD_23635,6354,Atulya Hibiscus & Black Seed Shampoo 300 ml,Warehouse A,17,2,2025-02-09 18:09:00,15
23635,ORD_23636,3901,Ajmal Selfie Concentrated Perfume Oil Woody Aromatic Attar And Aurum Concentrated Perfume Oil Fruity Floral Attar 20 ml,Warehouse A,89,73,2025-02-09 09:55:00,16
23636,ORD_23637,24849,"Skudgear Toe Separators - 1 Pair (White, Free Size) | Toe Straighteners | Bunion Relief | Relaxing Toes | Hammer Toe Strai...",Warehouse B,80,69,2025-02-09 20:56:00,11
23637,ORD_23638,35748,Wipro Extension Board with 4 Universal Sockets - Grey & White,Warehouse B,107,99,2025-02-09 02:18:00,8
23638,ORD_23639,6877,Ibvog-M 0.3 Tablet,Warehouse B,65,56,2025-02-09 23:11:00,9
23639,ORD_23640,18142,"Lauret Blanc Daily Planner and Organizer, Gratitude and Affirmation Journal with Weekly and Monthly Review- A5 Size, Plan ...",Warehouse A,74,58,2025-02-09 03:04:00,16
23640,ORD_23641,14776,Nomokof Expectorant,Warehouse B,112,99,2025-02-09 04:23:00,13
23641,ORD_23642,32087,TheGiftKart Tough Armor Bumper Back Case Cover for OnePlus Nord CE 2 5G | Ring Holder & Kickstand in-Built | 360 Degree Pr...,Warehouse C,85,80,2025-02-09 21:30:00,5
23642,ORD_23643,21708,"Fashion Colour Jersy Girl Kiss Proof No Transfer Lipstick, 15 Terra Copper 2 gm",Warehouse B,63,53,2025-02-09 20:58:00,10
23643,ORD_23644,11414,Vega Nail Clipper Set Of 10 Pcs (LNCB - 01) 445 gm,Warehouse C,101,87,2025-02-09 09:57:00,14
23644,ORD_23645,8603,Leoflox 500mg Tablet,Warehouse C,73,65,2025-02-09 05:04:00,8
23645,ORD_23646,814,Disomet 1.37gm Syrup,Warehouse A,44,27,2025-02-09 11:14:00,17
23646,ORD_23647,18186,Bact 200mg Tablet,Warehouse A,95,78,2025-02-09 23:00:00,17
23647,ORD_23648,25299,"Apsara Assorted Dustless Chalks, 100 Units (Pack of 10 x 10 Units)",Warehouse B,20,10,2025-02-09 00:50:00,10
23648,ORD_23649,32034,"1Pcs Jar Beauty Blender Sponge Set (4PCS BIG+2PCS SMALL) Face Makeup Puff Flawless Blending Sponge Foundation, Cream & Pow...",Warehouse C,93,79,2025-02-09 02:54:00,14
23649,ORD_23650,10515,Jovees Face Cream - Pearl Whitening 60 gm,Warehouse A,43,38,2025-02-09 05:15:00,5
23650,ORD_23651,4061,Sirona Under Arm Sweat Pads 80's,Warehouse B,70,63,2025-02-09 16:59:00,7
23651,ORD_23652,21298,Methi Powder,Warehouse B,76,67,2025-02-09 02:12:00,9
23652,ORD_23653,25145,"Samsung 25W Original Charger PD 3.0 USB C Adapter Compatible for Samsung Mobiles Phone Galaxy S20 FE 5G, S20+ 5G, S21, S21...",Warehouse B,17,11,2025-02-09 02:08:00,6
23653,ORD_23654,16950,Delacort 6mg Tablet,Warehouse B,40,25,2025-02-09 22:05:00,15
23654,ORD_23655,24652,Forbidden Affair Eau De Toilette,Warehouse C,29,10,2025-02-09 04:25:00,19
23655,ORD_23656,942,Pulmoxyl 500mg Capsule,Warehouse C,80,68,2025-02-09 15:08:00,12
23656,ORD_23657,21446,Truke Air Buds Bluetooth Truly Wireless in Ear Earbuds with Mic Ai Powered Noise Cancellation(Ai-Enc) for Hd Calls Upto 48...,Warehouse A,78,65,2025-02-09 23:47:00,13
23657,ORD_23658,2924,CP PLUS 4MP Bullet Wireless Security Camera | 1440P Resolution | Motion Detection | Two Way Talk | Night Vision | Supports...,Warehouse B,69,50,2025-02-09 03:57:00,19
23658,ORD_23659,6519,Infagyl Forte 500mg/600mg Tablet,Warehouse B,13,6,2025-02-09 18:13:00,7
23659,ORD_23660,21443,Razonix 20mg Capsule,Warehouse A,90,83,2025-02-09 00:34:00,7
23660,ORD_23661,6632,Cloworth 0.05% Cream,Warehouse C,12,7,2025-02-09 09:47:00,5
23661,ORD_23662,23559,Evanorm 20mg/20mg/5mg Tablet,Warehouse A,55,50,2025-02-09 10:18:00,5
23662,ORD_23663,16862,Ajmal Wisal Dhahab Carbon Deodorant Spray (Pack of 4) 200 ml,Warehouse C,22,3,2025-02-09 02:43:00,19
23663,ORD_23664,36683,BluArmor Action-cam Compatible Chin Mount for Motorcycle Helmets,Warehouse A,63,46,2025-02-09 16:31:00,17
23664,ORD_23665,11259,Taxim 500mg Injection,Warehouse A,30,21,2025-02-09 03:54:00,9
23665,ORD_23666,24281,Rabitiv DSR Tablet,Warehouse C,21,3,2025-02-09 18:06:00,18
23666,ORD_23667,7086,Charmacy Milano Luxe Creme Lipstick (Flamenco Red) 3.8 gm,Warehouse A,61,47,2025-02-09 11:22:00,14
23667,ORD_23668,3131,Faces Canada Epic Skin Facewash For Dry Skin 50 Ml,Warehouse A,50,36,2025-02-09 02:37:00,14
23668,ORD_23669,22073,Razer Basilisk X HyperSpeed Wireless Gaming Mouse: Bluetooth & HyperSpeed Wireless Compatible | 6 Programmable Buttons | 1...,Warehouse B,100,95,2025-02-09 18:23:00,5
23669,ORD_23670,10443,Organic Vata Tea,Warehouse C,102,96,2025-02-09 09:46:00,6
23670,ORD_23671,22064,Panzamin-DSR Capsule,Warehouse A,44,28,2025-02-09 13:53:00,16
23671,ORD_23672,22058,Statpure Gold 10 Capsule,Warehouse A,106,94,2025-02-09 22:48:00,12
23672,ORD_23673,13002,Atsyp Syrup,Warehouse C,19,13,2025-02-09 15:50:00,6
23673,ORD_23674,24319,HP 682 Color/Black Combo 2-Pack,Warehouse C,77,60,2025-02-09 12:41:00,17
23674,ORD_23675,10718,Winnow Tablet,Warehouse C,45,30,2025-02-09 10:46:00,15
23675,ORD_23676,14091,Dan LC Tablet,Warehouse C,67,58,2025-02-09 23:43:00,9
23676,ORD_23677,17920,Thioquest 8mg Fast Acting Capsule,Warehouse A,26,9,2025-02-09 13:11:00,17
23677,ORD_23678,21946,Idemox 500mg Capsule,Warehouse B,105,95,2025-02-09 08:34:00,10
23678,ORD_23679,18039,"Tecno POVA 3 (Tech Silver, 4GB RAM,64GB Storage) | 7000mAh Battery |33W Fast Charger",Warehouse A,42,26,2025-02-09 16:23:00,16
23679,ORD_23680,8386,Contra Premium L21 TWS Earbuds Wireless Earphone Mini Bluetooth 5.0 Truly Sports Over Ear Headphone Waterproof Earbuds HD ...,Warehouse B,16,4,2025-02-09 23:18:00,12
23680,ORD_23681,24542,"Amkette Pocket FM Radio Portable Multimedia Speaker with Powerful Torch | USB, AUX, and SD Card Input | 12 Hours Playback...",Warehouse A,106,98,2025-02-09 22:25:00,8
23681,ORD_23682,24543,Coorgi Coffee Lip Smoothening Salve,Warehouse C,78,60,2025-02-09 00:25:00,18
23682,ORD_23683,35998,Condic Aqua 75mg Injection,Warehouse C,46,29,2025-02-09 20:05:00,17
23683,ORD_23684,8505,Asmasef-LS Syrup,Warehouse C,97,79,2025-02-09 03:41:00,18
23684,ORD_23685,17113,Mepelon 4mg Tablet,Warehouse B,46,32,2025-02-09 11:54:00,14
23685,ORD_23686,692,Jor-LS Capsule,Warehouse C,89,73,2025-02-09 21:34:00,16
23686,ORD_23687,11263,Ajmal 2 Distraction & Nightingale Deodorant Pack of 3 Deodorants 200 ml,Warehouse C,111,94,2025-02-09 18:15:00,17
23687,ORD_23688,10685,Radiant Diamond Cellular Radiance 1 Facial Kit,Warehouse A,82,69,2025-02-09 10:44:00,13
23688,ORD_23689,707,Cefugen 750mg Injection,Warehouse A,24,12,2025-02-09 03:15:00,12
23689,ORD_23690,24600,"Seagate One Touch 5TB External HDD with Password Protection – Light Blue, for Windows and Mac, with 3 yr Data Recovery Ser...",Warehouse A,102,84,2025-02-09 21:14:00,18
23690,ORD_23691,30300,Spigen EZ Fit Tempered Glass Screen Protector for iPhone 14 Pro - 2 Pack (Sensor Protection),Warehouse B,24,10,2025-02-09 19:16:00,14
23691,ORD_23692,18052,Fixman 100mg Tablet DT,Warehouse C,60,54,2025-02-09 17:31:00,6
23692,ORD_23693,718,Vovituf SP 50mg/325mg/10mg Tablet,Warehouse C,102,96,2025-02-09 17:22:00,6
23693,ORD_23694,17076,"Gaiatop Mini Handheld Fan, Portable Personal Folding Cooling Hand Fan Rechargeable Battery Operated Power Bank with 2 Spee...",Warehouse B,51,34,2025-02-09 22:34:00,17
23694,ORD_23695,542,AmazonBasics 60-Inch Lightweight Tripod with Bag,Warehouse A,42,33,2025-02-09 07:35:00,9
23695,ORD_23696,11063,Nails On Board Handmade Press On Gel Nails- Holographic Liliac Small 50 gm,Warehouse A,53,38,2025-02-09 20:03:00,15
23696,ORD_23697,7054,BESTOR® USB C Hub Multiport Adapter for MacBook Pro Air 2021 2020 31C 4-in-1 USB Hub (Type C to 4 USB-A Ports) with Fast D...,Warehouse B,39,27,2025-02-09 02:47:00,12
23697,ORD_23698,30714,Thiomin A 100mg/4mg Tablet,Warehouse B,75,59,2025-02-09 02:18:00,16
23698,ORD_23699,30710,Berina Heat Protector 230 ml,Warehouse B,80,65,2025-02-09 10:17:00,15
23699,ORD_23700,17976,Trinetra 20W USB-C Adapter Charger 3D Cute Cartoon Designs Lightning Cable Protector Cable Protector (MICKY GIRL)(carger &...,Warehouse A,80,65,2025-02-09 11:29:00,15
23700,ORD_23701,22012,Chillpol 650mg Tablet,Warehouse B,14,3,2025-02-09 13:12:00,11
23701,ORD_23702,11232,Zeroderm Plus Cream,Warehouse B,23,4,2025-02-09 01:48:00,19
23702,ORD_23703,30412,Maryaj Deuce Homme EDP Spicy Woody Perfume And Ajmal Shadow Homme Deodorant Citrus Woody Fragrance 300 ml,Warehouse C,92,76,2025-02-09 15:48:00,16
23703,ORD_23704,30409,Park Avenue Original Deodorant Set For Men 150ml Each (Combo Of 3),Warehouse A,105,89,2025-02-09 11:15:00,16
23704,ORD_23705,21988,"AGARO Micro to USB A 3.0 OTG Adapter, Micro USB to Female USB Compatible with Most Micro USB Devices",Warehouse B,63,52,2025-02-09 23:10:00,11
23705,ORD_23706,17964,"Beetel B80 Corded Landline Phone(Without Display), Ringer Volume Control, Wall/Desk Mountable, Classic Design, Clear Call ...",Warehouse B,19,11,2025-02-09 04:10:00,8
23706,ORD_23707,31651,"Adjustable Face Mask - Medium, Black",Warehouse C,22,6,2025-02-09 00:53:00,16
23707,ORD_23708,21984,Qatalitic Set of 5 Painting Knives of Various Sizes & Shapes,Warehouse C,27,17,2025-02-09 23:54:00,10
23708,ORD_23709,7051,Lavender Hexagon Festive Gift Set For Skin & Hair Care,Warehouse B,70,54,2025-02-09 11:32:00,16
23709,ORD_23710,22089,GATRI 200 MG TABLET,Warehouse B,59,41,2025-02-09 02:05:00,18
23710,ORD_23711,8437,"VONZEE Liquid Silicone Soft Back Cover for iPhone 14 Pro Case, Shockproof Slim Camera & Full Body Protection Non Yellowing...",Warehouse C,82,63,2025-02-09 08:45:00,19
23711,ORD_23712,36087,Tramib P 37.5mg/325mg Tablet,Warehouse C,67,53,2025-02-09 03:21:00,14
23712,ORD_23713,24389,Pedicure Manicure Kit,Warehouse C,84,78,2025-02-09 11:59:00,6
23713,ORD_23714,24407,PAERIK INDIA Derma Color Camouflage Creme Palette 12 color Matte & Glossy Finish,Warehouse A,42,28,2025-02-09 19:41:00,14
23714,ORD_23715,10719,"Finautica Italian Lamp With 3 Tier Shelf for Home Decor Jute Drum Shade, Bulb, Wiring, E27 Holder Included Home Decors Gift",Warehouse C,94,86,2025-02-09 17:46:00,8
23715,ORD_23716,10732,Voncef 50mg Tablet,Warehouse B,101,86,2025-02-09 03:05:00,15
23716,ORD_23717,592,Pikkme iPhone XR Back Cover | Flexible Pu Leather | Full Camera Protection | Raised Edges | Super Soft-Touch | Bumper Case...,Warehouse B,116,97,2025-02-09 05:39:00,19
23717,ORD_23718,31641,"Logitech Brio Stream, Ultra 4K HD Video Calling, Optical Zoom, Noise-Canceling mic,HD Auto Light Correction, Works with Mi...",Warehouse C,37,21,2025-02-09 13:26:00,16
23718,ORD_23719,543,"ZEBRONICS Zeb Yoga N1 Wireless in Ear Neckband with 50ms Low Latency Gaming Mode, 20H Backup, Voice Assistant, Splash Proo...",Warehouse B,6,1,2025-02-09 05:16:00,5
23719,ORD_23720,24250,"Amazfit GTS 4 Smart Watch with 1.75” AMOLED Display, Bluetooth Calling, Alexa Built-in, SpO2, Accurate GPS Tracking Fitnes...",Warehouse B,55,36,2025-02-09 14:14:00,19
23720,ORD_23721,13984,Liposoluble Wax - Banana,Warehouse C,65,49,2025-02-09 19:05:00,16
23721,ORD_23722,18055,Nasopass-NS Nasal Drops/Spray,Warehouse A,93,76,2025-02-09 15:40:00,17
23722,ORD_23723,8526,"ESR Rebound Magnetic Case Compatible with iPad Pro 11 Inch (2022/2021/2020, 4th/3rd/2nd Generation), Convenient Magnetic A...",Warehouse C,99,83,2025-02-09 04:18:00,16
23723,ORD_23724,726,Surecort Tablet,Warehouse A,114,97,2025-02-09 07:42:00,17
23724,ORD_23725,3630,Alcitam 800mg Tablet,Warehouse B,52,44,2025-02-09 23:26:00,8
23725,ORD_23726,17802,"Wayona USB Type C Long Charger Cable Fast Charging USB C Cable 2meter/ 6ft for Samsung Galaxy S10e S10 S9 S8 Plus S10+, No...",Warehouse A,94,79,2025-02-09 05:05:00,15
23726,ORD_23727,7289,Onsitego 1 Year Extended Warranty for Small Home & Kitchen Appliances from Rs. 501-1000 (Email Delivery - No Physical Kit),Warehouse B,105,98,2025-02-09 23:27:00,7
23727,ORD_23728,24001,Bonjour Paris Silk Matte Lipstick-Cherry Red 4.2 gm,Warehouse C,72,58,2025-02-09 14:17:00,14
23728,ORD_23729,36308,Massage Lotion For Stretch Marks,Warehouse C,100,85,2025-02-09 08:50:00,15
23729,ORD_23730,3184,Norgyn-N 5mg Tablet,Warehouse A,74,59,2025-02-09 22:42:00,15
23730,ORD_23731,22256,Orient Electric 3 pin Universal Multi plug Travel Adapter 6 Amp Pack of 2,Warehouse A,71,57,2025-02-09 19:24:00,14
23731,ORD_23732,13896,Celrax Touch Lamp Truly Wireless Bluetooth Portable Speaker (Multicolour),Warehouse B,48,38,2025-02-09 16:22:00,10
23732,ORD_23733,24025,Ashwagandha Fizz Powder For Calm & Relaxed Mind - Refreshing Jeera Flavour,Warehouse A,101,88,2025-02-09 15:56:00,13
23733,ORD_23734,30591,LAIQA Premium Ultrathin Panty Liners 20's,Warehouse C,76,66,2025-02-09 16:05:00,10
23734,ORD_23735,22241,Medimade Tea Tree Oil And Ginger Oil Body Wash 300 ml,Warehouse A,47,39,2025-02-09 09:46:00,8
23735,ORD_23736,24033,Hand Made Organic Charcoal Soap,Warehouse C,101,84,2025-02-09 22:36:00,17
23736,ORD_23737,411,Ayurvedic Shampoo - Hair Care,Warehouse C,99,81,2025-02-09 04:36:00,18
23737,ORD_23738,11155,Alex+ Syrup Sugar Free,Warehouse A,84,71,2025-02-09 06:33:00,13
23738,ORD_23739,10827,Touch & Glow Advanced Fairness Cream,Warehouse A,45,35,2025-02-09 08:06:00,10
23739,ORD_23740,23856,Glimmer Premium Nail Enamel Bright Red 10 ml,Warehouse A,60,45,2025-02-09 04:00:00,15
23740,ORD_23741,24522,CEDO Redmi Note 9 Back Cover | Matte Soft Silicon Flexible | Camera Bump Protection | All Side Shock Proof Rubberised Back...,Warehouse C,75,57,2025-02-09 20:32:00,18
23741,ORD_23742,3617,Cetricold-P 500 Tablet,Warehouse A,69,58,2025-02-09 20:28:00,11
23742,ORD_23743,23863,Pantadex 40mg Tablet,Warehouse B,66,47,2025-02-09 04:29:00,19
23743,ORD_23744,31423,Mikaone 500 Injection,Warehouse C,33,23,2025-02-09 05:25:00,10
23744,ORD_23745,7366,"BigPassport USB Headphone with mic, Wired Over Ear Computer Laptop Headphones for Skype, Zoom Online Classes, Office & Cal...",Warehouse A,23,5,2025-02-09 03:25:00,18
23745,ORD_23746,13813,"Inditradition 30x60 High Powered Binoculars | for Both Adults & Kids, Waterproof (Black)",Warehouse B,42,34,2025-02-09 00:20:00,8
23746,ORD_23747,378,Panty Liners - Intima Plus Normal,Warehouse A,91,74,2025-02-09 23:36:00,17
23747,ORD_23748,36430,Meghdoot Honey Almond Body Lotion,Warehouse B,94,87,2025-02-09 17:53:00,7
23748,ORD_23749,22338,Lxopi D 10mg/20mg Capsule,Warehouse B,53,44,2025-02-09 07:51:00,9
23749,ORD_23750,3650,"Fashion Colour Professional Makeup Kit, 1822 - 1 109.3 gm",Warehouse B,19,7,2025-02-09 07:45:00,12
23750,ORD_23751,3631,"Zayn & Myza Transfer - Proof Power Matte Lip Color, Royal Maroon 6 ml",Warehouse A,22,12,2025-02-09 20:28:00,10
23751,ORD_23752,3636,Insight Cosmetics Concealer - Medium Yellow 3.5 gm,Warehouse C,33,21,2025-02-09 05:52:00,12
23752,ORD_23753,30666,Antonio Banderas Her Golden Secret Deodorant Spray 150ML,Warehouse C,86,75,2025-02-09 00:15:00,11
23753,ORD_23754,23925,Soldeen 5% Solution,Warehouse B,44,38,2025-02-09 10:26:00,6
23754,ORD_23755,23665,Whipped Mousse 86 ml,Warehouse B,61,47,2025-02-09 11:24:00,14
23755,ORD_23756,23997,Plantas Shine & Glow Skin Brightening Organic Face Cream 30 gm,Warehouse A,99,84,2025-02-09 21:02:00,15
23756,ORD_23757,13884,"REDMI Wired High Definition in-Ear Earphones with in-Built HD Mic, Hi-Res Audio Certified, 10 mm Driver, Metal Sound Chamb...",Warehouse B,54,49,2025-02-09 19:44:00,5
23757,ORD_23758,31485,Arifix 200mg Tablet DT,Warehouse C,102,87,2025-02-09 05:06:00,15
23758,ORD_23759,31481,"Tecno Pop 5 LTE (Deepsea Luster, 2GB RAM,32GB Storage) | Front Flash | 8MP Dual Camera",Warehouse A,73,55,2025-02-09 16:11:00,18
23759,ORD_23760,3058,Bathing Soap - Honey & Cream,Warehouse A,63,51,2025-02-09 08:36:00,12
23760,ORD_23761,17131,Retory 90mg Tablet,Warehouse A,19,8,2025-02-09 08:41:00,11
23761,ORD_23762,8467,PROCUS-ONE X VR Headset | VR Box 3D for All Mobiles | 40mm Lense | Virtual Reality Headset with Inbuilt Headphones and Tou...,Warehouse B,35,23,2025-02-09 16:14:00,12
23762,ORD_23763,36061,Mefonac P DS Oral Suspension,Warehouse C,83,65,2025-02-09 09:09:00,18
23763,ORD_23764,30376,Spigen Cyrill Leather Brick Back Cover Case Compatible with iPhone 12 Pro and iPhone 12 (2020) - Black,Warehouse A,78,66,2025-02-09 18:05:00,12
23764,ORD_23765,30372,Nortex TZ Tablet,Warehouse C,86,79,2025-02-09 01:35:00,7
23765,ORD_23766,24452,Fulloric 100mg Tablet,Warehouse A,29,16,2025-02-09 23:14:00,13
23766,ORD_23767,10712,Hysight Eye Drop,Warehouse A,37,20,2025-02-09 16:45:00,17
23767,ORD_23768,24463,Mirabelle Korea Kf94 Face Mask 1' s,Warehouse A,86,78,2025-02-09 01:46:00,8
23768,ORD_23769,30363,Combo Of Makeup Blender Puff Sponge + EYEBROW Razer + Nail Buffer/Shiner/Filer M1,Warehouse A,51,33,2025-02-09 12:57:00,18
23769,ORD_23770,7004,Ceftiforce SB 2000mg/1000mg Injection,Warehouse C,100,95,2025-02-09 06:10:00,5
23770,ORD_23771,12955,"Arata Vitamin C Face Serum For Glowing Skin (30 ML) Anti-Aging, Boosts Collagen 30 ml",Warehouse A,71,58,2025-02-09 17:14:00,13
23771,ORD_23772,6979,"Fashion Colour Bb Roll On Concealer, Shade 02 16 ml",Warehouse A,104,89,2025-02-09 18:50:00,15
23772,ORD_23773,21925,Ceftspn-S 1.5 Injection,Warehouse A,6,1,2025-02-09 23:07:00,5
23773,ORD_23774,3801,"Tukzer Tabletop Fully Foldable Desktop Tablet Mobile Stand Holder with Angle & Height Adjustable for Desk, Cradle, Dock, C...",Warehouse A,106,98,2025-02-09 19:18:00,8
23774,ORD_23775,663,Daily Life Forever52 Glitz Waterproof Eyeliner Eyeshadow Glt005 0.6 gm,Warehouse C,43,37,2025-02-09 00:55:00,6
23775,ORD_23776,21918,LAIQA Premium Ultrathin Day Pads (L) 10's,Warehouse C,58,51,2025-02-09 08:37:00,7
23776,ORD_23777,24486,"ZEBRONICS K24 USB Keyboard with Long Life 8 Million Keystrokes, Silent & Comfortable Use, Slim Design, Retractable Stand, ...",Warehouse C,108,98,2025-02-09 06:03:00,10
23777,ORD_23778,12943,"Portronics Power Brick II 10000 mAh Power Bank with LED Indicators, Fast Charging for Mobile & Other Devices(Black)",Warehouse A,25,19,2025-02-09 11:11:00,6
23778,ORD_23779,8484,Soulflower Tea Tree Foot Reflexology Aroma Massage Oil 90 ml,Warehouse C,77,66,2025-02-09 22:40:00,11
23779,ORD_23780,14155,"Canon GI-71 PGBK Ink Bottle, Black, Regular",Warehouse C,39,23,2025-02-09 08:24:00,16
23780,ORD_23781,36213,Enerject 12 Injection,Warehouse B,82,72,2025-02-09 23:42:00,10
23781,ORD_23782,30470,Dotix M 80mg/250mg Tablet,Warehouse C,101,94,2025-02-09 18:52:00,7
23782,ORD_23783,31381,"MI Fashion Deep Violet Matte Liquid Lipstick Water Proof, Smudge Proof and Non Transfer Long Lasting Liquid Lipstick Matt...",Warehouse C,67,49,2025-02-09 10:13:00,18
23783,ORD_23784,7262,Zisper LS Tablet,Warehouse B,10,4,2025-02-09 18:07:00,6
23784,ORD_23785,7301,Pikkme Redmi 9 Power Flip Cover| PU Leather Finish | 360 Protection | Wallet & Stand | Strong Magnetic Flip Case for Redmi...,Warehouse C,57,52,2025-02-09 12:58:00,5
23785,ORD_23786,30641,Levitor F 10mg/160mg Tablet,Warehouse B,96,83,2025-02-09 08:48:00,13
23786,ORD_23787,31453,Baroxime 100mg Tablet DT,Warehouse C,98,93,2025-02-09 04:27:00,5
23787,ORD_23788,13863,Glimper MV 2mg/500mg/0.2mg Tablet SR,Warehouse A,31,15,2025-02-09 05:17:00,16
23788,ORD_23789,23833,"PRAUSH (Formerly Plume) Creme Gel Kajal liner, Siloxane Free Formula kajal for Sensitive Eyes, Black Intense Colour, Water...",Warehouse A,50,42,2025-02-09 01:32:00,8
23789,ORD_23790,17287,"Amazon Basics Laptop Backpack - 24L, Water Repellent and Wear Resistant, Melange Slub Grey",Warehouse C,64,47,2025-02-09 18:00:00,17
23790,ORD_23791,17428,Metforise 500mg Tablet,Warehouse B,80,69,2025-02-09 11:40:00,11
23791,ORD_23792,31049,Spigen NeoFlex Screen Protector Guard for Galaxy S23 Ultra - 2 Pack,Warehouse A,10,3,2025-02-09 03:56:00,7
23792,ORD_23793,36512,Revlon So Fierce Vinyl Eye Liner - Mighty Mocha 1.2 Gm,Warehouse A,103,87,2025-02-09 12:33:00,16
23793,ORD_23794,7456,Endotel-M Tablet,Warehouse B,109,98,2025-02-09 07:19:00,11
23794,ORD_23795,3575,"ProElite Smart Flip case Cover for Samsung Galaxy Tab A8 10.5"" 2023/2022 SM-X200/ SM-X205/ SM-X207, Black",Warehouse B,35,28,2025-02-09 09:25:00,7
23795,ORD_23796,7440,CEDO OnePlus Nord CE 2 (5G) Case Back Cover Shockproof Bumper Crystal Clear | 360 Degree Protection TPU+PC | Camera Protec...,Warehouse A,37,24,2025-02-09 00:35:00,13
23796,ORD_23797,30758,Suzidrox KID 125mg Tablet,Warehouse C,50,43,2025-02-09 21:38:00,7
23797,ORD_23798,36550,Aloe Propolis creme,Warehouse C,20,10,2025-02-09 00:35:00,10
23798,ORD_23799,309,"Pikkme Back Cover for Redmi Note 8 Pro (TPU, Plastic | Black)",Warehouse C,55,44,2025-02-09 17:27:00,11
23799,ORD_23800,17713,BRALCON Organic Rose Petal Powder - 100g | Rosa indica for Facial & Skin Care| 100 % Pure & Natural Rose Powder for Tannin...,Warehouse A,84,73,2025-02-09 14:04:00,11
23800,ORD_23801,13544,Miss Claire Nmf Hydrating Solution Mask 1'S,Warehouse C,68,59,2025-02-09 03:49:00,9
23801,ORD_23802,23396,"NEWorld Premium Microfiber Cleaning/Polishing Cloth for Mobile Screen, Camera Lenses, Tablets, Monitors, Sunglasses and Ot...",Warehouse B,83,65,2025-02-09 07:43:00,18
23802,ORD_23803,31235,"Telescope Adjustable Phone Scope Mount:Cellphone Telescope Adapter Mount, Compatible with Smartphone Adapter Mount for Mon...",Warehouse C,95,86,2025-02-09 03:19:00,9
23803,ORD_23804,22821,Diever 125 Tablet,Warehouse C,54,35,2025-02-09 18:29:00,19
23804,ORD_23805,23100,Soulflower Coldpressed Sesame Carrier Oil 225 ml,Warehouse C,107,98,2025-02-09 15:17:00,9
23805,ORD_23806,23115,"iQOO 11 5G (Legend, 16GB RAM, 256 GB Storage) | Snapdragon ® 8 Gen 2 Mobile Platform| 2K E6 AMOLED Display | V2 Intelligen...",Warehouse C,57,50,2025-02-09 18:48:00,7
23806,ORD_23807,22826,Allure Wingliner Brush - (317s) 1's,Warehouse B,46,39,2025-02-09 21:34:00,7
23807,ORD_23808,22876,"Hudacrush Beauty Professional Nude And Rose Gold Eyeshadow Palette Combo, Matte And Shimmers Finish",Warehouse B,27,10,2025-02-09 00:30:00,17
23808,ORD_23809,13432,Trypam Plus 0.5mg/5mg Tablet,Warehouse C,32,22,2025-02-09 09:28:00,10
23809,ORD_23810,37052,Bodylicious Deodorant Spray - Rush (For Men),Warehouse A,46,29,2025-02-09 11:04:00,17
23810,ORD_23811,11036,Revidec 25mg Injection,Warehouse A,106,92,2025-02-09 15:10:00,14
23811,ORD_23812,37045,HANUMEX 6x9FT Chroma Green Backdrop Green Screen Background Photo Light Studio Green Photography Background for VFX Editin...,Warehouse B,38,24,2025-02-09 09:15:00,14
23812,ORD_23813,22862,"MOTOROLA e32s (Slate Gray, 4GB RAM 64GB Storage)",Warehouse B,54,42,2025-02-09 22:26:00,12
23813,ORD_23814,7781,Orflo Tablet,Warehouse A,33,20,2025-02-09 23:01:00,13
23814,ORD_23815,22859,Zaclofen 20mg Tablet ER,Warehouse A,84,78,2025-02-09 13:30:00,6
23815,ORD_23816,11042,Cx-One 1000mg Injection,Warehouse B,86,68,2025-02-09 23:37:00,18
23816,ORD_23817,23153,"Tower Mouth Organ Harmonica 24 Holes Key-C With Scale Change Option, Silver",Warehouse B,26,19,2025-02-09 09:28:00,7
23817,ORD_23818,22840,Shea Butter Soap,Warehouse A,94,87,2025-02-09 08:22:00,7
23818,ORD_23819,30990,Zifi 400mg Tablet,Warehouse C,31,15,2025-02-09 16:58:00,16
23819,ORD_23820,13321,Covent Syrup,Warehouse B,33,23,2025-02-09 13:10:00,10
23820,ORD_23821,70,"Samsung Galaxy Tab A8 26.69 cm (10.5 inch) Display, RAM 4 GB, ROM 64 GB Expandable, Wi-Fi Tablet, Silver, (SM-X200NZSEINU)",Warehouse A,72,54,2025-02-09 06:53:00,18
23821,ORD_23822,22524,Synacin 200mg Tablet,Warehouse B,77,64,2025-02-09 10:20:00,13
23822,ORD_23823,36620,Ropizuva 7.5mg Injection,Warehouse B,91,81,2025-02-09 21:41:00,10
23823,ORD_23824,31275,"TIZUM Travel Organizer Case for Earphones, Pen Drives, Memory Card, Data Cable (Black)",Warehouse A,59,48,2025-02-09 13:29:00,11
23824,ORD_23825,30783,Hair Cream - Styling With Normal Hold & Matte Finish,Warehouse B,51,36,2025-02-09 14:03:00,15
23825,ORD_23826,3550,Black Naturals - Shade 3.16 Natural Burgundy,Warehouse B,57,48,2025-02-09 06:58:00,9
23826,ORD_23827,3304,Favros 10mg Tablet,Warehouse C,113,94,2025-02-09 03:51:00,19
23827,ORD_23828,31298,Oflo 100mg Oral Suspension,Warehouse C,59,51,2025-02-09 20:08:00,8
23828,ORD_23829,7425,Correct & Perfect All-in-One Color Correcting Palette,Warehouse A,32,23,2025-02-09 07:50:00,9
23829,ORD_23830,8176,"pTron Newly Launched Boom Buddy in-Ear Wired Earphones with Mic, Type-C Audio Connector, Immersive Stereo Sound with Deep ...",Warehouse C,61,44,2025-02-09 10:55:00,17
23830,ORD_23831,3590,OpenTech Tempered Glass Screen Protector Compatible for iPhone XR / 11 with Edge to Edge Coverage and Easy Installation kit,Warehouse B,13,1,2025-02-09 05:48:00,12
23831,ORD_23832,3265,"Fashion Colour 24hr Longwear Liquid Foundation With Skin Care, Amber 30 ml",Warehouse C,51,43,2025-02-09 20:09:00,8
23832,ORD_23833,36490,Miniature Coconut & Pea Protein Shampoo,Warehouse C,32,13,2025-02-09 21:24:00,19
23833,ORD_23834,36488,Okacet Cold Tablet,Warehouse C,37,31,2025-02-09 20:09:00,6
23834,ORD_23835,36479,Pubnol-ET Tablet,Warehouse C,46,33,2025-02-09 19:40:00,13
23835,ORD_23836,7408,Genger-XP Syrup,Warehouse B,63,46,2025-02-09 12:10:00,17
23836,ORD_23837,31359,"Mobistyle,Luxury Electroplating TPU Case Individual Camera Protection for Each Lens with Logo Cut Design Back Cover Case f...",Warehouse C,83,78,2025-02-09 21:09:00,5
23837,ORD_23838,23804,Advog M 0.2 Tablet SR,Warehouse C,22,11,2025-02-09 16:26:00,11
23838,ORD_23839,7400,"Sounce Compatible for OnePlus Watch Protector Case, Heavy-Duty Overall Full Body Protective TPU Anti-Scratch from Cover fo...",Warehouse A,54,44,2025-02-09 08:44:00,10
23839,ORD_23840,36450,"Fashion Colour Kiss Lip No Transfer Lipstick, 46 Orange Red 2.6 gm",Warehouse B,19,3,2025-02-09 19:50:00,16
23840,ORD_23841,30727,Ascoril LS Junior Syrup,Warehouse C,44,25,2025-02-09 21:48:00,19
23841,ORD_23842,23827,Blue Heaven Bling Nailpaint 812 (Sea of Blue) 7 ml,Warehouse C,48,41,2025-02-09 21:21:00,7
23842,ORD_23843,23830,Rhuma Oil - Pain Relief,Warehouse C,22,16,2025-02-09 07:37:00,6
23843,ORD_23844,13797,"Fashion Colour Professional Face & Body Highlighter, Shade 02 35 gm",Warehouse A,65,55,2025-02-09 12:42:00,10
23844,ORD_23845,8171,D Xime Plus 200mg/200mg Tablet,Warehouse B,9,3,2025-02-09 10:19:00,6
23845,ORD_23846,22465,"One Plus Type C to 3.5mm Audio Jack, car Audio Connector USB Type c, Headphone Converter Cable Stereo Jack Splitter Compat...",Warehouse A,99,92,2025-02-09 20:51:00,7
23846,ORD_23847,23677,Saffron Skin-Whitening Face Scrub - With Walnut Scrub & Cinnamon Oil,Warehouse B,70,62,2025-02-09 13:31:00,8
23847,ORD_23848,7474,"Lakmé Liquid Lipstick Pink Glam,Crimson Rose (Matte)",Warehouse B,65,46,2025-02-09 10:40:00,19
23848,ORD_23849,13197,Angicam-M Tablet PR,Warehouse C,41,31,2025-02-09 14:32:00,10
23849,ORD_23850,13694,Feni 100mg Tablet,Warehouse B,52,35,2025-02-09 06:40:00,17
23850,ORD_23851,10983,eS³kube 100ml Empty Printed Bottle for Sanitizer/Lotion/Cream/Soap Dispenser (Multi Purpose) with Pump Action and Safety L...,Warehouse C,31,18,2025-02-09 13:15:00,13
23851,ORD_23852,11106,Anarex DX Syrup,Warehouse B,23,13,2025-02-09 13:23:00,10
23852,ORD_23853,23087,Hareetaki Tablets,Warehouse C,84,73,2025-02-09 22:10:00,11
23853,ORD_23854,30982,Cefox O 50mg Tablet DT,Warehouse A,34,27,2025-02-09 03:55:00,7
23854,ORD_23855,13516,Fexostar-M Tablet,Warehouse C,17,2,2025-02-09 15:49:00,15
23855,ORD_23856,17590,TWC Day and Night Sanitary Pads Combo Pack x 3 540 gm,Warehouse C,70,63,2025-02-09 05:37:00,7
23856,ORD_23857,7663,"Me Now Dual Balancing Cream Foundation, 50 ml Matte Finish",Warehouse C,112,99,2025-02-09 03:51:00,13
23857,ORD_23858,23345,Kefonic 200 Tablet,Warehouse B,17,2,2025-02-09 14:09:00,15
23858,ORD_23859,17417,Parker Vector Standard Calligraphy CT Fountain Pen (Blue),Warehouse B,48,33,2025-02-09 00:30:00,15
23859,ORD_23860,23372,Tasya Green Tea & Cucumber Pore Minimizing Face Toner 120 ml,Warehouse B,107,88,2025-02-09 14:07:00,19
23860,ORD_23861,30914,Charmacy Milano Stunning Longstay Liquid Lip (Red Sangria) 5.6 ml,Warehouse B,20,11,2025-02-09 10:10:00,9
23861,ORD_23862,7643,Eyetex Dazller Classique Compact Powder- 8002 Honey 9 gm,Warehouse B,48,29,2025-02-09 15:29:00,19
23862,ORD_23863,7640,Antiseptic - Disinfectant Liquid,Warehouse A,50,33,2025-02-09 07:09:00,17
23863,ORD_23864,22707,ADISA 15.6 inch Laptop Backpack Office Bag College Travel Back Pack 32 Ltrs (z-Navy Blue),Warehouse A,106,97,2025-02-09 05:56:00,9
23864,ORD_23865,17568,Ultican 50 DT Tablet,Warehouse A,30,18,2025-02-09 12:35:00,12
23865,ORD_23866,36919,Al-Nauim Chocolate Musk Attar (6 ml Each) - Pack of 4,Warehouse C,47,30,2025-02-09 05:07:00,17
23866,ORD_23867,30949,Cefdac 50mg Tablet,Warehouse C,17,12,2025-02-09 02:40:00,5
23867,ORD_23868,23191,NOTE ULTRA RICH COLOR EYE PENCIL 10 1.1 gm,Warehouse C,45,27,2025-02-09 04:09:00,18
23868,ORD_23869,30922,"VINAURA Microfiber Beauty Blender, Latex free, Microfiber Velvet Sponge, Used as Wet and dry Sponge both, for Airbrushed M...",Warehouse B,34,28,2025-02-09 15:25:00,6
23869,ORD_23870,13467,"Paraspapermart PPM Rubber Band for Offices use/Home/Kitchen Uses (Fluorescent Colour, 2 inch) - Pack of 100 Gm",Warehouse B,102,90,2025-02-09 20:06:00,12
23870,ORD_23871,23196,Opitel H Tablet,Warehouse A,76,61,2025-02-09 01:51:00,15
23871,ORD_23872,30985,SSKR Pure and Natural Laal Kumkum Sindoor Roli for Tilak and Puja (100 gm),Warehouse C,69,60,2025-02-09 04:31:00,9
23872,ORD_23873,23211,Rabirap D 30mg/20mg Capsule,Warehouse A,80,64,2025-02-09 21:14:00,16
23873,ORD_23874,3458,Wellpra 0.5mg Tablet,Warehouse C,38,28,2025-02-09 00:42:00,10
23874,ORD_23875,23219,Red Hot Mouthwash,Warehouse A,29,21,2025-02-09 23:31:00,8
23875,ORD_23876,36963,Spigen Essential Sand Blast TPU Back Cover Compatible for OnePlus Nord CE 5G (Matte Black),Warehouse A,80,64,2025-02-09 12:38:00,16
23876,ORD_23877,17439,ZigZag Anti-Bacterial Toothbrush - Medium,Warehouse A,65,50,2025-02-09 07:25:00,15
23877,ORD_23878,23279,Pure Detox Face Wash  - Anti-Pollution & Purity With Activated Charcoal,Warehouse B,76,63,2025-02-09 23:30:00,13
23878,ORD_23879,3467,Nourishment Radiance Rich Body Lotion,Warehouse C,38,23,2025-02-09 19:43:00,15
23879,ORD_23880,23246,Simmtronics 4GB DDR3 Laptop RAM 1600 MHz (PC 12800) with 3 Year Warranty,Warehouse B,108,92,2025-02-09 10:22:00,16
23880,ORD_23881,36942,"Khadi Omorose Neem Leaves Powder, 100 Grams",Warehouse B,104,87,2025-02-09 13:55:00,17
23881,ORD_23882,17466,Depcort 6mg Tablet,Warehouse C,56,37,2025-02-09 21:41:00,19
23882,ORD_23883,10967,Mecip 500 Tablet,Warehouse B,21,11,2025-02-09 17:11:00,10
23883,ORD_23884,3488,American Tourister Spin 49 cms Teal Laptop Backpack,Warehouse B,80,74,2025-02-09 05:04:00,6
23884,ORD_23885,13492,Duolix G 1mg/500mg Tablet,Warehouse C,10,2,2025-02-09 11:17:00,8
23885,ORD_23886,118,Man - Indigo Eau De Toilette Deodorant,Warehouse B,95,83,2025-02-09 17:05:00,12
23886,ORD_23887,3422,Anti Fung 150mg Tablet,Warehouse A,43,25,2025-02-09 08:41:00,18
23887,ORD_23888,17507,Ozen-OZ Tablet,Warehouse B,51,33,2025-02-09 00:29:00,18
23888,ORD_23889,37124,Mithen Injection,Warehouse B,24,12,2025-02-09 07:30:00,12
23889,ORD_23890,22953,Vilshine M 1000mg/50mg Tablet,Warehouse B,95,89,2025-02-09 06:22:00,6
23890,ORD_23891,7869,"Pre-Shave Oil For Moisturising, Healing & Conditioning - Argan & Jojoba",Warehouse C,100,86,2025-02-09 19:31:00,14
23891,ORD_23892,7865,Hedzole 40mg Tablet,Warehouse B,104,89,2025-02-09 16:28:00,15
23892,ORD_23893,3404,"DIGITEK® (DLS-9FT) Lightweight & Portable Aluminum Alloy Light Stand for Ring Light, Reflector, Flash Units, Diffuser, Por...",Warehouse A,24,16,2025-02-09 12:59:00,8
23893,ORD_23894,22987,Comet Busters Long Multicolor Tilak Bindi (13mm) (BV1505),Warehouse C,104,97,2025-02-09 13:54:00,7
23894,ORD_23895,7887,Nirmal Ganga - Ayurvedic Bath Scrubber,Warehouse C,66,60,2025-02-09 08:09:00,6
23895,ORD_23896,22994,HSR Car Accessories Anti-Slip Car Dashboard Mat & Mobile Phone Holder Mount - Universal Non Slip Sticky Rubber Pad for Sma...,Warehouse B,19,14,2025-02-09 23:41:00,5
23896,ORD_23897,22933,Verpitos 40mg Tablet,Warehouse A,95,83,2025-02-09 01:28:00,12
23897,ORD_23898,23065,Dryness Care Shampoo,Warehouse B,67,51,2025-02-09 21:52:00,16
23898,ORD_23899,31075,"Prolet Chain Strap Compatible with Watch 4 20mm, Watch 4 Classic 20mm, 20mm Stainless Steel Metal Bands Replacement Bracel...",Warehouse C,102,86,2025-02-09 08:34:00,16
23899,ORD_23900,13401,Chambor Gel Effectnail Lacquer The French Manicure - 0316 30 ml,Warehouse B,60,44,2025-02-09 22:27:00,16
23900,ORD_23901,36929,Flormar Illuminating Makeup Primer Plus+ 35 ml,Warehouse B,60,41,2025-02-09 11:20:00,19
23901,ORD_23902,37106,Rovapure 10mg Tablet,Warehouse A,77,72,2025-02-09 05:22:00,5
23902,ORD_23903,11049,MARVIK Soft Silicone Adjustable Band Strap Compatible for Oneplus Smart Band & Oppo Smart Band,Warehouse C,93,86,2025-02-09 08:10:00,7
23903,ORD_23904,7903,Sirona Exfoliating Face Wash 125 ml,Warehouse A,15,10,2025-02-09 20:17:00,5
23904,ORD_23905,23306,Nutriment Wine and Beer Gel All Skin Type 250 gm,Warehouse C,53,37,2025-02-09 04:16:00,16
23905,ORD_23906,23299,Gettifen Injection,Warehouse C,79,69,2025-02-09 00:35:00,10
23906,ORD_23907,22756,Mgdox 50 Dry Syrup,Warehouse B,49,31,2025-02-09 02:09:00,18
23907,ORD_23908,36912,Gliss Hair Repair Extreme Serum - Deep Repair,Warehouse A,55,46,2025-02-09 12:43:00,9
23908,ORD_23909,23311,"AmazonBasics Male to Male Stereo Audio Aux Cable with Gold Plated Connectors Tablet, Smartphone 4 Feet",Warehouse C,90,72,2025-02-09 00:18:00,18
23909,ORD_23910,31228,"7 Ultra Hair Oils - Almond, Castor, Jojoba, Coconut, Olive, Walnut, Amla Oils",Warehouse B,70,60,2025-02-09 19:46:00,10
23910,ORD_23911,17499,Maxxcode Fresh Airfreshener - Rose Ectasy 200 ml,Warehouse A,34,21,2025-02-09 15:29:00,13
23911,ORD_23912,17443,Zebi-LSR Capsule,Warehouse A,21,16,2025-02-09 13:16:00,5
23912,ORD_23913,22912,Comb - 9F Ladies Derby Deluxe No 59,Warehouse B,105,98,2025-02-09 20:11:00,7
23913,ORD_23914,30,Vovituf TH 4mg/50mg Capsule,Warehouse B,30,24,2025-02-09 18:45:00,6
23914,ORD_23915,37009,Gliptel Tablet,Warehouse B,37,24,2025-02-09 04:43:00,13
23915,ORD_23916,14287,Kama Ayurveda Natural Soap Box,Warehouse A,29,22,2025-02-08 05:26:00,7
23916,ORD_23917,14685,Hand Sanitizer - 70% Alcohol Base,Warehouse C,28,14,2025-02-08 01:23:00,14
23917,ORD_23918,8090,TheGiftKart Back Cover Case for Google Pixel 6A Back Cover Case | Soft Silicon Rubberised Matte Cover | Protective Sleek P...,Warehouse C,42,25,2025-02-08 13:56:00,17
23918,ORD_23919,18753,POPIO Tempered Glass Screen Protector Compatible for Samsung Galaxy A52 / Samsung Galaxy A52s (Black) with Edge to Edge Co...,Warehouse B,117,99,2025-02-08 08:16:00,18
23919,ORD_23920,20673,"Ceptics UK Adapter, India to Hong Kong, UAE, Dubai Travel Adapter, UK Adapter for Indian Pins - Type G Adapter - Perfect f...",Warehouse A,103,84,2025-02-08 17:28:00,19
23920,ORD_23921,10161,Arive 30mg Tablet,Warehouse A,106,94,2025-02-08 04:29:00,12
23921,ORD_23922,18817,Flormar Silk Matte Liquid Lipstick 001 Undressed 4.5 gm,Warehouse A,81,70,2025-02-08 20:35:00,11
23922,ORD_23923,14322,Streetwear Nail Enamel (Pretty Girl Collection) - I Swear 8 Ml,Warehouse B,105,86,2025-02-08 19:38:00,19
23923,ORD_23924,18803,Careflix Edge Under Eye Gel + Careflix Edge Eye Drop,Warehouse C,25,6,2025-02-08 05:41:00,19
23924,ORD_23925,18796,"MI Rechargeable Electric Toothbrush T100 for Adults with Dual Pro Mode & USB Fast Charging (White,Pack of 1)",Warehouse A,39,27,2025-02-08 22:27:00,12
23925,ORD_23926,18570,Miss Claire Extra Gentle Lip Scrub - Watermelon 5.7 Gm,Warehouse A,100,92,2025-02-08 02:51:00,8
23926,ORD_23927,18564,Aloe Veda Sweet Almond Oil 200 ml,Warehouse C,21,7,2025-02-08 14:34:00,14
23927,ORD_23928,10350,Adlynlife 22mm Smart Watch Straps/Smart Watch Band Compatible for Mi Revolve watch (Black),Warehouse A,77,67,2025-02-08 11:39:00,10
23928,ORD_23929,10503,"IRONFIX® Unbreakable Mobile Holder for Home Wall Charging, Wall Mount Phone Holder, Wall Mobile Charging Holder,Wall Holde...",Warehouse B,60,46,2025-02-08 21:15:00,14
23929,ORD_23930,9051,Cefrosun 1000 Injection,Warehouse C,42,33,2025-02-08 15:19:00,9
23930,ORD_23931,18388,Cetzil Forte 10mg Tablet,Warehouse B,31,15,2025-02-08 01:03:00,16
23931,ORD_23932,10486,"Amazonbasics Lightning To Usb Cable - Advanced Collection, Mfi Certified Apple Iphone, Tablet Charger, White, 3-Foot (Dura...",Warehouse A,76,68,2025-02-08 06:03:00,8
23932,ORD_23933,14642,Gluxit M 5 Tablet ER,Warehouse B,62,43,2025-02-08 03:47:00,19
23933,ORD_23934,8194,Radifix CV Oral Suspension,Warehouse A,55,37,2025-02-08 04:56:00,18
23934,ORD_23935,12648,Cruzone S 500mg/250mg Injection,Warehouse A,74,57,2025-02-08 08:56:00,17
23935,ORD_23936,10126,Nomxime 50mg Tablet,Warehouse B,77,64,2025-02-08 00:40:00,13
23936,ORD_23937,20906,"O3+ Collagen Serum To Brighten, Lighten, Tighten, Hydrate and Moisturise Skin and Instantly Smoothen Fine Lines and Wrinkl...",Warehouse A,72,63,2025-02-08 02:02:00,9
23937,ORD_23938,8135,REDTECH iPhone Lightning to 3.5 mm Headphone Jack Connector Audio Adapter for iPhone 13Mini/13/13 Pro/13 ProMax/12Mini/12/...,Warehouse C,92,80,2025-02-08 14:42:00,12
23938,ORD_23939,18324,AmazonBasics MFI certified 1.2M USB C to lightning aluminum with nylon braided charging cable (Grey),Warehouse A,57,45,2025-02-08 11:57:00,12
23939,ORD_23940,18282,Flormar Glitter Nail Enamel GL01 Stardust 11 ml,Warehouse B,33,28,2025-02-08 01:59:00,5
23940,ORD_23941,12619,Makeup Revolution Blender Bestie 1's,Warehouse C,54,35,2025-02-08 15:00:00,19
23941,ORD_23942,18254,Ofloked Oral Suspension,Warehouse C,78,65,2025-02-08 03:06:00,13
23942,ORD_23943,18248,Vedarambha essence of ayurveda Handmade Ayurvedic Lipsticks (G17),Warehouse C,67,61,2025-02-08 06:21:00,6
23943,ORD_23944,18244,Xycalm 0.25mg Tablet,Warehouse B,39,26,2025-02-08 16:50:00,13
23944,ORD_23945,12796,Soncef O Tablet,Warehouse B,66,52,2025-02-08 02:42:00,14
23945,ORD_23946,18908,Vega Grooming Comb (HMBC - 402) 23 gm,Warehouse B,34,25,2025-02-08 20:31:00,9
23946,ORD_23947,18915,"L'Oreal Paris Excellence Creme Hair Color, 1 Black 168 Gm",Warehouse B,51,36,2025-02-08 10:37:00,15
23947,ORD_23948,15151,Aerocast L Kid 2.5mg/4mg Syrup,Warehouse A,91,86,2025-02-08 23:49:00,5
23948,ORD_23949,17794,"MINDFIED 20W Fast Charger with Cable Compatible with Apple iPhone 13, iPhone 12, iPhone 11, iPhone X, iPhone 8 Series | 20...",Warehouse B,46,29,2025-02-08 20:12:00,17
23949,ORD_23950,10832,"Samsung Galaxy M13 5G (Aqua Green, 6GB, 128GB Storage) | 5000mAh Battery | Upto 12GB RAM with RAM Plus",Warehouse C,38,24,2025-02-08 13:51:00,14
23950,ORD_23951,8307,Ardon 60mg Injection,Warehouse A,67,60,2025-02-08 18:39:00,7
23951,ORD_23952,14782,Smartears DS Aqua Gel,Warehouse B,25,6,2025-02-08 17:17:00,19
23952,ORD_23953,20964,Lotus Herbals Baby+ Little Bubbles Gentle Bathing Soap 75 Gm,Warehouse B,37,22,2025-02-08 02:57:00,15
23953,ORD_23954,12253,Forglyn Respicap,Warehouse B,69,57,2025-02-08 02:54:00,12
23954,ORD_23955,9129,"Alboss Wall Mounted Storage Box Remote Storage Organizer Case for TV Mobile Phone Plug Air Conditioner Holder Stand Rack, ...",Warehouse C,9,4,2025-02-08 00:03:00,5
23955,ORD_23956,18735,Vestable 25mg Tablet,Warehouse A,54,36,2025-02-08 06:27:00,18
23956,ORD_23957,20722,Four Blades Pack,Warehouse B,16,3,2025-02-08 12:44:00,13
23957,ORD_23958,18703,Elugel,Warehouse B,94,83,2025-02-08 07:55:00,11
23958,ORD_23959,14410,Cepotral CV 200mg/125mg Tablet,Warehouse C,98,92,2025-02-08 20:39:00,6
23959,ORD_23960,18698,Mahir Multipurpose Laptop Table with Dock Stand & Non-Slip Legs Foldable and Portable Lapdesk for Study & Bed (Pink),Warehouse A,52,37,2025-02-08 22:43:00,15
23960,ORD_23961,12774,"Matlek Bluetooth Wireless in Ear Earphones with Mic V 5.0, 16 Hours Playtime, Low Latency for Gaming, CVC Passive Noise Ca...",Warehouse C,18,1,2025-02-08 10:25:00,17
23961,ORD_23962,14433,Tycuf-LS Syrup,Warehouse C,22,10,2025-02-08 04:54:00,12
23962,ORD_23963,18229,Dolsco 75mg Injection,Warehouse C,52,43,2025-02-08 06:21:00,9
23963,ORD_23964,18659,Rogee 500mg Injection,Warehouse B,44,27,2025-02-08 14:38:00,17
23964,ORD_23965,18615,"Lenovo IdeaPad Slim 3 Intel Celeron N4020 4th Gen 15.6"" (39.62cm) HD 220nits Anti-Glare (8GB/256GB SDD/Windows 11/Office 2...",Warehouse A,76,67,2025-02-08 15:39:00,9
23965,ORD_23966,20755,Fashion Colour Gel Primer 30 ml,Warehouse A,60,53,2025-02-08 08:57:00,7
23966,ORD_23967,8123,Tapra D 30mg/40mg Capsule SR,Warehouse B,37,25,2025-02-08 21:06:00,12
23967,ORD_23968,18589,"BIOLAGE Colorlast Conditioner | Paraben free|Helps Maintain Color Depth, Tone & Shine | Anti-Fade | For Colored Hair",Warehouse B,84,73,2025-02-08 03:15:00,11
23968,ORD_23969,20762,Moisturizing Baby Soap - Olive & Almond Oil,Warehouse B,92,80,2025-02-08 19:24:00,12
23969,ORD_23970,18576,"Versace Eros Pour Femme Eau De Toilette Natural Spray, 100Ml for Women",Warehouse C,114,98,2025-02-08 06:43:00,16
23970,ORD_23971,12785,Reokast-L Syrup,Warehouse C,27,9,2025-02-08 21:57:00,18
23971,ORD_23972,18218,Reliora-D Capsule SR,Warehouse A,9,4,2025-02-08 03:19:00,5
23972,ORD_23973,14304,Nyc DP 50mg/325mg Tablet,Warehouse B,22,6,2025-02-08 11:16:00,16
23973,ORD_23974,14252,Munixim 200mg Tablet DT,Warehouse C,38,29,2025-02-08 09:55:00,9
23974,ORD_23975,10116,"LG 87 cm (34 Inches) UltraWide Full HD (2560 x 1080) Pixels Display - HDR 10, AMD Free sync, IPS with sRGB 95%, Multitaski...",Warehouse B,12,3,2025-02-08 04:42:00,9
23975,ORD_23976,18746,Numinac P 100mg/325mg Tablet,Warehouse A,41,25,2025-02-08 16:10:00,16
23976,ORD_23977,11595,Xinof-OZ Tablet,Warehouse C,63,57,2025-02-08 12:24:00,6
23977,ORD_23978,14607,Modcet M 5mg/10mg Tablet,Warehouse A,116,98,2025-02-08 12:32:00,18
23978,ORD_23979,11361,"Duracell Ultra Alkaline 9V Battery, 2 Pcs",Warehouse C,49,35,2025-02-08 09:45:00,14
23979,ORD_23980,16809,Etorav-Plus Tablet,Warehouse C,29,13,2025-02-08 07:12:00,16
23980,ORD_23981,16074,Ufiflox OZ 200mg/500mg Tablet,Warehouse A,29,24,2025-02-08 09:44:00,5
23981,ORD_23982,16785,"Tecno Pop 5 LTE (Ice Blue, 2GB RAM,32GB Storage) | Front Flash | 8MP Dual Camera",Warehouse B,61,54,2025-02-08 07:06:00,7
23982,ORD_23983,21584,"Chambor Silver Shadow, Sable Rr3-103 16 gm",Warehouse A,84,68,2025-02-08 19:08:00,16
23983,ORD_23984,8502,Honey - Pure & Natural Immunity Booster,Warehouse A,18,5,2025-02-08 00:21:00,13
23984,ORD_23985,16883,Mini Boost Series Splash Proof Nano Bluetooth Speaker for Call and Music (5 watts),Warehouse C,66,56,2025-02-08 19:42:00,10
23985,ORD_23986,15840,Vega Straightening Brush (H1 - SB) 160 gm,Warehouse A,54,35,2025-02-08 03:12:00,19
23986,ORD_23987,21898,Xerobact TZ 500mg/600mg Tablet,Warehouse A,28,21,2025-02-08 06:35:00,7
23987,ORD_23988,11975,"ULANZI Camera Tripod, Mini Flexible Tripod Stand with Hidden Phone Holder w Cold Shoe Mount, 1/4'' Screw for Magic Arm, Un...",Warehouse A,14,1,2025-02-08 19:40:00,13
23988,ORD_23989,15859,"FLAGEHAVEN Mini Slide Projector Flashlight Torch, Kids Projection Light Toy Slide Flashlight Lamp Education Learning Night...",Warehouse A,32,15,2025-02-08 09:56:00,17
23989,ORD_23990,15872,Milixone 250mg Injection,Warehouse C,89,72,2025-02-08 10:22:00,17
23990,ORD_23991,11355,Wissclav 1000mg/200mg Injection,Warehouse B,99,80,2025-02-08 08:03:00,19
23991,ORD_23992,8480,Revlon Top Speed Hair Color Man-Natural Black 70M 40 Gm,Warehouse A,50,45,2025-02-08 18:29:00,5
23992,ORD_23993,11912,Moisturising Shampoo - For Dry Hair,Warehouse C,18,1,2025-02-08 20:32:00,17
23993,ORD_23994,8178,OJ Unique Stone Stud Bindi Round Bridal Dulhan Bindi Rajasthani Marvadi Gujrati Indian Bindiya Traditional Look Tikka for ...,Warehouse A,25,6,2025-02-08 23:49:00,19
23994,ORD_23995,16907,Ajmal Asher Concentrated Perfume Oil Oriental And Evoke Silver Edition Him Deodorant Spicy Floral Fragrance 212 ml,Warehouse C,102,92,2025-02-08 05:18:00,10
23995,ORD_23996,15967,"JBL Tune 710BT by Harman, 50 Hours Playtime with Quick Charging Wireless Over Ear Headphones with Mic, Dual Pairing, AUX &...",Warehouse B,77,64,2025-02-08 13:44:00,13
23996,ORD_23997,21897,"Brustro Drawing Papers 200 GSM A3 , Pack of 20 + 4 Free Sheets",Warehouse C,40,22,2025-02-08 12:57:00,18
23997,ORD_23998,8697,House of Beauty Hair Tonic 30 ml,Warehouse A,59,41,2025-02-08 06:49:00,18
23998,ORD_23999,8490,"Fashion Colour Jersy Girl Kiss Proof No Transfer Lipstick, 19 Chilli 2 gm",Warehouse B,58,52,2025-02-08 22:24:00,6
23999,ORD_24000,21535,Amazon Brand - Solimo Back Cover for Samsung Galaxy M32 (Silicone | Black),Warehouse A,98,90,2025-02-08 20:00:00,8
24000,ORD_24001,11900,"Ambrane 10000mAh Magnetic Wireless Power Bank for iPhone 12 & Above, 22.5W Wired + 15W Wireless Charging, Mobile Stand, Ty...",Warehouse C,115,98,2025-02-08 01:37:00,17
24001,ORD_24002,21892,Argan Oil Conditioner,Warehouse A,43,31,2025-02-08 07:10:00,12
24002,ORD_24003,8671,"Reusable Menstrual Cup With Medical Grade Silicone - Medium, FDA Approved",Warehouse A,94,80,2025-02-08 18:59:00,14
24003,ORD_24004,8662,Ajmal Aurum & Sacred Love & Shadow Homme & Avid Deo & Yearn EDP Pack of 5 20 ml,Warehouse C,62,56,2025-02-08 10:09:00,6
24004,ORD_24005,16494,LF Digital Console Protector Compatible with Suzuki Burgman | Access Street 125 Accessories - Clear (Pack of 1),Warehouse B,84,69,2025-02-08 17:06:00,15
24005,ORD_24006,21797,Mirah Belle Tea Tree Natural Face Wash 200 ml,Warehouse A,96,77,2025-02-08 14:18:00,19
24006,ORD_24007,8609,Maxocef T 250mg/31.25mg Injection,Warehouse B,14,4,2025-02-08 21:46:00,10
24007,ORD_24008,8518,"Fujifilm Instax Mini Rainbow Instant Film (Multi-Color, 10 Photos per Pack)",Warehouse C,24,10,2025-02-08 14:58:00,14
24008,ORD_24009,8517,Dezar 6mg Tablet,Warehouse A,107,94,2025-02-08 22:30:00,13
24009,ORD_24010,8516,"Lenovo IdeaPad Slim 3 Intel Core i5 11th Gen 15.6"" (39.62cm) FHD Laptop (16GB/512GB SSD/Win 11/Office 2021/2 Years Warrant...",Warehouse B,69,58,2025-02-08 18:03:00,11
24010,ORD_24011,8499,The Moms Co. Protein Hair Care Bundle 400 ml,Warehouse B,68,57,2025-02-08 04:12:00,11
24011,ORD_24012,18426,Krypxem O 200mg  Tablet,Warehouse C,105,87,2025-02-08 04:52:00,18
24012,ORD_24013,18428,"Lafz Transfer Proof & Smudge Proof Velvet Matte Lip Colour, Pink Berry 5.5 ml",Warehouse A,56,42,2025-02-08 13:39:00,14
24013,ORD_24014,22525,Agesik SP 100mg/325mg/15mg Tablet,Warehouse B,35,30,2025-02-08 01:21:00,5
24014,ORD_24015,22520,Kefotax O 200mg Tablet,Warehouse B,95,78,2025-02-08 09:54:00,17
24015,ORD_24016,10382,Flormar Touch Up Concealer 20 Ivory 4 ml,Warehouse A,43,26,2025-02-08 05:40:00,17
24016,ORD_24017,14520,"ProElite Smart Flip Case Cover for Apple iPad 10.2"" 9th Gen (2021) / 8th Gen / 7th Gen with Stylus Pen, Light Blue",Warehouse A,66,48,2025-02-08 14:51:00,18
24017,ORD_24018,22496,Neurofit 12 Tablet,Warehouse B,33,27,2025-02-08 18:16:00,6
24018,ORD_24019,18467,Cello ColourUP Celebration Kit Mega Gift Pack | Kids Colouring Set | 1 Gel Pen | 12 Crayons | 15 Oil Pastels Colouring Set...,Warehouse C,40,31,2025-02-08 16:37:00,9
24019,ORD_24020,8156,Amitryp-Plus Tablet,Warehouse B,82,71,2025-02-08 01:07:00,11
24020,ORD_24021,18461,"ORCHID ENGINEERS - Welcome Gesture Lady Design Remote Holder/Organizer For Tv Ac Dvd Dth Remotes, Living Room Decor, Showp...",Warehouse C,78,63,2025-02-08 23:59:00,15
24021,ORD_24022,8165,"NK STAR 950 Mbps USB WiFi Adapter Wireless Network Receiver Dongle for Desktop Laptop, (Support- Windows XP/7/8/10 & MAC O...",Warehouse B,64,45,2025-02-08 04:03:00,19
24022,ORD_24023,14565,"Nik case 19mm Silicone Smartwatch Strap/Band with Black Metal Buckle Strap for Noise ColorFit Pulse, ColorFit Pro 2, Color...",Warehouse C,91,85,2025-02-08 22:36:00,6
24023,ORD_24024,12698,"Beetel B11 Corded Landline Phone, Ringer Volume Control, LED for Ring Indication, Wall/Desk Mountable, Classic Design,Clea...",Warehouse A,68,52,2025-02-08 10:53:00,16
24024,ORD_24025,12693,Ajmal Avid & Raindropss & Blu & Aurum Deo & Ascend EDP Pack of 5 20 ml,Warehouse B,63,58,2025-02-08 09:13:00,5
24025,ORD_24026,18458,"Himalaya Erina Plus Coat Cleanser with Conditioner, 200 ml",Warehouse B,56,38,2025-02-08 16:35:00,18
24026,ORD_24027,18443,Kodak 80 cm (32 inches) HD Ready Certified Android LED TV 32HDX7XPRO (Black),Warehouse C,72,66,2025-02-08 08:01:00,6
24027,ORD_24028,8342,"Saregama Carvaan Hindi - Portable Music Player with 5000 Preloaded Songs, FM/BT/AUX (Porcelain White)",Warehouse B,78,71,2025-02-08 10:25:00,7
24028,ORD_24029,10936,"CREATiON Facial Exerciser - Jawline Exerciser Jaw, Face, and Neck Exerciser - Define Your Jawline, Slim and Tone Your Face...",Warehouse B,27,15,2025-02-08 05:40:00,12
24029,ORD_24030,12875,Mobibet BR Tablet,Warehouse A,64,57,2025-02-08 07:53:00,7
24030,ORD_24031,16832,Sounce Telescope Zoom 90X HD Focus Astronomical Refractor with Portable Tripod Stand. High-Power Telescope and Beginners t...,Warehouse A,78,64,2025-02-08 10:31:00,14
24031,ORD_24032,15979,Sofdase Plus 50 mg/500 mg/10 mg Tablet,Warehouse A,43,26,2025-02-08 01:29:00,17
24032,ORD_24033,16848,Daparyl 10 Tablet,Warehouse B,52,46,2025-02-08 10:08:00,6
24033,ORD_24034,16010,Ranpan DSR Capsule,Warehouse A,61,48,2025-02-08 11:25:00,13
24034,ORD_24035,16843,Brahmi Pearls,Warehouse C,104,92,2025-02-08 08:52:00,12
24035,ORD_24036,11866,Physicians Formula Shimmer Strips Extreme Shimmer Shadow & Liner - Platinum Eyes 3.4 gm,Warehouse B,80,69,2025-02-08 11:09:00,11
24036,ORD_24037,11864,Fypod 100mg Dry Syrup,Warehouse C,24,16,2025-02-08 23:03:00,8
24037,ORD_24038,16035,"TP-Link 300Mbps 2.4GHz Wireless 3G/4G Portable Router with Access Point/WISP/Router Modes (TL-MR3020), Travel-sized Desig...",Warehouse A,52,44,2025-02-08 04:30:00,8
24038,ORD_24039,17798,Metzil O Oral Suspension,Warehouse C,60,45,2025-02-08 08:11:00,15
24039,ORD_24040,14953,Mangolide 50mg Suspension,Warehouse A,47,35,2025-02-08 19:57:00,12
24040,ORD_24041,15122,"PERPAA Kumkum Red Round Bindi Book for Ladies Forehead (Stick On) (Size 11, Diameter 1.5mm)",Warehouse B,62,57,2025-02-08 14:13:00,5
24041,ORD_24042,29024,"ESR HaloLock Magnetic Phone Ring Grip, Compatible with MagSafe Phone Ring Stand, Phone Grip Compatible with iPhone 14/13/1...",Warehouse C,44,30,2025-02-08 17:08:00,14
24042,ORD_24043,24439,Lecz Tablet,Warehouse C,74,55,2025-02-08 06:48:00,19
24043,ORD_24044,7021,Breeze Paddle Hairbrush - Yellow,Warehouse C,97,89,2025-02-08 08:23:00,8
24044,ORD_24045,24501,Ayurvedic Sonth Powder,Warehouse A,30,20,2025-02-08 10:16:00,10
24045,ORD_24046,31709,Vencef 100mg Tablet,Warehouse C,98,89,2025-02-08 23:17:00,9
24046,ORD_24047,725,House of Aroma Fragrance Oil - Meditation 100 ml,Warehouse A,17,2,2025-02-08 16:11:00,15
24047,ORD_24048,2602,Clinstar-N Gel,Warehouse A,99,86,2025-02-08 08:32:00,13
24048,ORD_24049,31774,Anti-Dandruff Styling Gel - Normal Hold,Warehouse B,42,29,2025-02-08 11:42:00,13
24049,ORD_24050,24637,"Face Mask GP95+ - Blue, Large",Warehouse C,48,39,2025-02-08 22:06:00,9
24050,ORD_24051,5803,"MAYU Supracolor Foundation Palette (12 in 1) Concealer (Fair, 150 g)",Warehouse B,88,73,2025-02-08 10:00:00,15
24051,ORD_24052,3844,Teen Teen Matte Pure Base Mousse Foundation (Cool Beige),Warehouse A,106,93,2025-02-08 09:10:00,13
24052,ORD_24053,24629,Oflamed 200 Tablet,Warehouse A,88,70,2025-02-08 13:05:00,18
24053,ORD_24054,5801,BROTHER TN-B021 Toner Cartridge,Warehouse C,14,3,2025-02-08 09:31:00,11
24054,ORD_24055,34349,Fenofibric 105mg Tablet,Warehouse C,55,46,2025-02-08 21:59:00,9
24055,ORD_24056,34347,Isozit 10mg Soft Gelatin Capsule,Warehouse C,49,44,2025-02-08 17:25:00,5
24056,ORD_24057,8244,The Moms Co. Body Butter 200 gm,Warehouse B,30,15,2025-02-08 17:11:00,15
24057,ORD_24058,30338,Skin Cottage Shower Gel (Lemon) 400 ml,Warehouse A,105,89,2025-02-08 10:59:00,16
24058,ORD_24059,2600,"Arata Vitamin C Renew & Repair Combo With Purifying Face Wash (150 ML), Vitamin C Oatmeal Face Scrub (75 ML) & Vitamin C Night Repair Gel (50 ML) 275 ml",Warehouse A,102,93,2025-02-08 12:44:00,9
24059,ORD_24060,35974,"SanDisk 64GB High Endurance Video MicroSDXC Card with Adapter for Dash Cam and Home Monitoring Surveillance Systems - C10,...",Warehouse A,104,89,2025-02-08 14:13:00,15
24060,ORD_24061,4526,Safe Sun Sun Block Cream PA+ - SPF 20,Warehouse A,56,41,2025-02-08 22:40:00,15
24061,ORD_24062,28988,Lexinor TZ 400mg/600mg Tablet,Warehouse C,35,19,2025-02-08 18:15:00,16
24062,ORD_24063,26738,ZEBRONICS LPC12A Printer Cartridge for HP LJ 1010/1012/1015/1018/1020/1022/1022N/1022NW/3015/3020/3030/3050/3052/3055/M100...,Warehouse C,88,76,2025-02-08 07:05:00,12
24063,ORD_24064,24518,"ZXN 5V 10W USB Charging Cable for Mi Trimmer, Shavers, Body Groomers & Multi Grooming Models (Replacement for Mi Chargers)...",Warehouse C,90,81,2025-02-08 05:42:00,9
24064,ORD_24065,5759,Cpine 5mg Tablet,Warehouse C,110,96,2025-02-08 11:28:00,14
24065,ORD_24066,2263,HP 805 Clr/Black Ink Crtg Combo 2-Pack,Warehouse B,45,32,2025-02-08 00:02:00,13
24066,ORD_24067,13369,Dr Sheth's Centella & Niacinamide Sunscreen with SPF 50 PA+++ | For Oily & Acne-Prone Skin | Dry Touch Matte Finish | Cont...,Warehouse A,77,65,2025-02-08 20:15:00,12
24067,ORD_24068,20179,CROSSVOLT Adjustable Mi Band 5 & Mi Band 6 Watch Silicone Strap Band - (Set 5),Warehouse B,45,33,2025-02-08 21:02:00,12
24068,ORD_24069,10662,LOHAYA LED LCD TV HD Remote Compatible for TCL Android Smart LED LCD HD 4k Ultra with Netflix Function Model No:- RC802V F...,Warehouse B,53,47,2025-02-08 21:24:00,6
24069,ORD_24070,26829,GT Cin 400mg Tablet,Warehouse B,92,79,2025-02-08 20:31:00,13
24070,ORD_24071,26827,OFIXO 100 Pieces Colour Sheets Copy Printing Papers/Art and Craft Paper A4 Sheets Double Sided Coloured Origami Folding DI...,Warehouse B,22,6,2025-02-08 20:03:00,16
24071,ORD_24072,34299,"Ant Value FKBRI02 / Spill-Resistant, Silent Keys, DPI Mouse & KB Combo Wired Desktop KB, USB Keyboard Mouse Set (Black) Ga...",Warehouse C,16,3,2025-02-08 02:19:00,13
24072,ORD_24073,24467,Deca Evabolin 25mg Injection,Warehouse C,115,97,2025-02-08 02:58:00,18
24073,ORD_24074,21775,Adlynlife 22mm Smart Watch Straps/Smart Watch Band Compatible for Realme Watch S/Realme S Pro (Black),Warehouse C,68,53,2025-02-08 00:36:00,15
24074,ORD_24075,29065,HELLO ZONE Back Cover for Xiaomi Mi A3 (Rubber | Matte Black),Warehouse A,51,46,2025-02-08 21:37:00,5
24075,ORD_24076,24792,Activated Bamboo Charcoal Shampoo,Warehouse B,73,60,2025-02-08 13:28:00,13
24076,ORD_24077,24781,Provake 100mg Tablet,Warehouse A,37,30,2025-02-08 17:29:00,7
24077,ORD_24078,35799,Sofast 200mg Tablet CR,Warehouse B,80,68,2025-02-08 10:18:00,12
24078,ORD_24079,26561,Colaba PB 750mcg/75mg Capsule,Warehouse C,22,7,2025-02-08 09:19:00,15
24079,ORD_24080,24766,TheGiftKart Shockproof Crystal Clear Back Cover Case for OnePlus 6 | 360 Degree Protection | Protective Design | Transpare...,Warehouse C,49,30,2025-02-08 02:24:00,19
24080,ORD_24081,32475,Arata Natural Hydrating & Non-Drying Body Wash With Coconut & Citrus Extracts 300 ml,Warehouse B,86,80,2025-02-08 04:10:00,6
24081,ORD_24082,5810,OneAssist 3Yrs Total Protection Plan for TV (Price Range 25001-30000)-Digital Delivery in 2 Hours,Warehouse A,102,85,2025-02-08 22:37:00,17
24082,ORD_24083,1613,StayHappi Gabapentin+Amitriptyline 300mg/10mg Tablet,Warehouse C,38,31,2025-02-08 05:46:00,7
24083,ORD_24084,34273,Beauty People Velvet Matte Nail Polish Matte - Me - Magenta - Haze - 1002 9.9 ml,Warehouse A,22,13,2025-02-08 21:58:00,9
24084,ORD_24085,28950,Bella Voste 4-In-1 Makeup Stick Lavender (22) 5.5 Gm,Warehouse B,40,35,2025-02-08 01:57:00,5
24085,ORD_24086,4539,Rinostat L 2.5mg/10mg Tablet,Warehouse A,86,70,2025-02-08 15:08:00,16
24086,ORD_24087,24499,Signature Suave Body Perfume,Warehouse C,49,40,2025-02-08 17:34:00,9
24087,ORD_24088,36002,KAIASHA Smooth Loose Powder Makeup Transparent Finishing Oil Control Waterproof For Face Finish Setting With Cosmetic Puff...,Warehouse B,80,69,2025-02-08 18:09:00,11
24088,ORD_24089,6991,Olmezen 20 Tablet,Warehouse A,9,4,2025-02-08 07:50:00,5
24089,ORD_24090,5740,BabyChakra Natural Foaming Handwash 1's,Warehouse C,52,35,2025-02-08 10:09:00,17
24090,ORD_24091,24483,Zenox 200mg Tablet,Warehouse C,53,48,2025-02-08 04:35:00,5
24091,ORD_24092,6999,Monocortil 20mg Tablet,Warehouse B,97,90,2025-02-08 07:34:00,7
24092,ORD_24093,1643,"Giorgio Armani Acqua Di Gio EDT Spray for Men, 100ml",Warehouse C,74,59,2025-02-08 08:48:00,15
24093,ORD_24094,26799,Gabator NT 400mg/10mg Tablet,Warehouse A,89,82,2025-02-08 11:05:00,7
24094,ORD_24095,26805,Swipa Eyeliner Mascara Kajal 5in1 Lipstick Kajal Pencil 36hrs Eyeliner(Pack Of-6),Warehouse A,39,34,2025-02-08 20:01:00,5
24095,ORD_24096,26745,Levostat 500mg Tablet,Warehouse A,55,40,2025-02-08 09:45:00,15
24096,ORD_24097,31694,RE' EQUIL Dandruff Control Shampoo 250 ml,Warehouse C,45,35,2025-02-08 04:46:00,10
24097,ORD_24098,36028,Simulax 0.25mg/20mg Tablet,Warehouse A,95,86,2025-02-08 13:51:00,9
24098,ORD_24099,24469,Cello Technotip Ball Pen Set (Pack of 10 pens - Black) | Lightweight ball pens for pressure free & fine writing | Exam pen...,Warehouse B,104,89,2025-02-08 03:17:00,15
24099,ORD_24100,18148,The Whole Truth All-in-One | Pack of 6 x 40g | Energy Bars,Warehouse C,109,95,2025-02-08 14:28:00,14
24100,ORD_24101,10624,Advent 1.2gm  Injection,Warehouse B,113,99,2025-02-08 19:42:00,14
24101,ORD_24102,17838,Total Effects 7-In-1 -Lightweight Anti- Ageing Moisturizer Cream SPF 15,Warehouse C,24,13,2025-02-08 10:40:00,11
24102,ORD_24103,17705,Meglipride 2mg Tablet,Warehouse B,114,95,2025-02-08 19:25:00,19
24103,ORD_24104,15085,Olanex 5 Tablet,Warehouse C,60,54,2025-02-08 15:34:00,6
24104,ORD_24105,10877,Batiste Dry Hair Shampoo - Coconut & Exotic Tropical 50 ml + Fruity & Cheeky Cherry 50 ml + Floral & Flirty Blush 50 ml,Warehouse C,44,37,2025-02-08 11:58:00,7
24105,ORD_24106,8316,3D Temporary Tattoo Cross Mix Design Size 10.5x6CM - 1PC.,Warehouse C,35,24,2025-02-08 19:52:00,11
24106,ORD_24107,21172,Olancare 20mg Tablet MD,Warehouse A,38,27,2025-02-08 08:29:00,11
24107,ORD_24108,15234,"EGOTUDE Soft Slim Flexible Silicone Back Cover Case for iPhone 13 (Navy Blue, TPU)",Warehouse B,90,71,2025-02-08 19:44:00,19
24108,ORD_24109,21177,Levigress 250 Tablet,Warehouse C,17,2,2025-02-08 17:35:00,15
24109,ORD_24110,8885,TheGiftKart Shockproof Crystal Clear OnePlus 10R 5G / 10R Prime 5G Back Cover Case 360 Degree Protection Design Transparen...,Warehouse B,32,13,2025-02-08 20:29:00,19
24110,ORD_24111,17718,Omestar D Tablet,Warehouse B,64,53,2025-02-08 05:04:00,11
24111,ORD_24112,22181,Telmistal-H 40mg/12.5mg Tablet,Warehouse C,44,35,2025-02-08 06:19:00,9
24112,ORD_24113,12296,House Of Makeup Nail Lacquer - Kashmiri Chai 12 ml,Warehouse A,94,83,2025-02-08 06:44:00,11
24113,ORD_24114,22255,Ajmal Classic Oud Concentrated Perfume Oil Woody Oudh Attar And Jannatul Firdaus Concentrated Perfume Oil Oriental Attar 20 ml,Warehouse A,13,2,2025-02-08 17:22:00,11
24114,ORD_24115,22180,"FACES CANADA Comfy Matte Liquid Lipstick - Note To Self 07, 1.2 ml | Comfortable 10HR Longstay | Intense Matte Color | Alm...",Warehouse C,70,58,2025-02-08 11:41:00,12
24115,ORD_24116,17712,Voglitab 0.3 Tablet,Warehouse B,86,73,2025-02-08 22:38:00,13
24116,ORD_24117,10881,Dylor M 5mg/10mg Tablet,Warehouse B,82,75,2025-02-08 01:20:00,7
24117,ORD_24118,12262,"DIGITEK® (Platinum FW-50) Platinum Lithium-ion Rechargeable Battery for Sony DSLR Camera | Compatibility - Alpha NEX-3, 5,...",Warehouse B,110,92,2025-02-08 00:03:00,18
24118,ORD_24119,12492,Safe Sun Kids Sun Block Cream - SPF 25,Warehouse A,46,33,2025-02-08 15:08:00,13
24119,ORD_24120,17640,"Spigen Faux Leather, Polyurethane leather, Thermoplastic Polyurethane Rugged Armor Pro Cover Case Designed for Samsung Gal...",Warehouse A,88,74,2025-02-08 22:15:00,14
24120,ORD_24121,17627,Blossom Arabian Jasmine Face & Body Mist,Warehouse B,43,38,2025-02-08 01:49:00,5
24121,ORD_24122,10860,"Boat Dual QC Port Rapid Car Charger with 18W Qualcomm Quick Charge 3.0 Fast Charge, Smart IC Protection, Universal Compati...",Warehouse C,63,49,2025-02-08 01:47:00,14
24122,ORD_24123,12353,Rutek P 300 mg/500 mg Tablet,Warehouse A,105,93,2025-02-08 21:28:00,12
24123,ORD_24124,22210,Hinguvachadi Gulika,Warehouse B,37,26,2025-02-08 13:06:00,11
24124,ORD_24125,10833,Thiodase-D 4mg/50mg Capsule,Warehouse A,99,80,2025-02-08 05:33:00,19
24125,ORD_24126,8929,Rom 500 Tablet,Warehouse B,91,74,2025-02-08 02:45:00,17
24126,ORD_24127,17917,Epimute 500mg Tablet,Warehouse A,37,29,2025-02-08 22:59:00,8
24127,ORD_24128,15108,Gillette Mach 3 Manual  Shaving Razor Blades (Cartridge) 12s pack,Warehouse A,32,15,2025-02-08 15:58:00,17
24128,ORD_24129,17886,Brazo-D 10mg/20mg Tablet,Warehouse A,45,27,2025-02-08 18:13:00,18
24129,ORD_24130,12399,Charmacy Milano Star Bomb Eyeshadow 006 3.2 gm,Warehouse A,41,36,2025-02-08 04:49:00,5
24130,ORD_24131,17871,Ajmal Jannatul Firdaus Concentrated Perfume Oil Oriental And Raindrops Femme Deodorant Floral Chypre Fragrance 210 ml,Warehouse C,15,10,2025-02-08 00:36:00,5
24131,ORD_24132,8277,Wet N Wild Proline Felt Tip Eyeliner - Black 0.5 gm,Warehouse A,82,68,2025-02-08 00:13:00,14
24132,ORD_24133,12432,Lulivin Cream,Warehouse C,68,50,2025-02-08 08:04:00,18
24133,ORD_24134,14894,"Gel Bathing Bar - Men, Energising Sport",Warehouse B,76,57,2025-02-08 07:02:00,19
24134,ORD_24135,14893,Lakme 9To5 Primer + Gloss Nail Colour Cherry Red 6 Ml,Warehouse C,58,53,2025-02-08 05:10:00,5
24135,ORD_24136,14964,"Zebronics H61 Motherboard ATX Intel LGA 1155 Socket | 6USB,1VGA,1LAN,1Audio,1HDMI Port, DDR3",Warehouse A,68,55,2025-02-08 16:24:00,13
24136,ORD_24137,15022,Doxowan 400mg Tablet,Warehouse B,67,54,2025-02-08 15:08:00,13
24137,ORD_24138,8252,Metclass G 1 Tablet SR,Warehouse B,70,54,2025-02-08 10:48:00,16
24138,ORD_24139,14907,Vega Graduated Dressing Comb (HMSC - 02D) 41 gm,Warehouse A,64,55,2025-02-08 22:17:00,9
24139,ORD_24140,8253,House of Aroma Eucalyptus Essential Oil 10 ml,Warehouse B,40,35,2025-02-08 18:20:00,5
24140,ORD_24141,22297,"anchor by panasonic 22841 6A 3 Pin Multiplug Adaptor (White & Black, Pack of 2)",Warehouse B,30,13,2025-02-08 20:31:00,17
24141,ORD_24142,15043,"TheGiftKart Back Cover for Samsung S20 FE/S20 FE 5G (Poly Carbonate, Polymer | Greyish Blue)",Warehouse B,76,57,2025-02-08 16:01:00,19
24142,ORD_24143,12454,Acebel MR 100mg/325mg/250mg Tablet,Warehouse C,14,8,2025-02-08 13:34:00,6
24143,ORD_24144,22284,Anti-Dry Revitalizing Shampoo,Warehouse C,15,3,2025-02-08 18:06:00,12
24144,ORD_24145,15065,Mi QC 3.0 Charger|18W Wall Charger|Fast Lightning Charging|Certified Qualcomm Quick Charge 3.0 + BIS Certified|Compatible ...,Warehouse A,29,17,2025-02-08 05:12:00,12
24145,ORD_24146,8941,"Luxor 6 Subject Spiral Premium Exercise Notebook, Single Ruled - (18cm X 24cm), 300 Pages, Pack of 3",Warehouse B,84,73,2025-02-08 11:37:00,11
24146,ORD_24147,10619,"Amazon Brand - Solimo Anti Dust Plug Soft & Flexible Silicone, Thermoplastic Polyurethane Mobile Back Cover for Realme 7- ...",Warehouse B,92,86,2025-02-08 06:12:00,6
24147,ORD_24148,12521,Mitroja 15 Tablet,Warehouse B,107,93,2025-02-08 18:24:00,14
24148,ORD_24149,18215,"Pollution Protect - Mineral Sunscreen Gel, SPF 40",Warehouse B,95,81,2025-02-08 22:45:00,14
24149,ORD_24150,12557,Penex-SP Tablet,Warehouse B,92,78,2025-02-08 10:42:00,14
24150,ORD_24151,12584,Vega Flat Brush (R13 - FB) 106 gm,Warehouse A,101,90,2025-02-08 12:39:00,11
24151,ORD_24152,12575,Esiclo PT 4mg/100mg/325mg Tablet,Warehouse A,44,37,2025-02-08 22:54:00,7
24152,ORD_24153,12574,Dog Animal Cute Combo Tattoo Waterproof Men and Women Temporary Body Tattoo,Warehouse C,97,85,2025-02-08 02:11:00,12
24153,ORD_24154,20967,Lipitab 10mg Tablet,Warehouse B,89,79,2025-02-08 01:21:00,10
24154,ORD_24155,14819,"Camel Artist's Oil Color Box - 20ml tubes, 12 Shades",Warehouse B,47,42,2025-02-08 11:09:00,5
24155,ORD_24156,14820,Minglip M 1000mg/50mg Tablet,Warehouse B,104,86,2025-02-08 21:18:00,18
24156,ORD_24157,10594,Meftadol-Spas 10mg/250mg Tablet,Warehouse A,26,10,2025-02-08 05:12:00,16
24157,ORD_24158,8978,Munident Oil,Warehouse B,59,49,2025-02-08 06:31:00,10
24158,ORD_24159,22339,Zestocef 100mg Tablet,Warehouse C,66,57,2025-02-08 01:03:00,9
24159,ORD_24160,18195,Gulabari Premium Rose Water – 100% Natural,Warehouse B,41,23,2025-02-08 11:37:00,18
24160,ORD_24161,20984,Mecotab 500mcg Tablet,Warehouse A,97,81,2025-02-08 18:04:00,16
24161,ORD_24162,18193,Gyan Up Syrup,Warehouse A,96,88,2025-02-08 07:05:00,8
24162,ORD_24163,18171,Vivo Y15s Wave Green (3GB RAM & 32GB ROM) with No Cost EMI/Additional Exchange Offers,Warehouse B,27,18,2025-02-08 15:35:00,9
24163,ORD_24164,8566,Bio Spanish Jasmine Refreshing Hand Moisturiser Gotu Kola 180 Ml,Warehouse A,76,71,2025-02-08 04:45:00,5
24164,ORD_24165,13053,Ethikox 250mg Tablet,Warehouse B,87,81,2025-02-08 21:59:00,6
24165,ORD_24166,13721,Flormar BB Cream BB05 Medium 35 ml,Warehouse A,107,94,2025-02-08 00:12:00,13
24166,ORD_24167,19700,Khadi Essentials Ratnagarbha Clay Hair Rinser - Coffee & Red Moroccan 200 ml,Warehouse B,94,80,2025-02-08 12:36:00,14
24167,ORD_24168,13136,Plum Bodylovin Drivin Me Cherry Smoothie (Creme Lotion) 240 Ml,Warehouse C,31,17,2025-02-08 05:07:00,14
24168,ORD_24169,19486,Storite PU Leather 14 inch Laptop Messenger Organizer Bag/Shoulder Sling Office Business Professional Travel Messenger Bag...,Warehouse C,20,14,2025-02-08 08:33:00,6
24169,ORD_24170,22773,Siomik 500mg Injection,Warehouse A,88,71,2025-02-08 13:59:00,17
24170,ORD_24171,13771,Mecostem-P Capsule,Warehouse A,68,63,2025-02-08 06:44:00,5
24171,ORD_24172,9343,Metagard 60mg Tablet,Warehouse A,33,28,2025-02-08 01:04:00,5
24172,ORD_24173,19671,Albiflex 50mg/400mg Tablet,Warehouse A,106,93,2025-02-08 04:36:00,13
24173,ORD_24174,13146,Stipan DSR 30mg/40mg Capsule,Warehouse C,100,85,2025-02-08 12:21:00,15
24174,ORD_24175,19503,Zinlevo 500 Tablet,Warehouse C,30,16,2025-02-08 16:51:00,14
24175,ORD_24176,20365,Whitening Pearl Facial Kit,Warehouse B,75,61,2025-02-08 22:08:00,14
24176,ORD_24177,9790,DeBelle Gel Nail Lacquer Caramello Yellow Yellow Nail Polish 8 ml,Warehouse C,36,18,2025-02-08 04:40:00,18
24177,ORD_24178,7982,Azirich 500mg Tablet,Warehouse A,74,62,2025-02-08 07:07:00,12
24178,ORD_24179,13838,Maliao Non Greesy Vitamin Enriched Primer Oil 35 ml,Warehouse C,100,87,2025-02-08 10:40:00,13
24179,ORD_24180,13757,Bisveda 5mg Tablet,Warehouse B,103,97,2025-02-08 22:53:00,6
24180,ORD_24181,9623,Thioq-AP Tablet,Warehouse A,63,44,2025-02-08 22:26:00,19
24181,ORD_24182,20371,PLATEFORCE Smart Watch for Men - ID116 Water Proof Touchscreen Smart Watch Bluetooth 1.44 HD Screen Smart Watch with Daily...,Warehouse B,77,69,2025-02-08 21:32:00,8
24182,ORD_24183,19594,JUAREZ Octavé JRK661 61-Key Electronic Keyboard Piano with LED Display | Adapter | Key Note Stickers | Mic |Music Sheet St...,Warehouse C,99,92,2025-02-08 01:50:00,7
24183,ORD_24184,19591,TheGiftKart Crystal Clear Samsung Galaxy S20 FE / S20 FE 5G Back Cover Case 360 Degree Protection Shock Proof Design Trans...,Warehouse A,38,28,2025-02-08 18:24:00,10
24184,ORD_24185,13181,Medimade Aloe Vera And Neem Body Wash 300 ml,Warehouse C,62,43,2025-02-08 12:11:00,19
24185,ORD_24186,19576,Belora Paris Paint & Pout- Lip & Cheek - Kitten Pink 3 ml,Warehouse B,68,61,2025-02-08 13:38:00,7
24186,ORD_24187,13179,"Ajmal 1 Wisal Dhahab, 1 Nightingale, 1 Distraction And 1 Persuade Deodorants Pack of 4 200 ml",Warehouse C,108,90,2025-02-08 08:25:00,18
24187,ORD_24188,9320,Bayumont FX 10mg/120mg Tablet,Warehouse C,70,65,2025-02-08 10:03:00,5
24188,ORD_24189,20404,"Chambor Orosa Defining 10h Eyeliner Pencil, Blue No.02",Warehouse C,76,58,2025-02-08 21:33:00,18
24189,ORD_24190,19513,"Tarkan Universal Bike Mount Silicone Mobile Holder, 360° Rotating Handlebar Stand for Bicycle, Motorcycle, Scooty Fits All...",Warehouse C,99,80,2025-02-08 18:58:00,19
24190,ORD_24191,13123,SanDisk Cruzer Blade 32GB USB Flash Drive,Warehouse A,86,76,2025-02-08 05:35:00,10
24191,ORD_24192,9835,Wacom One by CTL-472/K0-CX Digital Drawing Graphics Pen Tablet (Red & Black) Small (6-inch x 3.5-inch)(15x8cm) | Battery F...,Warehouse A,70,56,2025-02-08 06:54:00,14
24192,ORD_24193,13651,Zion 4mg Tablet,Warehouse C,95,90,2025-02-08 16:38:00,5
24193,ORD_24194,22851,Brahmi Capsules,Warehouse C,43,33,2025-02-08 08:08:00,10
24194,ORD_24195,8009,Bio Kelp Protein Shampoo For Falling Hair 180 Ml,Warehouse C,41,34,2025-02-08 03:12:00,7
24195,ORD_24196,13072,Top DPS 50mg/325mg/10mg Tablet,Warehouse B,42,24,2025-02-08 00:12:00,18
24196,ORD_24197,13911,"6pcs Nail Files Set for Manicure, Nail Buffer Files Block Coarse Washable Nail Polisher Double Sided Nail Shaper Emery Boa...",Warehouse B,37,22,2025-02-08 10:30:00,15
24197,ORD_24198,9274,Insight Cosmetics Mousse Foundation - Cream Natural 30 gm,Warehouse A,46,39,2025-02-08 00:00:00,7
24198,ORD_24199,9383,"Wet n Wild MegaGlo Dual-Ended Contour Stick, 2-in-1 Contour Stick with Contouring Shade and Highlighter, Easy-to-Blend For...",Warehouse B,108,96,2025-02-08 21:44:00,12
24199,ORD_24200,19348,Passion For Vanilla Shampoo & Shower Gel,Warehouse A,102,86,2025-02-08 12:22:00,16
24200,ORD_24201,13647,Spigen Ultra Hybrid Back Cover Case for iPhone 11 (TPU + Poly Carbonate | Crystal Clear),Warehouse B,32,16,2025-02-08 05:11:00,16
24201,ORD_24202,9957,"Nokia T20 Tab with 10.36""(26cm) 2K Screen, Low Blue Light, Wi-Fi & LTE, 8200mAh Battery, Android 11 with 2 Years of OS Upg...",Warehouse A,52,45,2025-02-08 18:23:00,7
24202,ORD_24203,19217,Ciprofast 250mg Tablet,Warehouse B,28,16,2025-02-08 02:58:00,12
24203,ORD_24204,9960,Avopod 25mg Oral Drops,Warehouse A,24,16,2025-02-08 11:12:00,8
24204,ORD_24205,19187,"Gizga Essentials Laptop Bag Sleeve Case Cover Pouch for 14.1 Inch Laptop for Men & Women, Padded Laptop Compartment, Free ...",Warehouse B,49,35,2025-02-08 17:42:00,14
24205,ORD_24206,9221,Shower Gel - Patchouli & Macadamia,Warehouse A,98,92,2025-02-08 00:09:00,6
24206,ORD_24207,13286,POPIO Screen Guard for OnePlus 10 Pro/OnePlus 11 / OnePlus 9 Pro/Oppo Find X3 / X3 Pro / X5 Pro (Transparent) Edge to Edge...,Warehouse B,58,49,2025-02-08 15:21:00,9
24207,ORD_24208,19160,The Body Shop 100% Natural Shea Butter,Warehouse A,73,68,2025-02-08 02:10:00,5
24208,ORD_24209,19166,Apexim 200mg Tablet,Warehouse B,59,51,2025-02-08 16:47:00,8
24209,ORD_24210,14106,Detoxifying Mineral Pack,Warehouse C,42,26,2025-02-08 04:25:00,16
24210,ORD_24211,14090,"Engage M4 Perfume Spray For Men, Spicy and Lavender, Skin Friendly, 120ml",Warehouse A,77,60,2025-02-08 16:12:00,17
24211,ORD_24212,13268,The Moms Co. Protein Shampoo 200 ml,Warehouse C,70,59,2025-02-08 03:55:00,11
24212,ORD_24213,9391,Soulflower Coffee Glitter Peel-Off Mask 100 gm,Warehouse B,66,60,2025-02-08 02:29:00,6
24213,ORD_24214,9993,"Gizga Essentials High Performance USB Hub, 5 in 1 USB Hub, Fast Data Transfer, 3 USB 2.0, 2-Port Card Reader, SD TF Data T...",Warehouse A,18,5,2025-02-08 17:33:00,13
24214,ORD_24215,13267,Ultra Light Aquagel Suncreen+Purifying Cleanser,Warehouse B,40,25,2025-02-08 20:27:00,15
24215,ORD_24216,14072,ALOXE Cute Makeup Cosmetic Organizer Box With Drawer Storage | Plastic Storage Organizer Box For Women(Green),Warehouse B,47,28,2025-02-08 13:51:00,19
24216,ORD_24217,9601,Airlift 100mg Capsule,Warehouse C,103,91,2025-02-08 23:57:00,12
24217,ORD_24218,9232,Tanzen-D 50mg/10mg Tablet,Warehouse C,40,28,2025-02-08 20:17:00,12
24218,ORD_24219,22683,Tea Tree & Vetiver Aroma Radical Refresher Shampoo,Warehouse B,48,42,2025-02-08 13:07:00,6
24219,ORD_24220,13557,WOW Skin Science Cool Mint Hair Oil - with Comb Applicator - Non Sticky & Non Greasy - for All Hair Types - No Mineral Oi...,Warehouse C,51,42,2025-02-08 03:34:00,9
24220,ORD_24221,8039,Omtech 20mg Capsule,Warehouse A,30,25,2025-02-08 06:44:00,5
24221,ORD_24222,9973,"Revetime Anti Aging, Pollution Protection & Skin Brightening Face Wash | Dry, Oily Skin | For Men And Women | With Morocca...",Warehouse C,78,61,2025-02-08 01:13:00,17
24222,ORD_24223,22894,"Wiffy  Gel Lipstick Green Jelly Lipstick Long Lasting Color Changing  (green, 3.6 g)",Warehouse C,76,60,2025-02-08 14:23:00,16
24223,ORD_24224,9594,TheGiftKart Back Cover for Samsung Galaxy M21/M21 2021 Edition/M30s (Poly Carbonate | Blue),Warehouse A,86,67,2025-02-08 12:14:00,19
24224,ORD_24225,20279,"Yardley London English Rose Moisturising Shower Crème (Body wash), With Natural Floral Essence & Shea Butter, 250ml",Warehouse B,97,87,2025-02-08 23:47:00,10
24225,ORD_24226,8007,Dexobet 4mg Injection,Warehouse A,47,30,2025-02-08 22:40:00,17
24226,ORD_24227,13217,Cosklot 250mg Tablet,Warehouse B,90,75,2025-02-08 02:08:00,15
24227,ORD_24228,9886,"NOVEL Medi bath Antiseptic Agent and Aqua Glycerine Adult Body Wipes 10""s Alovera (Pack of 8 / 8 Wipes)",Warehouse C,58,49,2025-02-08 19:20:00,9
24228,ORD_24229,20009,Dipro 125mg Tablet,Warehouse A,35,17,2025-02-08 22:14:00,18
24229,ORD_24230,19021,Votri 5mg Tablet,Warehouse C,80,62,2025-02-08 06:16:00,18
24230,ORD_24231,18977,"DIGITEK® (DBSK-009FT) Studio Background Stand Kit for Backdrop Photography and Videography, Portable and Foldable Stand Ki...",Warehouse B,37,18,2025-02-08 04:46:00,19
24231,ORD_24232,12933,Rimit D 30mg/20mg Capsule SR,Warehouse C,97,86,2025-02-08 16:57:00,11
24232,ORD_24233,19087,Fairness Moisturiser With Mandarin Extract,Warehouse B,25,6,2025-02-08 16:49:00,19
24233,ORD_24234,9458,Action Pro Tripod Mount Adapter and Screw Compatible with GoPro Hero 11 10 9 8 7 6 5 4 3 2 SJCAM Yi 4K Eken and Other Acti...,Warehouse C,83,76,2025-02-08 03:40:00,7
24234,ORD_24235,19112,"Parker Vector CT Fountain Pen, Stainless Steel",Warehouse A,67,52,2025-02-08 10:02:00,15
24235,ORD_24236,8063,Kancin 500mg Injection,Warehouse C,109,94,2025-02-08 22:17:00,15
24236,ORD_24237,20192,Bedoxim Syrup,Warehouse A,21,16,2025-02-08 15:51:00,5
24237,ORD_24238,20600,Henna Template Hand Body Art Tattoo Stencils Reusable Temporary Tools DIY,Warehouse C,17,1,2025-02-08 12:37:00,16
24238,ORD_24239,10090,Organic Cotton Tampons - Medium,Warehouse B,71,55,2025-02-08 20:40:00,16
24239,ORD_24240,20245,Telminorm 40 H Tablet,Warehouse B,53,41,2025-02-08 11:50:00,12
24240,ORD_24241,14146,OpenTech® Silicone Protection Bumper Case Cover for Samsung Galaxy Watch 4 Classic (46mm) Full Coverage (Black),Warehouse A,43,36,2025-02-08 05:02:00,7
24241,ORD_24242,14177,Saaraswatha Granules,Warehouse A,51,39,2025-02-08 07:09:00,12
24242,ORD_24243,18987,House Of Makeup Nail Lacquer - Flat White 12 ml,Warehouse B,13,7,2025-02-08 10:41:00,6
24243,ORD_24244,20043,Doubledicestore Tempered Glass Screen Protector Compatible for Redmi Note 11 Pro Plus 5G / Redmi Note 11 Pro / 5G with Edg...,Warehouse C,36,30,2025-02-08 16:47:00,6
24244,ORD_24245,20065,Arctic Hunter Laptop Bag Expandable Backpack for 16 inch Lapotp 40L Travel Backpack Water-resistant Business School Backpa...,Warehouse B,69,63,2025-02-08 17:42:00,6
24245,ORD_24246,22951,Suchek 500mg Tablet,Warehouse A,57,48,2025-02-08 23:42:00,9
24246,ORD_24247,14193,Zaling Plus Tablet CR,Warehouse C,53,40,2025-02-08 10:02:00,13
24247,ORD_24248,20166,Gold Deodorizing Talc - For Men,Warehouse B,27,19,2025-02-08 15:12:00,8
24248,ORD_24249,13490,Gliss Hair Repair Colour Protect & Shine Anti-Fading Mask,Warehouse B,40,27,2025-02-08 02:07:00,13
24249,ORD_24250,13405,Kenulide T 100mg/2mg Tablet,Warehouse C,92,87,2025-02-08 07:19:00,5
24250,ORD_24251,14226,Levozee 500mg Tablet,Warehouse A,59,50,2025-02-08 20:01:00,9
24251,ORD_24252,13450,"Faber-Castell Tri-Grip Brush - Flat, Pack of 4 (Assorted)",Warehouse C,91,78,2025-02-08 11:15:00,13
24252,ORD_24253,9209,"Biotique Natural Makeup Starkissed Moist Matte Lipstick, Born Wild",Warehouse A,77,61,2025-02-08 12:33:00,16
24253,ORD_24254,20020,Brustro Professional Art Masking Fluid 100ml (75ml + 25ml Free),Warehouse C,73,58,2025-02-08 16:32:00,15
24254,ORD_24255,20190,Asifin 100mg Tablet,Warehouse A,94,83,2025-02-08 03:15:00,11
24255,ORD_24256,5863,Elspas Tablet,Warehouse C,10,4,2025-02-08 04:27:00,6
24256,ORD_24257,19996,"Amblitz Unruled Spiral Notebook (A4, 400 Pages) 70GSM",Warehouse B,49,39,2025-02-08 22:00:00,10
24257,ORD_24258,20589,Lakme 9 to 5 Complexion Care CC Cream,Warehouse C,59,40,2025-02-08 11:38:00,19
24258,ORD_24259,9874,Biov-D3 Softgel Capsule,Warehouse C,37,21,2025-02-08 01:23:00,16
24259,ORD_24260,20103,"Glowy Professional Makeup Brush Set - 13 Piece Makeup Brushes for Eyeshadow, Powder, Blush, Foundation Blending Brush Set ...",Warehouse B,72,53,2025-02-08 19:23:00,19
24260,ORD_24261,22860,Rose Geranium Aroma Massage Oil,Warehouse A,21,14,2025-02-08 21:47:00,7
24261,ORD_24262,19374,Spasgan-M 50mg/250mg Tablet,Warehouse B,25,12,2025-02-08 21:31:00,13
24262,ORD_24263,9868,Sweet Revival Chocolate Peel-Off Mask,Warehouse C,103,84,2025-02-08 12:39:00,19
24263,ORD_24264,9861,Essential Oil - Lemon,Warehouse B,94,78,2025-02-08 16:48:00,16
24264,ORD_24265,19805,Ink 100mg Injection,Warehouse B,89,82,2025-02-08 17:55:00,7
24265,ORD_24266,20452,Miss Diva Showstopper Gift Set,Warehouse C,27,22,2025-02-08 16:56:00,5
24266,ORD_24267,19788,Bql 2.5mg Tablet,Warehouse C,84,65,2025-02-08 14:53:00,19
24267,ORD_24268,19769,Axatol 20IU Infusion,Warehouse C,113,98,2025-02-08 20:45:00,15
24268,ORD_24269,19749,FRU 20 MG INJECTION,Warehouse C,52,47,2025-02-08 03:47:00,5
24269,ORD_24270,19401,Wet N Wild Color Icon Eyeshadow Glitter Single - Karma 1.4 gm,Warehouse C,17,11,2025-02-08 17:17:00,6
24270,ORD_24271,20343,Livzing Multipurpose Foldable Study Desk Portable Wooden Utility Laptop Table Bedside Drawing Room Home Decor-Space Saving...,Warehouse A,72,63,2025-02-08 04:52:00,9
24271,ORD_24272,9299,Zall-XP Tablet,Warehouse A,27,12,2025-02-08 00:04:00,15
24272,ORD_24273,13110,Saregama Carvaan Mini 2.0 Telugu- Music Player with Bluetooth/FM/AM/AUX (Sunset Red),Warehouse B,100,82,2025-02-08 17:04:00,18
24273,ORD_24274,7994,Fexin 120mg Tablet,Warehouse C,93,83,2025-02-08 06:56:00,10
24274,ORD_24275,19705,Everycom EC-58 58mm (2 Inches) Direct Thermal Printer- Monochrome Desktop (1 Year Warranty) (USB),Warehouse C,36,23,2025-02-08 04:30:00,13
24275,ORD_24276,9690,Flezox RB 200mg/20mg Tablet,Warehouse A,66,59,2025-02-08 00:37:00,7
24276,ORD_24277,12953,"realme narzo 50A (Oxygen Blue , 4GB RAM + 64 GB Storage) Helio G85 Processor | 6000 mAh Battery",Warehouse A,61,47,2025-02-08 22:42:00,14
24277,ORD_24278,13170,Prota 10mg Injection,Warehouse A,41,30,2025-02-08 22:37:00,11
24278,ORD_24279,8062,Evening Primrose Oil - Vegetarian Capsule (500 mg),Warehouse A,82,71,2025-02-08 13:08:00,11
24279,ORD_24280,12923,Venflaz 6mg Tablet,Warehouse B,101,88,2025-02-08 21:14:00,13
24280,ORD_24281,18947,MOSHKING Back Cover Case Compatible for iPhone 13 with Slide Camera || Heavy Duty Military Grade Protection Mobile Phone C...,Warehouse A,50,43,2025-02-08 20:16:00,7
24281,ORD_24282,14212,Ketohext 200mg Tablet,Warehouse B,39,23,2025-02-08 08:49:00,16
24282,ORD_24283,20193,Elev 250mg Tablet,Warehouse A,47,41,2025-02-08 08:07:00,6
24283,ORD_24284,19064,Artikel Monitor Desk Mount | Adjustable Spring Assisted Monitor Arm | VESA Mount with C Clamp & Grommet Mounting Base | Co...,Warehouse A,51,33,2025-02-08 04:45:00,18
24284,ORD_24285,10083,Extreme Repair Acai Oil Shampoo 250 ml,Warehouse C,102,86,2025-02-08 09:04:00,16
24285,ORD_24286,13326,Fexohist 120mg Tablet,Warehouse B,39,26,2025-02-08 13:51:00,13
24286,ORD_24287,20315,Fashion Colour Sun Block Cream Spf 50 130 gm,Warehouse A,79,70,2025-02-08 16:20:00,9
24287,ORD_24288,19839,Dayclazide-XR Mex 60 Tablet,Warehouse A,81,65,2025-02-08 11:25:00,16
24288,ORD_24289,16263,Cefiante 100mg Tablet DT,Warehouse C,109,90,2025-02-08 22:08:00,19
24289,ORD_24290,11054,Azafran Organics Skin Brightening Face Wash 50 gm,Warehouse A,40,22,2025-02-08 11:22:00,18
24290,ORD_24291,17460,OBOE Silicon Soft Cover Case for Mi Power Bank 3i 10000 mAh/Mi Wireless Power Bank 10000 mAh Battery (Black),Warehouse C,81,66,2025-02-08 10:07:00,15
24291,ORD_24292,8823,Tnw The Natural Wash Vitamin C Exfoliating Face Wash 125 gm,Warehouse B,28,15,2025-02-08 17:09:00,13
24292,ORD_24293,17448,Olque H 12.5mg/40mg Tablet,Warehouse A,65,46,2025-02-08 23:26:00,19
24293,ORD_24294,21300,LF 250mg Tablet,Warehouse B,97,79,2025-02-08 15:27:00,18
24294,ORD_24295,17447,"SanDisk Ultra Shift USB Flash Drive USB 3.0, 100MB/s R, 32GB",Warehouse B,105,87,2025-02-08 08:21:00,18
24295,ORD_24296,15505,Onpen-P Tablet,Warehouse C,41,31,2025-02-08 10:49:00,10
24296,ORD_24297,21302,"realme Buds Q2s Bluetooth Truly Wireless in Ear Earbuds with Mic, Fast Charging & Up to 30Hrs Playtime (Green)",Warehouse A,53,43,2025-02-08 18:16:00,10
24297,ORD_24298,15496,"Lapster USB 3.0 Male to Female usb extension cable, super speed 5GBps usb 3.0 extension cable Data Transfer for Hard Driv...",Warehouse C,56,39,2025-02-08 17:55:00,17
24298,ORD_24299,22114,Tobiotic 125mg/125mg Capsule,Warehouse A,20,12,2025-02-08 20:41:00,8
24299,ORD_24300,8820,Oline 2.5mg Tablet,Warehouse B,16,9,2025-02-08 11:21:00,7
24300,ORD_24301,15520,Ajmal Tempest Concentrated Perfume Oil Floral Attar And Colaba Mukhallat Concentrated Perfume Oil Floral Oriental Attar 26 ml,Warehouse C,30,18,2025-02-08 15:16:00,12
24301,ORD_24302,22101,Layer'r Shot Black Noir | Long Lasting Body Spray | for Men | 130ml,Warehouse A,19,9,2025-02-08 17:32:00,10
24302,ORD_24303,17444,MANCODE De-Tan Mask 100 gm,Warehouse C,48,30,2025-02-08 17:42:00,18
24303,ORD_24304,17434,Vagilds 25mg Tablet,Warehouse C,47,39,2025-02-08 19:43:00,8
24304,ORD_24305,22122,HP 47 Black Original Ink Cartridge,Warehouse B,90,85,2025-02-08 23:13:00,5
24305,ORD_24306,20518,Ranozex 1gm Tablet ER,Warehouse B,84,74,2025-02-08 21:00:00,10
24306,ORD_24307,8832,"Smart Watch for Men - Smart Watches for Men Women, Bluetooth Smartwatch Touch Screen Bluetooth Smart Watches for Android i...",Warehouse C,100,83,2025-02-08 10:49:00,17
24307,ORD_24308,17053,Rozy 500mg Tablet,Warehouse B,22,11,2025-02-08 11:12:00,11
24308,ORD_24309,17524,I AM EYECONIC FINE GLITTER GOLD SOUK 4 gm,Warehouse C,65,59,2025-02-08 04:50:00,6
24309,ORD_24310,12245,Vermikill Plus 12mg/400mg Tablet,Warehouse B,100,93,2025-02-08 06:20:00,7
24310,ORD_24311,17576,Amoxiv CV 1000mg/200mg Injection,Warehouse A,35,22,2025-02-08 00:37:00,13
24311,ORD_24312,21252,Exudolp Tablet,Warehouse B,103,92,2025-02-08 17:39:00,11
24312,ORD_24313,8845,"WALKENT Home Digital LED Clock (Black,Plastic) Bluetooth Speaker, Dual Alarm, Temperature Sensor & Display, Mobile Phone H...",Warehouse C,31,17,2025-02-08 23:37:00,14
24313,ORD_24314,10978,Onsitego 1 Year Extended Warranty for Small Household Appliances from Rs. 12501-15000 (Email Delivery - No Physical Kit),Warehouse A,44,28,2025-02-08 15:36:00,16
24314,ORD_24315,15415,Plus 360 Protection Back Cover Case for LG G8X ThinQ (TPU + Poly Carbonate | Black),Warehouse C,20,10,2025-02-08 23:40:00,10
24315,ORD_24316,10985,Felox 200mg Tablet,Warehouse C,23,18,2025-02-08 12:47:00,5
24316,ORD_24317,12215,NOCXTUN 360 Degree Rotation Mini Tripod Support Stand for DSLR and Smartphones - Foldable Shockproof Lightweight Bracket f...,Warehouse B,66,52,2025-02-08 21:12:00,14
24317,ORD_24318,11016,Non-Gas Body Perfume For Men - Blanc,Warehouse C,72,56,2025-02-08 02:37:00,16
24318,ORD_24319,10996,Grooming Solutions Kit,Warehouse A,27,8,2025-02-08 00:56:00,19
24319,ORD_24320,21281,Spigen EZ Fit Tempered Glass Screen Protector Guard for Valve Steam Deck - 1 Pack,Warehouse A,102,97,2025-02-08 18:17:00,5
24320,ORD_24321,12181,Migranoc 250mg/10mg Tablet,Warehouse A,102,93,2025-02-08 19:07:00,9
24321,ORD_24322,12168,Glimmer Ne Cherry Red 5Ml Btl M 24 ml,Warehouse B,29,23,2025-02-08 13:04:00,6
24322,ORD_24323,21235,"OnePlus 11 5G (Titan Black, 8GB RAM, 128GB Storage)",Warehouse A,45,33,2025-02-08 17:32:00,12
24323,ORD_24324,16488,"SPIN CART 2.5 inch SATA to USB 3.0 External Hard Drive Enclosure, Transparent Portable Hard Disk HDD SSD Case Cover Box",Warehouse A,33,16,2025-02-08 04:54:00,17
24324,ORD_24325,11510,Salvadol-SP Tablet,Warehouse C,93,87,2025-02-08 23:38:00,6
24325,ORD_24326,16465,Qutec 100mg Tablet,Warehouse B,86,67,2025-02-08 10:26:00,19
24326,ORD_24327,21758,Allgoric Tablet,Warehouse C,57,40,2025-02-08 14:58:00,17
24327,ORD_24328,16385,Handmade Pocket Dressing Comb - HMC06,Warehouse B,34,21,2025-02-08 09:13:00,13
24328,ORD_24329,21734,Divine-Issme Set - Eau De Parfum + Deodorant,Warehouse A,67,48,2025-02-08 15:45:00,19
24329,ORD_24330,11701,Emanzen 5mg Tablet,Warehouse B,17,5,2025-02-08 00:24:00,12
24330,ORD_24331,16336,Etonis 90mg Tablet,Warehouse C,101,83,2025-02-08 20:46:00,18
24331,ORD_24332,21750,Ajmal Nightingale And Magnetize For Men & Women And Wisal Deodorants Pack of 3 200 ml,Warehouse B,59,45,2025-02-08 15:21:00,14
24332,ORD_24333,11759,"ProElite Deer Smart Flip case Cover for Samsung Galaxy Tab S6 Lite 10.4 Inch 2022 SM-P610/P615 with S Pen Holder , Black",Warehouse C,36,20,2025-02-08 10:10:00,16
24333,ORD_24334,21670,"SanDisk Ultra 128 GB USB Pen Drive (SDDDC2-128G-G46, Black, Silver)",Warehouse B,22,6,2025-02-08 09:35:00,16
24334,ORD_24335,16206,Rosusin 10mg Tablet,Warehouse B,68,60,2025-02-08 17:33:00,8
24335,ORD_24336,11575,Power 10 Formula Propolis,Warehouse B,78,61,2025-02-08 12:57:00,17
24336,ORD_24337,16673,Nortrop 25 Tablet,Warehouse C,24,9,2025-02-08 00:21:00,15
24337,ORD_24338,11529,Medimade Aloe Vera & Vitamin E Moisturising Cream 200 gm,Warehouse A,67,56,2025-02-08 23:42:00,11
24338,ORD_24339,8651,Stagrel-A Tablet,Warehouse C,8,2,2025-02-08 00:48:00,6
24339,ORD_24340,8649,Vominar 4mg Tablet,Warehouse C,84,76,2025-02-08 14:19:00,8
24340,ORD_24341,16151,Bella Voste Sugar Baby Nail Paints Shade 371 10 Ml,Warehouse C,86,69,2025-02-08 23:09:00,17
24341,ORD_24342,16632,Electvision Remote Control Compatible with Amazon Fire tv Stick (Pairing Manual Will be Back Side Remote Control)(PP),Warehouse C,39,21,2025-02-08 05:38:00,18
24342,ORD_24343,8648,Neomentin CV 500mg/125mg Tablet,Warehouse C,30,22,2025-02-08 15:38:00,8
24343,ORD_24344,16595,Gofloxa 500mg Tablet,Warehouse A,76,63,2025-02-08 08:16:00,13
24344,ORD_24345,16585,Telmicam 20mg Tablet,Warehouse B,53,44,2025-02-08 22:33:00,9
24345,ORD_24346,16165,TopFinder® 24h Glitter Glossy Lipstick Set Light Shade Waterproof Long Lasting Eye Glow Clear Lip-gloss Makeup Kit Face Sh...,Warehouse A,78,61,2025-02-08 07:11:00,17
24346,ORD_24347,8545,Cixdop 200mg Tablet DT,Warehouse C,97,92,2025-02-08 12:45:00,5
24347,ORD_24348,11778,Glucomark 50mg Tablet,Warehouse B,71,56,2025-02-08 19:13:00,15
24348,ORD_24349,16174,I AM EYECONIC FINE GLITTER BAD B 4 gm,Warehouse B,79,63,2025-02-08 09:02:00,16
24349,ORD_24350,11570,Zuflo 200mg Tablet,Warehouse B,65,58,2025-02-08 13:24:00,7
24350,ORD_24351,21939,"Omron MC 246 Digital Thermometer With Quick Measurement of Oral & Underarm Temperature in Celsius & Fahrenheit, Water Resi...",Warehouse B,108,98,2025-02-08 01:08:00,10
24351,ORD_24352,10999,"Fashion Colour Kiss Lip Balm, Shade 08 2 gm",Warehouse B,21,6,2025-02-08 17:58:00,15
24352,ORD_24353,15471,HUMBLE Universal Monopod Holder Clip for Mobile Camera Holder and Tripod Mount Holder- Black (Pack of Two),Warehouse A,20,10,2025-02-08 01:16:00,10
24353,ORD_24354,17514,"MI 10000mAh Lithium Ion, Lithium Polymer Power Bank Pocket Pro with 22.5 Watt Fast Charging, Dual Input Ports(Micro-USB an...",Warehouse C,66,58,2025-02-08 22:03:00,8
24354,ORD_24355,12131,Natural Hand Made Travel Soap - Turmeric,Warehouse A,78,71,2025-02-08 20:53:00,7
24355,ORD_24356,12126,Glimmer Ne Fresh Blue 5Ml Btl M 25 ml,Warehouse C,74,58,2025-02-08 18:40:00,16
24356,ORD_24357,17365,SanDisk ® Ultra Curve USB 3.2 64GB 100MB/s R Black,Warehouse C,64,52,2025-02-08 22:59:00,12
24357,ORD_24358,12121,Pure Aloe Soothing Gel,Warehouse B,65,56,2025-02-08 06:10:00,9
24358,ORD_24359,8405,Actorab AC 200mg/20mg Capsule SR,Warehouse A,85,77,2025-02-08 05:59:00,8
24359,ORD_24360,11107,The Real Man Liquid Concealer & Facial Sponge. (SHADE: 02 BEIGE),Warehouse B,92,77,2025-02-08 02:58:00,15
24360,ORD_24361,15615,Giloy Churna,Warehouse B,55,47,2025-02-08 19:44:00,8
24361,ORD_24362,15630,Loose Orginal Shinning Surma - (1 Pic) (Shinningwala Surma),Warehouse B,116,97,2025-02-08 00:31:00,19
24362,ORD_24363,20649,Oil Control Face Wash - For 12hr Oil Control With 10x Vitamin C Effect,Warehouse A,79,68,2025-02-08 20:15:00,11
24363,ORD_24364,21748,"Streax Professional Hold & Play Funky Colours Hair Color, 100g - Crazy Violet 100g",Warehouse C,104,93,2025-02-08 11:59:00,11
24364,ORD_24365,18935,Rabemol 20mg Tablet,Warehouse B,99,80,2025-02-08 09:50:00,19
24365,ORD_24366,19126,Carvenol 25 Tablet,Warehouse C,67,53,2025-02-08 14:41:00,14
24366,ORD_24367,20291,"boAt Airdopes Atom 81 True Wireless in Ear Earbuds with Upto 50H Playtime, Quad Mics ENx Tech, 13MM Drivers, Beast Mode(50...",Warehouse B,28,14,2025-02-08 16:47:00,14
24367,ORD_24368,19859,"Ciate London Glow- To Illuminating Blush, Summer love, 4 g",Warehouse A,71,57,2025-02-08 14:12:00,14
24368,ORD_24369,9952,Kimid Soap,Warehouse C,110,93,2025-02-08 10:19:00,17
24369,ORD_24370,9944,Penzer 40mg Tablet,Warehouse A,66,57,2025-02-08 23:41:00,9
24370,ORD_24371,13240,Vega Lice Comb (HMC - 37) 26 gm,Warehouse A,45,31,2025-02-08 19:36:00,14
24371,ORD_24372,9939,Pink Grapefruit & Vitamin C Luxury Shower Gel,Warehouse B,78,73,2025-02-08 06:16:00,5
24372,ORD_24373,19266,Koszid 1000mg Injection,Warehouse A,52,41,2025-02-08 15:14:00,11
24373,ORD_24374,20550,Paratop 500mg Tablet,Warehouse B,30,17,2025-02-08 02:09:00,13
24374,ORD_24375,19274,Monceclo 200mg Tablet SR,Warehouse B,60,43,2025-02-08 04:07:00,17
24375,ORD_24376,13231,Dilona 50mg Tablet,Warehouse A,91,85,2025-02-08 01:29:00,6
24376,ORD_24377,13634,"TRUNISH Multi-Purpose Laptop Desk for Study and Reading with Foldable Non-Slip Legs Reading Table Tray, Laptop Table, Lapt...",Warehouse B,76,66,2025-02-08 15:19:00,10
24377,ORD_24378,13954,"Tecno POVA 3 (Eco Black, 4GB RAM,64GB Storage) | 7000mAh Battery |33W Fast Charger",Warehouse A,23,10,2025-02-08 06:57:00,13
24378,ORD_24379,9256,"VONZEE® Back Cover for iPhone SE (2020/2022) Case, Shockproof Slim Camera & Full Body Protection Liquid Silicone TPU Cover...",Warehouse C,28,21,2025-02-08 01:25:00,7
24379,ORD_24380,22730,Tolfen 400mg/350mg Tablet DT,Warehouse B,105,98,2025-02-08 16:53:00,7
24380,ORD_24381,13228,"Cablet 2.5 Inch SATA USB 3.0 HDD/SSD Portable External Enclosure for 7mm and 9.5mm, Tool-Free Design, Supports UASP Max 6TB",Warehouse C,96,84,2025-02-08 04:56:00,12
24381,ORD_24382,9900,Vilbeat M 500mg/50mg Tablet,Warehouse C,66,60,2025-02-08 06:16:00,6
24382,ORD_24383,19842,Oblivion LCD Writing Tablet/pad 8.5 inches | Electronic Writing Scribble Board for Kids |Kids Learning Toy |for Home/Schoo...,Warehouse C,98,80,2025-02-08 04:08:00,18
24383,ORD_24384,22873,Divalcad 250mg Tablet ER,Warehouse A,33,23,2025-02-08 05:38:00,10
24384,ORD_24385,12130,"ProElite Trifold Flip case Cover for Samsung Galaxy Tab A8 10.5"" SM-X200/ SM-X205/ SM-X207 2021, Hippy",Warehouse A,86,68,2025-02-08 01:23:00,18
24385,ORD_24386,15582,Revlon Nearly Naked Pressed Powder - Medium Deep 8 Gm,Warehouse A,77,60,2025-02-08 02:47:00,17
24386,ORD_24387,17505,Mars Soft Matte Silicone Free Long Lasting Serum Drop Founcation-F3-125,Warehouse B,63,52,2025-02-08 00:05:00,11
24387,ORD_24388,12188,"Brand Conquer 6 in 1 with OTG, SD Card Reader, USB Type C, USB 3.0 and Micro USB, for Memory Card | Portable Card Reader |...",Warehouse B,67,55,2025-02-08 11:31:00,12
24388,ORD_24389,8379,Ceflee 500mg Tablet,Warehouse B,87,82,2025-02-08 18:19:00,5
24389,ORD_24390,12153,"Soulvinee Glass Eye Wash Cup for Keep Your Eyes Clean and Healthy | Soothing Relief from Allergens, Irritants, Makeup, Dus...",Warehouse A,36,19,2025-02-08 14:36:00,17
24390,ORD_24391,15551,Roslaren AC 20 Capsule,Warehouse C,67,62,2025-02-08 06:49:00,5
24391,ORD_24392,17277,"LIMESHOT DX2 Charger Compatible with Fossil Gen 5 Smartwatch Charging USB Magnetic Cable for Gen 5 Carlyle, Julianna, Gare...",Warehouse C,79,67,2025-02-08 05:41:00,12
24392,ORD_24393,21386,Fashion Colour Dtan Facial Kit (On The Go) 125 gm,Warehouse C,73,55,2025-02-08 07:56:00,18
24393,ORD_24394,8768,Lebact Am 500mg/75mg Tablet,Warehouse C,106,99,2025-02-08 10:58:00,7
24394,ORD_24395,17228,"Klenzmo Screen Cleaner and Lens Cleaner with Microfiber Cloth 250ml, Laptop Cleaner, Mobile Screen Cleaner, TV & Flat Scre...",Warehouse C,104,92,2025-02-08 06:48:00,12
24395,ORD_24396,15688,Emprox CV Syrup,Warehouse A,104,88,2025-02-08 23:54:00,16
24396,ORD_24397,15692,Infemox 500mg Capsule,Warehouse C,22,4,2025-02-08 22:22:00,18
24397,ORD_24398,15718,Ibuflam 400 mg/500 mg Tablet,Warehouse C,92,82,2025-02-08 16:45:00,10
24398,ORD_24399,11235,M.A.C Studio Fix Fluid Foundation Spf15 Nc37 (JL69060906),Warehouse B,81,70,2025-02-08 07:31:00,11
24399,ORD_24400,17401,Navneet HQ | Five Subject Spiral Wiro Bound Notebook | 14.8x21 cm |Single Line |300 Pages |Black,Warehouse B,110,98,2025-02-08 06:49:00,12
24400,ORD_24401,21421,C-Bend Syrup,Warehouse B,40,29,2025-02-08 23:47:00,11
24401,ORD_24402,15759,"Fashion Colour Satin Smooth Lip Definer, 15 Oak Brown 1.41 gm",Warehouse C,15,1,2025-02-08 12:29:00,14
24402,ORD_24403,17094,"i-feel Gentle Intimate Wash Sensitive Cleanser, Helps maintain Vaginal pH balance, Soothes from Dryness, Itchiness, Irrita...",Warehouse C,75,61,2025-02-08 12:22:00,14
24403,ORD_24404,17072,Bronko Syrup,Warehouse C,41,22,2025-02-08 22:05:00,19
24404,ORD_24405,11285,"Sanitary Pads - XL Plus Wings, Ultra",Warehouse B,90,79,2025-02-08 04:54:00,11
24405,ORD_24406,8739,"Fashionury Back Cover for Realme 6 Transparent Hybrid Hard PC Back TPU Bumper Impact Resistant Case (Black,Transparent)",Warehouse A,63,52,2025-02-08 13:51:00,11
24406,ORD_24407,8738,Prexol 0.375mg Tablet SR,Warehouse C,37,28,2025-02-08 14:53:00,9
24407,ORD_24408,15638,"IVANA'S Heena Mehandi Tatto Stencil Set for | Hand | Body | Fingure | Face | Heena Art Temporary Tatto for Kids, Girls & W...",Warehouse B,53,46,2025-02-08 17:51:00,7
24408,ORD_24409,15634,Chymotry 90mg/48mg/100mg Tablet,Warehouse C,113,94,2025-02-08 13:24:00,19
24409,ORD_24410,17313,Star Polaris,Warehouse B,36,30,2025-02-08 08:32:00,6
24410,ORD_24411,17348,Spigen Ultra Hybrid Back Cover Case Compatible with iPhone 14 (TPU + Poly Carbonate | Matte Black),Warehouse A,13,2,2025-02-08 01:22:00,11
24411,ORD_24412,17397,Portronics Konnect B Micro USB Cables For Fast Charging & Data Sync 3.0 Amp with PVC Heads I Nylon Braided I 1 mtr(Black),Warehouse A,73,58,2025-02-08 22:05:00,15
24412,ORD_24413,21333,Sodoxim 200 Tablet,Warehouse C,71,52,2025-02-08 19:40:00,19
24413,ORD_24414,15566,"TP-Link USB Bluetooth Adapter for PC 4.0 Bluetooth Dongle Receiver Support Windows 11/10/8.1/8/7 for Desktop, Laptop, Mous...",Warehouse B,30,21,2025-02-08 06:33:00,9
24414,ORD_24415,11093,Shampoo - Egg White Protein,Warehouse C,103,84,2025-02-08 12:30:00,19
24415,ORD_24416,24798,Cipti 250mg/300mg Tablet,Warehouse C,84,76,2025-02-08 07:26:00,8
24416,ORD_24417,26567,"LS LAPSTER Quality Assured USB 2.0 morpho cable, morpho device cable for Mso 1300 E3/E2/E Biometric Finger Print Scanner m...",Warehouse C,53,36,2025-02-08 22:45:00,17
24417,ORD_24418,30198,Colorbar Accessories Eye Blending Brush Zacc020 1'S,Warehouse A,63,55,2025-02-08 08:23:00,8
24418,ORD_24419,33432,Spigen Rugged Armor Back Cover Compatible for Google Pixel 6a (TPU | Matte Black),Warehouse A,61,43,2025-02-08 03:25:00,18
24419,ORD_24420,223,N T Dip Plus 0.5mg/10mg Tablet,Warehouse C,36,25,2025-02-08 23:04:00,11
24420,ORD_24421,28405,"Noise Newly Launched Air Buds 2 Truly Wireless in Ear Earbuds with 40H of Playtime, Instacharge(10 min=240 min), Quad Mic ...",Warehouse B,72,53,2025-02-08 03:24:00,19
24421,ORD_24422,36719,Adamon 50mg Capsule,Warehouse C,48,37,2025-02-08 09:57:00,11
24422,ORD_24423,36847,Batiste Plus Dry Hair Shampoo - Beautiful Brunette 200 ml,Warehouse B,34,22,2025-02-08 09:55:00,12
24423,ORD_24424,33463,Panda Dsr 30mg/40mg Capsule,Warehouse A,12,6,2025-02-08 04:46:00,6
24424,ORD_24425,30847,"Sennheiser HD 458 ANC Foldable Bluetooth Wireless Over Ear Headphones with Mic, Alexa Built-in - Active Noise Cancellatio...",Warehouse C,85,73,2025-02-08 23:22:00,12
24425,ORD_24426,2373,"boAt Airdopes 393ANC True Wireless in Ear Earbuds with 32dB Hybrid ANC, Quad Mics with ENx™ Tech, 30 Hours Playback, Beas...",Warehouse B,48,31,2025-02-08 10:12:00,17
24426,ORD_24427,30868,Valnigo-Chrono 500mg Tablet,Warehouse C,52,42,2025-02-08 17:56:00,10
24427,ORD_24428,31240,Telvok Trio 20mg Tablet,Warehouse A,98,85,2025-02-08 12:06:00,13
24428,ORD_24429,23492,"SAIJI Gooseneck Cell Phone Holder, Universal Clamp Lazy Mount Clip Hands Free Flexible Long Arm Bracket Grip for 4.0-6.3 P...",Warehouse A,25,14,2025-02-08 12:51:00,11
24429,ORD_24430,7589,"Vox V11 Keypad Mobile with King Talker, Auto Call Recording & Contact Icon (1.8 Inch, Dual Sim Multimedia) (Red)",Warehouse A,26,18,2025-02-08 19:05:00,8
24430,ORD_24431,23478,"Lakmé Rose Face Powder, Soft Pink, 40g And Lakmé Nail Color Remover, 27ml",Warehouse B,81,71,2025-02-08 21:18:00,10
24431,ORD_24432,33439,Ateleb 100mg Tablet,Warehouse B,16,6,2025-02-08 22:03:00,10
24432,ORD_24433,23452,Vibmont-L Tablet,Warehouse B,86,69,2025-02-08 05:19:00,17
24433,ORD_24434,2371,Modopan D 10mg/40mg Tablet,Warehouse A,67,50,2025-02-08 11:33:00,17
24434,ORD_24435,28445,Orik 20mg Capsule,Warehouse B,80,69,2025-02-08 23:46:00,11
24435,ORD_24436,28412,VW 80 cm (32 inches) Playwall Frameless Series HD Ready Android Smart LED TV VW3251 (Black),Warehouse C,81,74,2025-02-08 14:41:00,7
24436,ORD_24437,27730,Mecosung P 750mcg/75mg Capsule,Warehouse A,31,20,2025-02-08 01:13:00,11
24437,ORD_24438,144,Antoine 250mg Tablet,Warehouse C,38,29,2025-02-08 12:17:00,9
24438,ORD_24439,32944,Flormar Matte Nail Enamel M23 Burgundy in Matte 11 ml,Warehouse A,63,55,2025-02-08 17:32:00,8
24439,ORD_24440,23979,"Tough Lee Tempered Glass Screen Guard for Apple iPhone 12/12 Pro, Apple iPhone 11 / XR (Transparent) Full Coverage Gorilla...",Warehouse C,93,84,2025-02-08 10:14:00,9
24440,ORD_24441,36826,Arata Natural Face Wash(50 Ml) & Toothpaste(50 Ml) Facewash - Gently Exfoliates & Controls Oil Toothpaste - Fluoride-Free Formula 100 ml,Warehouse B,99,83,2025-02-08 21:59:00,16
24441,ORD_24442,36820,Agirest 250 Tablet,Warehouse A,19,5,2025-02-08 09:26:00,14
24442,ORD_24443,27673,"DIGITEK® (DTR-200MT) (18 CM) Portable & Flexible Mini Tripod with Mobile Holder & 360 Degree Ball Head, For Smart Phones, ...",Warehouse B,40,30,2025-02-08 15:25:00,10
24443,ORD_24444,2394,"Dermafique Intensive Restore Body Serum, Body Lotion for Dry Skin, 10x Vitamin E, Deeply hydrates and moisturizes, Repairs...",Warehouse A,58,48,2025-02-08 20:04:00,10
24444,ORD_24445,23626,"Loofah/Sponge Scrubber/Body Bath - Hangable, Dual Side, Brown, BH-064D BRN",Warehouse C,102,88,2025-02-08 03:52:00,14
24445,ORD_24446,33552,Perfume Spray - Gold,Warehouse C,113,97,2025-02-08 23:07:00,16
24446,ORD_24447,27660,Feepod 50mg Dry Syrup,Warehouse C,56,37,2025-02-08 23:05:00,19
24447,ORD_24448,7525,Light Moisturiser,Warehouse A,98,93,2025-02-08 06:51:00,5
24448,ORD_24449,23600,"ONUMTZ 30W USB-C Female to Lightning Cable Adapter, Type-C to 8 Pin Male PD Fast Charging Converter Cord Data Sync Connect...",Warehouse C,68,59,2025-02-08 14:42:00,9
24449,ORD_24450,2397,Chutki Bestie Kids Toothbrush For Age 3-14 Years,Warehouse B,78,63,2025-02-08 03:40:00,15
24450,ORD_24451,36572,SpiffySky USB CH340/341 to RS485 Converter Adapter Module,Warehouse A,22,12,2025-02-08 18:37:00,10
24451,ORD_24452,36567,Itragic 200mg Capsule,Warehouse B,49,36,2025-02-08 07:37:00,13
24452,ORD_24453,260,Levomet 500 Tablet,Warehouse A,22,15,2025-02-08 12:08:00,7
24453,ORD_24454,2024,Slazenger Eau De Toilette Blue For Men 125 ml,Warehouse C,90,72,2025-02-08 09:55:00,18
24454,ORD_24455,30786,Cadilose Oral Solution,Warehouse A,102,89,2025-02-08 21:19:00,13
24455,ORD_24456,23690,VINAURA Makeup Remover Towel | Removes Waterproof Face Eye Lip Make up Instantly with water Make-up Cleansing Pad Sponge C...,Warehouse B,117,98,2025-02-08 21:50:00,19
24456,ORD_24457,27608,"Kanget Type C Female to Lightning Male Adapter, Compatible with All iOS Devices (iOS 13 or Above)",Warehouse A,56,50,2025-02-08 04:43:00,6
24457,ORD_24458,33574,"TheGiftKart Shockproof Crystal Clear Back Cover Case for OnePlus Nord CE 2 5G (Polycarbonate, TPU | Transparent Back | Bla...",Warehouse A,89,81,2025-02-08 22:45:00,8
24458,ORD_24459,23681,MI Original 27W Superfast Charging Adapter for Cellular Phones - White (2021 Edition),Warehouse A,52,38,2025-02-08 08:27:00,14
24459,ORD_24460,33572,Dezlac 6 Tablet,Warehouse B,33,17,2025-02-08 11:46:00,16
24460,ORD_24461,36702,Terbiax 250mg Tablet,Warehouse A,75,65,2025-02-08 18:36:00,10
24461,ORD_24462,31268,Hello Zone Matte Finish Soft Back Case Cover for Realme 1 - Black,Warehouse A,17,11,2025-02-08 22:38:00,6
24462,ORD_24463,7494,Ajmal Selfie Concentrated Perfume Oil Woody Aromatic And Maryaj Wild Speed EDP Citrus Spicy Perfume 110 ml,Warehouse A,38,27,2025-02-08 14:57:00,11
24463,ORD_24464,5308,"Trudiance Transfer-Proof Velvet Finish Matte Cream Lipstick Long-Lasting, Vegan,Toxin-Free with Natural Active Ingredients...",Warehouse A,50,37,2025-02-08 12:58:00,13
24464,ORD_24465,36593,"Redmi K50i 5G (Stealth Black, 8GB RAM, 256GB Storage) | Flagship Mediatek Dimensity 8100 Processor | 144Hz Liquid FFS Disp...",Warehouse B,47,29,2025-02-08 03:10:00,18
24465,ORD_24466,3288,Afxo MT 10mg/120mg Tablet,Warehouse A,97,90,2025-02-08 20:11:00,7
24466,ORD_24467,32837,7SEVEN¨ Suitable Sony Tv Remote Original Bravia for Smart Android Television Compatible for Any Model of LCD LED OLED UHD ...,Warehouse A,87,71,2025-02-08 07:12:00,16
24467,ORD_24468,36498,Cipronit 500mg Tablet,Warehouse C,107,93,2025-02-08 01:36:00,14
24468,ORD_24469,2417,Body Wash Macadamia Oil & Peony Extracts + Invigorating Handwash Refill (750ml),Warehouse B,98,90,2025-02-08 23:22:00,8
24469,ORD_24470,33626,Amthro CF LB 200mg/250mg Tablet,Warehouse B,72,53,2025-02-08 15:27:00,19
24470,ORD_24471,33625,Delbitol 50mg Tablet,Warehouse A,13,1,2025-02-08 14:20:00,12
24471,ORD_24472,32853,"Samsung Galaxy M04 Light Green, 4GB RAM, 64GB Storage | Upto 8GB RAM with RAM Plus | MediaTek Helio P35 | 5000 mAh Battery",Warehouse C,38,23,2025-02-08 07:07:00,15
24472,ORD_24473,316,Vigini Bust Firming Massage Cream 100 gm,Warehouse A,88,79,2025-02-08 10:09:00,9
24473,ORD_24474,294,Ripoxim CV 200mg/125mg Tablet,Warehouse C,38,27,2025-02-08 12:11:00,11
24474,ORD_24475,313,Cello Maxriter Ball Pen | Pack of 10 | Black Ball Pen | Lightweight Ball Pens for Pressure Free & Fine Writing | Elasto Gr...,Warehouse A,14,8,2025-02-08 17:45:00,6
24475,ORD_24476,27560,Hello Zone Exclusive Matte Finish Soft Back Case Cover for Nokia 7.2 - Black,Warehouse B,103,91,2025-02-08 19:30:00,12
24476,ORD_24477,33606,"DIZO Watch D2 Power (by realme TechLife) – Large 1.91"" Superlight, Single Chipset Bluetooth Calling Smartwatch with Smart ...",Warehouse C,39,22,2025-02-08 21:06:00,17
24477,ORD_24478,2055,"JBL Flip 6 Wireless Portable Bluetooth Speaker Pro Sound, Upto 12 Hours Playtime, IP67 Water & Dustproof, PartyBoost & Per...",Warehouse B,87,76,2025-02-08 21:45:00,11
24478,ORD_24479,7559,Nirgo-AL Syrup,Warehouse B,68,55,2025-02-08 21:45:00,13
24479,ORD_24480,35705,Kimirica Five Elements Moisturizing Scented Body Lotion with Tangerine and Green Tea for All Skin Type | Instant Hydratio...,Warehouse B,102,84,2025-02-08 06:43:00,18
24480,ORD_24481,6606,Ormalin 60 Tablet,Warehouse C,77,62,2025-02-08 14:13:00,15
24481,ORD_24482,34661,St.Botanica Conditioner - GO Strong 200 ml,Warehouse B,17,1,2025-02-08 21:13:00,16
24482,ORD_24483,29833,Soft Touch Hair Removal Cream Gold 50 gm,Warehouse C,52,46,2025-02-08 08:26:00,6
24483,ORD_24484,29813,Cardichem 6.25mg Tablet,Warehouse B,74,59,2025-02-08 12:37:00,15
24484,ORD_24485,2898,"Fashion Colour Super Matte Lipstick, Blush Pink 4 gm",Warehouse B,82,74,2025-02-08 11:30:00,8
24485,ORD_24486,2761,TheGiftKart Sleek Back Cover Case for Vivo V27 / V27 PRO 5G | Slim Fit Protective Design | Ultra Matte Finish | Camera Pro...,Warehouse B,12,6,2025-02-08 15:01:00,6
24486,ORD_24487,1388,Giloy Tablet,Warehouse C,87,68,2025-02-08 10:13:00,19
24487,ORD_24488,29365,Odema 100mg/15mg Tablet,Warehouse A,55,41,2025-02-08 19:18:00,14
24488,ORD_24489,1396,I AM EYECONIC Duo Chrome Pigments BEST LIFE 2 gm,Warehouse C,58,42,2025-02-08 04:40:00,16
24489,ORD_24490,25252,Floxivol OZ Oral Suspension,Warehouse C,55,36,2025-02-08 06:57:00,19
24490,ORD_24491,31958,Cassin 100mg Tablet DT,Warehouse C,29,23,2025-02-08 07:03:00,6
24491,ORD_24492,35521,"Blue Heaven Hypergel Nailpaint - Sangria GOLD, 711 11 ml",Warehouse C,108,92,2025-02-08 06:16:00,16
24492,ORD_24493,1408,Milestone Nothing Phone 1 Camera Protector/Camera Lens Tempered Glass Compatible with Nothing Phone 1 Back Metal Ring (Black),Warehouse A,22,15,2025-02-08 04:30:00,7
24493,ORD_24494,29353,Azenate Nasal Spray,Warehouse A,56,39,2025-02-08 08:49:00,17
24494,ORD_24495,952,Allure Angle Eyeshadow Brush - (235) 1's,Warehouse B,56,48,2025-02-08 10:46:00,8
24495,ORD_24496,36760,Elv Car Mount Adjustable Car Phone Holder Air Vent Mobile Mount with Automatic Lock Release Cradle for Smartphones,Warehouse A,47,31,2025-02-08 10:09:00,16
24496,ORD_24497,949,Oacef 100mg Tablet DT,Warehouse A,92,81,2025-02-08 04:03:00,11
24497,ORD_24498,6619,Mazoderm 1% Cream,Warehouse A,93,86,2025-02-08 01:32:00,7
24498,ORD_24499,26121,Libitus  Syrup,Warehouse B,104,91,2025-02-08 08:05:00,13
24499,ORD_24500,26123,Omoxyl 500mg Capsule,Warehouse C,83,73,2025-02-08 16:22:00,10
24500,ORD_24501,25171,Nature's Essence Anti-Pollution Gel Face Wash Active Charcoal 100 ml,Warehouse B,69,54,2025-02-08 04:55:00,15
24501,ORD_24502,6692,Amrevo AT 5mg/50mg Tablet,Warehouse A,52,47,2025-02-08 14:36:00,5
24502,ORD_24503,34593,Ajmal Blu Dreams EDP Citurs Fruity Perfume 100ml for Men and Carbon EDP Citrus Spicy Perfume 100ml for Men +1 Perfume Test...,Warehouse C,72,53,2025-02-08 10:55:00,19
24503,ORD_24504,34585,Nuroson GN 400mg/10mg Tablet,Warehouse C,39,20,2025-02-08 00:53:00,19
24504,ORD_24505,34450,Vega Graduated Dressing Comb (AC - 05) 45 gm,Warehouse A,72,54,2025-02-08 18:49:00,18
24505,ORD_24506,24918,Vega Grooming Comb (HMC - 75) 55 gm,Warehouse A,29,22,2025-02-08 23:42:00,7
24506,ORD_24507,6778,Rcap D 30mg/20mg Capsule SR,Warehouse A,23,9,2025-02-08 00:22:00,14
24507,ORD_24508,24909,"SWAPKART [2 PACK Fast Charging Cable and Data Sync USB Cable Compatible for iPhone 6/6S/7/7+/8/8+/10/11, 12, 13 Pro max iP...",Warehouse A,84,68,2025-02-08 04:40:00,16
24508,ORD_24509,1418,Engecet AM 5mg/60mg Tablet,Warehouse C,102,95,2025-02-08 09:45:00,7
24509,ORD_24510,6633,"TOSHIBA Canvio Advance 1TB Portable External HDD, USB3.0 for PC Laptop Windows and Mac. 3 Years Warranty. External Hard Dr...",Warehouse C,63,52,2025-02-08 11:55:00,11
24510,ORD_24511,6023,Zyncet Tablet,Warehouse B,92,78,2025-02-08 13:26:00,14
24511,ORD_24512,2736,Montbre 5mg/10mg Tablet,Warehouse B,84,75,2025-02-08 00:40:00,9
24512,ORD_24513,4819,"Blue Heaven Hypergel Nailpaint - Desert Nude, 201 11 ml",Warehouse C,7,2,2025-02-08 11:45:00,5
24513,ORD_24514,31247,Cilinimore 5mg Tablet,Warehouse B,22,16,2025-02-08 11:48:00,6
24514,ORD_24515,4828,Absolute Bi-Phased Make-Up Remover,Warehouse A,74,64,2025-02-08 13:25:00,10
24515,ORD_24516,33484,Beauty People Pure Matte Lipstick - Rustic - Magic - 207 3.8 gm,Warehouse B,9,4,2025-02-08 19:59:00,5
24516,ORD_24517,36798,BoldnYoung Eye Lash Curler Random color (1pcs.),Warehouse A,45,37,2025-02-08 11:55:00,8
24517,ORD_24518,30842,Glaze Hair Wax for Men,Warehouse B,31,19,2025-02-08 19:52:00,12
24518,ORD_24519,28871,"EMBOX 10A Extension board with usb port - 4 Universal Sockets and 3 USB (2.4 A) charging Ports with Indicator,2500w Heavy ...",Warehouse A,32,13,2025-02-08 22:01:00,19
24519,ORD_24520,428,Troypep TZ 4000mg/500mg Powder for Injection,Warehouse C,50,39,2025-02-08 03:35:00,11
24520,ORD_24521,2752,"XIAOMI Dual Driver Dynamic Bass in-Ear Wired Earphones with Mic, 10mm & 8mm Dual Dynamic Drivers for Heavy Bass & Crystal-...",Warehouse C,42,33,2025-02-08 22:13:00,9
24521,ORD_24522,34643,Tapnac Oral Suspension,Warehouse A,16,8,2025-02-08 07:50:00,8
24522,ORD_24523,25140,"Random-Mac Professional Prep + Prime Primer, Matchmaster Foundation, HD Glow Liquid Highlighter, 24 Hour Concealer With Ma...",Warehouse B,63,51,2025-02-08 10:25:00,12
24523,ORD_24524,32252,Portronics Car Power 6 Car Charger with Dual USB Port for Cellular Phones (PD+QC) 38 Watt(Black),Warehouse A,85,69,2025-02-08 08:47:00,16
24524,ORD_24525,29864,"HP G200 Backlit USB Wired Gaming Mouse with Ergonomic Design, All Customizable Buttons, Adjustable 4000 DPI, RGB Breathing...",Warehouse C,111,97,2025-02-08 10:04:00,14
24525,ORD_24526,1442,Perfect Radiance Intense Lightening - Night Creme,Warehouse A,35,27,2025-02-08 05:44:00,8
24526,ORD_24527,2928,"Elecshion (Full-Coverage) Privacy Screen Protector for iPhone 11 and iPhone XR(2 Pack), Anti-spy Tempered Glass Screen Pro...",Warehouse C,75,58,2025-02-08 16:35:00,17
24527,ORD_24528,26187,Conceft 1000mg Injection,Warehouse B,41,25,2025-02-08 15:15:00,16
24528,ORD_24529,25123,Joyspas-D Oral Drops,Warehouse C,99,88,2025-02-08 10:04:00,11
24529,ORD_24530,34614,Pazopan 40mg Tablet,Warehouse C,27,8,2025-02-08 13:55:00,19
24530,ORD_24531,35588,XX Revolution press shadow palette xxtortion 1.2 gm,Warehouse A,37,29,2025-02-08 01:32:00,8
24531,ORD_24532,2935,Syband Suspension,Warehouse C,24,10,2025-02-08 08:50:00,14
24532,ORD_24533,35597,Mefespas 80mg/250mg Tablet,Warehouse B,63,56,2025-02-08 06:03:00,7
24533,ORD_24534,31925,Double Side Cotton Pads,Warehouse B,87,79,2025-02-08 09:40:00,8
24534,ORD_24535,1455,"Tecno Spark 9 (Infinity Black, 4GB RAM,64GB Storage) | 7GB Expandable RAM | Helio G37 Gaming Processor",Warehouse B,109,93,2025-02-08 12:47:00,16
24535,ORD_24536,6037,"LAKMÉ Forever Matte Liquid Lip Color, Matte Finish, 5.6 ml - Wine Touch and Forever Matte Liquid Lip Color, Matte Finish, ...",Warehouse C,32,22,2025-02-08 20:05:00,10
24536,ORD_24537,2741,Faces Canada Eye Pencil Dark Sparkle-03 1.2 Gm,Warehouse A,19,7,2025-02-08 12:52:00,12
24537,ORD_24538,29263,ZEBRONICS Zeb-Grace U Wired Over Ear Headphone with Mic (Black),Warehouse C,32,16,2025-02-08 18:10:00,16
24538,ORD_24539,7465,Glita 30mg Tablet,Warehouse C,66,52,2025-02-08 19:40:00,14
24539,ORD_24540,28490,"Western Digital WD Blue SN570 NVMe 1TB, Upto 3000MB/s, with Free 1 Month Adobe Creative Cloud Subscription, 5 Y Warranty, ...",Warehouse C,16,4,2025-02-08 17:58:00,12
24540,ORD_24541,32857,Schwarzkopf Professional Bonacure Keratin Smooth Perfect Conditioner | For Frizzy Hair | 200ml,Warehouse B,70,59,2025-02-08 13:33:00,11
24541,ORD_24542,33031,SUGAR Cosmetics Eye Lit You So! Vivid Eyeliner - 01 Pink Sphinx - Bright Pink 1.7 ml,Warehouse C,66,47,2025-02-08 04:54:00,19
24542,ORD_24543,27461,M Olan 10mg Tablet,Warehouse B,29,12,2025-02-08 10:21:00,17
24543,ORD_24544,32829,Pikkme Samsung Galaxy M31 / F41 / M31 Prime Flip Cover| PU Leather Finish | 360 Protection | Wallet & Stand | Strong Magne...,Warehouse B,52,42,2025-02-08 11:25:00,10
24544,ORD_24545,5464,Lazis DM 10mg/30mg Tablet,Warehouse C,75,61,2025-02-08 22:34:00,14
24545,ORD_24546,23805,"Forest essentials Hair Conditioner Japapatti & Brahmi 200ml & Forest Essentials Hair Cleanser, Amla, Honey and Mulethi, 200ml",Warehouse C,103,87,2025-02-08 02:46:00,16
24546,ORD_24547,33674,Halostar Cream,Warehouse A,10,2,2025-02-08 15:09:00,8
24547,ORD_24548,4760,CLAVIER Super Bass Type-C in-Ear Earphones with Stereo Mic for All Smartphones with Rich Bass & Noise Cancellation,Warehouse B,86,72,2025-02-08 16:20:00,14
24548,ORD_24549,28552,"Texet LMA4-EX,A4 Lamination Machine with Jam Release Control,Automatic Portable Laminator, Single Switch Smooth Operations.",Warehouse A,75,56,2025-02-08 20:15:00,19
24549,ORD_24550,27368,Etix Plus 60mg/4mg Tablet,Warehouse C,40,28,2025-02-08 15:23:00,12
24550,ORD_24551,7569,Amazon Brand - Solimo Soft Flexible Back Cover for Xiaomi Redmi Note 8 (Transparent),Warehouse B,21,12,2025-02-08 06:38:00,9
24551,ORD_24552,5340,"AmazonBasics Uni-Directional DisplayPort to HDMI Video Display Cable, 4K@30Hz - 3 Feet, Black - (Not Compatible with Mobil...",Warehouse A,60,54,2025-02-08 21:40:00,6
24552,ORD_24553,2180,AND Eternal Radiance EDP & Serene Bliss Body Mist Pack of 2 250 ml,Warehouse A,92,86,2025-02-08 19:14:00,6
24553,ORD_24554,7719,Lulitez 1% Lotion,Warehouse B,106,97,2025-02-08 22:37:00,9
24554,ORD_24555,23706,"Hand Wash - Sea Mineral, Imported 250ml + Hand Wash - Natural, Sea Mineral 500ml",Warehouse A,91,86,2025-02-08 16:57:00,5
24555,ORD_24556,5129,"RAEGR RapidCool 900 Aluminum Laptop Cooling Pad | Two USB Port| with Multi-Angle Adjustment & Adjustable Wind Speed, Metal...",Warehouse C,59,52,2025-02-08 01:27:00,7
24556,ORD_24557,36985,Deep Brightening & Whitening Beauty Facial Mask,Warehouse B,106,98,2025-02-08 11:39:00,8
24557,ORD_24558,27937,Winble Case for iPhone 14 Pro Max Cover | Metal Camera Guard Acrylic Clear Protective Back | Back Cover Case for iPhone 14...,Warehouse A,63,49,2025-02-08 06:15:00,14
24558,ORD_24559,3456,NHP 8100 Silky Shine Hot & Cold Foldable Hair Dryer - 1200 Watt,Warehouse B,36,30,2025-02-08 16:28:00,6
24559,ORD_24560,36992,Condoms - Extra Thin,Warehouse A,58,41,2025-02-08 09:57:00,17
24560,ORD_24561,31174,Allure Chocolate brown makeup brush set (set of 4) 1's,Warehouse C,39,25,2025-02-08 20:15:00,14
24561,ORD_24562,27964,OneAssist 1 Year Extended Warranty Plan for Headphones 1001 to 2000 - Email Delivery Within 2 Hours,Warehouse C,102,92,2025-02-08 02:02:00,10
24562,ORD_24563,23155,Bralspas Injection,Warehouse A,101,85,2025-02-08 12:27:00,16
24563,ORD_24564,7769,Doxisure-LB Capsule,Warehouse B,60,44,2025-02-08 03:55:00,16
24564,ORD_24565,28258,Coffee Cranberry Skin Polishing Set,Warehouse A,83,65,2025-02-08 20:24:00,18
24565,ORD_24566,4932,Shampoo - Enriched with Henna,Warehouse A,95,81,2025-02-08 16:49:00,14
24566,ORD_24567,4935,DERMATOUCH 3% Vitamin C Face Wash for Glowing Skin | Bright & Firm Skin | Anti-aging Face Wash for Women & Men - 70G,Warehouse C,21,13,2025-02-08 13:41:00,8
24567,ORD_24568,37026,Normapac 25mg Tablet,Warehouse C,98,85,2025-02-08 21:33:00,13
24568,ORD_24569,37038,Ceptradin-S 1000mg/500mg Injection,Warehouse C,39,21,2025-02-08 03:44:00,18
24569,ORD_24570,36398,Elosone Nasal Spray,Warehouse B,104,86,2025-02-08 08:31:00,18
24570,ORD_24571,32792,Cimcan 150mg Tablet,Warehouse A,87,76,2025-02-08 05:27:00,11
24571,ORD_24572,23934,Orepride 25mg Tablet SR,Warehouse C,107,88,2025-02-08 19:41:00,19
24572,ORD_24573,28560,Coxval MR 10mg/2mg Tablet,Warehouse B,29,19,2025-02-08 04:01:00,10
24573,ORD_24574,3208,IPS-CR Tablet,Warehouse B,104,95,2025-02-08 11:08:00,9
24574,ORD_24575,372,"Tabelito Nylon, Pearl Cotton Hybrid Laptop Bag Sleeve Case Cover Pouch for laptops (Grey, 15.6 Inches/39.6Cm)",Warehouse A,87,79,2025-02-08 08:03:00,8
24575,ORD_24576,36419,Marox 150mg Tablet,Warehouse C,71,59,2025-02-08 22:32:00,12
24576,ORD_24577,32806,"Face Wash by Cetaphil , Gentle Skin Cleanser for Dry, Normal Sensitive Skin - 500 ml| Hydrating Face Wash with Niacinamid...",Warehouse C,21,14,2025-02-08 13:32:00,7
24577,ORD_24578,2451,"HIKVISION Wired 1080p HD 2MP Security Camera, White",Warehouse C,78,72,2025-02-08 10:26:00,6
24578,ORD_24579,33757,Santrox 150mg Tablet,Warehouse B,61,46,2025-02-08 23:09:00,15
24579,ORD_24580,3643,Destres-EC Tablet,Warehouse A,83,64,2025-02-08 21:21:00,19
24580,ORD_24581,35779,Formentin 500 Capsule,Warehouse A,61,48,2025-02-08 18:32:00,13
24581,ORD_24582,31425,AND Mystique Elegance & Love Muse Pack of 2 Eau De Parfum 100ML each for Women Crafted by Ajmal,Warehouse A,26,17,2025-02-08 20:50:00,9
24582,ORD_24583,7348,Cold Pressed Castor Oil,Warehouse C,47,30,2025-02-08 02:48:00,17
24583,ORD_24584,3593,Trajone Taz 1000mg/125mg Injection,Warehouse B,46,40,2025-02-08 21:33:00,6
24584,ORD_24585,23855,"Just Herbs Kumuda Indian White Water Lily Conditioner for All Type of Hair, 200 ml (Parabens and SLS Free)",Warehouse C,45,40,2025-02-08 00:55:00,5
24585,ORD_24586,30742,"PALAY® BTS Backpack For Boys Kpop BTS Bangtan School Backback For Student with Cable Vent, Backpack Travel Bag Backpack La...",Warehouse B,28,18,2025-02-08 18:58:00,10
24586,ORD_24587,405,Astigo Compatible Remote Control for Dish TV Set Top Box,Warehouse B,90,71,2025-02-08 12:16:00,19
24587,ORD_24588,33707,Cytocristin Aqueous   1mg Injection,Warehouse A,33,23,2025-02-08 17:45:00,10
24588,ORD_24589,36466,Glevo 750 Tablet,Warehouse B,54,43,2025-02-08 17:13:00,11
24589,ORD_24590,31455,Ryvel 20mg Injection,Warehouse C,21,5,2025-02-08 18:20:00,16
24590,ORD_24591,5343,Epaal® Silicone Straps for Mi Band 6 / Mi Band 5 Rugged and Tough Bracelet Silicone Replacement Strap Compatible with Mi B...,Warehouse C,34,15,2025-02-08 15:43:00,19
24591,ORD_24592,23949,Thiobig Forte 100mg/8mg Tablet,Warehouse B,81,71,2025-02-08 03:39:00,10
24592,ORD_24593,27515,Crucial RAM 8GB DDR4 3200MHz CL22 (or 2933MHz or 2666MHz) Desktop Memory CT8G4DFRA32A,Warehouse A,71,63,2025-02-08 06:56:00,8
24593,ORD_24594,28635,Secnil Forte Tablet,Warehouse B,69,63,2025-02-08 01:31:00,6
24594,ORD_24595,5359,"ProElite Slim Trifold Flip case Cover for Xiaomi Mi Pad 5 11"" Tablet, Black",Warehouse B,85,77,2025-02-08 14:17:00,8
24595,ORD_24596,23841,Cenocef 200mg Tablet,Warehouse B,39,25,2025-02-08 20:19:00,14
24596,ORD_24597,3618,Ecosprin-AV 75 Capsule,Warehouse C,107,93,2025-02-08 21:56:00,14
24597,ORD_24598,409,Drosy M 80mg/250mg Tablet,Warehouse C,54,39,2025-02-08 21:10:00,15
24598,ORD_24599,2425,Beardo Skin Tightening Facewash Foam - Hemp 100 ml,Warehouse C,65,51,2025-02-08 12:28:00,14
24599,ORD_24600,3209,Raflozol P 40mg Tablet,Warehouse A,80,69,2025-02-08 08:26:00,11
24600,ORD_24601,36376,"DEVCOMM Tabletop Universal Mobile Stand for Table with Adjustable Height, 360 Degree Rotation Mobile Holder for Table and ...",Warehouse A,20,5,2025-02-08 11:46:00,15
24601,ORD_24602,7716,"MakeUp Eraser Holidaze 7 Day Set, Erase All Makeup With Just Water, Including Waterproof Mascara, Eyeliner, Foundation, Li...",Warehouse B,75,68,2025-02-08 20:18:00,7
24602,ORD_24603,33004,Wayona USB Type C Micro SD Card Reader Adapter (Type C Card Reader),Warehouse C,101,87,2025-02-08 06:05:00,14
24603,ORD_24604,2336,"Cubiker Multi-Purpose Height-Adjustable Laptop Table, Study Table, Portable, with Docking for Tablet, Room Work, Ideal for...",Warehouse B,48,33,2025-02-08 22:10:00,15
24604,ORD_24605,37125,Danavish Pregabalin+Methylcobalamin 75mg/750mcg Capsule,Warehouse C,36,23,2025-02-08 05:26:00,13
24605,ORD_24606,8,"FACTOR NOTES Notebooks Pack of 2: A5 Sized, 90 GSM,288 Pages (144 x 2) Journal Diary(Kraft/Dot Grid)",Warehouse A,33,25,2025-02-08 05:57:00,8
24606,ORD_24607,31124,Revlon So Fierce Vinyl Eye Liner - Force Of Steel 1.2 Gm,Warehouse A,87,69,2025-02-08 19:09:00,18
24607,ORD_24608,28156,Prestigesic Tablet SR,Warehouse A,75,62,2025-02-08 12:14:00,13
24608,ORD_24609,28054,"Note Italy Long Wearing Lipstick 09, Red, 4.5g",Warehouse A,38,22,2025-02-08 05:03:00,16
24609,ORD_24610,31064,Vivo 2E Bluetooth Truly Wireless in Ear Earbuds with Mic 30Hrs Ultra Battery Life (Moonlight White),Warehouse C,75,64,2025-02-08 21:57:00,11
24610,ORD_24611,37083,Gemblue Biocare Intensive Care Body Lotion 500 ml,Warehouse C,104,94,2025-02-08 21:57:00,10
24611,ORD_24612,37055,Passion Indulge CONDITIONING SHAMPOO PAPAIN 200 ml,Warehouse C,93,75,2025-02-08 01:54:00,18
24612,ORD_24613,23121,"ELV Aluminium Adjustable Mobile Phone Foldable Holder Tabletop Stand Dock Mount for All Smartphones, Tabs, Kindle, iPad (M...",Warehouse A,107,95,2025-02-08 04:09:00,12
24613,ORD_24614,28002,Daxicef 200 Tablet,Warehouse B,57,43,2025-02-08 06:11:00,14
24614,ORD_24615,28226,Oflocon 200mg Tablet,Warehouse C,103,98,2025-02-08 00:38:00,5
24615,ORD_24616,28013,Caprivon-AC Tablet,Warehouse A,48,41,2025-02-08 22:36:00,7
24616,ORD_24617,2216,EGOTUDE Silicone Soft Case Camera Protection Microfiber Lining Back Cover for iPhone 14 (Black),Warehouse B,90,80,2025-02-08 04:41:00,10
24617,ORD_24618,33205,Raycin 500mg Tablet,Warehouse B,70,62,2025-02-08 18:52:00,8
24618,ORD_24619,37088,Clomef 10mg/250mg Tablet,Warehouse C,71,63,2025-02-08 00:21:00,8
24619,ORD_24620,7806,Preda Met 40mg Injection,Warehouse C,53,40,2025-02-08 19:15:00,13
24620,ORD_24621,31053,Shribact-CV 625 Tablet,Warehouse C,34,20,2025-02-08 08:05:00,14
24621,ORD_24622,35,Pirox Gel,Warehouse B,111,98,2025-02-08 04:55:00,13
24622,ORD_24623,7812,"Syrup - Neem, Skin Wellness, Controls Acne",Warehouse C,65,54,2025-02-08 10:45:00,11
24623,ORD_24624,33194,Nepcoveu 0.1% Opthalmic Suspension,Warehouse A,53,39,2025-02-08 10:20:00,14
24624,ORD_24625,23064,Flormar Spider Lash 3in1 Mascara 13 ml,Warehouse A,13,8,2025-02-08 21:58:00,5
24625,ORD_24626,27751,Medimade Honey And Sandal Body Wash 300 ml,Warehouse B,26,7,2025-02-08 12:24:00,19
24626,ORD_24627,23428,Ondisun Drop,Warehouse C,71,55,2025-02-08 02:41:00,16
24627,ORD_24628,3591,Fivasa Cream,Warehouse A,78,66,2025-02-08 17:01:00,12
24628,ORD_24629,23647,Gasopep-DSR Capsule,Warehouse B,21,12,2025-02-08 07:46:00,9
24629,ORD_24630,31281,Dry Max All Nights XL - Sanitary Pads For Women,Warehouse C,100,85,2025-02-08 20:38:00,15
24630,ORD_24631,28183,Vigini VPlus Intense Blue 2 in 1 Massage Gel 100 gm,Warehouse B,80,71,2025-02-08 01:17:00,9
24631,ORD_24632,4994,"SanDisk Ultra UHS I 128GB SD Card 140MB/s for DSLR and Mirrorless Cameras, 10Y Warranty",Warehouse C,93,88,2025-02-08 02:07:00,5
24632,ORD_24633,123,"TP-Link Deco M4 Dual_Band Whole Home Mesh Wi-Fi System, Seamless Roaming and Speedy (AC1200) Mbps, Work with Amazon Echo/A...",Warehouse B,52,34,2025-02-08 03:06:00,18
24633,ORD_24634,33383,"Lenovo IdeaPad 3 11th Gen Intel Core i3 15.6"" FHD Thin & Light Laptop(8GB/512GB SSD/Windows 11/Office 2021/2Yr Warranty/3m...",Warehouse B,45,31,2025-02-08 05:11:00,14
24634,ORD_24635,30901,Rapicef D 200mg/500mg Tablet,Warehouse C,68,56,2025-02-08 11:36:00,12
24635,ORD_24636,28386,Allure Classic Eyeshadow and Eye Smudger (Set of 2 C-13 & C15) 1's,Warehouse C,89,78,2025-02-08 03:52:00,11
24636,ORD_24637,5202,"Western Digital WD 1.5TB Elements Portable Hard Disk Drive, USB 3.0, Compatible with PC, PS4 and Xbox, External HDD (WDBU6...",Warehouse A,47,37,2025-02-08 17:40:00,10
24637,ORD_24638,30911,Anti Cellulite Massager - Color May Vary,Warehouse B,102,84,2025-02-08 17:31:00,18
24638,ORD_24639,23359,Azithric 500mg Tablet,Warehouse A,68,57,2025-02-08 19:52:00,11
24639,ORD_24640,27809,"Tecno Spark 8 Pro (Interstellar Black, 4GB RAM,64GB Storage) | 48MP Triple Camera | 33W Fast Charger",Warehouse B,58,52,2025-02-08 18:04:00,6
24640,ORD_24641,36920,CROSSVOLT Tempered Glass Compatible with Google pixel 6a with Military-Grade Anti-Explosion Edge-to-Edge Coverage Screen P...,Warehouse B,13,4,2025-02-08 14:20:00,9
24641,ORD_24642,28353,SUGAR Cosmetics Rage For Coverage 24Hr Foundation - 55 Americano - Medium Deep Warm Undertone 25 Ml,Warehouse B,74,55,2025-02-08 13:17:00,19
24642,ORD_24643,4882,Boujee Beauty Bronzer Brush B103 135 gm,Warehouse A,60,41,2025-02-08 02:24:00,19
24643,ORD_24644,23316,"SanDisk Ultra 64 GB USB 3.0 Pen Drive (SDCZ48-064G-135/SDCZ48-064G-UAM46, Black)",Warehouse A,75,56,2025-02-08 20:04:00,19
24644,ORD_24645,5161,Altraflam-P Tablet,Warehouse C,24,17,2025-02-08 11:17:00,7
24645,ORD_24646,33308,Perfect Stay Matte Finish Loose Powder for Oily Skin Control,Warehouse B,74,57,2025-02-08 15:47:00,17
24646,ORD_24647,27871,Curelin 200mg/125mg Tablet,Warehouse C,38,33,2025-02-08 20:08:00,5
24647,ORD_24648,31015,"KRISONS Cylender 4” Double Woofer 30W Multi-Media Bluetooth Party Speaker with Wired Mic for Karaoke, RGB Lights, USB, SD ...",Warehouse B,82,66,2025-02-08 05:17:00,16
24648,ORD_24649,2299,Qpime Injection,Warehouse B,34,23,2025-02-08 16:27:00,11
24649,ORD_24650,23414,Rethitron Tablet,Warehouse A,51,38,2025-02-08 07:23:00,13
24650,ORD_24651,2291,Zilion SL 5mg Tablet,Warehouse A,32,20,2025-02-08 02:41:00,12
24651,ORD_24652,28073,Azys 250mg Tablet,Warehouse C,72,59,2025-02-08 09:24:00,13
24652,ORD_24653,37102,Face Wash - Neem + Anti Tan Skin Lightening,Warehouse B,24,8,2025-02-08 14:35:00,16
24653,ORD_24654,21,Eyetex Dazller Nail Glitter - DB19 (Burnt Orange) 12 ml,Warehouse C,75,60,2025-02-08 03:37:00,15
24654,ORD_24655,28081,Allure Powder Brush (c-27) 1's,Warehouse A,58,47,2025-02-08 09:41:00,11
24655,ORD_24656,28096,"Doodle Forever Mine Wiro Bound Undated Notebook Diary with Theme Based Dangler (8.5 X 6.5 inches, 80 GSM, 160 Pages) Love ...",Warehouse A,67,51,2025-02-08 01:15:00,16
24656,ORD_24657,31072,Insight Cosmetics Non Transfer Matte Lipstick - Scandal 4.2 gm,Warehouse B,98,83,2025-02-08 17:22:00,15
24657,ORD_24658,31127,Tipflox 200mg Tablet,Warehouse A,59,52,2025-02-08 18:18:00,7
24658,ORD_24659,28134,"Post-Shave Balm - After Shaving Lotion With Witch Hazel, Alcohol Free",Warehouse A,67,62,2025-02-08 03:46:00,5
24659,ORD_24660,37113,Jamun Seeds Powder,Warehouse A,91,85,2025-02-08 17:40:00,6
24660,ORD_24661,34493,Spigen Optik Camera Lens Tempered Protector Guard for iPhone 14 Pro / 14 Pro Max (Clear) - 2 Pack,Warehouse A,34,15,2025-02-08 05:17:00,19
24661,ORD_24662,31361,Sayoflox-OZ 200mg/500mg Tablet,Warehouse A,16,8,2025-02-08 19:41:00,8
24662,ORD_24663,31868,Adaqueen 0.1% Gel,Warehouse C,90,75,2025-02-08 22:22:00,15
24663,ORD_24664,36132,"Meera Hair Wash Powder, 120g (Pack of 2)",Warehouse A,61,49,2025-02-08 17:25:00,12
24664,ORD_24665,24380,Watch Charging Cable for Fire-Boltt Ninja/Ninja Pro/Ninja Pro Max/Ninja Call 2 / Beam Smartwatches,Warehouse B,42,35,2025-02-08 06:25:00,7
24665,ORD_24666,5675,"Fashion Colour Kiss Lip No Transfer Lipstick, 60 Maroon 2.6 gm",Warehouse A,33,28,2025-02-08 10:12:00,5
24666,ORD_24667,26897,"Syoss - Renew 7 Complete Repair, 01 Shampoo",Warehouse C,92,76,2025-02-08 14:12:00,16
24667,ORD_24668,36138,"M.G.R.J® Tempered Glass Screen Protector for Samsung Galaxy Watch 5 / Watch 4 (44mm) (1.4"" inch) (Pack of 2)",Warehouse C,86,77,2025-02-08 05:04:00,9
24668,ORD_24669,4573,"MAYCREATE® 10 Sheet Glittering Tattoo Sticker, Butterfly Dreamcatcher Theme Sticker Waterproof Temporary Tattoos for Birth...",Warehouse B,64,50,2025-02-08 04:57:00,14
24669,ORD_24670,26902,Quehexy 2mg Tablet,Warehouse C,32,22,2025-02-08 05:17:00,10
24670,ORD_24671,4574,Franac P Oral Suspension,Warehouse B,68,57,2025-02-08 01:47:00,11
24671,ORD_24672,4575,SUGAR Cosmetics Goddess Of Flawless SPF30+ BB Cream - 25 Macchiato (Light Medium) 25 ml,Warehouse B,63,57,2025-02-08 01:43:00,6
24672,ORD_24673,4579,Raap DSR Capsule,Warehouse B,78,63,2025-02-08 08:47:00,15
24673,ORD_24674,3769,M10 Premium TWS Bluetooth 5.1 Noise Canceling In Ear Earbuds LED Display & Power Bank Bluetooth Headset,Warehouse C,46,38,2025-02-08 09:01:00,8
24674,ORD_24675,34193,Vomimerz 4mg Tablet MD,Warehouse A,35,23,2025-02-08 07:43:00,12
24675,ORD_24676,26923,"Honor Band 6 Smartwatch with AMOLED 1.47'' Display,14 Days Battery, SpO2, 24/7 Heart Rate, Stress & Sleep Monitor, Persona...",Warehouse C,29,16,2025-02-08 17:11:00,13
24676,ORD_24677,24205,JXL 1063 10 Inch Active Bass Tube Subwoofer with Inbuilt Amplifier 5400W (Black),Warehouse B,43,36,2025-02-08 12:32:00,7
24677,ORD_24678,29749,"XINBAOHONG Rechargeable Portable Clip-on Selfie Ring Fill Light with 36 LED for iPhone/Android Smart Phone Photography, Ca...",Warehouse A,38,31,2025-02-08 12:43:00,7
24678,ORD_24679,34045,Cofzar AX Syrup,Warehouse A,98,91,2025-02-08 02:15:00,7
24679,ORD_24680,32547,Olovib MD 5 Tablet,Warehouse C,42,29,2025-02-08 23:29:00,13
24680,ORD_24681,3180,Kingston DataTraveler Exodia M 64GB USB-A Flash Drive USB 3.2 Gen 1 DTXM/64GBIN,Warehouse C,26,17,2025-02-08 02:37:00,9
24681,ORD_24682,27182,Tator 10mg Tablet,Warehouse A,21,4,2025-02-08 10:59:00,17
24682,ORD_24683,3695,Superdrug Vitamin E Eye Make Up Remo 100 ml,Warehouse A,68,63,2025-02-08 08:45:00,5
24683,ORD_24684,3693,Sylron 250mg Tablet,Warehouse A,26,19,2025-02-08 20:33:00,7
24684,ORD_24685,31522,Lapster cable Compatible with Xiaomi Mi band 5 charger/mi band 6 charger/Amazfit Band 5 -fitness tracker,Warehouse C,30,18,2025-02-08 13:30:00,12
24685,ORD_24686,32709,Elbion DS 2500mcg Injection,Warehouse C,30,18,2025-02-08 00:55:00,12
24686,ORD_24687,1841,Medimade Aloevera With Cranberry Moisturizing Body Lotion 300 ml,Warehouse B,94,79,2025-02-08 12:22:00,15
24687,ORD_24688,459,"Face Mask - Ultra-Light Contoured Fit, Small, Light Blue",Warehouse C,88,69,2025-02-08 12:57:00,19
24688,ORD_24689,27210,Sucrafet O Syrup,Warehouse B,26,15,2025-02-08 21:12:00,11
24689,ORD_24690,33883,Sobinid 500mg Tablet,Warehouse C,91,83,2025-02-08 19:35:00,8
24690,ORD_24691,36306,Ajmal Blu Dreams EDP Citurs Fruity Perfume And Bastion EDP Woody Aromatic Perfume 200 ml,Warehouse C,57,52,2025-02-08 15:43:00,5
24691,ORD_24692,30546,"Mobilife Selfie Stick,Long Selfie Stick with Tripod Stand upto 37.8 inch,4 in 1 Extendable Selfie Stick for Mobile Phone B...",Warehouse A,66,51,2025-02-08 02:57:00,15
24692,ORD_24693,32568,Miss Claire Butter Lip Balm - Red Velvet Bl03 4 Gm,Warehouse B,16,9,2025-02-08 16:53:00,7
24693,ORD_24694,30395,LIT Rolling Paper King Size Awesome Threesome Brown Smoking Paper (Pack of 50),Warehouse A,27,16,2025-02-08 17:18:00,11
24694,ORD_24695,620,Apple iPhone 12 (128GB) - Green,Warehouse C,64,48,2025-02-08 17:37:00,16
24695,ORD_24696,22952,Xib 120mg Tablet,Warehouse C,104,95,2025-02-08 03:16:00,9
24696,ORD_24697,6815,Gemblue Biocare Skin Brightening Face Mask 500 ml,Warehouse A,51,43,2025-02-08 00:42:00,8
24697,ORD_24698,2993,"(Renewed) MI Women's Smart Band 5 India's No. 1 Fitness Band, 1.1-inches AMOLED Color Display, Magnetic Charging, 2 Weeks ...",Warehouse A,71,66,2025-02-08 08:24:00,5
24698,ORD_24699,27019,Moxcidal 500 Capsule,Warehouse C,65,50,2025-02-08 18:27:00,15
24699,ORD_24700,36162,"Amazon Brand - Solimo Premium Acrylic Glass Wall-Mount Mobile Stand with Charging Holder, AC Remote Holder, TV Remote Stan...",Warehouse B,57,48,2025-02-08 10:50:00,9
24700,ORD_24701,34159,Lavender Florets Bath Salt,Warehouse B,92,84,2025-02-08 16:54:00,8
24701,ORD_24702,1721,TheGiftKart Polycarbonate Thermoplastic Polyurethane Shockproof Crystal Clear Back Cover Case for OnePlus 7T | 360 Degree ...,Warehouse C,30,22,2025-02-08 17:37:00,8
24702,ORD_24703,1722,Agroflox OZ 200 mg/500 mg Tablet,Warehouse A,85,76,2025-02-08 22:36:00,9
24703,ORD_24704,5625,"Amazon Basics Multipurpose Adjustable Portable Laptop Table with Cooling Fan, Black",Warehouse C,14,8,2025-02-08 15:09:00,6
24704,ORD_24705,27006,Ravozin 5 Tablet,Warehouse C,105,97,2025-02-08 13:27:00,8
24705,ORD_24706,34110,Fexicef-DT 200 Tablet,Warehouse C,55,39,2025-02-08 11:48:00,16
24706,ORD_24707,24251,"TP-Link AC1750 Universal Dual Band Range Extender, Broadband/Wi-Fi Extender, Wi-Fi Booster/Hotspot with 1 Gigabit Port and...",Warehouse A,79,62,2025-02-08 17:30:00,17
24707,ORD_24708,568,Elesert 25 Tablet,Warehouse B,97,82,2025-02-08 11:02:00,15
24708,ORD_24709,5603,Decocip 25mg Injection,Warehouse A,42,36,2025-02-08 13:42:00,6
24709,ORD_24710,34099,"Fashion Colour Feather Touch Matte Powder, Shade 02 10 gm",Warehouse A,98,88,2025-02-08 09:10:00,10
24710,ORD_24711,7131,Torgus Plus 60mg/325mg Tablet,Warehouse A,22,3,2025-02-08 12:17:00,19
24711,ORD_24712,28794,Hair Shield Anti Dandruff Shampoo,Warehouse B,30,22,2025-02-08 04:57:00,8
24712,ORD_24713,7143,Joycobal 75mg/10mg/1500mcg Tablet,Warehouse B,71,56,2025-02-08 01:00:00,15
24713,ORD_24714,30496,ng EarSafe Open Ear Bluetooth Wireless Headphones with Mic (Black),Warehouse B,75,57,2025-02-08 19:23:00,18
24714,ORD_24715,7161,CEDO Samsung M12 / A12 / F12 Tempered Glass | Screen Protector Full Glue Coverage Edge to Edge Tempered Glass for Samsung ...,Warehouse B,92,73,2025-02-08 03:53:00,19
24715,ORD_24716,31568,Adcco Citral Syrup,Warehouse C,101,93,2025-02-08 22:17:00,8
24716,ORD_24717,31607,OFIXO Metal Strong and Durable Remote Stand Remote Holder/Remote Stand/Remote Organizer showpiece (Black),Warehouse C,15,7,2025-02-08 22:05:00,8
24717,ORD_24718,24312,Krent 2% Shampoo,Warehouse C,68,62,2025-02-08 02:13:00,6
24718,ORD_24719,2520,Mayutel H 40mg/12.5mg Tablet,Warehouse A,48,39,2025-02-08 01:29:00,9
24719,ORD_24720,612,HUDA ZONE 3 in 1 BB Cream Foundation Water Proof Concealer Foundation Natural Cream with100% original Mushroom Head Air Cu...,Warehouse C,23,14,2025-02-08 04:30:00,9
24720,ORD_24721,3785,Squared Ronzille Glitter Eyeliner black and blue,Warehouse B,63,55,2025-02-08 03:35:00,8
24721,ORD_24722,27217,Cason CN10 Proffessional 4K 60fps HD 24MP Action Camera For Vlogging with EIS Anti Shake Touch Screen Waterproof Sports Ca...,Warehouse B,28,21,2025-02-08 21:51:00,7
24722,ORD_24723,36312,"Lenovo V15 AMD Ryzen 5 5500U 15.6"" (39.62cm) FHD 250 nits Antiglare Thin and Light Laptop (8GB/512GB SSD/Windows 11 Home/I...",Warehouse C,94,81,2025-02-08 13:37:00,13
24723,ORD_24724,36313,I AM EYECONIC 3D GLITTER GOLD SOUK 4 gm,Warehouse B,61,47,2025-02-08 16:24:00,14
24724,ORD_24725,3907,Tazy 2gm/250mg Injection,Warehouse B,98,82,2025-02-08 22:50:00,16
24725,ORD_24726,24744,Ortan H 12.5 mg/20 mg Tablet,Warehouse B,103,95,2025-02-08 10:45:00,8
24726,ORD_24727,24740,ZEBRONICS Zeb-Bro Wired Earphone (White),Warehouse C,49,32,2025-02-08 08:33:00,17
24727,ORD_24728,31797,Alzcort 24mg Tablet,Warehouse B,55,48,2025-02-08 01:51:00,7
24728,ORD_24729,3867,Jaszole 40mg Tablet,Warehouse A,68,58,2025-02-08 03:15:00,10
24729,ORD_24730,31795,Bioceftrix 500mg Injection,Warehouse C,66,50,2025-02-08 14:46:00,16
24730,ORD_24731,3022,Vomnu 4mg Injection,Warehouse A,116,98,2025-02-08 22:02:00,18
24731,ORD_24732,5843,Nazee P 0.05% Nasal Spray,Warehouse B,38,20,2025-02-08 03:28:00,18
24732,ORD_24733,35850,Sony SA-D40 4.1 Channel Multimedia Speaker System with Bluetooth (Black),Warehouse C,50,38,2025-02-08 16:31:00,12
24733,ORD_24734,26590,(Renewed) Jbl C115Tws Bluetooth Truly Wireless In Ear Earbuds With Mic Black,Warehouse C,39,32,2025-02-08 15:21:00,7
24734,ORD_24735,35846,"Car Charger, 120W Car Cigarette Lighter Splitter with QC3.0 & 2.4A USB Ports, PD Charging Port 12V/24V Car Charger Car Lig...",Warehouse C,112,93,2025-02-08 18:00:00,19
24735,ORD_24736,3023,Biocefu 250mg Tablet,Warehouse C,66,55,2025-02-08 09:05:00,11
24736,ORD_24737,2622,"Video Capture Card, PiBOX India Braided Tough, 4K HDMI to USB 3.0 Game Capture Device Aluminium Windows Android Mac,HD 108...",Warehouse A,61,56,2025-02-08 11:39:00,5
24737,ORD_24738,34364,Lakme 9To5 Primer + Matte Perfect Cover Foundation C300 Cool Cinnamon 25 Ml,Warehouse B,16,3,2025-02-08 09:53:00,13
24738,ORD_24739,6905,Alpot SP Tablet,Warehouse C,30,11,2025-02-08 07:24:00,19
24739,ORD_24740,32528,"Rian's Online Fabric Remote Control Case -(Multicolour, 3)",Warehouse C,10,1,2025-02-08 20:02:00,9
24740,ORD_24741,35900,"Amazon Basics USB 2.0 - A-Male to A-Female Extension Cable for Personal Computer, Printer (Black, 9.8 Feet/3 Meters)",Warehouse C,90,78,2025-02-08 06:23:00,12
24741,ORD_24742,35910,Amoxitica CV Dry Syrup,Warehouse A,77,64,2025-02-08 19:44:00,13
24742,ORD_24743,35911,Heksi 2mg Tablet,Warehouse A,51,38,2025-02-08 10:32:00,13
24743,ORD_24744,26575,Even SG 100mg Capsule,Warehouse A,74,56,2025-02-08 09:37:00,18
24744,ORD_24745,5808,"King Shine 2 in 1 Silicone Gel Pad Mobile Phone Holder with USB Earphone Cable Winder Cord Organizer for Car Home Office, ...",Warehouse C,106,95,2025-02-08 23:24:00,11
24745,ORD_24746,24800,Saco Keyboard Protector Silicone Skin Cover for Lenovo IdeaPad Gaming 3 15ARH05E AMD Ryzen 5 4000 Series 15.6-inch Full HD...,Warehouse C,103,96,2025-02-08 11:33:00,7
24746,ORD_24747,24851,House of Beauty Hydragel Face Wash 120 ml,Warehouse C,106,94,2025-02-08 00:32:00,12
24747,ORD_24748,26513,"Noise ColorFit Ultra 2 with 1.78""(4.5cm) AMOLED Display, Best-in-Class Resolution, Premium Stainless Steel Body, 60+ Sport...",Warehouse A,111,95,2025-02-08 17:23:00,16
24748,ORD_24749,5876,Slazenger Gift Set Purple For Men 275 ml,Warehouse A,21,7,2025-02-08 18:42:00,14
24749,ORD_24750,26536,Soulflower Vitamin C 0.5% Green Tea Glowing Day Cream SPF30+ 50 gm,Warehouse B,66,55,2025-02-08 19:35:00,11
24750,ORD_24751,24823,"KICKWIX Premium Collection DIY Kit of Henna Tattoo Stencil Set for Women, Girls (Body, Hand, Venty Design) Set of 8 Stickers",Warehouse B,33,21,2025-02-08 11:25:00,12
24751,ORD_24752,5930,Acnoklin-Ds Foam Face Wash,Warehouse C,60,54,2025-02-08 04:30:00,6
24752,ORD_24753,1597,Rabecon-DM Tablet,Warehouse C,59,50,2025-02-08 08:40:00,9
24753,ORD_24754,36067,DP Gesic 50 mg/500 mg Tablet,Warehouse A,83,74,2025-02-08 15:31:00,9
24754,ORD_24755,36314,Ekon XL 5mg Tablet MD,Warehouse C,59,52,2025-02-08 00:43:00,7
24755,ORD_24756,7029,Lxcon 200 Tablet,Warehouse B,20,2,2025-02-08 07:57:00,18
24756,ORD_24757,32759,"Gatsby Hair Styling Wax - Hard & Free, For Messy Scrunch Style, Non Sticky, Anytime Re-Stylable & Easy Wash Off, 75gm",Warehouse B,81,63,2025-02-08 10:28:00,18
24757,ORD_24758,1861,Alcecost SP 100mg/325mg/10mg Tablet,Warehouse A,57,49,2025-02-08 20:19:00,8
24758,ORD_24759,33855,"Samsung Galaxy Tab A8 10.5 inches Display, RAM 4 GB, ROM 64 GB Expandable, Wi-Fi+LTE Tablets, Silver,SM-X205NZSEINU",Warehouse B,80,72,2025-02-08 23:21:00,8
24759,ORD_24760,27268,Airtel DigitalTV Dth Remote with Recording Option Suitable for All Models Airtel Set of Boxes and 2 Batteries,Warehouse C,30,18,2025-02-08 10:07:00,12
24760,ORD_24761,24074,Excellence Creme Hair Color(72ml+100g) 3.16 Burgundy+Color Protect Shampoo 175ml,Warehouse A,14,9,2025-02-08 05:38:00,5
24761,ORD_24762,33918,"Redgear Grim V2 Wired Gaming Keyboard with Double Injected Keycaps, Floating Keycaps, Ergonomic Design, 3 Mix LED Modes an...",Warehouse C,56,37,2025-02-08 05:17:00,19
24762,ORD_24763,31564,Mirabelle Korea Turmeric Essential Facial Sheet Mask 25 Ml,Warehouse C,45,38,2025-02-08 10:47:00,7
24763,ORD_24764,7210,Noklot CV 75mg/10mg/75mg Tablet,Warehouse C,68,54,2025-02-08 12:33:00,14
24764,ORD_24765,7174,"Dove Hair Fall Rescue Shampoo 340 ml, For Damaged Hair, Hair Fall Control for Thicker Hair - Mild Daily Anti Hair Fall Sha...",Warehouse A,64,46,2025-02-08 13:50:00,18
24765,ORD_24766,30510,LUVYANSH Writing Table TOP Elevator Desk (P.S Sheets)7m.m Small Size (12 * 16) inch Transparent Clear with Height Adjustab...,Warehouse C,23,17,2025-02-08 16:24:00,6
24766,ORD_24767,24161,"Pears Pure & Gentle Shower Gel, Body Wash With Glycerine And Natural Oils, 100% Soap-Free And Dermatologically Tested, Imp...",Warehouse B,52,41,2025-02-08 15:33:00,11
24767,ORD_24768,4633,"Lakme Absolute Shine Liquid Eye Liner, Black, 4.5ml and Lakme Absolute Shine Line Eye Liner, Sparkling Olive, 4.5 ml",Warehouse A,26,13,2025-02-08 02:08:00,13
24768,ORD_24769,24144,T.O.G.Air Cushion BB Cream Brightening Concealer Even Skin Pigment White Color,Warehouse A,96,89,2025-02-08 15:48:00,7
24769,ORD_24770,36247,SanDisk ® Ultra Curve USB 3.2 128GB 100MB/s R Navy Blue,Warehouse A,96,78,2025-02-08 01:51:00,18
24770,ORD_24771,7209,"Fashion Colour Bb Roll On Concealer, Shade 01 16 ml",Warehouse A,30,14,2025-02-08 23:20:00,16
24771,ORD_24772,31559,"FIX MY CURLS 5 Steps Moisture Bundle | With Cleansing, Everyday Moisturizing Shampoo, Hydrating Deep Conditioner, Flax See...",Warehouse A,60,54,2025-02-08 01:02:00,6
24772,ORD_24773,33922,Maryaj Wild Speed EDP Citrus Spicy Perfume And Ajmal Carbon Homme Deodorant Citrus Spicy Fragrance 300 ml,Warehouse A,89,79,2025-02-08 01:08:00,10
24773,ORD_24774,33986,"BRUSTRO Artists Natural Hair MOP Brush Set of 4 (0, 2, 4, 8)",Warehouse B,106,88,2025-02-08 06:02:00,18
24774,ORD_24775,33971,Paraup 1000mg Tablet,Warehouse B,21,13,2025-02-08 04:22:00,8
24775,ORD_24776,2505,Herbal Sensitive pH Balanced Liquid Handwash,Warehouse C,62,52,2025-02-08 08:12:00,10
24776,ORD_24777,32704,Aloe Vera Juice,Warehouse C,49,42,2025-02-08 14:04:00,7
24777,ORD_24778,473,Losadoc H 50mcg/12.5mg Tablet,Warehouse B,33,19,2025-02-08 20:11:00,14
24778,ORD_24779,5533,Rebofit-DSR Capsule,Warehouse C,49,30,2025-02-08 22:33:00,19
24779,ORD_24780,33931,Glimipack M 1mg/500mg Tablet,Warehouse A,98,91,2025-02-08 09:02:00,7
24780,ORD_24781,27160,Ant Esports VS500L 500 Watt Non-Modular Continuous Power Gaming Power Supply/PSU for PC,Warehouse B,34,15,2025-02-08 05:08:00,19
24781,ORD_24782,1064,"Dime Store Wooden Monitor Stand with Storage Organizer for Desk, Tables, Office, Home, Studio, Study Table | Desktop Ergon...",Warehouse B,33,24,2025-02-08 16:15:00,9
24782,ORD_24783,30160,COSMAC PROFESSIONAL MAKEUP FIXER SPRAY WITH 24K GOLD BB CREAM. COMBO (PACK OF 2),Warehouse B,68,58,2025-02-08 17:33:00,10
24783,ORD_24784,25402,Urofit Oral Solution,Warehouse C,26,14,2025-02-08 05:50:00,12
24784,ORD_24785,34529,Cefjoin 1000 mg/500 mg Injection,Warehouse B,24,5,2025-02-08 11:38:00,19
24785,ORD_24786,29217,Rifintra 400mg Tablet,Warehouse A,19,13,2025-02-08 01:28:00,6
24786,ORD_24787,25300,Ameto 1000mg Tablet ER,Warehouse B,83,77,2025-02-08 05:00:00,6
24787,ORD_24788,6147,Troyhep 25000IU Injection,Warehouse C,72,63,2025-02-08 10:32:00,9
24788,ORD_24789,26020,Ompicid 20mg Capsule,Warehouse C,49,30,2025-02-08 09:06:00,19
24789,ORD_24790,29636,Beauty People Metallic Glitter Eyeliner Grey Magic 1's,Warehouse A,77,68,2025-02-08 03:35:00,9
24790,ORD_24791,6248,Ubdil Expectorant,Warehouse C,27,17,2025-02-08 12:14:00,10
24791,ORD_24792,1280,Trato 10mg Soft Gelatin Capsule,Warehouse B,106,91,2025-02-08 21:39:00,15
24792,ORD_24793,34895,Defjohn 30mg Tablet,Warehouse C,71,54,2025-02-08 10:34:00,17
24793,ORD_24794,35097,Nixkuf D Syrup Sugar Free,Warehouse B,76,61,2025-02-08 14:23:00,15
24794,ORD_24795,35123,"Amazon Basics HL-007347 HDMI Input to DVI Output (Not VGA) Adapter Cable, 6 Feet, Black",Warehouse A,29,21,2025-02-08 13:21:00,8
24795,ORD_24796,34877,"pTron Glam Extendable Selfie Stick with Bluetooth Remote & Tripod Stand, 75cm Extended Length, for 6.5 to 9.5cm Width Phon...",Warehouse B,104,94,2025-02-08 18:32:00,10
24796,ORD_24797,2849,Ajmal Aura Concentrated Perfume Oil Floral Fruity Attar And Colaba Mukhallat Concentrated Perfume Oil Floral Oriental Attar 24 ml,Warehouse B,80,71,2025-02-08 10:54:00,9
24797,ORD_24798,4266,"MAA AMBE Brush and 2 Blender Puff- Multicolour, Pack of 4",Warehouse A,80,70,2025-02-08 09:04:00,10
24798,ORD_24799,4267,Librin 25mg Tablet,Warehouse A,73,54,2025-02-08 08:19:00,19
24799,ORD_24800,32175,"TP-Link Deco E4 Whole Home Mesh Wi-Fi System, Seamless Roaming and Speedy (AC1200) Mbps Dual_Band, Work with Amazon Echo/A...",Warehouse C,104,88,2025-02-08 17:51:00,16
24800,ORD_24801,4254,Faber-Castell Connector Pen Set - Pack of 50 (Assorted),Warehouse B,90,73,2025-02-08 00:22:00,17
24801,ORD_24802,6399,"pTron Force X12S Bluetooth Calling Smartwatch, 1.85"" Full Touch HD Display, Functional Crown, Heart Rate Monitor, SpO2, Wa...",Warehouse B,28,21,2025-02-08 05:49:00,7
24802,ORD_24803,6400,Stritin 50mg Injection,Warehouse B,79,68,2025-02-08 09:31:00,11
24803,ORD_24804,25863,Naturale Pomegranate Brightening Bathing Soap Bar,Warehouse A,106,92,2025-02-08 04:56:00,14
24804,ORD_24805,35145,MO-GRIP Tabletop Finger Grip Selfie Holder & Mobile Stand for iPhones & Android Smartphones - Black,Warehouse B,98,87,2025-02-08 08:42:00,11
24805,ORD_24806,6235,Bar Syrup,Warehouse C,59,54,2025-02-08 13:38:00,5
24806,ORD_24807,29453,Stunner For Women,Warehouse C,43,27,2025-02-08 17:36:00,16
24807,ORD_24808,35158,Office OZ 200mg/200mg Tablet,Warehouse B,62,54,2025-02-08 02:07:00,8
24808,ORD_24809,34848,Ajmal Blu & Aurum & Evoke silver Edition Homme & Shadow Homme Deo & Ascend EDP Pack of 4 20 ml,Warehouse C,85,79,2025-02-08 08:55:00,6
24809,ORD_24810,35160,5 in 1 Keyboard & Earphone Cleaner Multi-Function Computer Cleaning Tools Kit Corner Gap Duster Keycap Puller (Black Red),Warehouse B,55,36,2025-02-08 12:41:00,19
24810,ORD_24811,32077,Decatune 25 Injection,Warehouse C,67,52,2025-02-08 22:54:00,15
24811,ORD_24812,29626,Xemo 250mg Tablet,Warehouse B,66,51,2025-02-08 00:54:00,15
24812,ORD_24813,34832,Stenz S 500mg/500mg Injection,Warehouse B,97,80,2025-02-08 21:35:00,17
24813,ORD_24814,30019,DZert Clasy Laptop Bag College Bag for Boys Girls 21 L Blue White,Warehouse A,52,35,2025-02-08 08:09:00,17
24814,ORD_24815,34537,Azisol 500mg Tablet,Warehouse C,46,38,2025-02-08 10:03:00,8
24815,ORD_24816,1233,Metnyle 500mg Tablet,Warehouse A,69,50,2025-02-08 11:46:00,19
24816,ORD_24817,31897,Solution Anti Ageing Masksheet (Pack of 3),Warehouse B,90,73,2025-02-08 01:13:00,17
24817,ORD_24818,35727,DNDEALS Makeup Sponge Beauty Blender Puff (Color MayVary)- Set Of 6,Warehouse A,27,10,2025-02-08 08:57:00,17
24818,ORD_24819,29142,Ajmal 4 Nightingale Deo & Prose EDP Pack of 3 20 ml,Warehouse C,80,70,2025-02-08 20:26:00,10
24819,ORD_24820,828,Elipod 200 Tablet,Warehouse C,105,95,2025-02-08 12:14:00,10
24820,ORD_24821,30128,"boAt LTG 500 Apple MFI Certified for iPhone, iPad and iPod 2Mtr Data Cable(Space Grey)",Warehouse C,39,33,2025-02-08 02:30:00,6
24821,ORD_24822,26496,Jetcam Tablet DT,Warehouse B,8,3,2025-02-08 22:59:00,5
24822,ORD_24823,24863,Denzy 100mg Tablet,Warehouse A,99,89,2025-02-08 11:08:00,10
24823,ORD_24824,4460,Genta Eye Drop,Warehouse C,78,72,2025-02-08 14:12:00,6
24824,ORD_24825,6810,House of Beauty ICE Roller- Pink 1's,Warehouse A,87,82,2025-02-08 15:37:00,5
24825,ORD_24826,30133,Rabcare O Oral Suspension,Warehouse C,15,3,2025-02-08 16:58:00,12
24826,ORD_24827,30136,Extra Virgin Coconut Massage Oil for Hair & Body,Warehouse C,73,66,2025-02-08 03:55:00,7
24827,ORD_24828,24925,Amazon Brand - Solimo Mobile Cover (Soft & Flexible Back case) Transparent for Google Pixel 6 5G,Warehouse C,27,9,2025-02-08 07:36:00,18
24828,ORD_24829,4406,K-Flox-OZ Tablet,Warehouse A,46,40,2025-02-08 17:29:00,6
24829,ORD_24830,2734,Skin Brightening Cream Pink Lentile 50 Ml,Warehouse C,52,45,2025-02-08 16:26:00,7
24830,ORD_24831,878,"Power One P10 Hearing Aid Battery, 60 Pieces (Multi Color)",Warehouse A,16,7,2025-02-08 11:39:00,9
24831,ORD_24832,2730,Angifree 20mg Tablet,Warehouse A,60,52,2025-02-08 02:56:00,8
24832,ORD_24833,34562,Zita Plus-R Tablet,Warehouse B,67,57,2025-02-08 12:11:00,10
24833,ORD_24834,2717,Aclonova MR Tablet,Warehouse B,50,45,2025-02-08 19:12:00,5
24834,ORD_24835,29974,"ZEBRONICS Zeb-PIXAPLAY 15 Android Smart LED Projector with WiFi/BT v5.1, FHD 1080p, Apps, Miracast DLNA/Airplay Support, 3...",Warehouse A,70,52,2025-02-08 16:42:00,18
24835,ORD_24836,32294,"TechSrmaji 2 in 1 Micro USB Male to 2.0 Female Host OTG Cable with Adapter and Y Splitter, USB Power for Fire TV Stick, No...",Warehouse A,103,87,2025-02-08 03:45:00,16
24836,ORD_24837,25001,VEGA 3 In 1 Facial Cleanser With Sonic Vibration Technique For Cleansing Exfoliation & Massaging 120 Mins Runtime 10 Adjustable Vibration Speed Settings & IPX 6 Washable (VHFC-02) 1 gm,Warehouse A,81,71,2025-02-08 13:43:00,10
24837,ORD_24838,34551,Tayan Womens & Girls 6in1 Multicolour Makeup Sponge Beauty Blenders Pack for Blending Face Makeup Foundation Sponge Set fo...,Warehouse C,99,84,2025-02-08 13:13:00,15
24838,ORD_24839,34543,EMBOX Tower Extension Boards with USB Port with Universal Sockets and USB Charging Ports (3.4A) with Indicator-2 mtr Exten...,Warehouse A,46,32,2025-02-08 04:18:00,14
24839,ORD_24840,35658,"Revolution Pro Lustre Blusher Brush Soft Synthetic Bristles for Applying Blusher Bronzer Contour Highlighter Foundation, S...",Warehouse C,16,2,2025-02-08 08:46:00,14
24840,ORD_24841,877,Biowin Plus 100mg/500mg Tablet,Warehouse B,62,57,2025-02-08 22:18:00,5
24841,ORD_24842,24948,"Oraimo 25.5W 4 Ports USB Charger, 5.1A USB Wall Charger Phone Adapter Compatible for iPhone 13/13 Mini/13 Pro Max/12/12 Pr...",Warehouse C,85,76,2025-02-08 06:32:00,9
24842,ORD_24843,35660,TheGiftKart Ultra-Hybrid Crystal Clear Back Cover Case for iPhone 13 Pro MAX | Camera & Screen Protection Bumps | Shockpro...,Warehouse A,74,59,2025-02-08 22:35:00,15
24843,ORD_24844,24978,Gemblue Biocare Skin Nourishing Body lotion 500 ml,Warehouse B,78,73,2025-02-08 01:34:00,5
24844,ORD_24845,26312,Cefarun 200mg Tablet,Warehouse A,64,55,2025-02-08 08:43:00,9
24845,ORD_24846,1251,Parker Classic Stainless Steel CT Ball Pen,Warehouse A,104,96,2025-02-08 14:47:00,8
24846,ORD_24847,26362,Ambrane Type-C to Micro USB OTG Adapter for 3A Fast Charging and Data Sync- Compatible with All Type-C Enabled Devices Black,Warehouse A,41,29,2025-02-08 01:36:00,12
24847,ORD_24848,1229,"POPIO Camera Lens Protector for iPhone 14 / iPhone 14 Plus (Transparent), Pack of 2",Warehouse C,9,4,2025-02-08 19:55:00,5
24848,ORD_24849,6486,"MURTI EXPORT TOX-FREE Foot Pads for Stress Relief Sleep - Remove Toxins, Rest and Pain Free, Premium Organic Adhesive Foot...",Warehouse A,101,83,2025-02-08 17:24:00,18
24849,ORD_24850,1036,TP-Link Tapo 360° 2MP 1080p Full HD Pan/Tilt Home Security Wi-Fi Smart Camera| Alexa Enabled| 2-Way Audio| Night Vision| M...,Warehouse A,101,88,2025-02-08 19:34:00,13
24850,ORD_24851,25966,Fragrance Body Spray - Tranquil,Warehouse C,33,25,2025-02-08 02:09:00,8
24851,ORD_24852,25980,realme narzo 50i Prime (Mint Green 4GB RAM+64GB Storage) Octa-core Processor |5000 mAh Battery,Warehouse C,39,27,2025-02-08 14:53:00,12
24852,ORD_24853,2895,"Maybelline New York Super Stay 24H Full coverage Liquid Foundation,Natural Ivory 112 30 gm",Warehouse B,99,80,2025-02-08 16:37:00,19
24853,ORD_24854,29395,Bigwig MATTE BLUE EYELINER,Warehouse A,103,97,2025-02-08 02:46:00,6
24854,ORD_24855,35429,"Hoteon Extension Board with USB Port, Power Strip with QC3.0 Fast Charging Ports, 4 Way Outlets Sockets with Master Switc...",Warehouse C,67,57,2025-02-08 09:33:00,10
24855,ORD_24856,29807,Telmizem 40 Tablet,Warehouse C,57,50,2025-02-08 02:34:00,7
24856,ORD_24857,35316,Lakme Forever Matte Liquid Lip Colour Pink Glam 5.6 Ml,Warehouse A,98,89,2025-02-08 16:50:00,9
24857,ORD_24858,34807,Ultraglow All-In-1 Mens Face Lotion,Warehouse B,115,99,2025-02-08 22:01:00,16
24858,ORD_24859,6428,"World Famous Tattoo Ink Special Shading Solution 2oz,60ml",Warehouse B,107,93,2025-02-08 20:24:00,14
24859,ORD_24860,35246,POPIO Tempered Glass Screen Protector for Canon 1100D / Canon 1200D / Canon 1300D / Canon 1500D with Edge To Edge Coverage...,Warehouse B,33,21,2025-02-08 10:21:00,12
24860,ORD_24861,32029,Aziken 500mg Tablet,Warehouse A,103,84,2025-02-08 10:41:00,19
24861,ORD_24862,25455,Loravil 10mg Tablet,Warehouse A,105,90,2025-02-08 01:51:00,15
24862,ORD_24863,32179,Fragrance Body Spray - Marco 150 ml + Fragrance Body Spray - Paradise 150 ml,Warehouse C,85,80,2025-02-08 09:36:00,5
24863,ORD_24864,25884,Nauvom 10mg/10mg Tablet,Warehouse C,37,31,2025-02-08 04:25:00,6
24864,ORD_24865,29447,Ondigest Oral Drops,Warehouse B,42,34,2025-02-08 11:47:00,8
24865,ORD_24866,29690,Artis BT90 Wireless Portable Bluetooth Speaker with USB/Micro SD Card/FM/AUX in (Black) (3W RMS Output),Warehouse A,13,8,2025-02-08 04:26:00,5
24866,ORD_24867,1330,Chymofix Forte Tablet,Warehouse B,54,48,2025-02-08 15:51:00,6
24867,ORD_24868,6214,"Cosmic Byte HyperGiant Speed Type Gaming Mousepad, 900mm x 450mm x 4mm É",Warehouse A,25,6,2025-02-08 18:43:00,19
24868,ORD_24869,32184,Medobee 500mg Tablet,Warehouse A,16,1,2025-02-08 23:00:00,15
24869,ORD_24870,2874,Daily Life Forever52 Eye Brow Brush Nx017 1's,Warehouse A,16,9,2025-02-08 07:48:00,7
24870,ORD_24871,6461,Flormar Compact Powder 093 Natural Coral Beige 11 gm,Warehouse C,48,37,2025-02-08 08:00:00,11
24871,ORD_24872,35257,"Nat Habit - Back To Natural Secrets Everyday Almond Marula Post-Wash Hair Balm | Split Ends, Hair Smoothening, Straighteni...",Warehouse C,20,4,2025-02-08 12:49:00,16
24872,ORD_24873,25412,SupCares Edge to Edge Tempered Glass for Xiaomi 11T Pro 5G / Xiaomi 11T 5G / Xiaomi 11i 5G / Xiaomi 11i 5G Hypercharge (6....,Warehouse C,66,60,2025-02-08 23:41:00,6
24873,ORD_24874,34990,Cufrev DX Syrup,Warehouse A,20,5,2025-02-08 21:08:00,15
24874,ORD_24875,35283,Pikkme Redmi A1 2022 Flip Case Leather Finish | Inside TPU with Card Pockets | Wallet Stand and Shock Proof | Magnetic Clo...,Warehouse A,40,26,2025-02-08 05:56:00,14
24875,ORD_24876,4434,"Miss rose Metallic Lip Gloss Stick Color Waterproof Liquid Matte Lipstick Long Lasting Lipgloss Lip Makeup Shade - 35, mar...",Warehouse C,30,22,2025-02-08 23:04:00,8
24876,ORD_24877,2776,"boAt Type-c A400 Type-C to USB A Cable for All Type C Phones (Lg nexus 5x), 1Mtr (Grey)",Warehouse A,89,77,2025-02-08 15:30:00,12
24877,ORD_24878,6512,Maryaj Blaze EDP Citrus Aromatic Perfume And Ajmal Avid Homme Deodorant Aquatic Woody Fragrance 300 ml,Warehouse B,71,52,2025-02-08 14:17:00,19
24878,ORD_24879,25761,3D Intense Revitaliser Serum,Warehouse A,23,15,2025-02-08 15:28:00,8
24879,ORD_24880,25763,"CAREHOOD Foot File Callus Remover - Multi Purpose 4 in 1 Feet Pedicure Tools with Foot Scrubber, Pumice Stone, Foot Rasp a...",Warehouse C,74,57,2025-02-08 14:16:00,17
24880,ORD_24881,29499,Hydro Boost Water Gel,Warehouse C,85,78,2025-02-08 10:46:00,7
24881,ORD_24882,29561,"Redmi 9A Sport (Carbon Black, 2GB RAM, 32GB Storage) | 2GHz Octa-core Helio G25 Processor | 5000 mAh Battery",Warehouse B,92,73,2025-02-08 11:37:00,19
24882,ORD_24883,29563,"KIRA Makeup Practice Face Board, Silicone Makeup Face - Practice Skin Board,for Makeup Practice Mask Skin Face Eye Makeup ...",Warehouse A,77,63,2025-02-08 06:07:00,14
24883,ORD_24884,32163,LISEN Pure Genius Multi - Action Peel Stick with AHA and BHA for Blackheads & Whiteheads (Pack of 5) 1's,Warehouse A,96,87,2025-02-08 22:47:00,9
24884,ORD_24885,35064,Tsart-H Tablet,Warehouse A,39,33,2025-02-08 18:05:00,6
24885,ORD_24886,25684,The Moms Co. Baby Lotion 400 ml,Warehouse B,55,46,2025-02-08 14:39:00,9
24886,ORD_24887,6339,Levflo 500mg Tablet,Warehouse C,40,34,2025-02-08 02:49:00,6
24887,ORD_24888,6281,Mobistyle Compatible for iPhone 11 Case 6.1 inch Hybrid PC+TPU Soft Grip Clear Back Panel Enhanced Metal Camera Guard Back...,Warehouse C,68,51,2025-02-08 18:15:00,17
24888,ORD_24889,29610,"Samsung Galaxy S23 Ultra 5G (Green, 12GB, 512GB Storage)",Warehouse C,99,80,2025-02-08 06:05:00,19
24889,ORD_24890,6344,Jasmine EDP,Warehouse B,93,77,2025-02-08 00:02:00,16
24890,ORD_24891,25802,"Fashion Colour Face & Body Hi - Lite Bronzer, Shade 07 4 gm",Warehouse B,47,28,2025-02-08 15:00:00,19
24891,ORD_24892,6296,Pro App Syrup,Warehouse B,32,13,2025-02-08 23:28:00,19
24892,ORD_24893,29613,Camel Premium Poster Colour with Brush - 20 Shades (Multicolor),Warehouse C,39,34,2025-02-08 23:20:00,5
24893,ORD_24894,32203,Matra French Green Clay Mask - Green Tea and Rice Enzymes (Free Brush) 100 gm,Warehouse A,42,34,2025-02-08 19:35:00,8
24894,ORD_24895,4253,Elcee Tablet,Warehouse B,27,22,2025-02-08 08:14:00,5
24895,ORD_24896,4111,"Verilux® 7 in 1 USB C Hub,Type C to 4K HDMI Output,PD Charging Port,RJ45 Ethernet, SD/TF Card, USB 3.0,USB 2.0 USB C Hub f...",Warehouse C,76,63,2025-02-08 23:48:00,13
24896,ORD_24897,34783,Tough Lee Tempered Glass Screen Guard for Samsung Galaxy M51 / F62 / A71 with Camera Cut (Transparent) Full Coverage Goril...,Warehouse B,109,99,2025-02-08 17:06:00,10
24897,ORD_24898,6193,SUNISA Powder Puff Soft Face Triangle Makeup Puff for Loose Powder Body Cosmetic Foundation Sponges Beauty Blender Makeup ...,Warehouse B,108,99,2025-02-08 13:25:00,9
24898,ORD_24899,29754,"Physicians Formula The Healthy Lip Velvet Liquid Lipstick - Tu-Lip Treatment, Pink, 7 ml",Warehouse B,110,91,2025-02-08 15:36:00,19
24899,ORD_24900,29750,"TheGiftKart Back Cover for iQOO 7 5G (Poly Carbonate, Polymer | Greyish Blue)",Warehouse B,62,51,2025-02-08 06:16:00,11
24900,ORD_24901,25382,Ngcet 1000mg Injection,Warehouse C,34,15,2025-02-08 10:49:00,19
24901,ORD_24902,35357,Pim 50mg Tablet,Warehouse B,71,56,2025-02-08 19:53:00,15
24902,ORD_24903,1355,Azinok 500mg Tablet,Warehouse B,114,96,2025-02-08 04:53:00,18
24903,ORD_24904,29808,Germ Protection Hand Sanitizer,Warehouse B,15,2,2025-02-08 21:24:00,13
24904,ORD_24905,4159,Tiaxmide 10mg Tablet,Warehouse A,30,20,2025-02-08 14:51:00,10
24905,ORD_24906,25486,"Mivi DuoPods A550 Truly Wireless in Ear Earbuds with Quad Mic ENC(Environmental Noise Cancellation), 13mm Powerful Bass, 5...",Warehouse B,20,3,2025-02-08 08:02:00,17
24906,ORD_24907,350,"Heavy Flow Tampons - 100% Organic Cotton, Non-Applicator",Warehouse C,76,61,2025-02-07 04:18:00,15
24907,ORD_24908,1742,Acutap 100mg Tablet,Warehouse A,35,30,2025-02-07 14:40:00,5
24908,ORD_24909,34107,Eightiz Mobile Stand Holder Metal Cell Phone Stand Perfect for Video Table Online Class Flexible Movie Office Desktop Fold...,Warehouse C,27,21,2025-02-07 11:29:00,6
24909,ORD_24910,15484,"AmazonBasics Bluetooth Speaker 5.0 Soundbar with 16W RMS, 2000mAh Battery, Upto 19 Hrs Playtime Aux/USB Port (Grey)",Warehouse A,48,29,2025-02-07 13:24:00,19
24910,ORD_24911,7155,Strong Diclofenac Gel - Pain Relief Specialist,Warehouse B,74,59,2025-02-07 02:54:00,15
24911,ORD_24912,15436,Oxyglow Insta Glow Bleach Cream - Multi Fruit 600 gm,Warehouse A,67,61,2025-02-07 03:50:00,6
24912,ORD_24913,36489,Remove Wax Strips 52 Pcs Maxi Set - Thick Hair (20 Body + 8 Bikini + 8 Face + 8 Underarm Strips & 4 Pain-Less + 4 Post Depilation Cleaning Wipes) 1's,Warehouse C,30,16,2025-02-07 16:49:00,14
24913,ORD_24914,15495,Ayurveda Natural Fairness Double Action Chandan & Kesar Face Wash,Warehouse A,93,76,2025-02-07 13:20:00,17
24914,ORD_24915,34115,D-cort 6mg Tablet,Warehouse C,64,59,2025-02-07 05:44:00,5
24915,ORD_24916,8360,Pikkme Vivo T1 5G / Vivo Y75 5G / iQOO Z6 5G Flip Cover | PU Leather Finish | 360 Protection | Wallet & Stand | Strong Mag...,Warehouse B,55,36,2025-02-07 19:19:00,19
24916,ORD_24917,34121,HP 680 Tri-color Original Ink Advantage Cartridge,Warehouse A,33,25,2025-02-07 12:03:00,8
24917,ORD_24918,366,Gear 5 Blade Razor with Contoured Rubber Handle & Blades - Black,Warehouse C,81,74,2025-02-07 19:14:00,7
24918,ORD_24919,34168,Robustrion Trifold Flip Stand Case Cover for Realme Pad X 11 inch Tablet Cover - Black,Warehouse B,56,48,2025-02-07 16:51:00,8
24919,ORD_24920,34163,Glimisave 3mg Tablet,Warehouse A,39,31,2025-02-07 09:39:00,8
24920,ORD_24921,34133,Atheart 10 Tablet,Warehouse B,106,95,2025-02-07 04:31:00,11
24921,ORD_24922,1720,Hemral 100mg Injection,Warehouse B,57,50,2025-02-07 08:37:00,7
24922,ORD_24923,34161,Round Brush - E9-RB,Warehouse A,29,21,2025-02-07 10:48:00,8
24923,ORD_24924,36384,Zoline Gold Eye Drop,Warehouse C,47,31,2025-02-07 04:46:00,16
24924,ORD_24925,23972,Cps 1000mg/500mg Injection,Warehouse C,96,84,2025-02-07 18:48:00,12
24925,ORD_24926,23968,"Sunsilk Nourishing Soft & Smooth Shampoo, Enriched With Natural Oils For Softer And Smoother Hair, 650 ml",Warehouse A,37,25,2025-02-07 08:36:00,12
24926,ORD_24927,1867,Mobile + Tablet Floor Stand [1 Mobile & 1 Tablet Clip] - SooPii Flexi Neck Tablet Holder Mount with Adjustable Height & St...,Warehouse C,102,97,2025-02-07 16:24:00,5
24927,ORD_24928,34745,Bella Voste Ultra Hd Primer 25 Ml,Warehouse A,49,32,2025-02-07 04:06:00,17
24928,ORD_24929,8087,Glimoris M 1mg/500mg Tablet,Warehouse A,65,48,2025-02-07 18:06:00,17
24929,ORD_24930,12833,Opimont-L Tablet,Warehouse C,66,53,2025-02-07 18:09:00,13
24930,ORD_24931,35379,Electa Plus 750mcg/75mg Capsule,Warehouse A,90,80,2025-02-07 11:03:00,10
24931,ORD_24932,7534,Oxib 90mg Tablet,Warehouse C,70,56,2025-02-07 00:44:00,14
24932,ORD_24933,14515,Dydrozole Cream,Warehouse B,74,63,2025-02-07 12:58:00,11
24933,ORD_24934,23734,"Biotique Natural Makeup Cream Magicolor Lipstick - Ladies Night, 4g",Warehouse C,22,7,2025-02-07 16:58:00,15
24934,ORD_24935,1657,Fur Jaden 25 Ltrs (40 Cms)Camera Backpack(Bm41_Black_Black),Warehouse A,27,13,2025-02-07 18:23:00,14
24935,ORD_24936,34264,Alerout 10mg Tablet,Warehouse B,33,23,2025-02-07 21:46:00,10
24936,ORD_24937,36385,Amalaki Capsules,Warehouse B,22,5,2025-02-07 23:07:00,17
24937,ORD_24938,24165,elago Silicone Hang Case Compatible For Samsung Galaxy Buds 2 Pro Case (2022) / Galaxy Buds 2 Case (2021) / Galaxy Buds Pr...,Warehouse A,85,79,2025-02-07 02:11:00,6
24938,ORD_24939,23248,Fresh Boost Deodorant - 48h Long Lasting Freshness With Fresh Musk Scent,Warehouse A,70,61,2025-02-07 02:36:00,9
24939,ORD_24940,36536,"CARE FORMULATION Glucose-D 1kg (Orange Flavour), Pack of 1/ Instant Energy Health Drink Energy Drink",Warehouse C,19,6,2025-02-07 20:50:00,13
24940,ORD_24941,33872,Bella Voste Hidefinition Liquid Concealer Shade Lc - 05 4 ml,Warehouse B,33,18,2025-02-07 11:20:00,15
24941,ORD_24942,1852,Gizga Essentials Laptop Power Cable Cord- 3 Pin Adapter Isi Certified(1 Meter/3.3 Feet),Warehouse B,105,94,2025-02-07 19:10:00,11
24942,ORD_24943,33905,"Zinq Technologies Full HD 1080P 2.1 Megapixel 30 FPS Auto Focus Webcam with Ring LED for Night Vision, Web Camera with Bui...",Warehouse A,77,70,2025-02-07 00:06:00,7
24943,ORD_24944,15572,"Omega ROLL-N-Draw, 30 cm Ruler",Warehouse C,101,89,2025-02-07 03:28:00,12
24944,ORD_24945,33912,Netromycin 25mg Injection,Warehouse B,39,26,2025-02-07 01:59:00,13
24945,ORD_24946,15560,Ormin 75mg Injection,Warehouse C,63,49,2025-02-07 13:17:00,14
24946,ORD_24947,33939,Regor Tabletop Finger Grip & Mobile Holder Mobile Stand Phone Holder for Hand & Mobile Back Holder Grip Great for Selfie &...,Warehouse A,17,9,2025-02-07 04:29:00,8
24947,ORD_24948,15531,Biproate 500 Tablet CR,Warehouse A,37,27,2025-02-07 11:44:00,10
24948,ORD_24949,1819,Mednac Tablet,Warehouse A,9,1,2025-02-07 20:25:00,8
24949,ORD_24950,36525,Lecherous Beauty Orange corrector Oil Concealer Matte finish Orange Corrector 8 g,Warehouse C,17,2,2025-02-07 06:16:00,15
24950,ORD_24951,33970,OVAS 10MG TABLET,Warehouse B,80,66,2025-02-07 00:20:00,14
24951,ORD_24952,15543,Wet N Wild Makeup Brush - Flat Top Brush 1's,Warehouse B,48,38,2025-02-07 11:15:00,10
24952,ORD_24953,1798,"GIZGA essentials (35cm x 25cm Extended Gaming Mouse Pad, Laptop Desk Mat, Computer Mouse Pad with Smooth Mouse Control, Me...",Warehouse C,61,56,2025-02-07 06:09:00,5
24953,ORD_24954,23229,"Maybelline New York Super Stay Matte Ink Liquid Lipstick, 15 Lover, 5ml and Maybelline New York Super Stay Matte Ink Liqui...",Warehouse B,40,34,2025-02-07 20:15:00,6
24954,ORD_24955,34057,"20W Type-C Fast Charger Adapter Compatible For Apple Iphone 13, 12, 11, X Series And Ipad (White)",Warehouse B,61,46,2025-02-07 18:01:00,15
24955,ORD_24956,15497,Terbihox 250mg Tablet,Warehouse A,109,98,2025-02-07 01:44:00,11
24956,ORD_24957,836,"Face Mask GP95+ - White, Large",Warehouse B,71,59,2025-02-07 09:13:00,12
24957,ORD_24958,395,"English Lavender Hand & Body Lotion,",Warehouse C,102,88,2025-02-07 13:29:00,14
24958,ORD_24959,24174,AEIDESS Tempered Glass Screen Protector Compatible For Oneplus Nord 2T 5G with Edge to Edge Coverage and Easy Installation,Warehouse B,102,92,2025-02-07 19:33:00,10
24959,ORD_24960,7704,Mothercare Narrow Neck Bottle - Blue 250 ml,Warehouse C,52,39,2025-02-07 13:08:00,13
24960,ORD_24961,36441,Biotique Bio Apricot Refreshing Body Wash 190 ml,Warehouse A,74,59,2025-02-07 02:57:00,15
24961,ORD_24962,1680,Rappit D 30mg/20mg Capsule SR,Warehouse C,32,14,2025-02-07 22:40:00,18
24962,ORD_24963,7990,Honitus - Madhuvaani,Warehouse A,31,25,2025-02-07 04:42:00,6
24963,ORD_24964,13113,"Zayn & Myza Breathable Nail Enamel With Raspberry & Almond Oil, Mauve Cheesecake 6 ml",Warehouse A,78,59,2025-02-07 15:08:00,19
24964,ORD_24965,15435,Beauty People Matte Lucious Liquid Lip Colorpretty - In - Carnation - L32 ,Warehouse B,67,51,2025-02-07 22:47:00,16
24965,ORD_24966,35606,Allure Classic Brush Set ACK-12 1's,Warehouse B,112,99,2025-02-07 17:20:00,13
24966,ORD_24967,36399,Asprito 10 Tablet,Warehouse B,32,19,2025-02-07 09:09:00,13
24967,ORD_24968,7190,Sino Plus Suspension,Warehouse C,22,16,2025-02-07 23:12:00,6
24968,ORD_24969,14628,Oflogod 400mg Tablet,Warehouse A,82,77,2025-02-07 07:51:00,5
24969,ORD_24970,7532,The Face Shop Jeju Volcanic Lava Deep Pore-Cleansing Foam Scrub 150 Ml,Warehouse C,92,79,2025-02-07 12:11:00,13
24970,ORD_24971,35438,"Ohuhu Double Tipped Alcohol Markers, Art Marker Set for Kids, Adults Coloring Illustration, Great Value Pack for Students'...",Warehouse A,103,84,2025-02-07 10:28:00,19
24971,ORD_24972,23658,Blaupunkt SBW600 5.1 Dolby Audio Home Theater Surround Soundbar with Wireless Rear Satellites I 360W with 20.32cm Subwoofe...,Warehouse C,112,95,2025-02-07 01:21:00,17
24972,ORD_24973,872,Manish Malhotra Beauty By MyGlamm Ginger & Tulsi purifying sheet Mask 25 ml,Warehouse A,97,92,2025-02-07 15:12:00,5
24973,ORD_24974,23657,Opgm 2mg/500mg/15mg Tablet,Warehouse C,71,59,2025-02-07 15:06:00,12
24974,ORD_24975,22572,"Nokia C01 Plus 4G, 5.45” HD+ Screen, Selfie Camera with Front Flash (Grey)",Warehouse C,13,2,2025-02-07 06:38:00,11
24975,ORD_24976,14395,"Samsung 8GB DDR4 PC4-19200, 2400MHz, 260 PIN SODIMM, CL 17, 1.2V, ram memory module, M471A1K43BB1-CRC",Warehouse C,39,27,2025-02-07 06:24:00,12
24976,ORD_24977,14427,Time Office Replacement Cable for Morpho MSO 1300 e/e2/e3 Scanner (Type C) - Black,Warehouse A,32,14,2025-02-07 23:56:00,18
24977,ORD_24978,915,Infurox 250 Tablet,Warehouse A,10,1,2025-02-07 06:18:00,9
24978,ORD_24979,23639,"Dell KM5221W Pro Wireless USB Keyboard and Mouse Set Quiet Keyboard, Full-Sized Keyboard, Ambidextrous Mouse, Upto 36 Mont...",Warehouse A,47,30,2025-02-07 01:53:00,17
24979,ORD_24980,8139,Zoyadec 25mg Injection,Warehouse A,98,90,2025-02-07 00:20:00,8
24980,ORD_24981,23694,Diclace P 100 mg/500 mg Tablet,Warehouse A,23,18,2025-02-07 10:16:00,5
24981,ORD_24982,14319,Medimade Orange & Grapefruit Premium Soap (Pack of 3) 1's,Warehouse B,43,28,2025-02-07 01:37:00,15
24982,ORD_24983,14324,"SanDisk Ultra Dual Drive Luxe USB 3.0, USB 2.0 Type-C 256GB, Metal Pendrive for Mobile, Silver",Warehouse B,104,88,2025-02-07 12:31:00,16
24983,ORD_24984,12816,Novartin 16 Tablet,Warehouse A,13,5,2025-02-07 20:37:00,8
24984,ORD_24985,8098,ABOUTTHEFIT Ultra Sleek Smart Flip Case Cover for Lenovo Tab M8 HD/M8 2nd Gen/M8 2nd Gen FHD TB-8505F TB-8505X TB-8505FS T...,Warehouse A,49,44,2025-02-07 00:30:00,5
24985,ORD_24986,14461,Bikzit 500mg Tablet,Warehouse A,8,2,2025-02-07 17:31:00,6
24986,ORD_24987,35498,Jyofex 100mg Tablet,Warehouse A,47,37,2025-02-07 15:09:00,10
24987,ORD_24988,35502,Flormar Full Color Nail Enamel FC48 Bright Azalea 8 ml,Warehouse A,110,93,2025-02-07 14:47:00,17
24988,ORD_24989,8124,Nishkuf-LS Syrup,Warehouse C,39,30,2025-02-07 08:45:00,9
24989,ORD_24990,14343,Aid-Air-AB Tablet,Warehouse C,32,16,2025-02-07 20:46:00,16
24990,ORD_24991,35536,"iQOO Z6 5G by vivo (Dynamo Black, 4GB RAM, 128GB Storage) | Snapdragon 695-6nm Processor | 120Hz FHD+ Display | Travel Ada...",Warehouse C,77,67,2025-02-07 09:19:00,10
24991,ORD_24992,35547,Roovsprin Gold 75mg/20mg/75mg Capsule,Warehouse A,81,69,2025-02-07 18:06:00,12
24992,ORD_24993,35550,Intor 10mg Tablet,Warehouse B,16,3,2025-02-07 10:26:00,13
24993,ORD_24994,22538,"OnePlus 11 5G (Eternal Green, 16GB RAM, 256GB Storage)",Warehouse B,71,66,2025-02-07 18:51:00,5
24994,ORD_24995,869,"AmazonBasics RJ45 Cat 7 High-Speed Gigabit Ethernet Patch Internet Cable For Printer, Server 10Gbps, 600MHz - White, 3-Foot",Warehouse B,96,81,2025-02-07 22:23:00,15
24995,ORD_24996,36522,Gesic-Dee MR Tablet,Warehouse B,92,85,2025-02-07 11:38:00,7
24996,ORD_24997,22418,OnePlus 138.7 cm (55 inches) U Series 4K LED Smart Android TV 55U1S (Black),Warehouse C,82,70,2025-02-07 22:02:00,12
24997,ORD_24998,35904,"GM 3045 Square 3 Pin Flex Box 4 Mtr. with Handle, Indicator & International Socket",Warehouse B,19,2,2025-02-07 12:00:00,17
24998,ORD_24999,35609,Oraimo 22.5W USB C Wall Charger 2 Port Fast Charger with 18W USB-C Power Adapter Foldable Plug Compatible for iPhone 13/13...,Warehouse A,70,62,2025-02-07 13:35:00,8
24999,ORD_25000,35634,Trumef 100mg/5ml Suspension,Warehouse A,28,16,2025-02-07 21:16:00,12
25000,ORD_25001,937,DeBelle Gel Nail Lacquer Luxe Lotus Dark Purple Nail Polish 8 ml,Warehouse B,56,46,2025-02-07 09:52:00,10
25001,ORD_25002,35273,Aedig 0.3mg Tablet,Warehouse B,16,2,2025-02-07 07:28:00,14
25002,ORD_25003,14505,"ESR Classic Hybrid Thermoplastic Polyurethane Magnetic Case with HaloLock, Compatible for iPhone 14 Pro, Compatible for Ma...",Warehouse C,47,38,2025-02-07 03:46:00,9
25003,ORD_25004,14498,Pumic Stone No 4,Warehouse A,77,64,2025-02-07 19:22:00,13
25004,ORD_25005,993,OneAssist 1 Year Extended Warranty Plan for Headphones 2001 to 3000 - Email Delivery Within 2 Hours,Warehouse C,51,40,2025-02-07 18:16:00,11
25005,ORD_25006,14484,EVM 8GB DDR3 1600MHz So-DIMM Laptop Memory Ram (EVMT8G1600S86P),Warehouse C,38,30,2025-02-07 12:01:00,8
25006,ORD_25007,23716,ZEBRONICS Zeb-Tulip Wired in Ear Earphone with Mic (White),Warehouse A,51,36,2025-02-07 18:45:00,15
25007,ORD_25008,8145,Bella Voste Hidefinition Liquid Concealer Shade Lc - 03 4 ml,Warehouse A,14,9,2025-02-07 12:57:00,5
25008,ORD_25009,12708,Sounce Anti-Slip Silicone Ear Buds 2-Pair 4-Pcs Silicone Earphone & Bluetooth Ear Hook Medium Size Ear Hooks Plugs for in-...,Warehouse C,47,37,2025-02-07 02:20:00,10
25009,ORD_25010,1038,Sivanna Colors Diamond Brightening Powder - HF4018 03 4.2 gm,Warehouse A,86,72,2025-02-07 00:10:00,14
25010,ORD_25011,7434,Ajmal Avid Carbon Carbon Deodorant Spray (Pack of 3) 200 ml,Warehouse A,114,97,2025-02-07 09:27:00,17
25011,ORD_25012,35309,Shatavari Tablets,Warehouse A,87,68,2025-02-07 03:36:00,19
25012,ORD_25013,35236,"Nivea Men Shaving Gel - Sensitive, 200ml Bottle",Warehouse B,106,88,2025-02-07 21:41:00,18
25013,ORD_25014,23533,Kar-B 6.25mg Tablet,Warehouse A,71,60,2025-02-07 08:51:00,11
25014,ORD_25015,14615,Cefisil LB 200mg Tablet,Warehouse C,74,69,2025-02-07 12:37:00,5
25015,ORD_25016,761,"Lenovo IdeaPad Gaming Cloth Mouse Pads, Medium",Warehouse A,43,33,2025-02-07 05:21:00,10
25016,ORD_25017,22551,St.Botanica Hair Oil 150 ml + Hair Mask 200 ml - Moroccan Argan,Warehouse A,36,19,2025-02-07 08:25:00,17
25017,ORD_25018,772,"LUNAGARIYA, Protective Cover for Sony HD Smart Android 4K LED TV Remote Control,PU Leather Cover Holder (Before Placing Or...",Warehouse C,97,79,2025-02-07 05:52:00,18
25018,ORD_25019,35347,ZEBRONICS Zeb-Duke Bluetooth Wireless Over Ear Headphone with Mic (Black),Warehouse A,18,8,2025-02-07 03:47:00,10
25019,ORD_25020,7423,Winter Cherry Lip Care,Warehouse C,61,46,2025-02-07 03:37:00,15
25020,ORD_25021,35778,Myrab 20 Tablet,Warehouse B,67,49,2025-02-07 18:24:00,18
25021,ORD_25022,22624,Original Scent - Dry Skin Moisturiser With Cherry Almond Essence,Warehouse A,86,76,2025-02-07 03:46:00,10
25022,ORD_25023,804,Petop-D 10mg/40mg Tablet,Warehouse C,15,10,2025-02-07 17:06:00,5
25023,ORD_25024,14274,"Portronics Pure Sound Pro IV Wireless Bluetooth 5.0 16W Soundbar for Mobile, Laptop/PC with in-Built Radio FM, USB Pendriv...",Warehouse C,83,71,2025-02-07 13:15:00,12
25024,ORD_25025,12848,Soap Tray - Highway Small,Warehouse B,26,19,2025-02-07 01:40:00,7
25025,ORD_25026,23601,Alzorin P 0.25mg/10mg Tablet,Warehouse B,28,14,2025-02-07 11:53:00,14
25026,ORD_25027,987,Lakme 9 To 5 Primer + Gloss Nail Color Magenta Mix 6 Ml,Warehouse A,30,19,2025-02-07 20:35:00,11
25027,ORD_25028,7505,Jannat Impex 2 In 1 Eyebrow & Hairline Stamp with Stencil Kit | Hair Shading Sponge Pen | Hairline Eyeshadow Pen | Instant...,Warehouse B,50,36,2025-02-07 20:00:00,14
25028,ORD_25029,35573,Diclocalm-S Tablet,Warehouse B,11,1,2025-02-07 15:55:00,10
25029,ORD_25030,7486,"Redgear Pro Wireless Gamepad with 2.4GHz Wireless Technology, Integrated Dual Intensity Motor, Illuminated Keys for PC(Com...",Warehouse B,18,13,2025-02-07 07:16:00,5
25030,ORD_25031,34315,Winble Silicone Back Cover for OnePlus Nord 2T 5G Back Cover Camera Protection Soft Protective Back Cover Designed for One...,Warehouse A,44,27,2025-02-07 03:46:00,17
25031,ORD_25032,323,Professional Brush,Warehouse A,94,88,2025-02-07 22:40:00,6
25032,ORD_25033,13099,"Artis PS-1000Eco 1000VA (1KVA) Line Interactive UPS for Personal Computers , Desktop PCs, Laptops, Routers, Networking Dev...",Warehouse C,42,24,2025-02-07 21:46:00,18
25033,ORD_25034,18036,Luke S 250mg/125mg Injection,Warehouse B,108,92,2025-02-07 03:22:00,16
25034,ORD_25035,19371,SanDisk SDDD3-032G-I35GW Ultra Dual 32GB USB 3.0 OTG Pen Drive (Gold),Warehouse A,82,71,2025-02-07 19:17:00,11
25035,ORD_25036,30331,Disulfiram 250mg Tablet,Warehouse C,55,47,2025-02-07 20:20:00,8
25036,ORD_25037,18033,"PENIKOSETE Cream Natural Solution For Management Of Varicose Veins, Spider Veins, Varicocele | Ayurvedic formula | Helps r...",Warehouse A,85,68,2025-02-07 15:14:00,17
25037,ORD_25038,18011,Prium 25mg Tablet CR,Warehouse B,96,82,2025-02-07 22:43:00,14
25038,ORD_25039,3976,Abolab Relief MR 250mg/50mg/325mg Tablet,Warehouse B,102,91,2025-02-07 13:50:00,11
25039,ORD_25040,1,"Oppo A16k (Midnight Black, 3GB RAM, 32GB Storage) with No Cost EMI/Additional Exchange Offers",Warehouse C,108,94,2025-02-07 03:19:00,14
25040,ORD_25041,7183,Apsara White Dustless Chalks,Warehouse B,50,36,2025-02-07 04:29:00,14
25041,ORD_25042,36099,"Lenovo 400 Wireless Mouse, 1200DPI Optical Sensor, 2.4GHz Wireless Nano USB, 3-Button (Left,Right,Scroll) Upto 8M Left/Rig...",Warehouse A,82,72,2025-02-07 01:49:00,10
25042,ORD_25043,23321,K-Aece Tablet,Warehouse C,116,98,2025-02-07 19:04:00,18
25043,ORD_25044,22169,"Fashion Colour Feather Touch Matte Powder, Shade 04 10 gm",Warehouse C,108,97,2025-02-07 15:06:00,11
25044,ORD_25045,34352,Urigal 200 Tablet,Warehouse A,40,22,2025-02-07 02:40:00,18
25045,ORD_25046,34359,Nimpain-T Tablet,Warehouse C,64,45,2025-02-07 01:13:00,19
25046,ORD_25047,12293,Neoloridin Rapitab Rapitab Tablet,Warehouse C,46,37,2025-02-07 14:20:00,9
25047,ORD_25048,7217,Biosoft Disposable Wax Spatuala (100Pc Box) Essentials 100 gm,Warehouse B,80,72,2025-02-07 09:26:00,8
25048,ORD_25049,1581,Fibrispa Tablet,Warehouse A,47,35,2025-02-07 23:45:00,12
25049,ORD_25050,451,Alkovak Oral Solution,Warehouse C,101,86,2025-02-07 05:53:00,15
25050,ORD_25051,36310,Xith 100mg Tablet DT,Warehouse A,32,20,2025-02-07 10:46:00,12
25051,ORD_25052,15241,Fenela-P Tablet,Warehouse B,96,82,2025-02-07 01:40:00,14
25052,ORD_25053,15236,Shilajitvadi Lauha Vati - 300mg,Warehouse B,67,56,2025-02-07 00:56:00,11
25053,ORD_25054,15210,Passion Indulge BATH BAR-LEMONGRASS ( PACK OF 3 ) 1's,Warehouse B,33,24,2025-02-07 14:29:00,9
25054,ORD_25055,7228,Biozit 200mg/250mg Tablet,Warehouse B,73,62,2025-02-07 20:53:00,11
25055,ORD_25056,13899,"LIRAMARK 30W USB-C Female to Lightning Cable Adapter, Type-C to 8 Pin Male PD Fast Charging Converter Cord Data Sync Conne...",Warehouse B,50,43,2025-02-07 18:52:00,7
25056,ORD_25057,22198,Soulflower Rosemary Essential Oil 30 ml,Warehouse C,70,51,2025-02-07 00:44:00,19
25057,ORD_25058,15329,Miss Claire Pearl Eyeliner - 15 - Black Blue 5 Gm,Warehouse B,94,88,2025-02-07 09:10:00,6
25058,ORD_25059,13888,Flormar Full Color Nail Enamel FC51 Funky Magenta 8 ml,Warehouse C,34,26,2025-02-07 07:00:00,8
25059,ORD_25060,13886,Modcort 6mg Tablet,Warehouse C,90,85,2025-02-07 12:03:00,5
25060,ORD_25061,12265,Green Clay Mask,Warehouse A,12,4,2025-02-07 18:51:00,8
25061,ORD_25062,1647,"Samsung Guru Music 2 315 (GT-B315, White) (SM-B315EZWDINS)",Warehouse A,100,81,2025-02-07 02:02:00,19
25062,ORD_25063,25710,"truke Buds BTG3 Bluetooth Truly Wireless in Ear Earbuds with mic, AI-Powered Noise Cancellation, Auto Play/Pause, 55ms Low...",Warehouse A,61,47,2025-02-07 07:49:00,14
25063,ORD_25064,30306,"HP 682 Tri-Color Original Ink Cartridge, Compatible 2335, 2338,2776,2778,6075, 4178 Printer Models",Warehouse B,64,49,2025-02-07 23:31:00,15
25064,ORD_25065,28051,Combither Forte 80 mg/480 mg Tablet,Warehouse C,67,55,2025-02-07 19:43:00,12
25065,ORD_25066,17907,Echo Dot (Black) Combo with Syska 12W Smart Color Bulb - Smart Home Starter Kit,Warehouse B,21,15,2025-02-07 22:01:00,6
25066,ORD_25067,9849,Amazon Basics Auto Focus Full HD 1080P 2.1 Megapixel 30 FPS Ring Light Web Camera with Built-in Mic for PC/Mac/Laptop Vide...,Warehouse B,39,22,2025-02-07 02:50:00,17
25067,ORD_25068,646,SVM Products Unbreakable Set Top Box Stand with Dual Remote Holder (Black),Warehouse B,106,87,2025-02-07 02:58:00,19
25068,ORD_25069,8921,"CROSSVOLT Tough Rugged Cover for Airpods Pro GEN-2 (2022) Black, Polycarbonate",Warehouse B,72,61,2025-02-07 08:35:00,11
25069,ORD_25070,30392,Livonorm Syrup,Warehouse A,34,21,2025-02-07 08:29:00,13
25070,ORD_25071,17972,Hair Removing Cream Rose Mist,Warehouse C,79,67,2025-02-07 00:29:00,12
25071,ORD_25072,5860,Gemblue Biocare Chocolate Face Scrub 500 ml,Warehouse A,91,85,2025-02-07 12:51:00,6
25072,ORD_25073,25644,Gulmahara Arka,Warehouse B,87,78,2025-02-07 19:11:00,9
25073,ORD_25074,3758,Clinch 300mg Capsule,Warehouse A,47,34,2025-02-07 05:41:00,13
25074,ORD_25075,30455,NOTE MINERAL EYESHADOW 302 2 gm,Warehouse A,89,73,2025-02-07 05:23:00,16
25075,ORD_25076,19389,Linanat-M 1000mg/2.5mg Tablet,Warehouse B,71,53,2025-02-07 09:57:00,18
25076,ORD_25077,30222,Amazon Brand - Solimo Silicone Back Cover for Apple iPhone 8 (Transparent),Warehouse A,21,2,2025-02-07 13:22:00,19
25077,ORD_25078,6358,"truke Air Buds+ Bluetooth 5.1 Truly Wireless in Ear Earbuds with Mic Noise Cancellation(AI-ENC) for HD Calls, Upto 48hrs o...",Warehouse B,79,62,2025-02-07 04:55:00,17
25078,ORD_25079,17909,"Lava Yuva 2 Pro (Glass Lavender, 4GB RAM, 64GB Storage)| 2.3 Ghz Octa Core Helio G37| 13 MP AI Triple Camera |Fingerprint ...",Warehouse C,45,40,2025-02-07 04:07:00,5
25079,ORD_25080,26569,Ajmal Aurum & Blu & Sacred Love Deo & Aretha EDP Pack of 4 20 ml,Warehouse C,53,39,2025-02-07 07:35:00,14
25080,ORD_25081,10680,Poviderm Solution,Warehouse B,20,7,2025-02-07 01:30:00,13
25081,ORD_25082,5073,Peebuddy Ladies Stand and Pee Reusable Urination Funnel (Pack of 2's),Warehouse C,59,40,2025-02-07 09:13:00,19
25082,ORD_25083,10778,"SanDisk 500GB Extreme Portable SSD 1050MB/s R, 1000MB/s W,Upto 2 Meter Drop Protection with IP55 Water/dust Resistance, HW...",Warehouse C,49,33,2025-02-07 14:02:00,16
25083,ORD_25084,9855,Divinate Mouth Wash,Warehouse A,26,21,2025-02-07 05:16:00,5
25084,ORD_25085,8933,Hugo Boss Man Eau De Toilette for Men Deodorant Spray 150ml,Warehouse B,49,32,2025-02-07 17:57:00,17
25085,ORD_25086,3799,Cinazole 100mg Capsule,Warehouse B,36,19,2025-02-07 16:03:00,17
25086,ORD_25087,28017,Nebula 5 Tablet,Warehouse A,87,79,2025-02-07 14:51:00,8
25087,ORD_25088,30353,Amber Woman Deodorant,Warehouse B,100,93,2025-02-07 13:28:00,7
25088,ORD_25089,8952,Nandika Beauty Cleansing Milk - Aloevera & Lemon 500 ml,Warehouse C,110,91,2025-02-07 21:40:00,19
25089,ORD_25090,6317,Spigen Ultra Hybrid Pro Back Cover Case Compatible with iPad Pro 11 inch (Version 2) (2022 | 2021) - Matte Black,Warehouse A,45,32,2025-02-07 09:48:00,13
25090,ORD_25091,28072,Omten-C 40/10 Tablet,Warehouse A,54,46,2025-02-07 14:26:00,8
25091,ORD_25092,21085,Pentonic Linc LNPTP50AS Ball Point Pen - Pack of 50 (Multicolour),Warehouse B,35,24,2025-02-07 22:57:00,11
25092,ORD_25093,3847,"Tokdis Premium Bluetooth Smartwatch - Wireless Fitness Band for Boys, Girls, Men, Women & Kids | Activity Tracker I Sports...",Warehouse B,99,93,2025-02-07 06:17:00,6
25093,ORD_25094,18053,Azilite 500mg Tablet,Warehouse C,46,27,2025-02-07 18:03:00,19
25094,ORD_25095,15373,"EZVIZ by Hikvision|C8C Outdoor WiFi 1080p Motorized Pan/Tilt Camera,Color Night Vision, Dust and Water Protection, BuiltIn...",Warehouse B,61,42,2025-02-07 06:05:00,19
25095,ORD_25096,23308,Essential Oil - Clove,Warehouse C,17,3,2025-02-07 06:27:00,14
25096,ORD_25097,1774,"HP w100 480P 30 FPS Digital Webcam with Built-in Mic, Plug and Play Setup, Wide-Angle View for Video Calling on Skype, Zoo...",Warehouse A,24,9,2025-02-07 14:25:00,15
25097,ORD_25098,1644,Lakme Absolute Shine Line Eye Liner Liquid Gold 4.5 Ml,Warehouse A,34,29,2025-02-07 06:40:00,5
25098,ORD_25099,22209,Maczone 1000mg Injection,Warehouse B,92,84,2025-02-07 13:51:00,8
25099,ORD_25100,8014,Nimuflex P 100mg/325mg Tablet,Warehouse A,83,77,2025-02-07 06:51:00,6
25100,ORD_25101,13948,Lanzorex 30mg Capsule,Warehouse C,36,30,2025-02-07 06:39:00,6
25101,ORD_25102,24067,Simmtronics 2GB DDR2 Desktop RAM 800 MHz (PC 6400) with 3 Year Warranty (Pack of 2),Warehouse C,97,83,2025-02-07 10:04:00,14
25102,ORD_25103,15155,Archies Parfum 01 MEN PARFUM ORIGINAL 50 ml,Warehouse A,95,83,2025-02-07 18:19:00,12
25103,ORD_25104,1476,Glokast 5mg/10mg Tablet,Warehouse C,64,49,2025-02-07 04:33:00,15
25104,ORD_25105,15146,Redmi 126 cm (50 inches) 4K Ultra HD Android Smart LED TV X50 | L50M6-RA (Black),Warehouse B,71,56,2025-02-07 07:45:00,15
25105,ORD_25106,12381,Mountain Essentials,Warehouse B,18,8,2025-02-07 17:46:00,10
25106,ORD_25107,1484,Doxinurin 25mg Tablet,Warehouse B,32,24,2025-02-07 05:07:00,8
25107,ORD_25108,13950,"Finger Brush For Kids - Blue, Ultra Soft",Warehouse A,27,22,2025-02-07 23:47:00,5
25108,ORD_25109,1479,Dyazo Zigzag Height Adjustable Ventilated Aluminium Tabletop Laptop Stand with 6 Angles Multi-Angle Compatible for MacBook...,Warehouse C,32,18,2025-02-07 11:34:00,14
25109,ORD_25110,24150,Shankhapushpi Herb Powder - Promotes General Intelligence & Mind Creativity,Warehouse C,43,31,2025-02-07 08:19:00,12
25110,ORD_25111,15376,Colorbar Oh So Happy Lippy Lip Balm Osl002 4.8 Gm,Warehouse B,53,35,2025-02-07 21:54:00,18
25111,ORD_25112,8370,"Blue Heaven 12-in-1 Bling Eyeshadow, Sorbet Pastel 22 gm",Warehouse A,64,59,2025-02-07 07:02:00,5
25112,ORD_25113,1794,Glista PM 1 mg/500 mg/15 mg Tablet,Warehouse B,41,22,2025-02-07 23:33:00,19
25113,ORD_25114,34009,Cosmic Byte CB-GK-23 Artemis 68Key Per Key RGB Wired Mechanical Keyboard with Outemu Blue Switches and Software (Black),Warehouse C,43,25,2025-02-07 22:34:00,18
25114,ORD_25115,12164,Shryoan Shimmer Highlighter SYHL-005-SH01,Warehouse B,105,87,2025-02-07 07:16:00,18
25115,ORD_25116,7128,Gpyrolon 0.2mg Injection,Warehouse C,85,80,2025-02-07 08:05:00,5
25116,ORD_25117,34016,N Able 200mg/125mg Tablet,Warehouse C,72,61,2025-02-07 05:57:00,11
25117,ORD_25118,1779,New Rhumacort Gel,Warehouse C,112,99,2025-02-07 14:58:00,13
25118,ORD_25119,24257,"XTRENGTH Advanced HD+ Full Glue Tempered Glass Screen Protector designed for Google Pixel 6 (6.4"") - Edge to Edge Full Scr...",Warehouse C,41,32,2025-02-07 18:20:00,9
25119,ORD_25120,7138,Gemblue Biocare Ultra moisture Body lotion 500 ml,Warehouse C,20,3,2025-02-07 10:08:00,17
25120,ORD_25121,15504,Serchcef-O Tablet,Warehouse A,36,24,2025-02-07 07:38:00,12
25121,ORD_25122,34042,Dragonwar Red Gear Emera ELE-G11 3200 DPI USB Gaming Mouse (Dark Blue),Warehouse B,53,46,2025-02-07 07:46:00,7
25122,ORD_25123,24236,"Amazon Basics 20000 Mah Lithium Polymer 22.5W Fast Charging Power Bank | Triple Output (Type C, 2 USB), Dual Input (Type ...",Warehouse A,77,61,2025-02-07 21:51:00,16
25123,ORD_25124,7979,Aegte Organics Skin Corrector DD Cream (BB+CC) Broad Spectrum SPF 25++ (Light) 30 gm,Warehouse B,93,81,2025-02-07 14:08:00,12
25124,ORD_25125,13057,Ventrab 20mg Tablet,Warehouse A,70,63,2025-02-07 22:22:00,7
25125,ORD_25126,13058,LAIQA Premium Sanitary Pads Combo Pack (Day Pads 10's + Night Pads 5's),Warehouse B,20,8,2025-02-07 14:54:00,12
25126,ORD_25127,13040,Robustrion Smart Trifold Flip Stand Case Cover for iPad 10th Generation Cover iPad Cover 10.9 inch Right Side [Pencil Hold...,Warehouse B,68,50,2025-02-07 13:37:00,18
25127,ORD_25128,34327,Zobeta 1gm/500mg Injection,Warehouse A,112,97,2025-02-07 12:37:00,15
25128,ORD_25129,24133,Shampa 1mg Tablet,Warehouse B,45,37,2025-02-07 16:28:00,8
25129,ORD_25130,426,"Boult Audio ProBass Thunder Over-Ear Wireless Bluetooth Headphones with Mic, Headset with Long Battery Life",Warehouse A,19,6,2025-02-07 18:43:00,13
25130,ORD_25131,34332,OF 100mg Tablet DT,Warehouse B,33,22,2025-02-07 16:01:00,11
25131,ORD_25132,12271,"Fashion Colour Super Matte Lipstick, Cherry Kiss 4 gm",Warehouse B,78,64,2025-02-07 08:16:00,14
25132,ORD_25133,15350,Robustrion Flip Stand Case Cover for Lenovo Tab M10 FHD Plus 3rd Gen 10.6 inch Tablet - Vine Red,Warehouse A,99,81,2025-02-07 00:41:00,18
25133,ORD_25134,13885,AEIDESS Tempered Glass Screen Protector Compatible for Oneplus 9R with Edge to Edge Coverage and Easy Installation Kit,Warehouse C,48,42,2025-02-07 04:10:00,6
25134,ORD_25135,7681,Oud Woman EDT,Warehouse B,18,2,2025-02-07 15:03:00,16
25135,ORD_25136,24099,Ointment - Fast Relief,Warehouse C,63,54,2025-02-07 16:02:00,9
25136,ORD_25137,34498,Eldine T Syrup,Warehouse B,61,54,2025-02-07 10:31:00,7
25137,ORD_25138,15091,Honey & Almonds Advanced Nourishing Body Lotion,Warehouse A,75,66,2025-02-07 15:35:00,9
25138,ORD_25139,13955,Ixim 50mg Tablet,Warehouse A,37,31,2025-02-07 13:58:00,6
25139,ORD_25140,13966,Storite 2 Pack 1.5M USB Extension Cable USB 3.0 Male to Female Extension Cable High Speed 5GBps Extension Cable Data Trans...,Warehouse A,54,40,2025-02-07 10:36:00,14
25140,ORD_25141,1522,Lakme Color Crush Nailart G12 6 Ml,Warehouse C,54,43,2025-02-07 07:25:00,11
25141,ORD_25142,1447,Bathing Soap - Cool Blue,Warehouse C,88,69,2025-02-07 19:35:00,19
25142,ORD_25143,12412,Arthrovit Tablet,Warehouse B,34,17,2025-02-07 02:18:00,17
25143,ORD_25144,24014,Serafen 50mg/10mg Tablet,Warehouse B,25,12,2025-02-07 18:32:00,13
25144,ORD_25145,23377,"AmazonBasics RJ45 Cat-6 Ethernet Patch/LAN Cable for Personal Computer - 5Feet (1.5Meters), Black",Warehouse A,86,74,2025-02-07 08:37:00,12
25145,ORD_25146,7281,Apsara Matt Magic Pencil 2.0 [Pack of 10],Warehouse B,86,78,2025-02-07 00:42:00,8
25146,ORD_25147,1424,Drofi 250mg Tablet,Warehouse C,19,4,2025-02-07 20:25:00,15
25147,ORD_25148,34649,Azibet 200mg Oral Suspension,Warehouse B,80,61,2025-02-07 04:00:00,19
25148,ORD_25149,8278,Diclosep 10mg Tablet,Warehouse A,37,23,2025-02-07 14:19:00,14
25149,ORD_25150,12433,ZONSHRICK USB Vacuum Cleaner for Laptop/Computer Keyboard/Mobile/Mini Vacuum Cleaner Electronic Part (Multicolor),Warehouse B,99,92,2025-02-07 14:54:00,7
25150,ORD_25151,36120,Sartel H 40 Tablet,Warehouse A,81,75,2025-02-07 19:18:00,6
25151,ORD_25152,24048,G Reg 1000mg Tablet SR,Warehouse A,37,26,2025-02-07 18:53:00,11
25152,ORD_25153,507,Acublast-SP Tablet,Warehouse A,97,78,2025-02-07 03:13:00,19
25153,ORD_25154,14199,"Ant Esports GS100 2.0 Multimedia Aux Connectivity, USB Powered and Volume Control Gaming Speaker (Black)",Warehouse B,92,87,2025-02-07 04:56:00,5
25154,ORD_25155,13579,Optisoft Eye Drop,Warehouse B,41,34,2025-02-07 00:32:00,7
25155,ORD_25156,1297,"Zureni Best Oval Makeup Brush Perfect Makeup Brush for Face Concealer, Contour Kit and Face Powder Foundation - 1 Pc",Warehouse A,73,61,2025-02-07 17:32:00,12
25156,ORD_25157,13424,"Sixfire 7 in 1 Electronic Cleaner kit, Cleaning Kit for Monitor Keyboard Airpods, Screen Dust Brush Including Soft Sweep, ...",Warehouse C,95,86,2025-02-07 09:17:00,9
25157,ORD_25158,4,"Loofah/Sponge Scrubber/Body Bath  - Hangable, White & Pink, BH-008 PNK",Warehouse B,64,49,2025-02-07 01:53:00,15
25158,ORD_25159,11708,mCaffeine Deep Pore Cleansing Regime 300 gm,Warehouse A,106,90,2025-02-07 23:23:00,16
25159,ORD_25160,2429,Maryaj Goldie EDP Fruity Floral Perfume And Ajmal Sacred Love Deodorant Floral Musky Fragrance 300 ml,Warehouse A,95,85,2025-02-07 10:42:00,10
25160,ORD_25161,11772,Cervifen 200mg Tablet,Warehouse A,30,18,2025-02-07 01:01:00,12
25161,ORD_25162,24711,Bontis 50mg/750mg/250mg Tablet,Warehouse C,59,51,2025-02-07 14:29:00,8
25162,ORD_25163,6925,POPIO Tempered Glass Compatible for iPhone 14 Pro Max (Transparent) Edge to Edge Full Screen Coverage with Installation Ki...,Warehouse B,111,98,2025-02-07 06:03:00,13
25163,ORD_25164,16168,Ocypo T Syrup,Warehouse C,78,73,2025-02-07 13:43:00,5
25164,ORD_25165,13480,Micromax X379 (Blue),Warehouse C,83,67,2025-02-07 16:46:00,16
25165,ORD_25166,84,Sensitive Shaving Foam - Home & Salon Use,Warehouse A,14,9,2025-02-07 22:15:00,5
25166,ORD_25167,7898,Future Generation v Group TV Setup Box Stand/TV Set UP Box Holder/TV Remote Holder,Warehouse C,21,9,2025-02-07 18:01:00,12
25167,ORD_25168,2280,Klenz-D 10mg/40mg Tablet,Warehouse C,115,98,2025-02-07 16:37:00,17
25168,ORD_25169,7842,TheGiftKart Crystal Clear Back Cover Case for Realme Narzo 50 Pro 5G | 360 Degree Protection | Shock Proof Design | Transp...,Warehouse A,65,54,2025-02-07 01:31:00,11
25169,ORD_25170,24646,Ayurvedic Massage Oil - Dhanwantharam Oil,Warehouse B,12,1,2025-02-07 12:00:00,11
25170,ORD_25171,13325,"Duracell USB A to Micro Cables, 2A Braided Sync & Quick Charging Cable, 3.9 Feet (1.2M), Supports QC 2.0/3.0 Charging, Rap...",Warehouse C,76,58,2025-02-07 21:49:00,18
25171,ORD_25172,16131,Ithro 500 Tablet,Warehouse B,77,70,2025-02-07 04:30:00,7
25172,ORD_25173,2293,Sparosh 200mg Tablet,Warehouse C,30,21,2025-02-07 16:39:00,9
25173,ORD_25174,33077,Eunacgen SP 100mg/325mg/15mg Tablet,Warehouse C,51,32,2025-02-07 08:30:00,19
25174,ORD_25175,23008,Cerobet 90mg Tablet,Warehouse A,27,21,2025-02-07 12:29:00,6
25175,ORD_25176,33076,Troyatro 0.6mg Injection,Warehouse A,39,30,2025-02-07 08:05:00,9
25176,ORD_25177,21829,Plum Grape Seed & Sea Buckthorn Renaissance Face Mask 75 ml,Warehouse A,90,72,2025-02-07 14:39:00,18
25177,ORD_25178,33059,Robustrion Deer Flip Case Cover for Realme Pad 10.4 inch Cover - Deer Wine Red,Warehouse C,106,89,2025-02-07 15:44:00,17
25178,ORD_25179,23007,Glimify-MV 1 Tablet,Warehouse C,105,91,2025-02-07 06:13:00,14
25179,ORD_25180,37044,Rotodec 50 Injection,Warehouse C,11,1,2025-02-07 01:12:00,10
25180,ORD_25181,33054,Fol-D Capsule,Warehouse B,16,8,2025-02-07 02:23:00,8
25181,ORD_25182,37051,Fashionury Soft Silicone Transparent Mobile Back Cover for Samsung Galaxy M53 5G -(Transparent),Warehouse A,30,15,2025-02-07 01:20:00,15
25182,ORD_25183,16157,Starone 250mg Injection,Warehouse B,31,18,2025-02-07 19:11:00,13
25183,ORD_25184,2319,Torsemax 100mg Tablet,Warehouse A,14,4,2025-02-07 02:48:00,10
25184,ORD_25185,6855,TAF GM Cream,Warehouse B,73,56,2025-02-07 18:24:00,17
25185,ORD_25186,13375,Fogg Deo Punch 150 Ml,Warehouse A,101,82,2025-02-07 20:46:00,19
25186,ORD_25187,37126,Shaddharana Choornam,Warehouse A,81,72,2025-02-07 12:13:00,9
25187,ORD_25188,21793,Angofen-DV Tablet,Warehouse C,12,7,2025-02-07 02:32:00,5
25188,ORD_25189,11907,Dibsan 1mg/500mg/15mg Tablet SR,Warehouse C,105,93,2025-02-07 21:28:00,12
25189,ORD_25190,36854,DeBelle Gel Nail Lacquer La Azure Blue Nail Polish 8 ml,Warehouse B,71,62,2025-02-07 11:00:00,9
25190,ORD_25191,16095,Tavicin 500mg Tablet,Warehouse B,71,63,2025-02-07 13:31:00,8
25191,ORD_25192,11820,Clor 250mg Tablet,Warehouse B,34,29,2025-02-07 02:54:00,5
25192,ORD_25193,7787,"OGX Strength & Length Keratin Fortifying Anti-Frizz Shampoo + Conditioner Combo | Damaged Hair & Split Ends, with Keratin ...",Warehouse A,59,54,2025-02-07 21:14:00,5
25193,ORD_25194,36,"USB Charger, Oraimo Elite Dual Port 5V/2.4A Wall Charger, USB Wall Charger Adapter for iPhone 11/Xs/XS Max/XR/X/8/7/6/Plu...",Warehouse C,107,93,2025-02-07 12:18:00,14
25194,ORD_25195,24717,Aloe Veda Hair Conditioner - Wild Lily 200 ml,Warehouse A,46,31,2025-02-07 04:39:00,15
25195,ORD_25196,13416,Voglow GM 1 Forte Tablet SR,Warehouse B,85,66,2025-02-07 08:07:00,19
25196,ORD_25197,13350,TheGiftKart Flip Back Cover Case for Redmi 9A / 9A Sport / 9i / 9i Sport Flip Back Cover Dual-Color Leather Finish | Inbui...,Warehouse B,45,38,2025-02-07 14:41:00,7
25197,ORD_25198,6885,Ancient Living Multani Mitti Luxury Handmade Soap - 100 gm (Set of 2) Pure Natural Facial Scrub & Deep Cleansing Soap Full...,Warehouse A,90,85,2025-02-07 18:51:00,5
25198,ORD_25199,16218,"LS LAPSTER Quality Assured Indian Style Plug Adapter Duck Head for Power Adapters of MacBook,Powerbook, Pro, Air, iPod, iP...",Warehouse C,48,43,2025-02-07 17:47:00,5
25199,ORD_25200,24731,Neuromore 2500mcg Injection,Warehouse B,107,96,2025-02-07 17:21:00,11
25200,ORD_25201,16242,Beauty People High Shine Nail Polish 1094 12 ml,Warehouse C,25,6,2025-02-07 10:00:00,19
25201,ORD_25202,7883,A Lith 300mg Tablet,Warehouse C,20,8,2025-02-07 10:52:00,12
25202,ORD_25203,21761,Ouxia P Tablet,Warehouse B,91,72,2025-02-07 14:25:00,19
25203,ORD_25204,32913,Soulflower Aroma Oil - Beautiful Day 30 ml,Warehouse C,55,49,2025-02-07 06:07:00,6
25204,ORD_25205,22944,Revlon Nail Enamel - Bewitching 8 Ml,Warehouse A,101,89,2025-02-07 11:56:00,12
25205,ORD_25206,16261,Ajmal Titanium EDP Citrus Spicy Perfume 100ml for Men and Wisal EDP Floral Musky Perfume 50ml for Women +1 Perfume Tester ...,Warehouse C,23,15,2025-02-07 01:50:00,8
25206,ORD_25207,7864,Betaford 8mg Tablet,Warehouse B,34,27,2025-02-07 09:14:00,7
25207,ORD_25208,16266,Vibodep 20 Capsule,Warehouse C,23,8,2025-02-07 20:59:00,15
25208,ORD_25209,21773,"ESR Pencil Case Compatible with iPad Pro 11 Inch (2022/2021, 4th/3rd Generation), Built-in Pencil Holder, Pencil 2 Suppor...",Warehouse C,81,68,2025-02-07 07:30:00,13
25209,ORD_25210,32888,Ocypod 200mg Tablet,Warehouse C,10,2,2025-02-07 15:02:00,8
25210,ORD_25211,22945,M Lanz 15mg Capsule,Warehouse B,77,70,2025-02-07 23:11:00,7
25211,ORD_25212,16278,Maxxcode Exclusive Fragrance Roll-On - Arzoo 2 ml,Warehouse B,54,39,2025-02-07 01:49:00,15
25212,ORD_25213,2415,AmazonBasics Digital Optical Coax to Analog RCA Audio Converter Adapter with Fiber Cable,Warehouse A,108,96,2025-02-07 09:59:00,12
25213,ORD_25214,16299,Oxflo 200mg Tablet,Warehouse A,26,7,2025-02-07 10:22:00,19
25214,ORD_25215,22959,"Just Herbs Neempure Arjun-Nutmeg Skin Purifying Neem Pack, 65gm",Warehouse A,32,27,2025-02-07 11:55:00,5
25215,ORD_25216,22946,"TP-Link Archer AC1200 Archer C6 Wi-Fi Speed Up to 867 Mbps/5 GHz + 400Mbps/2.4 GHz, 5 Gigabit Ports, 4 External Antennas, ...",Warehouse A,87,82,2025-02-07 16:55:00,5
25216,ORD_25217,8543,Trax MF 500mg/250mg Tablet,Warehouse A,69,57,2025-02-07 21:10:00,12
25217,ORD_25218,37085,Streetwear Nail Enamel (Matte) - Misty Mauve 8 Ml,Warehouse B,67,50,2025-02-07 23:14:00,17
25218,ORD_25219,7331,"SWAPKART 3 in 1 Screen Cleaning Kit with Brush and Micro Cloth for PC, laptops, LCD led mobiles,TV and Other Electronics(1...",Warehouse C,103,89,2025-02-07 10:25:00,14
25219,ORD_25220,33035,Qtexim-O Tablet,Warehouse B,43,31,2025-02-07 18:34:00,12
25220,ORD_25221,1900,Glimshine M Forte 1mg/1000mg Tablet,Warehouse B,24,19,2025-02-07 06:33:00,5
25221,ORD_25222,22842,"Arata Natural Clay Face Masque With Activated Charcoal ,Kaolin & Brazilian Blue Clay 100 gm",Warehouse B,24,7,2025-02-07 15:02:00,17
25222,ORD_25223,1894,Monobact 500 mg/250 mg Injection,Warehouse A,6,1,2025-02-07 21:13:00,5
25223,ORD_25224,7748,Atorlip 5 Tablet,Warehouse B,29,12,2025-02-07 21:27:00,17
25224,ORD_25225,226,Quilox 750mg Tablet,Warehouse A,108,97,2025-02-07 21:41:00,11
25225,ORD_25226,23149,Deodorant Spray - Romance,Warehouse B,105,91,2025-02-07 01:04:00,14
25226,ORD_25227,33614,"Compeed Blister Bandage For Foot, Toe, Finger Rubbing Protection, Breathable Foot Protector Hydrocolloid Bandage, 5 Mix Pa...",Warehouse A,40,25,2025-02-07 20:08:00,15
25227,ORD_25228,1892,"Deborah Milano Ls - 821 Il Rossetto Lipsticks, Orange Mix, 4.3g",Warehouse A,29,24,2025-02-07 04:25:00,5
25228,ORD_25229,8433,"Fashion Colour Pro Matte Liquid Foundation, Coffee 30 ml",Warehouse C,25,8,2025-02-07 23:43:00,17
25229,ORD_25230,24430,Actifed 25 mg/2.5 mg Tablet,Warehouse C,79,67,2025-02-07 14:53:00,12
25230,ORD_25231,13725,"doodle Morning Glory B5 Hard Bound Wiro Spiral Notebook Diary with Bookmark Dangler (80GSM,160 Undated Ruled Pages, )",Warehouse A,48,43,2025-02-07 15:14:00,5
25231,ORD_25232,33568,Casio MJ-12D 150 Steps Check and Correct Desktop Calculator,Warehouse B,87,79,2025-02-07 10:36:00,8
25232,ORD_25233,8427,Miss Claire Waterproof Eyebrow Pencil 03 Medium Brown 1.4 Gm,Warehouse A,100,85,2025-02-07 03:08:00,15
25233,ORD_25234,33816,"Shingar Kajal, Black, 2g (Pack Of 4) Matte Finish",Warehouse C,14,6,2025-02-07 21:34:00,8
25234,ORD_25235,12002,Phalasarpi - Uterine Disorders,Warehouse B,56,42,2025-02-07 10:03:00,14
25235,ORD_25236,22827,SD 50 mg/10 mg Capsule,Warehouse C,58,44,2025-02-07 13:20:00,14
25236,ORD_25237,15814,Lakme Color Crush Nailart M18 Deep Olive 6 Ml,Warehouse C,70,57,2025-02-07 10:39:00,13
25237,ORD_25238,24357,"Ceptics Universal Travel Adapter for USA, Canada, Japan, Philippines India to US Plug Adapter - Type B USA Plug - CE Certi...",Warehouse C,75,66,2025-02-07 01:59:00,9
25238,ORD_25239,7089,Ajmal Evoke & Wisal Dhahab Deo & Yearn EDP Pack of 3 20 ml,Warehouse C,52,38,2025-02-07 18:08:00,14
25239,ORD_25240,12001,Mcaffeine Naked & Raw Latte Coffee Shampoo 250 ml,Warehouse C,91,84,2025-02-07 22:47:00,7
25240,ORD_25241,15664,Garnier Color Naturals Creme Riche - Shade 4 Brown (70 ml + 60 gm),Warehouse B,52,34,2025-02-07 18:29:00,18
25241,ORD_25242,8445,Faber-Castell Jumbo Wax Crayons - 24 Shades,Warehouse C,41,22,2025-02-07 09:45:00,19
25242,ORD_25243,21983,Elsol-T Syrup,Warehouse A,38,28,2025-02-07 21:02:00,10
25243,ORD_25244,24360,Resque 4mg Tablet,Warehouse C,27,11,2025-02-07 21:01:00,16
25244,ORD_25245,23209,Troxone 1000mg Injection,Warehouse A,65,46,2025-02-07 04:49:00,19
25245,ORD_25246,22863,"Lava Gem (Blue Gold), Speaker with Amplifier, PMMA 2.5D Glass, Military Grade Certified,1.3 MP Camera, Keypad Mobile",Warehouse C,104,86,2025-02-07 06:49:00,18
25246,ORD_25247,25740,"OnePlus Nord CE 2 Lite 5G (Black Dusk, 8GB RAM, 128GB Storage)",Warehouse B,92,81,2025-02-07 19:12:00,11
25247,ORD_25248,36653,Super Greens Powder,Warehouse C,38,20,2025-02-07 13:36:00,18
25248,ORD_25249,36656,"QUBO 16A Smart Plug from Hero Group | Energy Monitoring, Suitable for large appliances like ACs, Geysers & Water Pumps (Vo...",Warehouse A,73,68,2025-02-07 07:34:00,5
25249,ORD_25250,7047,Lakme Absolute Shine Line Eye Liner Grey 4.5 Ml,Warehouse A,81,69,2025-02-07 12:06:00,12
25250,ORD_25251,7964,Emcip 250mg Tablet,Warehouse A,28,11,2025-02-07 15:47:00,17
25251,ORD_25252,24689,Passion Indulge FACIAL KIT - ETERNIA 5 STAR (pack of 3) 1's,Warehouse B,80,61,2025-02-07 02:40:00,19
25252,ORD_25253,21815,Glimmer Nail Polish Red Mocha 5 ml,Warehouse B,68,52,2025-02-07 11:33:00,16
25253,ORD_25254,32992,Telong 40mg Tablet,Warehouse B,22,10,2025-02-07 14:01:00,12
25254,ORD_25255,11985,Memycin 250mg Tablet,Warehouse A,88,82,2025-02-07 03:41:00,6
25255,ORD_25256,36858,Sounce Ethernet Adapter USB to RJ45 LAN Wired Adapter Compatible for Nintendo Switch Wii Wii U MacBook Chromebook Windows ...,Warehouse A,107,93,2025-02-07 22:45:00,14
25256,ORD_25257,33735,Urban Night Eau De Parfum - For Men,Warehouse C,13,1,2025-02-07 18:09:00,12
25257,ORD_25258,23157,"Oraimo Wireless Bluetooth Speaker with 8W Studio Quality Sound,Powerful Bass, 5 Hours Playtime, IPX7 Waterproof Portable S...",Warehouse B,53,47,2025-02-07 16:25:00,6
25258,ORD_25259,33762,Citizen 10mg Tablet DT,Warehouse C,84,74,2025-02-07 05:15:00,10
25259,ORD_25260,13210,Kainixim O 200mg/200mg Tablet,Warehouse A,31,14,2025-02-07 16:02:00,17
25260,ORD_25261,1918,Zoxakind 500 Tablet,Warehouse B,59,40,2025-02-07 12:40:00,19
25261,ORD_25262,13676,Mylefan 2mg Tablet,Warehouse B,41,35,2025-02-07 01:16:00,6
25262,ORD_25263,36705,Pidilite Fevicreate Make Your Own Bird House | DIY Art and Craft Set for Kids for 7 Years and Above | Kit Contains Fevicol...,Warehouse A,84,70,2025-02-07 14:46:00,14
25263,ORD_25264,7938,Etri 1000mg Injection,Warehouse C,60,49,2025-02-07 01:42:00,11
25264,ORD_25265,1920,iTronix Anodized Portable Aluminum Laptop Tabletop Stand | Anti-Slip Laptop Stand for Apple/ Dell/ HP/ Lenovo/ Asus/ Acer/...,Warehouse B,96,77,2025-02-07 01:17:00,19
25265,ORD_25266,36660,Daily Nourishing Night Cream,Warehouse A,100,95,2025-02-07 14:57:00,5
25266,ORD_25267,23174,"GOVO GOSURROUND 920 | 200W Soundbar, 2.1 Channel Home Theatre, Wireless Subwoofer, HDMI, AUX, Opt, USB & Bluetooth, 4 Equa...",Warehouse A,61,53,2025-02-07 20:24:00,8
25267,ORD_25268,15747,"Lava A5 (Gold), Military Grade Certified with 3 Days Battery Backup, Sound Leakage Resistance, Super Battery Mode, Keypad ...",Warehouse B,15,5,2025-02-07 16:00:00,10
25268,ORD_25269,33582,"Onelap GO - Wireless GPS Tracker with Voice Listen for School Kids, Car, Scooty, Truck or Anything with 1 Year sim Card +...",Warehouse C,45,32,2025-02-07 19:12:00,13
25269,ORD_25270,24351,DavaIndia Carvedilol 3.125mg Tablet,Warehouse A,97,88,2025-02-07 08:29:00,9
25270,ORD_25271,36687,Ondwell Oral Drops,Warehouse C,32,16,2025-02-07 09:32:00,16
25271,ORD_25272,12012,Ajmal 2 Magnetize Deo & Prose EDP Pack of 3 20 ml,Warehouse C,94,77,2025-02-07 03:16:00,17
25272,ORD_25273,12008,"Sport Deo Spray - Fresh, for Women",Warehouse C,13,3,2025-02-07 11:18:00,10
25273,ORD_25274,15687,Forest Essentials Hair Cleanser Bhringraj & Shikakai|Reduces Hair Fall & Dandruff|Hair Shampoo For Men And Women|200ml,Warehouse C,15,8,2025-02-07 22:44:00,7
25274,ORD_25275,15699,Gatiwel 400mg Tablet,Warehouse A,38,33,2025-02-07 11:40:00,5
25275,ORD_25276,23147,Vitalift Capsule,Warehouse C,41,22,2025-02-07 18:09:00,19
25276,ORD_25277,33776,Salbair I Neb 0.63mg Transpules 2.5ml,Warehouse B,54,37,2025-02-07 18:47:00,17
25277,ORD_25278,33633,"Vatika Select Shampoo - Apple Cider Vinegar, Smooth & Shine",Warehouse A,39,33,2025-02-07 05:31:00,6
25278,ORD_25279,22813,"TheGiftKart Shockproof Crystal Clear Back Cover Case for OnePlus Nord 2020, 360 Degree Protection | Protective Design | Tr...",Warehouse B,47,29,2025-02-07 08:30:00,18
25279,ORD_25280,33311,Ceretor 400mg Tablet,Warehouse A,25,15,2025-02-07 04:12:00,10
25280,ORD_25281,21907,Ringflox 200 Tablet,Warehouse A,61,52,2025-02-07 03:35:00,9
25281,ORD_25282,2146,"Zebronics DRIP Smart Watch with Bluetooth Calling, 4.3cm (1.69""), 10 built-in & 100+ Watch Faces, 100+ Sport Modes, 4 buil...",Warehouse A,73,68,2025-02-07 19:46:00,5
25282,ORD_25283,11919,Lenphor Nail Tint Oliveoto 51 12 Ml,Warehouse A,22,16,2025-02-07 22:05:00,6
25283,ORD_25284,1113,Netflox Tablet,Warehouse C,57,40,2025-02-07 10:38:00,17
25284,ORD_25285,22402,Roseleaf Artificial Nails High Coverage Foundation Essential Oil Compact powder Loose Powder Remover Fixer Primer Conceale...,Warehouse C,83,72,2025-02-07 12:59:00,11
25285,ORD_25286,23840,"Dressing Comb - Large, Colour May Vary",Warehouse A,97,83,2025-02-07 10:49:00,14
25286,ORD_25287,22383,VW 60 cm (24 inches) HD Ready Smart LED TV VW24S (Black) (2021 Model),Warehouse C,37,23,2025-02-07 21:52:00,14
25287,ORD_25288,23834,Clobezine S Ointment,Warehouse A,38,20,2025-02-07 01:06:00,18
25288,ORD_25289,14191,Lipicure-D 20 Tablet,Warehouse B,37,22,2025-02-07 17:08:00,15
25289,ORD_25290,35116,Acezon 325mg/250mg Tablet,Warehouse B,41,32,2025-02-07 11:13:00,9
25290,ORD_25291,12624,Bettor 40mg Tablet,Warehouse C,58,41,2025-02-07 00:25:00,17
25291,ORD_25292,14679,Onkem 2mg Oral Drops,Warehouse C,88,72,2025-02-07 15:16:00,16
25292,ORD_25293,35918,"Oaky Keyboard Protector Compatible with MacBook Air M1 13 inch 2020 Release Model A2179, A2337 Soft Silicone Waterproof Du...",Warehouse B,18,7,2025-02-07 20:50:00,11
25293,ORD_25294,1142,Ultra New Series Ultra Smart Watch Ultra Smartwatch Men Women Bluetooth Call Waterproof Wireless Charging HD Screen (Orange),Warehouse C,40,25,2025-02-07 10:51:00,15
25294,ORD_25295,14675,TheGiftKart Ultra-Hybrid Crystal Clear Back Cover Case for Samsung Galaxy S22 Ultra 5G | Slim Fit Shockproof Design | Came...,Warehouse A,44,32,2025-02-07 13:55:00,12
25295,ORD_25296,23522,Ceftraphy-S Injection,Warehouse B,81,67,2025-02-07 23:56:00,14
25296,ORD_25297,14657,Aroff EZ Tablet,Warehouse C,91,78,2025-02-07 17:17:00,13
25297,ORD_25298,7571,"Toothpaste - Total Charcoal, Anticavity",Warehouse A,64,59,2025-02-07 23:35:00,5
25298,ORD_25299,35190,Panty Liners - Herbs Verbena,Warehouse A,30,20,2025-02-07 20:46:00,10
25299,ORD_25300,1159,Staclav Dry Syrup,Warehouse A,90,72,2025-02-07 14:05:00,18
25300,ORD_25301,14723,Spigen Liquid Air Back Cover Case Compatible For OnePlus Nord 2T 5G (TPU | Matte Black),Warehouse B,13,3,2025-02-07 13:31:00,10
25301,ORD_25302,23882,Crimont LC 5mg/10mg Tablet,Warehouse B,105,97,2025-02-07 08:08:00,8
25302,ORD_25303,35039,Reondac-S Tablet,Warehouse C,73,59,2025-02-07 16:56:00,14
25303,ORD_25304,22360,Keratine Professional Smoothing Shampoo with extra Smoothing Dose,Warehouse A,78,63,2025-02-07 17:57:00,15
25304,ORD_25305,35969,Laptrix SATA 2nd 2.5'' Hard Drive Caddy for 12.7mm Universal CD/DVD-ROM - Expand Your Data Storage on Your Laptop with HD...,Warehouse A,105,96,2025-02-07 15:11:00,9
25305,ORD_25306,35027,"RAS Luxury Oils Tinted Lip Balm | Miniature Gift Set of 4 Shades Lip & Cheek Tint | Helps Moisturize, Nourishe & Soften Li...",Warehouse B,59,41,2025-02-07 08:26:00,18
25306,ORD_25307,35961,"Cubetek 3 in 1 LCD Display V5.0 Bluetooth Transmitter Receiver, Bypass Audio Adapter with Aux, Optical, Dual Link Support ...",Warehouse C,48,35,2025-02-07 06:58:00,13
25307,ORD_25308,23865,5X Cartridges,Warehouse A,28,14,2025-02-07 13:26:00,14
25308,ORD_25309,7373,Glam On Volume Perfect Mascara Black 8 gm,Warehouse A,93,75,2025-02-07 18:33:00,18
25309,ORD_25310,14178,Brightening Beads Cleanser,Warehouse A,52,40,2025-02-07 14:01:00,12
25310,ORD_25311,14180,Gemblue Biocare Saffron Face and Body Scrub 500 ml,Warehouse B,85,66,2025-02-07 17:35:00,19
25311,ORD_25312,35047,Lambre PURE THERAPY FACE WASH GEL Dry and Sensitive Skin 120ml,Warehouse C,21,15,2025-02-07 18:27:00,6
25312,ORD_25313,22643,"Celly BHSTEREO Magnetic in-Ear Bluetooth 5.0 Wireless Headset, Ergonomic Design, Tangle-Free Cord, Immersive Sound Experie...",Warehouse A,26,12,2025-02-07 13:05:00,14
25313,ORD_25314,36058,Daily Moisturizing Lotion - For Normal & Dry Skin,Warehouse A,113,94,2025-02-07 11:44:00,19
25314,ORD_25315,636,Olzox 40 Tablet,Warehouse B,110,92,2025-02-07 13:44:00,18
25315,ORD_25316,8239,Wilone 250mg Injection,Warehouse B,88,73,2025-02-07 06:42:00,15
25316,ORD_25317,22321,ORCHID ENGINEERS Stylish Iron Remote Stand For Home (Black Glossy Finish) |Tv Remote Stand Holder For Home Decor| Tv Unit ...,Warehouse B,61,47,2025-02-07 04:36:00,14
25317,ORD_25318,36036,Passion Indulge FACE SCRUBB 70 gm,Warehouse B,79,69,2025-02-07 03:00:00,10
25318,ORD_25319,1277,Teldil A 40 mg/5 mg Tablet,Warehouse B,55,48,2025-02-07 14:54:00,7
25319,ORD_25320,36032,"Maybelline New York Color Sensational Creamy Matte Lipstick, 696 Burgundy Blush, 3.9g and Maybelline New York Color Sensat...",Warehouse B,61,56,2025-02-07 22:03:00,5
25320,ORD_25321,14913,6 Oil Nourish Shampoo 640 ml + 6 Oil Nourish Conditioner 175 ml,Warehouse A,49,36,2025-02-07 08:54:00,13
25321,ORD_25322,14121,"Bowiemall Cell Phone Armband Sweatproof Sports Running Armband with Adjustable Elastic Band & Key Holder for Running, Walk...",Warehouse C,81,69,2025-02-07 19:18:00,12
25322,ORD_25323,23916,Zegerd 20mg Capsule,Warehouse C,70,59,2025-02-07 07:54:00,11
25323,ORD_25324,14172,Erixone TZ 1000mg/125mg Injection,Warehouse B,99,81,2025-02-07 11:12:00,18
25324,ORD_25325,34967,"Vaadi Herbals Becalming Tea Tree Soap Anti Acne Therapy, 75g x 6",Warehouse C,65,59,2025-02-07 15:43:00,6
25325,ORD_25326,23902,Rexez Premium Tempered Glass Design for OnePlus 11R Screen Protector and Easy Installation Kit (Pack of 1),Warehouse C,31,25,2025-02-07 05:39:00,6
25326,ORD_25327,12928,Deodorant Body Spray - Te Amo Pearl,Warehouse B,104,98,2025-02-07 12:16:00,6
25327,ORD_25328,637,JETLIFE Premium Mobile Handlebar Holder / Pouch-Bag for All Scooters Scooty Activa Jupiter EV's | Universal X2 Model (Poly...,Warehouse B,19,3,2025-02-07 07:34:00,16
25328,ORD_25329,12580,"Redmi Note 11T 5G (Stardust White, 8GB RAM, 128GB ROM) | Dimensity 810 5G | 33W Pro Fast Charging | Charger Included | Add...",Warehouse B,57,42,2025-02-07 21:04:00,15
25329,ORD_25330,14928,"Gizga Essentials Set of 10 Cable Organiser, Cable Protector & Wire Organizer Clips for Cables, Reusable Cable Organizer fo...",Warehouse C,104,97,2025-02-07 12:00:00,7
25330,ORD_25331,7314,"Newly Launched Pebble Cosmos Prime Bluetooth Calling Smart Watch,Largest 1.91"" Bezel-less Edge-to-Edge Display,600 Nits Br...",Warehouse B,81,66,2025-02-07 15:15:00,15
25331,ORD_25332,23401,"The Man Company Lightening Lip Scrub with Brown Sugar, Almond Oil, Vitamin E, Coconut Oil & Argan Oil | Chemical Free | Fo...",Warehouse A,72,56,2025-02-07 19:58:00,16
25332,ORD_25333,7306,OGTECH Fitness Band USB Charger for M3 Band Xiaomi Mi Band 3 - black,Warehouse B,41,26,2025-02-07 12:39:00,15
25333,ORD_25334,14992,"Blue Nectar Kumkumadi Oil Face Scrub For Glowing Skin, Ayurvedic Exfoliating Scrub For Tan Removal And Blackheads (16 Herb...",Warehouse A,85,73,2025-02-07 20:41:00,12
25334,ORD_25335,23407,Faces Canada Ultime Pro Matte Play Eyeliner Black 2.5 Ml,Warehouse B,83,66,2025-02-07 04:18:00,17
25335,ORD_25336,23409,Rosedeep Gold 75mg/20mg/75mg Capsule,Warehouse C,89,80,2025-02-07 09:35:00,9
25336,ORD_25337,23957,"GoPro AAMIC-001 USB Type C to 3.5mm (0.35 cm) Mic Auxiliary Adapter for HERO8, HERO7, HERO6, HERO5",Warehouse C,84,74,2025-02-07 06:10:00,10
25337,ORD_25338,1342,KOSHIN Red Half Moon Shape Small Size Height 5mm x Width 6mm Forehead Maharashtrian Style Traditional Bindi (Red Small Cha...,Warehouse B,107,92,2025-02-07 12:09:00,15
25338,ORD_25339,1319,Decef-S 375 Injection,Warehouse A,21,2,2025-02-07 03:57:00,19
25339,ORD_25340,22301,KABEER ART 16 Well Rectangle Plastic Painting Palette,Warehouse C,53,34,2025-02-07 18:56:00,19
25340,ORD_25341,34812,Ofdip Plus Cream,Warehouse B,93,86,2025-02-07 05:40:00,7
25341,ORD_25342,14087,Marcetam 500mg Syrup,Warehouse A,69,55,2025-02-07 14:33:00,14
25342,ORD_25343,23421,Esinex-Plus Tablet,Warehouse C,95,85,2025-02-07 07:52:00,10
25343,ORD_25344,712,SanDisk SDCZ430-064G-I35 Ultra Fit 3.1 64GB USB Flash Drive (Black),Warehouse B,83,70,2025-02-07 20:32:00,13
25344,ORD_25345,1190,Ciprozol 500mg Tablet,Warehouse C,38,20,2025-02-07 12:53:00,18
25345,ORD_25346,23499,Flormar Color Up Lip Crayon 10 Caramel 3.2 gm,Warehouse C,46,30,2025-02-07 01:49:00,16
25346,ORD_25347,7791,Hair Gel - Ultimate Hold 250 ml + Beard Cream 50 ml,Warehouse C,75,59,2025-02-07 11:46:00,16
25347,ORD_25348,36944,Insight Cosmetics Mousse Foundation - Honey 30 gm,Warehouse A,20,4,2025-02-07 05:18:00,16
25348,ORD_25349,33158,Medimade Aloe Vera & Neem Body Wash (Pack of 2) 1's,Warehouse A,80,73,2025-02-07 00:49:00,7
25349,ORD_25350,24523,Casio CBS100 Carry Bag CTS Series,Warehouse B,104,85,2025-02-07 19:04:00,19
25350,ORD_25351,36855,"PiBOX India - USB 3.0 to 2.5"" SATA III Hard Drive Adapter 0.5 M Long Cable w/UASP - SATA to USB 3.0 Converter for SSD/HDD...",Warehouse B,60,55,2025-02-07 00:10:00,5
25351,ORD_25352,6928,Sino Suspension,Warehouse C,97,87,2025-02-07 01:25:00,10
25352,ORD_25353,2169,"Mobilife Selfie Stick Tripod,3 in 1 Bluetooth Selfie Stick with Tripod Stand for iPhone Samsung and Mobile Phone Aluminium...",Warehouse A,91,83,2025-02-07 12:33:00,8
25353,ORD_25354,11984,"PHKMALL UD Light Weight Comfortable Full Head Hair Wig Cosplay costume, Fashion Women Synthetic Hair Cosplay Long Curly Wa...",Warehouse B,35,21,2025-02-07 20:27:00,14
25354,ORD_25355,21945,Ajmal Wisal Dhahab & Aurum Deo & Aretha EDP Pack of 3 20 ml,Warehouse C,106,91,2025-02-07 07:08:00,15
25355,ORD_25356,21943,Ursorna 300mg Tablet,Warehouse B,69,55,2025-02-07 02:50:00,14
25356,ORD_25357,13642,Revlon Colorstay Full Cover Foundation - Warm Golden 30 ml,Warehouse B,91,81,2025-02-07 19:33:00,10
25357,ORD_25358,2064,SUGAR Cosmetics Grand Finale Matte Setting Mist 50 Ml,Warehouse C,38,30,2025-02-07 03:54:00,8
25358,ORD_25359,24442,"Wi-Fi Wireless Display Dongle | DLNA Wireless HDMI Screen Mirroring Wi-Fi Adaptor, TV/LED/LCD/Projector Receiver Device Ea...",Warehouse A,26,9,2025-02-07 12:55:00,17
25359,ORD_25360,13641,Rabiphar-D Tablet,Warehouse B,25,6,2025-02-07 19:33:00,19
25360,ORD_25361,24457,Dolief 6 Tablet,Warehouse A,8,2,2025-02-07 04:15:00,6
25361,ORD_25362,21860,VEGA Handcrafted Round Teeth Comb Gentle On Scalp,Warehouse A,42,24,2025-02-07 14:12:00,18
25362,ORD_25363,33480,Under Eye Recovery Gel - Hyaluronic Acid & Caffeine,Warehouse C,60,41,2025-02-07 22:26:00,19
25363,ORD_25364,13640,"ZEBRONICS Bluetooth 5.0 Keyboard for Mac, Windows, Android, Up to 3 Connections, Built-in Rechargeable Battery, Scissor sw...",Warehouse A,97,81,2025-02-07 00:33:00,16
25364,ORD_25365,7795,Toflox Plus 200 mg/200 mg Tablet,Warehouse C,92,81,2025-02-07 10:44:00,11
25365,ORD_25366,36781,Park Avenue - Cool Blue Lather Shaving Cream 60g with Free 40% (60g + 24g =84g),Warehouse C,103,89,2025-02-07 15:28:00,14
25366,ORD_25367,7799,"Asus ADP-45ZE B 45W Laptop Adapter/Charger with Power Cord for Select Models of ASUS Laptop (19 V, 2.37 A, 4 mm x 1.2mm Di...",Warehouse B,28,20,2025-02-07 23:45:00,8
25367,ORD_25368,15878,"Portronics Radian 16W Bluetooth Stereo Soundbar with Multicolour LED Lights, in-Built FM Radio, Built in Mic, Aux in 3.5m...",Warehouse B,18,6,2025-02-07 23:44:00,12
25368,ORD_25369,33423,PureSense Macadamia Deep Moisturising Body Oil 100 ml,Warehouse A,58,41,2025-02-07 09:43:00,17
25369,ORD_25370,11951,I-Glide Eye Pencil New Mini Pencil Kajal Iglnm004 0.5 Gm,Warehouse A,87,78,2025-02-07 10:05:00,9
25370,ORD_25371,13630,Stotrip 90mg/48mg/100mg Tablet,Warehouse C,73,57,2025-02-07 10:03:00,16
25371,ORD_25372,22880,Comet Busters Moon Shaped Red Bindi With Silver Stones (9mm) (BIN971),Warehouse A,81,70,2025-02-07 02:22:00,11
25372,ORD_25373,8479,Newlike Thermoplastic Polyurethane Samsung Galaxy Z Fold 4 5G Case Premium Tough Rugged Solid [Bumper] Transparent Hard PC...,Warehouse B,32,19,2025-02-07 08:10:00,13
25373,ORD_25374,162,Deodorant Body Spray - Sunscent,Warehouse A,89,73,2025-02-07 12:24:00,16
25374,ORD_25375,21859,AN Mic 250mg Injection,Warehouse B,52,41,2025-02-07 03:11:00,11
25375,ORD_25376,2244,MADES Body Resort Clear Purple Pet Bottle Body Lotion 250 ml,Warehouse B,46,38,2025-02-07 09:21:00,8
25376,ORD_25377,12917,"BESTOR® Portable Ruff 12 inches LCD Paperless Memo Digital Tablet, LCD Writing Tablet for Kids, 12 Inch Doodle Board Drawi...",Warehouse B,70,51,2025-02-07 06:19:00,19
25377,ORD_25378,2177,Gzlsalic Ointment,Warehouse C,31,19,2025-02-07 09:30:00,12
25378,ORD_25379,14732,"boAt Airdopes 141 Bluetooth Truly Wireless in Ear Earbuds with mic, 42H Playtime, Beast Mode(Low Latency Upto 80ms) for Ga...",Warehouse C,56,48,2025-02-07 22:54:00,8
25379,ORD_25380,36562,"ProElite Slim Trifold Flip case Cover for Redmi Pad 10.6"" Tablet, Black",Warehouse B,103,93,2025-02-07 04:50:00,10
25380,ORD_25381,911,Maxidine 5% Ointment,Warehouse B,96,85,2025-02-07 08:02:00,11
25381,ORD_25382,33275,Livozed M 5mg/10mg Tablet,Warehouse B,110,94,2025-02-07 11:27:00,16
25382,ORD_25383,24525,Zimy 500mg Tablet,Warehouse C,37,20,2025-02-07 12:22:00,17
25383,ORD_25384,13553,Issey Miyake Nectar D'Issey Premiã¨Re Fleur For Women 90Ml,Warehouse A,26,21,2025-02-07 12:49:00,5
25384,ORD_25385,36870,Oripred 4mg Tablet,Warehouse B,48,32,2025-02-07 04:27:00,16
25385,ORD_25386,23060,Apper Syrup,Warehouse B,24,14,2025-02-07 12:38:00,10
25386,ORD_25387,24540,"iQOO Neo 6 5G (Dark Nova, 12GB RAM, 256GB Storage) | Only Snapdragon 870 in The Segment | 50% Charge in Just 12 Mins | 90 ...",Warehouse A,98,93,2025-02-07 21:15:00,5
25387,ORD_25388,21882,Dypsin-P Tablet,Warehouse B,40,31,2025-02-07 04:13:00,9
25388,ORD_25389,2176,"Samsung T7 1TB Up to 1,050MB/s USB 3.2 Gen 2 (10Gbps, Type-C) External Solid State Drive (Portable SSD) Grey(MU-PC1T0T)",Warehouse A,72,53,2025-02-07 06:56:00,19
25389,ORD_25390,24564,Methlone 4mg Tablet,Warehouse A,61,52,2025-02-07 07:49:00,9
25390,ORD_25391,33192,Original Care Lip Balm For 24h Moisture With Shea Butter & Natural Oils,Warehouse C,97,90,2025-02-07 20:04:00,7
25391,ORD_25392,2189,"Fashion Colour Pro Hd Eyeshadow Palette 15 Shades, Shade 01 18 gm",Warehouse C,96,85,2025-02-07 09:37:00,11
25392,ORD_25393,33244,Spigen Modern Fit Band Strap Compatible with Samsung Galaxy Watch 3 (45mm) | Galaxy Watch (46mm) | OnePlus Watch | Gear S3...,Warehouse C,31,24,2025-02-07 22:23:00,7
25393,ORD_25394,24575,Hair Color - Natural Black (101),Warehouse C,25,10,2025-02-07 16:44:00,15
25394,ORD_25395,13527,Biovom 4mg Tablet MD,Warehouse A,73,66,2025-02-07 23:57:00,7
25395,ORD_25396,16029,Yeldou Dual Tip Watercolour Painting Brush Marker Pens Set (Multicolour) -24 Pieces,Warehouse C,85,66,2025-02-07 08:38:00,19
25396,ORD_25397,23058,Vintop 40mg Injection,Warehouse A,53,44,2025-02-07 19:34:00,9
25397,ORD_25398,33213,Vitamin E Body Cream,Warehouse A,32,20,2025-02-07 16:15:00,12
25398,ORD_25399,24589,Insight Cosmetics Non - Transfer Lip Color - 24 CHARMED 4 ml,Warehouse A,45,37,2025-02-07 10:00:00,8
25399,ORD_25400,8514,Glipty 50mg Tablet,Warehouse A,20,5,2025-02-07 07:21:00,15
25400,ORD_25401,36916,Mamaearth Skin Illuminate Face Serum for Radiant Skin with Vitamin C and Turmeric (15g),Warehouse C,77,65,2025-02-07 14:34:00,12
25401,ORD_25402,33208,Talixim 200mg Tablet,Warehouse A,97,85,2025-02-07 22:13:00,12
25402,ORD_25403,113,Lip Balm,Warehouse C,98,93,2025-02-07 19:13:00,5
25403,ORD_25404,11842,Enlinea Edge to Edhe Screen Protector | Screen Guard for Ola S1 Pro | OLA S1 | OLA Air (Matte),Warehouse C,104,90,2025-02-07 13:51:00,14
25404,ORD_25405,8926,"Stbotanica Bulgarian Rose Otto Glow Day Cream Spf 30 Uva Uvb Protection, Brightening & Nourishing 50 gm",Warehouse A,18,9,2025-02-07 05:03:00,9
25405,ORD_25406,4971,Takara Karaoke Speaker Trolley 12 Inch Woofer Portable Multimedia Bluetooth; Audio Recording; USB; SD; TF; AUX PA System w...,Warehouse B,64,45,2025-02-07 11:39:00,19
25406,ORD_25407,11266,Voglimac GM 1 HD Tablet,Warehouse A,22,10,2025-02-07 09:20:00,12
25407,ORD_25408,11425,Hepaset Syrup,Warehouse C,31,15,2025-02-07 23:15:00,16
25408,ORD_25409,27331,Throin 200mg Suspension,Warehouse B,22,3,2025-02-07 08:15:00,19
25409,ORD_25410,32137,Cardimol CP 0.5 mg/20 mg Tablet,Warehouse C,65,49,2025-02-07 08:06:00,16
25410,ORD_25411,2757,Spigen Essential Sand Blast Back Cover Case Compatible with Galaxy M33 5G (TPU | Matte Black),Warehouse C,13,1,2025-02-07 18:36:00,12
25411,ORD_25412,9580,HP GT52 Ink Bottle (Yellow),Warehouse C,77,60,2025-02-07 09:39:00,17
25412,ORD_25413,24961,Trymosin BRD Tablet,Warehouse A,48,30,2025-02-07 01:11:00,18
25413,ORD_25414,32245,Charmacy Milano Soft Satin Matte Lipstick (Dip O Ruby) 3.8 gm,Warehouse B,40,24,2025-02-07 03:04:00,16
25414,ORD_25415,32133,Time Office Scanner Replacement Cable for Startek FM220U (Type C) Ivory,Warehouse C,75,58,2025-02-07 10:56:00,17
25415,ORD_25416,2820,Rejunuron Forte Injection,Warehouse B,74,58,2025-02-07 03:31:00,16
25416,ORD_25417,6724,Dexacore 4mg Injection,Warehouse C,44,39,2025-02-07 02:19:00,5
25417,ORD_25418,16757,Colorbar Full Cover Makeup Foundation Stick Fcms001 9 Gm,Warehouse C,82,69,2025-02-07 20:19:00,13
25418,ORD_25419,5439,Ajmal Impress Concentrated Perfume Oil Citrus And Evoke Silver Edition Him Deodorant Spicy Floral Fragrance 210 ml,Warehouse A,55,38,2025-02-07 22:39:00,17
25419,ORD_25420,26841,Moudzer TH 100mg/4mg Tablet,Warehouse A,37,22,2025-02-07 11:20:00,15
25420,ORD_25421,32096,Candidox Shampoo 100ML (1 unit),Warehouse A,19,2,2025-02-07 21:30:00,17
25421,ORD_25422,11411,"Offbeat® Bluetooth 5.1 + 2.4 Ghz Wireless Gaming 7D Buttons Mouse, 3 DPI Modes 1600:2400:3200 mice for ipad, Mac Book, Tab...",Warehouse A,34,15,2025-02-07 07:19:00,19
25422,ORD_25423,25058,Wokvent Syrup Sugar Free,Warehouse A,31,16,2025-02-07 19:24:00,15
25423,ORD_25424,9407,Decef-S 750 Injection,Warehouse C,99,94,2025-02-07 02:50:00,5
25424,ORD_25425,5374,Tahache-AS Tablet,Warehouse C,58,44,2025-02-07 09:02:00,14
25425,ORD_25426,11251,Olay 20mg Tablet,Warehouse C,45,32,2025-02-07 12:46:00,13
25426,ORD_25427,3000,Metohart 25mg Tablet XL,Warehouse B,85,67,2025-02-07 07:55:00,18
25427,ORD_25428,17047,"ZEBRONICS DC Joker Edition Rocket 500 Bluetooth 5.0 Portable Speaker 20W RMS, TWS, 10 Hour Backup, Built-in Rechargeable B...",Warehouse B,42,29,2025-02-07 07:26:00,13
25428,ORD_25429,3005,OFIXO 20 Meter Food WRAP Multipurpose Food Wrapping Paper,Warehouse C,92,80,2025-02-07 05:10:00,12
25429,ORD_25430,5525,S.A.V.I 3D Temporary Tattoo Golden and Silver Metallic Sticker Heart Dream Catcher Elephant Eye Rose Flower Hand Arm Desig...,Warehouse C,46,41,2025-02-07 01:42:00,5
25430,ORD_25431,31796,OnePlus 108 cm (43 inches) Y Series 4K Ultra HD Smart Android LED TV 43Y1S Pro (Black),Warehouse C,36,18,2025-02-07 20:27:00,18
25431,ORD_25432,11290,Sazithro 500mg Tablet,Warehouse A,35,29,2025-02-07 07:07:00,6
25432,ORD_25433,5392,Zorglim MV Tablet,Warehouse A,35,20,2025-02-07 01:52:00,15
25433,ORD_25434,9372,Nyrin 15mg Injection,Warehouse B,65,60,2025-02-07 10:54:00,5
25434,ORD_25435,19841,Colorbar Bewitching Eye Shadow Palette Bep001 6.4 Gm,Warehouse C,69,50,2025-02-07 15:25:00,19
25435,ORD_25436,31773,"Wooum 15.6 Inch Laptop Sleeve Laptop Protective Case Laptop Pouch Water Resistant Laptop Carrying Case for HP, Dell, Lenov...",Warehouse B,55,50,2025-02-07 04:09:00,5
25436,ORD_25437,16766,TheGiftKart Flexible Shockproof Crystal Clear TPU Soft Back Cover Case with Cushioned Edges for Ultimate Protection for Xi...,Warehouse A,105,93,2025-02-07 21:17:00,12
25437,ORD_25438,27330,Azibet 100mg Oral Drops,Warehouse B,34,28,2025-02-07 18:58:00,6
25438,ORD_25439,20248,TheGiftKart Sleek Back Cover Case for Samsung Galaxy S23 5G | Slim Fit Protective Design | Ultra Matte Finish | Camera Pro...,Warehouse A,64,53,2025-02-07 13:51:00,11
25439,ORD_25440,2899,Nimoliv P 100mg/325mg Tablet,Warehouse C,113,95,2025-02-07 21:52:00,18
25440,ORD_25441,5426,Spigen Ultra Hybrid Back Cover Case Compatible For Nothing Phone (1) (TPU + Polycarbonate | Space Crystal),Warehouse C,30,25,2025-02-07 12:12:00,5
25441,ORD_25442,11511,Ardiva 250mg Tablet ER,Warehouse B,33,16,2025-02-07 03:13:00,17
25442,ORD_25443,16684,Sehcef 50mg Dry Syrup,Warehouse C,76,62,2025-02-07 04:42:00,14
25443,ORD_25444,31983,Ajmal Classic Oud CP & Neea EDP Pack of 2 20 ml,Warehouse B,79,66,2025-02-07 08:30:00,13
25444,ORD_25445,20289,Sunaina COLORZ 288 Bindi Book For Women (Size-9),Warehouse A,17,10,2025-02-07 04:31:00,7
25445,ORD_25446,25045,Henopar-MR Tablet,Warehouse A,51,42,2025-02-07 18:19:00,9
25446,ORD_25447,25052,Nematobus Suspension,Warehouse C,21,10,2025-02-07 19:31:00,11
25447,ORD_25448,31963,Tolexant P 150mg/325mg Tablet,Warehouse C,58,50,2025-02-07 08:34:00,8
25448,ORD_25449,24934,"L'Oreal Paris Brow Artist Genius Kit, Medium To Dark 3.5 Gm",Warehouse A,58,52,2025-02-07 02:42:00,6
25449,ORD_25450,19882,Metoprax 50mg Tablet,Warehouse C,91,86,2025-02-07 16:34:00,5
25450,ORD_25451,2918,milk_shake® energizing blend conditioner,Warehouse B,111,95,2025-02-07 14:28:00,16
25451,ORD_25452,31954,LOMASATHANA THAILAM OIL(Pack of 2),Warehouse C,39,34,2025-02-07 16:37:00,5
25452,ORD_25453,2855,Zekmef-DS Oral Suspension Mango,Warehouse C,19,1,2025-02-07 05:02:00,18
25453,ORD_25454,32240,Bathing Soap - Trio Classic Sandal,Warehouse B,76,61,2025-02-07 02:44:00,15
25454,ORD_25455,32066,Kofcon CC Tablet,Warehouse C,87,77,2025-02-07 16:24:00,10
25455,ORD_25456,9390,Rabipil-DSR Capsule,Warehouse A,85,73,2025-02-07 04:53:00,12
25456,ORD_25457,32176,Dorocort Injection,Warehouse A,89,73,2025-02-07 15:32:00,16
25457,ORD_25458,16813,Intimate Wash,Warehouse A,60,45,2025-02-07 23:33:00,15
25458,ORD_25459,32170,"Dyazo Memory-Foam Gel Mouse Pad with Wrist Rest Support Non Slip Rubber Base Mousepad Suitable for Computer, Laptop, Noteb...",Warehouse C,43,33,2025-02-07 12:48:00,10
25459,ORD_25460,27310,Perum-S Injection,Warehouse B,12,7,2025-02-07 18:06:00,5
25460,ORD_25461,5681,3D Youth Boost Spf 40 Sunscreen Gel Creme 100 Gm,Warehouse A,81,66,2025-02-07 00:50:00,15
25461,ORD_25462,26861,Vildasan M 50mg/50mg Tablet,Warehouse C,28,14,2025-02-07 09:15:00,14
25462,ORD_25463,2801,Zodo 8. 5 inch LCD E-Writer Electronic Writing Pad/Tablet Drawing Board (Paperless Memo Digital Tablet),Warehouse A,86,68,2025-02-07 10:37:00,18
25463,ORD_25464,2764,"HP 15s, 11th Gen Intel Core i3, 8GB RAM/512GB SSD 15.6-inch(39.6 cm) Micro-Edge Anti-Glare FHD Laptop/Alexa Built-in/Win 1...",Warehouse C,19,6,2025-02-07 05:19:00,13
25464,ORD_25465,11271,Exfoliating Body Wash - Coconut Joy,Warehouse A,109,91,2025-02-07 18:02:00,18
25465,ORD_25466,32506,OpenTech® Tempered Glass Screen Protector Compatible for OnePlus 9R with Edge to Edge Coverage and Easy Installation kit,Warehouse C,98,92,2025-02-07 15:53:00,6
25466,ORD_25467,32325,Kolimef D 10mg/250mg Tablet,Warehouse C,116,98,2025-02-07 17:51:00,18
25467,ORD_25468,17141,Mitigate-MR Tablet,Warehouse B,75,59,2025-02-07 21:53:00,16
25468,ORD_25469,9525,Medimade Shea Body Butter 200 ml,Warehouse A,22,11,2025-02-07 17:02:00,11
25469,ORD_25470,5406,Setair Kid Tablet,Warehouse C,41,26,2025-02-07 21:42:00,15
25470,ORD_25471,6674,Streetwear Nail Enamel - Must Mustard 8 Ml,Warehouse C,12,3,2025-02-07 09:59:00,9
25471,ORD_25472,17007,Enal 2.5mg Tablet,Warehouse C,48,41,2025-02-07 21:29:00,7
25472,ORD_25473,25081,"Soft Rose Lip Balm - 24h Moisture With Natural Oils, Delicate Rose Shine",Warehouse B,101,85,2025-02-07 13:17:00,16
25473,ORD_25474,5720,TheGiftKart Shockproof Back Cover Case for OnePlus 11R 5G | Raised Bumps for Camera & Screen Protection | Ultra Clear Soft...,Warehouse C,46,38,2025-02-07 00:41:00,8
25474,ORD_25475,25095,Stbotanica Sensual Amber Handmade Luxury Soap 125 gm,Warehouse C,108,99,2025-02-07 14:36:00,9
25475,ORD_25476,31865,Soulflower Jasmine Aroma Massage Oil 90 ml,Warehouse B,94,84,2025-02-07 14:40:00,10
25476,ORD_25477,21477,Insight Non Transfer Matte Lipstick - 4.2g,Warehouse B,49,42,2025-02-07 02:36:00,7
25477,ORD_25478,32453,Men Hair Cream - Classic,Warehouse B,80,69,2025-02-07 15:57:00,11
25478,ORD_25479,31853,"Fashion Colour Kiss Lip No Transfer Lipstick, 07 Fuchsia 2.6 gm",Warehouse B,101,85,2025-02-07 03:52:00,16
25479,ORD_25480,2978,Zmox 250mg Capsule,Warehouse A,84,67,2025-02-07 22:58:00,17
25480,ORD_25481,31838,"Tecno Spark 9 (Vitality Green, 4GB RAM, 64GB Storage)| Upto 7GB Expandable RAM | 90Hz Refresh Rate | 6.6"" HD+Display | 13M...",Warehouse C,69,57,2025-02-07 09:04:00,12
25481,ORD_25482,8729,Wireless WiFi IP CCTV Security 1080p 12mp Ptz Outdoor Ip66 Waterproof Pan Tilt Speed Dome Home Surveillance Camera with Mo...,Warehouse A,65,46,2025-02-07 19:01:00,19
25482,ORD_25483,21467,"Cosmac Professional Combo Kit Primer,Foundation,Lipstick,Eyeshadow,Eyeliner,Mascara,Eyebrow Pencil,Kajal,Makeup Brush,Conc...",Warehouse B,58,52,2025-02-07 20:48:00,6
25483,ORD_25484,31827,"Terabyte 4k (DP) Display Port Male to HDMI Cable Male Port 1080P 1.8 m HDMI Cable (Compatible with HDTV, Smart-TV, Project...",Warehouse C,83,71,2025-02-07 03:00:00,12
25484,ORD_25485,2962,RD Best D 30mg/20mg Capsule SR,Warehouse B,45,32,2025-02-07 10:15:00,13
25485,ORD_25486,17665,Serpanis 50 mg/500 mg/10 mg Tablet,Warehouse A,25,6,2025-02-07 20:41:00,19
25486,ORD_25487,31039,"King Shine Multi Retractable 3.0A Fast Charger Cord, Multiple Charging Cable 4Ft/1.2m 3-in-1 USB Charge Cord Compatible wi...",Warehouse A,26,13,2025-02-07 10:58:00,13
25487,ORD_25488,10438,TRUEUPGRADE Silicone Back Case Cover Compatible with OnePlus Nord CE 2 Lite 5G Case Cover |Raised Lip Protection Back Case...,Warehouse B,27,8,2025-02-07 02:49:00,19
25488,ORD_25489,18459,Amz 100mg Injection,Warehouse A,38,29,2025-02-07 20:42:00,9
25489,ORD_25490,20842,"pTron Tangentbeat in-Ear Bluetooth 5.0 Wireless Headphones with Mic, Enhanced Bass, 10mm Drivers, Clear Calls, Snug-Fit, F...",Warehouse C,26,7,2025-02-07 22:27:00,19
25490,ORD_25491,28396,Perfecta Ultra Night Extra Soft Sanitary Napkins,Warehouse B,84,70,2025-02-07 09:17:00,14
25491,ORD_25492,20579,Beauty People High Shine Nail Polish 1086 12 ml,Warehouse A,67,62,2025-02-07 06:09:00,5
25492,ORD_25493,25973,"Lenovo 530 Wireless Mouse (Platinum Grey): Ambidextrous, Ergonomic Mouse, Up to 8 Million clicks for Left and Right Button...",Warehouse C,53,45,2025-02-07 04:56:00,8
25493,ORD_25494,18457,Etorimon T 60mg/4mg Tablet,Warehouse C,61,48,2025-02-07 02:51:00,13
25494,ORD_25495,9226,Belora Paris Leave No Evidence Liquid Matte Lipstick Hazelnut 4.5 gm,Warehouse C,92,83,2025-02-07 13:48:00,9
25495,ORD_25496,9061,Indard-MR Tablet,Warehouse A,60,52,2025-02-07 06:09:00,8
25496,ORD_25497,9531,OpenTech® Hard Silicone Protection Case Cover with Attached Screen Protector Compatible for Samsung Galaxy Watch 4 (44mm) ...,Warehouse B,30,25,2025-02-07 16:19:00,5
25497,ORD_25498,27206,Gudmar Leaves Powder - Supports Normal Blood Sugar Levels,Warehouse B,86,81,2025-02-07 01:42:00,5
25498,ORD_25499,6495,Eraser anti marks cream-15gm,Warehouse A,97,88,2025-02-07 03:07:00,9
25499,ORD_25500,2603,Shaving Foam Sensitive Type,Warehouse C,101,96,2025-02-07 15:08:00,5
25500,ORD_25501,31703,Anpod CV 200mg/125mg Tablet,Warehouse B,96,87,2025-02-07 21:50:00,9
25501,ORD_25502,11352,"QianLink Lightning to USB Cable Apple Certified (Mfi) Sync & Charge Cable for iPhone, Ipad and iPod. Fast Charging Lightni...",Warehouse B,69,62,2025-02-07 17:44:00,7
25502,ORD_25503,17157,Maryaj M For Her EDP Fruity Floral Perfume And Ajmal Wisal Deodorant Floral Musky Fragrance 290 ml,Warehouse A,97,91,2025-02-07 02:14:00,6
25503,ORD_25504,26905,Scent - Beautiful Secret For Women,Warehouse A,32,15,2025-02-07 08:52:00,17
25504,ORD_25505,31672,Total Effects 7-In-1 - Anti-Ageing Night Skin Cream,Warehouse A,29,19,2025-02-07 23:32:00,10
25505,ORD_25506,2611,Spigen Ultra Hybrid Back Cover Compatible for Google Pixel 6a (TPU + PC | Matte Black),Warehouse B,96,87,2025-02-07 09:07:00,9
25506,ORD_25507,11568,Luliglin Lotion,Warehouse C,97,86,2025-02-07 19:00:00,11
25507,ORD_25508,2609,JGD PRODUCTS for Samsung Galaxy S23 Ultra 5G Premium Transparent Hybrid Soft Slim Dust Proof Back Case Cover,Warehouse B,87,71,2025-02-07 22:28:00,16
25508,ORD_25509,31668,Anti-Dandruf shampoo,Warehouse B,43,37,2025-02-07 23:53:00,6
25509,ORD_25510,9569,Active Sport Face Wash,Warehouse B,45,36,2025-02-07 02:37:00,9
25510,ORD_25511,6622,"Storio Kids Toys LCD Writing Tablet 8.5Inch E-Note Pad Best Birthday Gift for Girls Boys, Multicolor (SC1667)",Warehouse C,53,43,2025-02-07 16:02:00,10
25511,ORD_25512,11225,SA Rapid 0.5mg Tablet,Warehouse C,75,66,2025-02-07 18:38:00,9
25512,ORD_25513,6803,AEIDESS Tempered Glass/Screen Guard Compatible for OnePlus 8 with Edge to Edge Full Screen Coverage (Transparent) Installa...,Warehouse B,89,72,2025-02-07 10:35:00,17
25513,ORD_25514,11223,HUION HS64 Graphics Drawing Tablet Battery-Free Stylus Android Windows macOS with 6.3 x 4in Working Area Pen Tablet for Li...,Warehouse B,99,89,2025-02-07 06:27:00,10
25514,ORD_25515,16642,Zodric 150mg Tablet,Warehouse A,84,74,2025-02-07 06:59:00,10
25515,ORD_25516,21408,Sternon-S Ointment,Warehouse A,109,96,2025-02-07 15:00:00,13
25516,ORD_25517,5724,Omilin 20mg Capsule,Warehouse B,31,15,2025-02-07 09:13:00,16
25517,ORD_25518,2625,Orcefix 100 Tablet,Warehouse C,57,42,2025-02-07 02:05:00,15
25518,ORD_25519,25135,"Blue Heaven 12-in-1 Bling Eyeshadow, Indie Vibe 22 gm",Warehouse A,28,22,2025-02-07 22:00:00,6
25519,ORD_25520,20294,Comet Busters Black Traditional Long Bindis (BV494),Warehouse B,51,33,2025-02-07 16:50:00,18
25520,ORD_25521,11540,Bekacin 250mg Injection,Warehouse C,24,18,2025-02-07 16:56:00,6
25521,ORD_25522,13370,Hello Aloe Just Gel For All Skin & Hair Types 99% Natural 250 Gm,Warehouse B,35,30,2025-02-07 07:43:00,5
25522,ORD_25523,31940,Cefoprim 750mg Injection,Warehouse B,20,2,2025-02-07 08:46:00,18
25523,ORD_25524,31939,DeBelle Gel Nail Lacquer Twilight Sapphire Navy Blue Nail Polish 8 ml,Warehouse B,76,67,2025-02-07 06:19:00,9
25524,ORD_25525,31920,Pain-X Ortho Oil - Ayurvedic Pain Oil,Warehouse A,32,22,2025-02-07 01:03:00,10
25525,ORD_25526,16984,Tezcort GM Cream,Warehouse A,19,11,2025-02-07 05:09:00,8
25526,ORD_25527,31905,Perfume - Extreme Red,Warehouse A,39,28,2025-02-07 02:16:00,11
25527,ORD_25528,16645,Zexate 50mg Injection,Warehouse B,85,72,2025-02-07 05:33:00,13
25528,ORD_25529,32372,Shalcip 500mg Tablet,Warehouse B,89,70,2025-02-07 22:40:00,19
25529,ORD_25530,16922,Aroxib P 60mg/325mg Tablet,Warehouse C,32,13,2025-02-07 10:32:00,19
25530,ORD_25531,9999,"Just herbs Amla Vitamin C Face Serum For Glowing Skin & Brightening,Reduce Dark Spots - Suitable for All Skin Types Men & ...",Warehouse B,33,17,2025-02-07 07:12:00,16
25531,ORD_25532,19606,Virpan IV 40mg Injection,Warehouse B,34,25,2025-02-07 22:56:00,9
25532,ORD_25533,27500,Revas-H Tablet,Warehouse C,24,8,2025-02-07 17:47:00,16
25533,ORD_25534,31344,Healerace 100 mg/500 mg/15 mg Tablet,Warehouse B,30,18,2025-02-07 15:40:00,12
25534,ORD_25535,21380,Remote Control Compatible for Amazon Fire Tv Stick Remote Control [ 3rd Gen ](Not Compatible for Fire TV Edition Smart TV)...,Warehouse B,65,53,2025-02-07 08:52:00,12
25535,ORD_25536,3198,"Sounce Watch Case Compatible for Fire-Boltt Ninja 3 Tempered Glass Screen Protector,HD Clear Touch Sensitive Ultra Thin PE...",Warehouse C,31,24,2025-02-07 09:05:00,7
25536,ORD_25537,32563,Activ Beaute Brightening & Anti - Blemish Face Serum 25 ml,Warehouse C,80,72,2025-02-07 02:57:00,8
25537,ORD_25538,25238,Charcoal Face Mask,Warehouse B,35,26,2025-02-07 01:57:00,9
25538,ORD_25539,3204,Refin-DSR Capsule,Warehouse A,83,67,2025-02-07 01:54:00,16
25539,ORD_25540,17284,Histamat Atg Syrup,Warehouse C,37,30,2025-02-07 12:51:00,7
25540,ORD_25541,6586,Cello Deco Gel Pen | Gel Pens Blue | Jar of 25 Units | Gel Pens for Students | Pens for Office Use | Gel Pens for Writing...,Warehouse B,102,88,2025-02-07 22:56:00,14
25541,ORD_25542,31265,Reynolds SMOOTHMATE 10 CT BOX - BLUE I Lightweight Ball Pen With Comfortable Grip for Extra Smooth Writing I School and Of...,Warehouse B,114,95,2025-02-07 20:27:00,19
25542,ORD_25543,17295,Stbotanica Nutritivo Pomegranate Radiant Glow Firming Serum 30 ml,Warehouse A,98,82,2025-02-07 00:44:00,16
25543,ORD_25544,3218,GAH Empty Makeup Powder Foundation Case Air Cushion Puff BB Cream Container 15g Gold,Warehouse C,40,25,2025-02-07 14:54:00,15
25544,ORD_25545,3226,Oflo G 0.3% Eye Drop,Warehouse A,78,68,2025-02-07 07:02:00,10
25545,ORD_25546,19789,SYSKA 3 Way Spike and Surge Guard with USB,Warehouse C,71,59,2025-02-07 13:01:00,12
25546,ORD_25547,2574,"Ambrane 12W Fast Mobile Charger/Adapter, Multi-Layer Protection, Made in India, BIS Certified, Fast Charging Without Cable...",Warehouse A,70,61,2025-02-07 10:11:00,9
25547,ORD_25548,16497,Pierre Cardin Paris - Studio Nails 49,Warehouse B,21,13,2025-02-07 17:13:00,8
25548,ORD_25549,20268,"NoiseFit Force Rugged Round Dial Bluetooth Calling Smart Watch with 1.32"" HD Screen, Functional Crown, 550 NITS, 7 Days Ba...",Warehouse B,66,54,2025-02-07 02:09:00,12
25549,ORD_25550,9348,Fox 200mg Tablet,Warehouse A,75,62,2025-02-07 02:24:00,13
25550,ORD_25551,2473,Enzycare 5mg Tablet,Warehouse B,43,35,2025-02-07 10:45:00,8
25551,ORD_25552,27659,Vivo T1 44w Starry Sky (4+128GB),Warehouse B,94,80,2025-02-07 06:34:00,14
25552,ORD_25553,27669,SoniVision SA-D10 SA-D100 SA-D40 Home Theater Systems Remote Compatible with Sony RM-ANU156,Warehouse B,13,1,2025-02-07 17:31:00,12
25553,ORD_25554,16439,Face Cleanser,Warehouse A,46,39,2025-02-07 11:21:00,7
25554,ORD_25555,26697,RPM Euro Games 2.4 Ghz Rechargeable Wireless Gaming Mouse | 500 mAh Battery | Adjustable DPI Upto 2400 | 6 Color RGB Light...,Warehouse C,82,67,2025-02-07 22:08:00,15
25555,ORD_25556,19633,Sivanna Colors In The Peach Pro Cheek - HF6038 08 10 gm,Warehouse B,71,58,2025-02-07 08:33:00,13
25556,ORD_25557,2481,KINDED Loose Shimmer Makeup Foil Pigments Glitter Eyeshadow for Women Smokey Eyes Face Brow Bones Body Highlighter Metalli...,Warehouse C,64,56,2025-02-07 11:10:00,8
25557,ORD_25558,3379,MIkcin 100mg Injection,Warehouse B,95,85,2025-02-07 00:57:00,10
25558,ORD_25559,32737,Artis AR-MINIDC-3 Mini UPS for WiFi Router/Modem/Set top Box Devices. 8800mAh Battery. Supports 9V/12V-1A/1.5A/2A Routers....,Warehouse A,109,98,2025-02-07 09:23:00,11
25559,ORD_25560,27012,Lenol Eye Drop,Warehouse C,53,41,2025-02-07 18:27:00,12
25560,ORD_25561,9729,Halobex F Cream,Warehouse C,47,41,2025-02-07 17:04:00,6
25561,ORD_25562,6600,Linc Shine Glitter Pen Assorted Colours - Pack of 10,Warehouse A,54,35,2025-02-07 03:33:00,19
25562,ORD_25563,32554,"WZATCO Pixel | Portable LED Projector | Native 720p with Full HD 1080P Support | 2000 Lumens (200 ANSI) | 176"" Large Scree...",Warehouse A,80,66,2025-02-07 11:47:00,14
25563,ORD_25564,31512,Gemblue Biocare Oatmeal cream 500 ml,Warehouse C,83,66,2025-02-07 22:22:00,17
25564,ORD_25565,5758,"ForMen Hair Growth Oil 100% Natural with 22 Powerful Scalp Health And Hair Growth Ingredients 100ml | Onion Oil, Black See...",Warehouse C,21,15,2025-02-07 13:09:00,6
25565,ORD_25566,28175,Emeeflu 150mg Tablet,Warehouse C,73,61,2025-02-07 07:59:00,12
25566,ORD_25567,9354,Laformin GP 1mg Tablet,Warehouse A,53,35,2025-02-07 12:16:00,18
25567,ORD_25568,5568,Color Fever Eye Bomb Metallic Eye Pencil cum Eye Shadow Water Proof - Cool Purple 1.8 gm,Warehouse A,22,10,2025-02-07 19:49:00,12
25568,ORD_25569,31303,"Printme Silicone Protective Case Cover for Oneplus Buds Z2 TWS, Anti Fall Anti Dust, with Hook (2022) (Earbuds Not Include...",Warehouse A,86,67,2025-02-07 23:30:00,19
25569,ORD_25570,21368,"Fashion Colour Terra Cotta Blusher, Shade 09 16 gm",Warehouse B,71,55,2025-02-07 09:11:00,16
25570,ORD_25571,27574,ENVIE® (ECR11+AA2800 4PL) Speedster Rechargeable Batteries Charger for AA & AAA with 4x2800mah Batteries (with LCD Display),Warehouse A,55,42,2025-02-07 10:31:00,13
25571,ORD_25572,5756,Swarna Guggulu,Warehouse C,57,41,2025-02-07 12:55:00,16
25572,ORD_25573,3296,Robustrion Trifold Flip Stand Hard Back Case Cover for Redmi Pad 10.61 inch Tablet - Black,Warehouse C,18,9,2025-02-07 09:59:00,9
25573,ORD_25574,5591,SONATA GOLD Smart Band Wireless Sweatproof Fitness Band S6-6| Activity Tracker| Blood Pressure| Heart Rate Sensor | Step T...,Warehouse A,44,27,2025-02-07 18:25:00,17
25574,ORD_25575,16528,Betagel-G Cream,Warehouse C,48,42,2025-02-07 00:02:00,6
25575,ORD_25576,16538,Ajmal 2 Persuade And 1 Shadow Him Deodorants Pack of 3 200 ml,Warehouse A,29,18,2025-02-07 09:52:00,11
25576,ORD_25577,17351,"AMOSFIA 3 Style False Magnetic Eyelashes, (Pack of 1)",Warehouse B,17,7,2025-02-07 18:03:00,10
25577,ORD_25578,16499,Flormar Full Color Nail Enamel FC15 Awaken Your Senses 8 ml,Warehouse B,48,38,2025-02-07 07:13:00,10
25578,ORD_25579,20152,"Redgear Blaze Semi-Mechanical wired Gaming keyboard with 3 colour backlit, full aluminium body & Windows key lock for PC (...",Warehouse A,100,90,2025-02-07 15:25:00,10
25579,ORD_25580,3174,Vanace P 100mg/325mg Tablet,Warehouse A,92,84,2025-02-07 23:39:00,8
25580,ORD_25581,31286,Kaizol-DSR Capsule,Warehouse A,74,63,2025-02-07 06:53:00,11
25581,ORD_25582,20069,Aerocort 100mcg/50mcg Inhaler,Warehouse A,12,1,2025-02-07 23:01:00,11
25582,ORD_25583,31339,"Maybelline New York Super Stay 24H Full coverage Liquid Foundation,Warm Nude 128 30 gm",Warehouse A,36,31,2025-02-07 03:51:00,5
25583,ORD_25584,31486,Xynity 's Advanced HD+ Tempered Glass Screen Protector Designed for Google Pixel 6A - Edge to Edge Full Screen Coverage wi...,Warehouse B,29,16,2025-02-07 06:46:00,13
25584,ORD_25585,25194,Miss Rose 9 Color Matte & Glitter Mini Eyeshadow Palette 7001 - 122N 02 7.5 gm,Warehouse C,99,94,2025-02-07 14:06:00,5
25585,ORD_25586,3139,MOSHKING Back Cover for Samsung Galaxy A23 4G / 5G with Slide Camera | Heavy Duty Military Grade Protection Mobile Phone C...,Warehouse C,57,44,2025-02-07 22:54:00,13
25586,ORD_25587,11210,Airset-L Tablet,Warehouse B,27,8,2025-02-07 17:16:00,19
25587,ORD_25588,31569,"OPPO A31 (Mystery Black, 6GB RAM, 128GB Storage) with No Cost EMI/Additional Exchange Offers",Warehouse A,76,65,2025-02-07 15:11:00,11
25588,ORD_25589,17226,"LIRAMARK Type c Female to Micro USB Male Adapter, Converter USB C to Micro USB, Charger Connector Works with Smartphones, ...",Warehouse A,43,38,2025-02-07 14:31:00,5
25589,ORD_25590,3166,Robustrion Deer Pattern Flip Stand Case Cover for Lenovo Tab M10 HD 2nd Gen TB-X306X / Smart Tab M10 HD 2nd Gen TB-X306F -...,Warehouse A,99,85,2025-02-07 07:39:00,14
25590,ORD_25591,3173,WOW Skin Science Himalayan Rose Lip Scrub - Exfoliates/Smoothens Chapped & Cracked lips with 100% Natural Himalayan Pure R...,Warehouse C,71,54,2025-02-07 07:39:00,17
25591,ORD_25592,27487,Miniature Helichrysum & Sage Hand & Body Lotion,Warehouse C,6,1,2025-02-07 17:13:00,5
25592,ORD_25593,20379,Merigest 100mg Capsule,Warehouse B,89,81,2025-02-07 21:30:00,8
25593,ORD_25594,26681,Rofibax 50mg Tablet,Warehouse A,74,60,2025-02-07 21:22:00,14
25594,ORD_25595,9592,Revlon Nail Enamel - Matte Top Coat 8 Ml,Warehouse B,97,81,2025-02-07 09:05:00,16
25595,ORD_25596,31132,"BLAXSTOC (P11+Pyramid) Tabletop Mobile Stand for Table, Table Mobile Stand, Mobile Holder for Table, Stand for Mobile and ...",Warehouse C,109,92,2025-02-07 02:50:00,17
25596,ORD_25597,32694,Medicure CV 500mg/125mg Tablet,Warehouse C,31,21,2025-02-07 06:18:00,10
25597,ORD_25598,25325,Boujee Beauty Ultra Fine Liner Brush B112 135 gm,Warehouse B,89,82,2025-02-07 10:29:00,7
25598,ORD_25599,32629,"Cetaphil Brightening Night Comfort Cream - 50 g| For Dark Spots, Uneven Skin Tone| Hyaluronic Acid & Niacinamide| Fragranc...",Warehouse C,55,37,2025-02-07 18:36:00,18
25599,ORD_25600,19683,Wcs-LS Syrup,Warehouse A,69,57,2025-02-07 12:25:00,12
25600,ORD_25601,6534,"FACTOR NOTES Notebook: 90 GSM, B6, Ruled, 112 Pages Journal Diary (Sunshine Mixed with a Hurricane)",Warehouse C,57,41,2025-02-07 21:24:00,16
25601,ORD_25602,11066,Ajmal 2 Nightingale And 1 Wisal Dhahab Deodorants Pack of 3 200 ml,Warehouse B,97,79,2025-02-07 11:58:00,18
25602,ORD_25603,11059,black eyebrow Definer pencil with brush pack of 2,Warehouse C,8,1,2025-02-07 11:02:00,7
25603,ORD_25604,5774,Acugest 500 Injection,Warehouse C,111,95,2025-02-07 23:12:00,16
25604,ORD_25605,19673,Clobit MR 100mg/325mg/250mg Tablet,Warehouse C,35,17,2025-02-07 19:59:00,18
25605,ORD_25606,32652,Piogood-M Tablet,Warehouse A,70,65,2025-02-07 15:15:00,5
25606,ORD_25607,26704,"Head & Shoulders , Anti Dandruff Shampoo, Smooth & Silky, 72 ML",Warehouse A,14,1,2025-02-07 17:56:00,13
25607,ORD_25608,31171,Lifecort 6mg Tablet,Warehouse A,27,12,2025-02-07 09:59:00,15
25608,ORD_25609,31169,Flormar Jelly Look Nail Enamel JL27 Milky Pinky 11 ml,Warehouse B,42,36,2025-02-07 18:39:00,6
25609,ORD_25610,3378,"OLICOM M1 Smart Watch Id-116 Bluetooth Smartwatch Wireless Fitness Band for Boys, Girls, Men, Women & Kids | Sports Gym Wa...",Warehouse C,36,24,2025-02-07 05:00:00,12
25610,ORD_25611,21339,Disitch 5mg Tablet,Warehouse B,58,41,2025-02-07 07:13:00,17
25611,ORD_25612,9512,Ceptovir 800mg Tablet,Warehouse A,37,18,2025-02-07 00:42:00,19
25612,ORD_25613,9500,"Sery Colorflirt Nail Paint Soft Marshmello, Pink 10 ml",Warehouse A,65,56,2025-02-07 17:10:00,9
25613,ORD_25614,27239,Pazospas 10mg/250mg Tablet,Warehouse A,77,63,2025-02-07 12:34:00,14
25614,ORD_25615,5437,Pilocar 1% Eye Drop,Warehouse C,96,83,2025-02-07 07:00:00,13
25615,ORD_25616,27256,"TheGiftKart Shockproof Crystal Clear Back Cover Case for Nothing Phone 1 | 360 Degree Protection | Protective Design | PC,...",Warehouse A,90,75,2025-02-07 03:42:00,15
25616,ORD_25617,5436,Myglamm Wandurlust Matt Chrome Nail Paint Blue Lagoon 11 Ml,Warehouse A,81,63,2025-02-07 06:34:00,18
25617,ORD_25618,16724,Fenobax 200mg Tablet SR,Warehouse A,51,42,2025-02-07 08:51:00,9
25618,ORD_25619,20262,Blenior Waxing Paper 2m Roll 2 gm,Warehouse A,81,70,2025-02-07 07:33:00,11
25619,ORD_25620,24949,"Mizi [2 Pack] Metal Anti Dust Plug, Protect Charging Port from Dust and Moist with Storage Box and Cable Clip Holder for i...",Warehouse B,95,77,2025-02-07 22:33:00,18
25620,ORD_25621,25027,"SUGAR Cosmetics - Powder Play - Banana Compact - For Colour Correction or to Mask Shine - Oil-Controlling, Smooth Applicat...",Warehouse B,38,33,2025-02-07 00:14:00,5
25621,ORD_25622,11376,"Seagate One Touch 5TB External HDD with Password Protection – Black, for Windows and Mac, with 3 yr Data Recovery Service...",Warehouse B,8,2,2025-02-07 07:46:00,6
25622,ORD_25623,26833,Bioproxe 200mg Tablet,Warehouse C,30,15,2025-02-07 14:01:00,15
25623,ORD_25624,21536,ONUMTZ USB Fast Charger Magnetic Charging Cable Adapter for Fire-Boltt 360 SpO2 Smartwatch (Black),Warehouse C,12,6,2025-02-07 04:31:00,6
25624,ORD_25625,2894,FB 40 Tablet,Warehouse A,36,30,2025-02-07 03:54:00,6
25625,ORD_25626,31209,Nucort 5mg Tablet,Warehouse A,47,38,2025-02-07 20:44:00,9
25626,ORD_25627,17416,Zotipax 100mg Tablet,Warehouse C,101,82,2025-02-07 23:54:00,19
25627,ORD_25628,32699,Hand Wash White Tea & Ginger - Anti Bacterial,Warehouse A,102,94,2025-02-07 15:15:00,8
25628,ORD_25629,21289,Bio Quince Seed Nourishing & Face Massage Cream,Warehouse B,30,20,2025-02-07 03:44:00,10
25629,ORD_25630,17483,Taurlans 30mg Capsule,Warehouse B,110,97,2025-02-07 06:02:00,13
25630,ORD_25631,20185,Fashion Colour Water Based Moisturizer Primer 45 gm,Warehouse A,70,53,2025-02-07 09:06:00,17
25631,ORD_25632,32778,Acicrol-O Oral Suspension Sugar Free,Warehouse B,44,35,2025-02-07 13:10:00,9
25632,ORD_25633,26984,"Brillare Real Rose Face Wash For Hydrated, Younger Looking Skin 45 gm",Warehouse A,102,97,2025-02-07 17:29:00,5
25633,ORD_25634,25363,Youthrx Anti Ageing Firming Face Masque,Warehouse C,70,59,2025-02-07 16:51:00,11
25634,ORD_25635,31101,Zacin-XF 200mg/200mg Tablet,Warehouse C,54,45,2025-02-07 22:17:00,9
25635,ORD_25636,19555,"HP Pavilion 14, AMD Ryzen 5-5625U 8GB RAM/512GB SSD 14inches/35.6 cm FHD, IPS Micro-Edge Display/Radeon Graphics/Alexa/B&O...",Warehouse A,25,15,2025-02-07 17:20:00,10
25636,ORD_25637,3415,Acezen-P Tablet,Warehouse A,17,11,2025-02-07 05:53:00,6
25637,ORD_25638,19523,Age-Defying Hand Cream,Warehouse B,62,50,2025-02-07 20:34:00,12
25638,ORD_25639,17506,CoCo Face Scrub With Coffee & Cocoa For Rich Exfoliation,Warehouse A,103,93,2025-02-07 18:34:00,10
25639,ORD_25640,19515,Soft Touch Body Lotion,Warehouse C,102,84,2025-02-07 17:42:00,18
25640,ORD_25641,25342,Deltoid Lite Face Masks In Pink Knit Fabric With Binding - 1S1014-XL,Warehouse B,60,53,2025-02-07 06:05:00,7
25641,ORD_25642,3336,Maryaj Wild Stripes EDP Aromatic Oriental Perfume And Maryaj Wild Speed EDP Citrus Spicy Perfume 200 ml,Warehouse C,102,94,2025-02-07 22:53:00,8
25642,ORD_25643,24827,Mancode Beard Oil -Cedar Wood & Rose Mary 60 ml,Warehouse C,33,16,2025-02-07 19:59:00,17
25643,ORD_25644,5301,Cefscan-T 281.25mg Injection,Warehouse A,13,8,2025-02-07 08:29:00,5
25644,ORD_25645,25321,"Glamyou Bindi Daily Use Simple Forehead Bindi For Women Pack of 3 Boxes Red, Multi, Marron (Bindi Size : 2mm each)",Warehouse B,94,79,2025-02-07 11:51:00,15
25645,ORD_25646,16496,Razor - Sport 3 Triple Blade,Warehouse C,60,46,2025-02-07 08:13:00,14
25646,ORD_25647,3312,"Samsung T7 1TB Up to 1,050MB/s USB 3.2 Gen 2 (10Gbps, Type-C) External Solid State Drive (Portable SSD) Red (MU-PC1T0R)",Warehouse A,26,16,2025-02-07 10:59:00,10
25647,ORD_25648,32624,Wild Stone Stone Perfume Body Spray Pack of 2 (120 ml each),Warehouse A,34,17,2025-02-07 09:47:00,17
25648,ORD_25649,25301,"ZEBRONICS DC Joker Edition Sound Bomb 7 TWS Earbuds with 40H* Backup, Rapid Charge, 50ms Gaming Mode, ENC mic, Voice Assis...",Warehouse C,33,21,2025-02-07 05:51:00,12
25649,ORD_25650,26720,"Parachute Advansed Jasmine Gold Coconut Hair Oil with Vitamin E for Super Shiny Hair, Non-sticky, 300ml",Warehouse C,17,4,2025-02-07 12:16:00,13
25650,ORD_25651,26718,NMFe Moisturising Bar 75 gm,Warehouse B,100,82,2025-02-07 11:37:00,18
25651,ORD_25652,25311,"BenQ Gw2785Tc 27 Inch(68.58 Cm) 1920 X 1080 Pixels 1080P Fhd IPS Eye Care Monitor, USB Type-C with 60W Power Delivery & Da...",Warehouse B,80,63,2025-02-07 02:36:00,17
25652,ORD_25653,5609,"Zayn & Myza Transfer - Proof Power Matte Lip Color, Toasted Berry 6 ml",Warehouse B,40,25,2025-02-07 01:47:00,15
25653,ORD_25654,27639,"Covergirl Farewell Feathering Lip Liner, Clear, 0.04 Ounce",Warehouse A,17,8,2025-02-07 06:25:00,9
25654,ORD_25655,5771,"Poco F1 by Xiaomi (Rosso Red, 6GB RAM, SD 845, 128GB Storage)",Warehouse B,78,71,2025-02-07 09:34:00,7
25655,ORD_25656,29646,House of Beauty Hyaluronic Serum 30 ml,Warehouse A,93,80,2025-02-07 12:59:00,13
25656,ORD_25657,16710,"Gaiatop Mini Portable Fan, Powerful Hand Fan Cute Design 3 Speed Dual Motors Personal Small Desk Fan with Base, Lightweigh...",Warehouse A,79,74,2025-02-07 01:28:00,5
25657,ORD_25658,9998,"DigiTek (DWM-003) 2 Unit Wireless Microphone & 1 Unit Receiver with Type C, Compatible for Noise Cancellation Mic Suitable...",Warehouse C,32,13,2025-02-07 04:47:00,19
25658,ORD_25659,30700,BRUSTRO Artists Fineart Graphite Pencil Set of 12 (10B-2H) with Elegant Tin Box,Warehouse A,62,55,2025-02-07 18:10:00,7
25659,ORD_25660,10848,"Buds & Berries Anti-Frizz Shampoo with Apple Cider Vinegar and Goji Berry | Fight Frizz, 120 Hours of Conditioning | No Su...",Warehouse B,30,24,2025-02-07 15:55:00,6
25660,ORD_25661,25522,"GO SHOPS Watch Charger Compatible with Apple Watch Charger, Magnetic Charging Cable for iWatch Series 8/7/6/SE/5/4/3/2,Por...",Warehouse C,13,8,2025-02-07 12:48:00,5
25661,ORD_25662,30567,Onsitego 1 Year Extended Warranty for Non Robotic Vacuum Cleaners Up to Rs 5k (Email Delivery),Warehouse A,88,81,2025-02-07 23:14:00,7
25662,ORD_25663,30577,"Syoss - Oleo 21 Intense Care, 02 Conditioner",Warehouse C,31,13,2025-02-07 12:01:00,18
25663,ORD_25664,21146,"VCare Henna Natural Powder for Hair - 100 gm (Pack of 5) | Natural Conditioning & Anti-Dandruff | Control Hair Fall, Natur...",Warehouse C,48,34,2025-02-07 11:22:00,14
25664,ORD_25665,9848,Ekorab 20mg Injection,Warehouse C,42,31,2025-02-07 01:58:00,11
25665,ORD_25666,3672,Ole 5mg Tablet,Warehouse B,58,40,2025-02-07 13:49:00,18
25666,ORD_25667,6384,"coconut WM22 Gold Wireless Gaming Mouse, 500 mAh Rechargeable Battery with 7 Color RGB LED Lighting,7 Buttons with Fire Ke...",Warehouse C,90,75,2025-02-07 16:15:00,15
25667,ORD_25668,30604,"AlexVyan TV Wall Mount Stand 32 to 55"" (32 40 42 46 52 55 inch) LCD Plasma LED Bracket for TV of Sony LG Samsung Micromax ...",Warehouse B,16,2,2025-02-07 06:32:00,14
25668,ORD_25669,5093,"Pavanhara Vati - Gas Reliever, 500 mg",Warehouse A,79,74,2025-02-07 14:23:00,5
25669,ORD_25670,30613,"Fashion Colour Proffessional Makeup Kit, Fc2821a - 03 209.3 gm",Warehouse B,53,40,2025-02-07 05:10:00,13
25670,ORD_25671,30652,"Fashion Colour German Eyeshadow, 01 Crystal Light 1.4 gm",Warehouse B,99,80,2025-02-07 15:01:00,19
25671,ORD_25672,30660,Aloe Honey Gel - Soothing & Moisturizing,Warehouse C,75,60,2025-02-07 01:10:00,15
25672,ORD_25673,30665,"Face Pack - Bio Fruit Spot Lightening, Bxl Cellular",Warehouse B,46,34,2025-02-07 13:35:00,12
25673,ORD_25674,3635,Fogg Status 1000 Sprays 150 Ml,Warehouse A,48,33,2025-02-07 21:49:00,15
25674,ORD_25675,27850,SLOVIC® Tripod Mount Adapter| Tripod Mobile Holder|Tripod Phone Mount(Made in India)| Smartphone Clip Clipper 360 Degree f...,Warehouse C,88,83,2025-02-07 21:31:00,5
25675,ORD_25676,30557,TWIREY Face Cleansing Sponge Puff Makeup Washing Pad Deep Cleansing & Exfoliating Facial Sponge - Assorted Color Pack of,Warehouse C,91,74,2025-02-07 14:04:00,17
25676,ORD_25677,19508,"Hair Conditioner - No More Tangles, Silicone/Paraben free",Warehouse C,67,58,2025-02-07 19:22:00,9
25677,ORD_25678,26633,"oraimo 65W Type C to C Fast Charging Cable USB C to USB C Cable High Speed Syncing, Nylon Braided 1M length with LED Indic...",Warehouse A,113,94,2025-02-07 09:58:00,19
25678,ORD_25679,3470,"Kanget [2 Pack] Type C Female to USB A Male Charger | Charging Cable Adapter Converter compatible for iPhone 14, 13, 12,11...",Warehouse A,43,27,2025-02-07 01:14:00,16
25679,ORD_25680,30976,"Turron Both sides Ruled Index Flash Cards Tray - 200 GSM, 150 Cards, 3x5 inch, White - with Free Binder Rings for Short No...",Warehouse B,17,10,2025-02-07 12:48:00,7
25680,ORD_25681,17541,Daily Life Forever52 Glitz Waterproof Eyeliner Eyeshadow Glt003 0.6 gm,Warehouse C,81,73,2025-02-07 20:26:00,8
25681,ORD_25682,26640,CEDO OnePlus Nord CE 2 Lite Case Back Cover Shockproof Bumper Crystal Clear | 360 Degree Protection TPU+PC | Camera Protec...,Warehouse A,51,44,2025-02-07 15:41:00,7
25682,ORD_25683,8842,Ajmal Khallab EDP Woody Oudh Perfume 50ml for Unisex and Blu Femme EDP Floral Woody Perfume 50ml for Women +1 Perfume Test...,Warehouse C,50,38,2025-02-07 23:49:00,12
25683,ORD_25684,9785,"Dyazo Height and Angle Adjustable Tripod Stand Holder for Mobile Phones & Camera, Aluminum Travel Tripod for Smart Phones/...",Warehouse C,40,21,2025-02-07 06:19:00,19
25684,ORD_25685,21165,Ctrate 20mg Soft Gelatin Capsule,Warehouse A,104,85,2025-02-07 08:03:00,19
25685,ORD_25686,25478,SINLOE 2 MP Day/Night Color Vision 1080p Full HD Wired Bullet CCTV Camera Compatible for All 2MP Supporting DVRs (Pack of ...,Warehouse A,59,52,2025-02-07 03:47:00,7
25686,ORD_25687,19461,Faces Canada Ultime Pro Hd Lights.Camera.Blush Blossom 01 6.5 Gm,Warehouse C,45,39,2025-02-07 16:40:00,6
25687,ORD_25688,27776,Flormar Matte Nail Enamel M25 Grapefruit 11 ml,Warehouse B,94,76,2025-02-07 12:04:00,18
25688,ORD_25689,20612,Zeena 750mg Tablet,Warehouse A,16,10,2025-02-07 17:15:00,6
25689,ORD_25690,29062,Glupred 4mg Tablet,Warehouse B,65,46,2025-02-07 04:22:00,19
25690,ORD_25691,19048,VLCC Turmeric & Berberis Face Wash + Anti Tan Skin Lightening Face Wash (Buy 1 Get 1 Free),Warehouse A,45,37,2025-02-07 01:42:00,8
25691,ORD_25692,28500,"ASUS VivoBook 15 (2021), 15.6-inch (39.62 cm) HD, Dual Core Intel Celeron N4020, Thin and Light Laptop (4GB RAM/256GB SSD/...",Warehouse B,23,12,2025-02-07 22:56:00,11
25692,ORD_25693,4482,St.Botanica Shampoo - GO Curls 200 ml,Warehouse B,63,49,2025-02-07 03:04:00,14
25693,ORD_25694,9124,HP 803 Tri-Color Original Ink Cartridge,Warehouse A,28,11,2025-02-07 01:52:00,17
25694,ORD_25695,29117,"ESR Pencil Case Compatible with iPad Pro 12.9 Inch (2022/2021, 6th/5th Gen), Built-in Pencil Holder, Pencil 2 Support, Fle...",Warehouse C,60,49,2025-02-07 06:17:00,11
25695,ORD_25696,4436,DavaIndia Itraconazole 100mg Capsule,Warehouse C,85,72,2025-02-07 04:03:00,13
25696,ORD_25697,4426,Amoxyron 250mg Tablet,Warehouse B,22,5,2025-02-07 01:52:00,17
25697,ORD_25698,29172,Cefy KID 100mg Tablet,Warehouse B,90,80,2025-02-07 06:38:00,10
25698,ORD_25699,8994,SanDisk iXpand Flash Drive Flip USB 3.2 Gen 1 256GB for iOS and Windows,Warehouse A,58,41,2025-02-07 17:17:00,17
25699,ORD_25700,26476,(Renewed) CP Plus 1080P Full HD Smart WiFi Camera |360° with Pan & Tilt | View and Talk | Motion Alert | Night Vision |SD ...,Warehouse C,100,94,2025-02-07 05:23:00,6
25700,ORD_25701,9830,Belkin Privacy Tempered Glass for iPhone 12/12 Pro Screen Protector with Easy Application Tray,Warehouse A,56,44,2025-02-07 22:36:00,12
25701,ORD_25702,10876,Clospeed Cream,Warehouse A,76,69,2025-02-07 02:49:00,7
25702,ORD_25703,10859,"Maybelline New York Super Stay 24H Full coverage Liquid Foundation,Golden 312 30 gm",Warehouse B,88,74,2025-02-07 11:47:00,14
25703,ORD_25704,21166,"ZEBRONICS Zeb-Thunder Wireless Bluetooth Over The Ear Headphone FM, mSD, 9 hrs Playback with Mic (Brown)",Warehouse B,96,90,2025-02-07 06:31:00,6
25704,ORD_25705,5116,St.Botanica Body Wash - Jasmine Saffron & Rice 250 ml,Warehouse B,13,2,2025-02-07 16:15:00,11
25705,ORD_25706,17748,Lakeer Self Adhesive Sticky A4 Size Glitter Sparkles Foam Sheet with Sticky Back Pack of 10 Sheets (10 Colours x 1 Pcs Each),Warehouse C,57,48,2025-02-07 17:58:00,9
25706,ORD_25707,10865,"Dettol Original Germ Protection Alcohol Based Hand Sanitizer, 50ml",Warehouse C,45,37,2025-02-07 20:21:00,8
25707,ORD_25708,10866,Voorkoms Temporary Tattoo Waterproof For Girls Men Women Beautiful & Popular Water Transfer 3D Color Name A to Z Alphabet ...,Warehouse C,23,10,2025-02-07 04:47:00,13
25708,ORD_25709,26596,LC-Sure 5mg Tablet,Warehouse B,40,21,2025-02-07 03:44:00,19
25709,ORD_25710,3567,"Spigen USB 4 Cable for Thunderbolt 4 Cable, 100W Charging 40Gbps Data Transfer 8K Video Type C for Thunderbolt 4 3 Macbook...",Warehouse C,89,73,2025-02-07 16:34:00,16
25710,ORD_25711,5127,"Faber-Castell Erasable Plastic Crayon Set - 70mm, Pack of 15 (Assorted)",Warehouse B,25,8,2025-02-07 09:47:00,17
25711,ORD_25712,19460,& Moms - Citrus Soap,Warehouse A,83,69,2025-02-07 07:52:00,14
25712,ORD_25713,21183,Maryaj Pebble Style EDP Spicy Woody Perfume And Ajmal Blu Homme Deodorant Aquatic Woody Fragrance 300 ml,Warehouse C,58,45,2025-02-07 12:50:00,13
25713,ORD_25714,6481,Acemed Plus 100mg/500mg Tablet,Warehouse C,45,31,2025-02-07 04:24:00,14
25714,ORD_25715,8839,"Admiz Cleaner Fluid Gel LCD Cleaning Kit, Liquid Solution with Cloth to Clean Mobile/Laptop Screen Pack of 3",Warehouse C,45,30,2025-02-07 18:50:00,15
25715,ORD_25716,4511,Ajmal Majmua And Jannatul Firdaus & Aretha EDP Pack of 3 20 ml,Warehouse C,109,95,2025-02-07 04:17:00,14
25716,ORD_25717,26651,Ajmal Blu & Aurum & Sacred Love & Silver Shade Deo & Neea EDP Pack of 4 20 ml,Warehouse A,88,83,2025-02-07 17:01:00,5
25717,ORD_25718,4982,"Samsung Galaxy M53 5G (Mystique Green, 6GB, 128GB Storage) | 108MP | sAmoled+ 120Hz | 12GB RAM with RAM Plus | Travel Adap...",Warehouse A,58,50,2025-02-07 00:47:00,8
25718,ORD_25719,19321,Spigen Ultra Hybrid Back Cover Case Compatible with Samsung Galaxy S20 FE 5G (TPU + PC | Crystal Clear),Warehouse B,94,80,2025-02-07 01:05:00,14
25719,ORD_25720,26527,LAPSTER Spiral Charger Spiral Charger Cable Protectors for Wires Data Cable Saver Charging Cord Protective Cable Cover Set...,Warehouse C,57,40,2025-02-07 23:26:00,17
25720,ORD_25721,8957,Shizole 20 Capsule,Warehouse B,32,22,2025-02-07 02:30:00,10
25721,ORD_25722,9894,Beauty People Velvet Matte Nail Polish Matte - Me - Moody - 1006 9.9 ml,Warehouse A,100,94,2025-02-07 03:10:00,6
25722,ORD_25723,21016,Lopez 2mg Injection,Warehouse C,99,83,2025-02-07 22:49:00,16
25723,ORD_25724,30142,"POCO X4 Pro 5G (Laser Blue, 6GB RAM 128GB Storage)",Warehouse B,46,35,2025-02-07 12:37:00,11
25724,ORD_25725,21023,Fitgut 1mg Tablet,Warehouse A,87,75,2025-02-07 21:19:00,12
25725,ORD_25726,25755,"ZOBRAS FIREBOLT Usb Cable, Watch Charger Magnetic 4 Pin, For Gionee gsw8, Firebolt Invincible, Firebolt Visionary Watch Ch...",Warehouse B,19,2,2025-02-07 15:09:00,17
25726,ORD_25727,21037,Maryaj Ramona EDP Citrus Floral Perfume And Ajmal Wisal Deodorant Floral Musky Fragrance 300 ml,Warehouse A,20,1,2025-02-07 13:24:00,19
25727,ORD_25728,3891,Panrio 40 Injection,Warehouse B,51,42,2025-02-07 07:00:00,9
25728,ORD_25729,30127,Lakme 9 To 5 Weightless Mousse Foundation Beige Caramel 25 Gm,Warehouse A,43,31,2025-02-07 16:32:00,12
25729,ORD_25730,26504,Hiodic Plus Tablet,Warehouse B,56,42,2025-02-07 15:01:00,14
25730,ORD_25731,30120,Aricep-M  Forte Tablet,Warehouse A,45,30,2025-02-07 00:12:00,15
25731,ORD_25732,25786,Argan Oil,Warehouse C,89,72,2025-02-07 01:02:00,17
25732,ORD_25733,3968,Mirabelle Korea Neem Essential Facial Sheet Mask 25 Ml,Warehouse B,86,79,2025-02-07 10:30:00,7
25733,ORD_25734,20546,Tooth Brush - Sensitive Whitening Value Pack,Warehouse A,67,54,2025-02-07 21:28:00,13
25734,ORD_25735,19276,Paracetapro 650mg Tablet,Warehouse C,100,95,2025-02-07 20:50:00,5
25735,ORD_25736,5899,"ProElite Smart Flip Case Cover for Apple iPad 10.2"" 9th Gen (2021) / 8th Gen / 7th Gen with Stylus Pen, Dark Green",Warehouse C,102,84,2025-02-07 00:46:00,18
25736,ORD_25737,25815,Trival 200mg Tablet CR,Warehouse C,43,33,2025-02-07 09:00:00,10
25737,ORD_25738,3952,OpenTech® Military-Grade Tempered Glass Screen Protector Compatible for iPhone 13/13 Pro / 14 with Edge to Edge Coverage a...,Warehouse B,30,13,2025-02-07 01:01:00,17
25738,ORD_25739,9252,"Fashion Colour Kiss Lip No Transfer Lipstick, 10 Blood 2.6 gm",Warehouse C,96,86,2025-02-07 17:27:00,10
25739,ORD_25740,10595,Golden Wolf Laptop Bag Anti-theft Backpack with Lock College School Laptop Backpack with Rain Cover Water Resistant Busine...,Warehouse C,28,12,2025-02-07 05:59:00,16
25740,ORD_25741,30045,Pain Releaver - White,Warehouse B,22,5,2025-02-07 11:44:00,17
25741,ORD_25742,20541,Makeup Revolution Glam Balm So Berry 15 ml,Warehouse A,67,58,2025-02-07 00:14:00,9
25742,ORD_25743,30060,Rebotin 4mg Tablet,Warehouse B,97,86,2025-02-07 08:14:00,11
25743,ORD_25744,3943,"inari 95W GaN PD 3.0 Fast charger with PPS technology,Dual USB-C+USB-A supervook,charge 3 devices at a time,Fast charge Ma...",Warehouse C,88,76,2025-02-07 07:02:00,12
25744,ORD_25745,29601,Azearly 40 Tablet,Warehouse A,59,40,2025-02-07 12:02:00,19
25745,ORD_25746,6278,Vedanantaka Balm - Pain Relief,Warehouse A,47,33,2025-02-07 06:51:00,14
25746,ORD_25747,10615,Stbotanica Go Long Onion Hair Conditioner + Shampoo + Go Long Onion Hair Oil With Comb Applicator 550 ml,Warehouse C,62,47,2025-02-07 07:00:00,15
25747,ORD_25748,20537,Rejuvenating UBTAN Essential Oil - Lime 10 ml,Warehouse B,81,74,2025-02-07 07:52:00,7
25748,ORD_25749,18158,Ocean Professional Lip Liner,Warehouse C,59,49,2025-02-07 02:56:00,10
25749,ORD_25750,17648,Aloe & Cucumber Refreshing Body Lotion,Warehouse A,67,57,2025-02-07 08:54:00,10
25750,ORD_25751,3440,Belora Paris Leave No Evidence Liquid Matte Lipstick Brown Or Red 4.5 gm,Warehouse C,54,40,2025-02-07 04:58:00,14
25751,ORD_25752,5196,Lavender Essential Oil - 100% Pure & Natural,Warehouse A,32,27,2025-02-07 04:40:00,5
25752,ORD_25753,25381,Rolod K 50mg Tablet,Warehouse C,12,7,2025-02-07 12:18:00,5
25753,ORD_25754,30942,POPIO Screen Protector Tempered Glass Compatible for Samsung Galaxy M51 / A71 / Note 10 Lite (Transparent) Full Screen Cov...,Warehouse B,72,65,2025-02-07 03:35:00,7
25754,ORD_25755,10938,Sunscreen SPF 30,Warehouse C,83,66,2025-02-07 18:51:00,17
25755,ORD_25756,5180,Zicet L 5mg Tablet,Warehouse A,70,62,2025-02-07 09:41:00,8
25756,ORD_25757,25474,Mesulid 100mg Tablet,Warehouse B,104,98,2025-02-07 02:11:00,6
25757,ORD_25758,17673,Morezole 400mg Tablet,Warehouse A,62,49,2025-02-07 09:24:00,13
25758,ORD_25759,17666,INDRICO Extension Board Heavy Duty 1 Socket 15A 16A 20A High Load Capacity 3000 Watts with 16A Big Plug PVC White (2 Meter),Warehouse B,52,44,2025-02-07 10:38:00,8
25759,ORD_25760,4702,Prodept 200 Tablet DT,Warehouse C,77,66,2025-02-07 13:48:00,11
25760,ORD_25761,30811,Zerfa 5 in 1 Soft Brush Multi-Function Cleaning Tools Kit for Keyboard & Earphone Cleaner Soft High-Density Brush Set with...,Warehouse A,104,86,2025-02-07 04:42:00,18
25761,ORD_25762,6444,Faber-Castell Whiteboard Bold Marker - Pack of 4 (Assorted),Warehouse C,32,18,2025-02-07 13:50:00,14
25762,ORD_25763,3922,Met XL 100 Tablet,Warehouse C,66,52,2025-02-07 13:23:00,14
25763,ORD_25764,21208,"pTron Tangent Urban with 60Hrs Playtime, ENC Wireless Bluetooth 5.3 Headphones, Low Latency Gaming, Punchy Bass, in-Ear Wi...",Warehouse C,67,57,2025-02-07 12:54:00,10
25764,ORD_25765,8868,Aloe Relaxing Emulsion,Warehouse B,21,11,2025-02-07 20:04:00,10
25765,ORD_25766,17633,Gliminn M Forte 2mg/1000mg Tablet,Warehouse B,74,58,2025-02-07 16:12:00,16
25766,ORD_25767,3521,Kama Sutra Spark Power Series Fragrance Body Spray 135ml,Warehouse C,54,47,2025-02-07 07:31:00,7
25767,ORD_25768,21223,"RAS Luxury Oils 24K Gold Radiance Beauty Boosting Face Elixir Serum | Glow With Vitamin C | Helps Brighten Skin, Reduces W...",Warehouse B,91,82,2025-02-07 14:36:00,9
25768,ORD_25769,30861,Gynae Pil 500mg Tablet,Warehouse C,14,6,2025-02-07 03:05:00,8
25769,ORD_25770,27821,Danemox Dry Syrup,Warehouse B,107,95,2025-02-07 23:20:00,12
25770,ORD_25771,17836,"O3+ Bright under Eye Circle Cream - Brightening & Whitening for Dark Circles, Fine lines & Puffy Bags",Warehouse B,89,73,2025-02-07 14:38:00,16
25771,ORD_25772,27968,Essential Souls Foaming Facewash - Matcha 150 ml,Warehouse C,50,42,2025-02-07 21:54:00,8
25772,ORD_25773,30009,Primecobal 500mcg Injection,Warehouse A,31,14,2025-02-07 04:07:00,17
25773,ORD_25774,21008,Lyrolin Tablet,Warehouse C,37,26,2025-02-07 02:01:00,11
25774,ORD_25775,21006,"Honeywell Zest Sonic 5-Way Multi Headphone Earphone Audio Splitter Aux Adapter, 3.5 mm, 1 Male – 5 Female Port",Warehouse A,85,78,2025-02-07 22:22:00,7
25775,ORD_25776,10244,Serrahex AP 100mg/325mg/15mg Tablet,Warehouse B,72,55,2025-02-07 17:25:00,17
25776,ORD_25777,3558,"Samsung Galaxy M53 5G (Emerald Brown, 6GB, 128GB Storage) | 108MP | sAmoled+ 120Hz | 12GB RAM with RAM Plus | Travel Adapt...",Warehouse C,94,77,2025-02-07 00:12:00,17
25777,ORD_25778,20935,Mucifi 100mg Capsule,Warehouse C,34,25,2025-02-07 08:32:00,9
25778,ORD_25779,10361,"Mamaearth Bye Bye Acne Face Cream Face Moisturizer For Acne Prone Skin, with Willow Bark Extract & Salicylic Acid For Clea...",Warehouse A,50,38,2025-02-07 20:38:00,12
25779,ORD_25780,18250,"SeCro Plastic Film Universal Travel Adapter with Built in Dual USB Charger Ports with 125V 6A, 250V Surge/Spike Protected ...",Warehouse A,54,39,2025-02-07 05:11:00,15
25780,ORD_25781,20560,Miss Rose Waterproof Long Lasting Glitter Glue 1 Piece (25ml),Warehouse B,101,94,2025-02-07 00:28:00,7
25781,ORD_25782,4913,"Fashion Colour Cc Cream, Shade 01 35 gm",Warehouse A,26,19,2025-02-07 16:42:00,7
25782,ORD_25783,4173,Ajmal Desert Rose EDP Floral Oriental Perfume And Carbon Homme Deodorant Citrus Spicy Fragrance 300 ml,Warehouse C,57,49,2025-02-07 22:53:00,8
25783,ORD_25784,28277,"Iba Perfect Look BB Cream With 24 Karat Gold, 30g (Medium Shade) l Even Coverage l Fades Dark Spots & Blemishes l Vegan & ...",Warehouse C,63,54,2025-02-07 23:54:00,9
25784,ORD_25785,4013,Neem & Lemon Bathing Soap,Warehouse B,86,79,2025-02-07 12:00:00,7
25785,ORD_25786,4003,"Myvn Dash Cable/Warp Usb Type C Charging Charger Data Sync Fast Charging Cable Compatible For Oneplus 8, 8 Pro, 7, 7T, 6T,...",Warehouse C,72,65,2025-02-07 06:13:00,7
25786,ORD_25787,29976,Hensal 500mg/500mg Injection,Warehouse C,33,14,2025-02-07 21:00:00,19
25787,ORD_25788,20554,Flexiflam 100 mg/325 mg Tablet,Warehouse A,42,30,2025-02-07 18:54:00,12
25788,ORD_25789,18211,worison Crystal Glass Dip Pen With 12 Colors,Warehouse A,72,61,2025-02-07 06:47:00,11
25789,ORD_25790,3982,Cotsul 12.5mg Injection,Warehouse B,67,56,2025-02-07 21:53:00,11
25790,ORD_25791,18285,Lavender French Essentail Oil - 100% Pure & Natural,Warehouse B,77,71,2025-02-07 15:06:00,6
25791,ORD_25792,4073,CASEOLOGY by Spigen Nano Pop Thermoplastic Polyurethane and PC Back Cover Compatible for Samsung Galaxy S21 FE 5G ( Light ...,Warehouse C,107,90,2025-02-07 04:15:00,17
25792,ORD_25793,29817,"Wings Phantom Pro Earphones Gaming Earbuds with LED Battery Indicator, 50ms Low Latency, Bluetooth 5.3, 40 Hours Playtime,...",Warehouse B,89,84,2025-02-07 18:53:00,5
25793,ORD_25794,18326,AEIDESS Tempered Glass Screen Guard Compatible for Samsung Galaxy S23 Ultra with Edge to Edge Full Screen Coverage With In...,Warehouse A,100,87,2025-02-07 13:24:00,13
25794,ORD_25795,6203,"Ikoo Infusions - Thermal Treatment Wrap, Hydrate & Shine (Single Sachet) 35 gm",Warehouse B,38,28,2025-02-07 18:12:00,10
25795,ORD_25796,20869,Setalin 50mg Tablet,Warehouse A,38,24,2025-02-07 06:33:00,14
25796,ORD_25797,4142,Koinstec My Angel Always with Me Tattoo Waterproof Sticker Temporary Body Tattoo,Warehouse A,94,84,2025-02-07 14:50:00,10
25797,ORD_25798,29721,Cameleon 5d Wet Eyeshadow in Tan Gold,Warehouse B,75,61,2025-02-07 21:16:00,14
25798,ORD_25799,4134,Miss Rose 2 In 1 Creamy Matte Lipstick Passion 7102 - 001M 35 2.1 gm,Warehouse A,16,9,2025-02-07 21:39:00,7
25799,ORD_25800,28318,GEOCARTER Multi-Purpose Wall mount Mobile holder | Mobile Phone Charging Stand | Self Adhesive Universal Smartphone AC TV ...,Warehouse B,81,64,2025-02-07 20:08:00,17
25800,ORD_25801,29745,L.A Girl HD PRO Conceal Toffee 8 gm,Warehouse A,54,45,2025-02-07 14:31:00,9
25801,ORD_25802,18355,Oripod-CV Tablet,Warehouse A,110,99,2025-02-07 09:02:00,11
25802,ORD_25803,18353,Paragesic 100mg/125mg Syrup,Warehouse B,27,12,2025-02-07 20:56:00,15
25803,ORD_25804,29755,Vero Forza Glide V2 (4 Pieces) | Mobile Gaming Sleeve | VFiber 2.0 Technology,Warehouse A,80,65,2025-02-07 08:46:00,15
25804,ORD_25805,29777,Power - Fresh Breath Fluoride Toothpaste 100 g + Sensitive Toothpaste 80 g,Warehouse B,57,52,2025-02-07 10:51:00,5
25805,ORD_25806,26423,BROTHER TN-2365 Original Toner (Mono/Black),Warehouse A,60,51,2025-02-07 04:02:00,9
25806,ORD_25807,29792,NAGARAKU Colored Eyelash Extensions 8 Colors Rainbow 0.12mm C curl 10mm Purple Blue Pink Brown Individual Lashes Soft Natu...,Warehouse B,64,45,2025-02-07 04:13:00,19
25807,ORD_25808,26431,Emeeola H 12.5mg/20mg Tablet,Warehouse B,76,57,2025-02-07 08:26:00,19
25808,ORD_25809,25870,"Makeup Sponge Beauty Facial Kit Makeup Sponge Round Face Powder Pad Blending Sponge Puff, Cotton Makeup Puff with Strap fo...",Warehouse C,10,2,2025-02-07 01:35:00,8
25809,ORD_25810,18280,Copetab 10mg Tablet,Warehouse A,108,98,2025-02-07 03:49:00,10
25810,ORD_25811,20799,"Artis MS301 Wireless Bluetooth Portable Party Speaker with RGB Glow Lights, Wired Mic, Remote Control, FM Radio & Aux in/U...",Warehouse B,27,20,2025-02-07 23:24:00,7
25811,ORD_25812,29611,FosCadit Dummy Fake Bullet Camera with Flashing Red LED Light Dummy CCTV Security Camera for Home & Office (Pack of 1 Pcs),Warehouse C,57,48,2025-02-07 09:40:00,9
25812,ORD_25813,4194,Rekool 40 Tablet,Warehouse B,64,53,2025-02-07 08:37:00,11
25813,ORD_25814,18732,"Maliao Sheer Shimmer Liquid Foundation Spf 20, 40 ml",Warehouse C,83,74,2025-02-07 11:47:00,9
25814,ORD_25815,25924,"(Renewed) Dell Latitude Laptop E7470 Intel Core I5 - 6300U Processor, 16 Gb Ram & 256 Gb Ssd, 14.1 Inches Screen Windows 1...",Warehouse B,36,21,2025-02-07 21:21:00,15
25815,ORD_25816,28423,Senic 50mg/10mg Tablet,Warehouse B,44,36,2025-02-07 09:45:00,8
25816,ORD_25817,20834,Hand & Cuticle Moisturiser,Warehouse C,79,63,2025-02-07 09:08:00,16
25817,ORD_25818,26378,Zimat Syrup,Warehouse C,31,18,2025-02-07 18:43:00,13
25818,ORD_25819,25989,Walnut & Orange Face & Body Scrub,Warehouse C,67,49,2025-02-07 07:49:00,18
25819,ORD_25820,6141,English Rose - Eau De Toilette For Women,Warehouse A,68,63,2025-02-07 06:11:00,5
25820,ORD_25821,4303,DeBelle Gel Nail Lacquer Peppermint Pudding Mint Green Nail Polish 8 ml,Warehouse A,42,28,2025-02-07 21:31:00,14
25821,ORD_25822,4299,Miss Rose Matte Finish Bullet Lipstick Shade 51 Monica 7301 - 026B 51 3.4 gm,Warehouse B,76,60,2025-02-07 12:28:00,16
25822,ORD_25823,29402,Trustyl X Syrup,Warehouse C,73,54,2025-02-07 04:12:00,19
25823,ORD_25824,29403,Schwarzkopf Gliss Hair Repair Conditioner Serum Deep Repair 400 ml,Warehouse C,15,6,2025-02-07 00:25:00,9
25824,ORD_25825,28295,Maryaj Tuxedo EDP Spicy Woody Perfume And Ajmal Sacrifice II For Him Deodorant Fruity Aromatic Fragrance 300 ml,Warehouse B,56,44,2025-02-07 11:19:00,12
25825,ORD_25826,26014,Clobkare-Mx Ointment,Warehouse A,76,63,2025-02-07 13:41:00,13
25826,ORD_25827,29405,A Flox OZ Suspension,Warehouse B,97,89,2025-02-07 22:08:00,8
25827,ORD_25828,18502,"rts (2 PACK )USB Type C USB 3.1 Type C Female to USB Male Adapter Connector Converter Works with Laptops,Chargers Compatib...",Warehouse C,108,94,2025-02-07 07:02:00,14
25828,ORD_25829,18491,Rimcet A 5mg/60mg Tablet,Warehouse A,107,97,2025-02-07 05:10:00,10
25829,ORD_25830,29433,"HAMMONDS FLYCATCHER Genuine Leather Laptop Bag for Men/Office Bag for Men, Brushwood | Fits Upto 16 Inch Laptop/MacBook | ...",Warehouse B,35,22,2025-02-07 17:29:00,13
25830,ORD_25831,4277,"VBA Eyebrow Pencil With Eyebrow Comb Waterproof Eyebrow Pencil,Long-lasting Sweat-proof Eyeliner Makeup EyeBrow Tint Pen (...",Warehouse B,99,80,2025-02-07 00:54:00,19
25831,ORD_25832,18474,"Yaanman Makeup Base Highlighting Primer for Face | Navigator Base With Goodness of Hemp Oil | Face Makeup | Clean, Natura...",Warehouse A,51,33,2025-02-07 19:09:00,18
25832,ORD_25833,20814,"Oxlaw USB C Female to USB Type A Male Adapter,Compatible with Apple MagSafe Watch to USB Wall Plug,Type-C to A Charger Cab...",Warehouse C,53,45,2025-02-07 16:18:00,8
25833,ORD_25834,26004,RIMARK-AM 5MG/2.5MG TABLET,Warehouse A,96,84,2025-02-07 23:04:00,12
25834,ORD_25835,28359,Zigarab D Capsule,Warehouse C,36,21,2025-02-07 19:11:00,15
25835,ORD_25836,29661,Nimble 100mg Tablet MD,Warehouse B,108,89,2025-02-07 18:08:00,19
25836,ORD_25837,29927,Beauty People Pout - Me - Matte Lipstick - Sfire - Red - 1001 3.8 gm,Warehouse A,15,6,2025-02-07 00:48:00,9
25837,ORD_25838,10368,Argical HD Tablet,Warehouse C,22,8,2025-02-07 19:37:00,14
25838,ORD_25839,4155,Gavinor-M 2 Tablet,Warehouse C,10,5,2025-02-07 15:18:00,5
25839,ORD_25840,18596,Reldic Fast 75mg Injection,Warehouse C,36,17,2025-02-07 01:38:00,19
25840,ORD_25841,18896,Cut Cold Syrup,Warehouse B,113,97,2025-02-07 05:46:00,16
25841,ORD_25842,18881,Pip 40 Injection,Warehouse C,78,60,2025-02-07 08:20:00,18
25842,ORD_25843,28717,"Fashion Colour Face & Body Hi - Lite Bronzer, Shade 03 4 gm",Warehouse B,21,3,2025-02-07 06:11:00,18
25843,ORD_25844,28721,Gemblue Biocare Shea Butter Skin Body cream 500 ml,Warehouse A,83,69,2025-02-07 22:22:00,14
25844,ORD_25845,26230,"HAMMER KO Pro Bluetooth Earbuds with Upto 20H Playtime, ENC, Fast Charging Type-C, IPX4 Water Resistant, Bluetooth v5.3, T...",Warehouse A,80,70,2025-02-07 05:57:00,10
25845,ORD_25846,20715,Diclotech MR Tablet,Warehouse A,100,84,2025-02-07 12:57:00,16
25846,ORD_25847,26329,Blumef Spas 10mg/250mg Tablet,Warehouse A,66,58,2025-02-07 09:50:00,8
25847,ORD_25848,28439,Eurocold Syrup,Warehouse B,46,39,2025-02-07 09:35:00,7
25848,ORD_25849,5968,Azitl 250 Tablet,Warehouse A,76,59,2025-02-07 09:05:00,17
25849,ORD_25850,4405,"Moroccanoil Mending Infusion, 75ml",Warehouse C,100,89,2025-02-07 01:14:00,11
25850,ORD_25851,4797,"boAt Newly Launched Airdopes 458 TWS Earbuds with Spatial Bionic Sound by THX,in Ear Detection, ENx™Tech, 30H Playtime, Be...",Warehouse A,44,33,2025-02-07 15:05:00,11
25851,ORD_25852,29210,SUGAR Cosmetics Aquaholic Hydrating Stick 32 gm,Warehouse C,57,39,2025-02-07 10:33:00,18
25852,ORD_25853,11695,Jamriya Natural Baby Powder 200 gm,Warehouse B,47,35,2025-02-07 04:56:00,12
25853,ORD_25854,20761,"ELV Metal Adjustable Mobile Phone Foldable Holder Stand Dock Mount with Big Back Support to Hold (Upto 10inch) of iPhone, ...",Warehouse A,105,97,2025-02-07 21:30:00,8
25854,ORD_25855,18590,DavaIndia Alfuzosin 10mg Tablet PR,Warehouse B,33,27,2025-02-07 14:40:00,6
25855,ORD_25856,9215,CEDO Redmi Note 10 / Note 10S Back Cover | Matte Soft Silicon Flexible | Camera Bump Protection | All Side Shock Proof Rub...,Warehouse B,88,72,2025-02-07 20:16:00,16
25856,ORD_25857,18583,"Duracell Ultra Alkaline D Battery, 2 Pcs",Warehouse B,31,26,2025-02-07 20:28:00,5
25857,ORD_25858,4769,"ELV Direct Wall Mount Mobile Holder, Charging Holder Compatible All Smartphone and Remote Stand/Organizer/Showpiece for Tv...",Warehouse B,97,85,2025-02-07 12:26:00,12
25858,ORD_25859,28443,Leonid 500mg Tablet,Warehouse C,58,52,2025-02-07 10:11:00,6
25859,ORD_25860,29289,Rosuvib-F Tablet,Warehouse A,84,69,2025-02-07 20:31:00,15
25860,ORD_25861,29292,Oxy-Infusion Day Cream with SPF 15,Warehouse B,86,69,2025-02-07 15:42:00,17
25861,ORD_25862,10352,Skin Lightening Mask,Warehouse B,103,88,2025-02-07 05:31:00,15
25862,ORD_25863,29313,T.O.G. Microblading Permanent Makeup Eyebrow Tattoo Needle Pen Pigment Skin Kit #4,Warehouse A,56,39,2025-02-07 04:54:00,17
25863,ORD_25864,5971,Indard-P 100mg/325mg Tablet,Warehouse C,30,19,2025-02-07 14:35:00,11
25864,ORD_25865,29182,Freshness Gel Natural Ayurvedic Cardamom Toothpaste,Warehouse A,68,58,2025-02-07 14:20:00,10
25865,ORD_25866,29179,"Body Bath Loofah Face Towel Hangable, Assorted - BH065D",Warehouse A,14,5,2025-02-07 11:50:00,9
25866,ORD_25867,18614,Tattoo Gizmo Professional Stainless Steel Tip Tattoo Machine Gun Grip Nozzle (5RT),Warehouse B,33,17,2025-02-07 03:42:00,16
25867,ORD_25868,10067,Nithra 10mg Tablet,Warehouse B,84,73,2025-02-07 10:16:00,11
25868,ORD_25869,18976,Pierre Cardin Paris - Pearly Velvet Eyeshadow 475-Moon Grey,Warehouse B,67,53,2025-02-07 10:43:00,14
25869,ORD_25870,9192,Candid KZ Cream,Warehouse A,116,99,2025-02-07 14:37:00,17
25870,ORD_25871,28676,Ulno 40mg Tablet,Warehouse A,51,33,2025-02-07 11:14:00,18
25871,ORD_25872,18760,Montonex Forte 450 mg/300 mg Tablet,Warehouse C,21,7,2025-02-07 02:54:00,14
25872,ORD_25873,18805,Mucaryl-AB Tablet,Warehouse B,35,26,2025-02-07 14:53:00,9
25873,ORD_25874,20676,Welspas 80mg/250mg Tablet,Warehouse A,16,5,2025-02-07 01:45:00,11
25874,ORD_25875,4643,Stealodeal Eva Portable Storage Box Earphone Headset Carry Pouch Headphone Carrying Case,Warehouse B,47,36,2025-02-07 14:08:00,11
25875,ORD_25876,26206,Edicold A Syrup,Warehouse C,46,29,2025-02-07 05:45:00,17
25876,ORD_25877,28842,Daily Life Forever52 Glitz Waterproof Eyeliner Eyeshadow Glt004 0.6 gm,Warehouse C,81,75,2025-02-07 08:30:00,6
25877,ORD_25878,10186,Atorlife 40mg Tablet,Warehouse B,105,96,2025-02-07 19:09:00,9
25878,ORD_25879,4729,Beauty People Sheer Color Lipstick - Just - Pink - 408 3.8 gm,Warehouse A,71,54,2025-02-07 11:15:00,17
25879,ORD_25880,18995,"SUGAR Cosmetics Twist and Shout Fade Proof Kajal, 02 Still Got the Blues Dark Blue 0.35 gm",Warehouse A,96,87,2025-02-07 08:50:00,9
25880,ORD_25881,28880,"ProElite Deer Flip case Cover for Realme PadMini 8.68 inch Tablet, Black",Warehouse A,48,31,2025-02-07 17:15:00,17
25881,ORD_25882,18797,"Amazon Basics Multipurpose Foldable Laptop Table with Mac Holder/Tab Holder | Table Holder Study Table, Breakfast Table, F...",Warehouse B,100,87,2025-02-07 14:19:00,13
25882,ORD_25883,28888,Amozo Designed for iPhone 14 Pro Max Case | Ultra Hybrid Drop and Camera Protection Back Cover Case for iPhone 14 Pro Max...,Warehouse C,37,23,2025-02-07 00:30:00,14
25883,ORD_25884,18790,Vibheetaki Tablets,Warehouse B,83,71,2025-02-07 10:00:00,12
25884,ORD_25885,26162,Zhenmol-SP Tablet,Warehouse B,48,35,2025-02-07 05:05:00,13
25885,ORD_25886,18943,"Seagate One Touch 2TB External HDD with Password Protection – Space Gray, for Windows and Mac, with 3 yr Data Recovery Ser...",Warehouse A,65,46,2025-02-07 03:35:00,19
25886,ORD_25887,28672,Minet-SR Tablet,Warehouse A,35,18,2025-02-07 21:50:00,17
25887,ORD_25888,10225,Artzom 60mg Injection,Warehouse C,58,53,2025-02-07 00:11:00,5
25888,ORD_25889,26266,HP 65W AC Laptops Charger Adapter 4.5mm for HP Pavilion Black (Without Power Cable),Warehouse B,51,37,2025-02-07 14:55:00,14
25889,ORD_25890,20641,Reflanim P Tablet,Warehouse C,41,26,2025-02-07 09:06:00,15
25890,ORD_25891,28659,"Just Herbs Ayurvedic Rose Lip Mask, Balm For Dark, Dry & Pigmented Lips - Vegan Lip Mask For Men & Women 15gm",Warehouse C,71,65,2025-02-07 00:55:00,6
25891,ORD_25892,28731,Wild Set,Warehouse C,44,30,2025-02-07 07:51:00,14
25892,ORD_25893,20670,Cgros 10mg Tablet,Warehouse A,90,74,2025-02-07 14:45:00,16
25893,ORD_25894,28612,Men - Hair Removal Body Cream,Warehouse C,69,60,2025-02-07 12:30:00,9
25894,ORD_25895,18911,"Flash Acrylic Colour (White, 200 ml)",Warehouse B,76,65,2025-02-07 18:16:00,11
25895,ORD_25896,28609,Honey Facial Massage Gel,Warehouse B,22,15,2025-02-07 21:15:00,7
25896,ORD_25897,34921,Ajmal Avid & Blu Deo & Yearn EDP Pack of 3 20 ml,Warehouse A,28,10,2025-02-06 08:14:00,18
25897,ORD_25898,30110,Vicbact Z 250mg/31.25mg Injection,Warehouse A,46,39,2025-02-06 13:56:00,7
25898,ORD_25899,30093,Fotaxon 250mg Injection,Warehouse B,74,58,2025-02-06 04:28:00,16
25899,ORD_25900,30094,Levofox 250mg Tablet,Warehouse B,8,1,2025-02-06 00:11:00,7
25900,ORD_25901,34901,Hydro Cleanser,Warehouse A,31,25,2025-02-06 16:32:00,6
25901,ORD_25902,30129,Telba 40mg Tablet,Warehouse B,56,49,2025-02-06 22:26:00,7
25902,ORD_25903,14888,"Noise ColorFit Pro 3 Alpha Bluetooth Calling Smart Watch with Alexa Built-in, Fast Charging, 1.69""(42cm) Display, 80+ Song...",Warehouse A,26,7,2025-02-06 07:19:00,19
25903,ORD_25904,34890,"Samsung T7 500GB Up to 1,050MB/s USB 3.2 Gen 2 (10Gbps, Type-C) External Solid State Drive (Portable SSD) Grey(MU-PC500T)",Warehouse A,40,22,2025-02-06 05:32:00,18
25904,ORD_25905,34873,Global Desi Soulful Trance Eau De Parfum 50ML & Cosmic Dreamer Body Mist 200ML Pack of 2 for Women Crafted by Ajmal,Warehouse C,70,54,2025-02-06 23:03:00,16
25905,ORD_25906,14880,The Man Company Daily Moisturising Cream - Shea Butter & Vitamin E 50 gm,Warehouse A,77,63,2025-02-06 15:04:00,14
25906,ORD_25907,12506,VLCC Diamond Facial Kit,Warehouse C,43,26,2025-02-06 05:17:00,17
25907,ORD_25908,10711,WOW IMAGINE Shock Proof Clear Back Cover Case Mobile Cover for Samsung Galaxy M53 5G (Hard | Hybrid PC + TPU | Full Armour...,Warehouse B,102,93,2025-02-06 10:40:00,9
25908,ORD_25909,34943,CZARTECH Native Back Cover for iPhone 13 Clear case (TPU + Tough Polycarbonate Back I 5ft Drop Protection Tested I Transpa...,Warehouse C,111,97,2025-02-06 07:51:00,14
25909,ORD_25910,34944,OnePlus Warp Charge 50 Wireless Charger for OnePlus Phones - White (in),Warehouse B,98,86,2025-02-06 15:57:00,12
25910,ORD_25911,1260,Brivalyst 50mg Tablet,Warehouse C,30,16,2025-02-06 22:47:00,14
25911,ORD_25912,1256,"BB Cream Encapsulated organic sunscreen minerals, Argan Oil, Shea Butter, Cocoa Butter Sunehri ( PACK OF 1 )",Warehouse B,24,12,2025-02-06 15:50:00,12
25912,ORD_25913,30181,Morning Dew Deodorant - For Women,Warehouse C,18,13,2025-02-06 01:38:00,5
25913,ORD_25914,3880,RIXTEC Face Cleansing Sponge Puff Makeup Washing Pad Deep Cleansing & Exfoliating Facial Sponge - Assorted Color Pack of 4,Warehouse C,53,40,2025-02-06 13:32:00,13
25914,ORD_25915,10640,Romantic Perfumed Talc - For Women,Warehouse B,37,20,2025-02-06 18:33:00,17
25915,ORD_25916,34671,DEVICE OF URBAN INFOTECH 40x60 Magnification Monocular Telescope with Mobile Holder & Tripod with BAK4 Prism & Zoom HD Lon...,Warehouse B,105,86,2025-02-06 18:06:00,19
25916,ORD_25917,3766,Deflagic 6mg Tablet,Warehouse B,107,90,2025-02-06 21:13:00,17
25917,ORD_25918,30410,Mars Poppins Kiss Proof LIP Color Highly Pigmented Transfer Proof Long Lasting Matte Lipstick Berry Wine-NT02,Warehouse C,33,20,2025-02-06 07:51:00,13
25918,ORD_25919,3779,"Noise ColorFit Pulse Grand Smart Watch with 1.69""(42.9cm) HD Display, 60 Sports Modes, 150 Watch Faces, Fast Charge, Spo2,...",Warehouse C,75,61,2025-02-06 22:59:00,14
25919,ORD_25920,15086,Amitias Plus 12.5mg/5mg Tablet,Warehouse A,78,71,2025-02-06 22:05:00,7
25920,ORD_25921,30390,"GM 3059 G-Power 6+1 Spike Adaptor with Master Switch, Indicator, Safety Shutter, International Sockets & Surge Protector",Warehouse B,107,88,2025-02-06 18:46:00,19
25921,ORD_25922,10713,Uzitel A 40mg/5mg Tablet,Warehouse B,32,25,2025-02-06 14:22:00,7
25922,ORD_25923,3909,Ultipime O 500mg Tablet,Warehouse C,23,11,2025-02-06 05:46:00,12
25923,ORD_25924,12502,Lulinik 1% Cream,Warehouse A,84,66,2025-02-06 09:18:00,18
25924,ORD_25925,6718,Catfin 250 Tablet,Warehouse C,76,64,2025-02-06 07:30:00,12
25925,ORD_25926,30147,Asdec 75mg Injection,Warehouse C,93,86,2025-02-06 06:57:00,7
25926,ORD_25927,10627,Servospore Gel,Warehouse A,97,90,2025-02-06 20:55:00,7
25927,ORD_25928,12279,Eyetex Pallavi Sticker Kumkum 3in1 - Black Color Bindi - Size P6 (Pack of 15),Warehouse B,46,38,2025-02-06 19:36:00,8
25928,ORD_25929,1417,Telmeyes H 40mg/12.5mg Tablet,Warehouse B,70,55,2025-02-06 08:02:00,15
25929,ORD_25930,17699,"Ambrane Wired in Earphones with in-line Mic for Clear Calling, 14mm Dynamic Drivers for BoostedBass™, 3.5mm Jack, Multi-Fu...",Warehouse C,47,34,2025-02-06 11:53:00,13
25930,ORD_25931,12308,"Noise ColorFit Pulse Spo2 Smart Watch 1.4"" Full Touch HD Display, 10 Days Battery Life with Heart Rate, Sleep Monitoring &...",Warehouse A,24,16,2025-02-06 20:30:00,8
25931,ORD_25932,12316,Iqoo neo 6 Camera Lens Protector Pack of 2,Warehouse B,22,5,2025-02-06 03:23:00,17
25932,ORD_25933,34421,Sodicarb Tablet,Warehouse A,54,41,2025-02-06 12:19:00,13
25933,ORD_25934,3588,Ajmal Nightingale And Magnetize For Men & Women And Raindrops Femme Deodorants Pack of 3 200 ml,Warehouse C,52,44,2025-02-06 15:22:00,8
25934,ORD_25935,17723,Loosepain 75mg Injection,Warehouse C,79,66,2025-02-06 23:57:00,13
25935,ORD_25936,15237,Amazon Basics 10000mAH Lithium Polymer 18W Fast Charging Power Bank | Dual Input and Triple Output Ports | Flat Metallic B...,Warehouse A,30,22,2025-02-06 18:51:00,8
25936,ORD_25937,1555,CEDO Defender Case iQOO Neo 6 (5G) | Rotating Ring Holder & Kickstand in-Built | Military Grade Armor | Bumper Back Cover ...,Warehouse B,62,55,2025-02-06 23:03:00,7
25937,ORD_25938,15193,Daily Life Forever52 Foundation Brush Nx009 1's,Warehouse C,102,91,2025-02-06 22:36:00,11
25938,ORD_25939,34518,Vanpox Oral Drop,Warehouse A,102,83,2025-02-06 19:43:00,19
25939,ORD_25940,34487,O3+ Bridal Facial Kit Oxygenating Glow Skin 81gm,Warehouse B,57,46,2025-02-06 02:28:00,11
25940,ORD_25941,17749,Health+ Bath Soap - 99.9% Germ Protection,Warehouse C,15,3,2025-02-06 13:14:00,12
25941,ORD_25942,30690,Luzifine Cream,Warehouse C,74,59,2025-02-06 14:16:00,15
25942,ORD_25943,30684,"Lenovo 300 Wireless Compact Mouse, 1000 DPI Optical sensor, 2.4GHz Wireless Nano USB, 10m range, 3-button(left,right,scrol...",Warehouse C,42,30,2025-02-06 01:25:00,12
25943,ORD_25944,3626,"Revolution Pro 4K Blush Palette, Peach, 16 g",Warehouse B,29,20,2025-02-06 19:47:00,9
25944,ORD_25945,34502,Osomox 250mg Tablet,Warehouse C,26,12,2025-02-06 12:25:00,14
25945,ORD_25946,34507,Cadrob LS 75mg/20mg Capsule SR,Warehouse B,30,21,2025-02-06 07:39:00,9
25946,ORD_25947,34511,Dothepin 75 Tablet,Warehouse B,79,74,2025-02-06 16:28:00,5
25947,ORD_25948,3645,Gemblue Biocare Pearl Face and Body cream 500 ml,Warehouse A,14,2,2025-02-06 09:45:00,12
25948,ORD_25949,34515,Colosafe 20mg Tablet,Warehouse C,72,58,2025-02-06 23:14:00,14
25949,ORD_25950,30445,Azipat 250mg Tablet,Warehouse C,97,90,2025-02-06 23:58:00,7
25950,ORD_25951,30434,FUR JADEN Vegan Leather 30L 15.6 Inch Laptop Backpack for Men Women for Office Professionals and College Students,Warehouse B,63,56,2025-02-06 08:43:00,7
25951,ORD_25952,12548,Active 2mg/500mg Tablet,Warehouse B,108,90,2025-02-06 13:38:00,18
25952,ORD_25953,17946,Nykaa So Matte Lipstick - Naughty Nude 11 M (4.2Grams),Warehouse C,41,25,2025-02-06 10:01:00,16
25953,ORD_25954,3902,"Decor Black Pen Stand for Office Table with Airplane Miniature, Clock and Pencil Holder - Stationary Desk Organizer",Warehouse A,83,74,2025-02-06 07:52:00,9
25954,ORD_25955,1328,boAt Bassheads 220 Wired in Ear Earphones(Black Indi),Warehouse A,15,9,2025-02-06 04:03:00,6
25955,ORD_25956,12427,"Chicco Baby Moments Gentle Body Wash and Shampoo for Soft Skin and Hair, Dermatologically tested, Paraben free (500 ml)",Warehouse A,85,69,2025-02-06 10:10:00,16
25956,ORD_25957,7970,REALCASE Designed for iPhone 14 Pro Max Back Cover Case | Stylish Frameless Matte Hard Skin | Soft TPU Shock Proof Bumper ...,Warehouse C,8,3,2025-02-06 11:43:00,5
25957,ORD_25958,3807,PoviTotal Gargle,Warehouse B,27,22,2025-02-06 03:38:00,5
25958,ORD_25959,6728,"Maybelline New York The Colossal Liner, 1.2ml (Black) And Maybelline Hyper Glossy Liquid Liner, Black, 3g",Warehouse C,63,49,2025-02-06 01:29:00,14
25959,ORD_25960,22808,Dipinol 5 mg/25 mg Tablet,Warehouse B,47,42,2025-02-06 09:55:00,5
25960,ORD_25961,8684,Ryvel-DSR Capsule,Warehouse A,82,72,2025-02-06 22:47:00,10
25961,ORD_25962,5750,"AYA Meilin Non Transfer Waterproof Matte Lipstick, Pure Red,",Warehouse A,94,89,2025-02-06 07:12:00,5
25962,ORD_25963,7497,Dytel 80H Tablet,Warehouse B,39,21,2025-02-06 14:23:00,18
25963,ORD_25964,23182,Krispraz D 30mg/40mg Capsule SR,Warehouse A,14,7,2025-02-06 07:04:00,7
25964,ORD_25965,22800,Anycast Wireless WiFi 1080P HDMI Display TV Dongle Receiver Black,Warehouse C,86,75,2025-02-06 10:55:00,11
25965,ORD_25966,7966,"Insight Non Transfer Lip Color, 4ml (05 Cocoa Plum) & Insight Non Transfer Lip Color, 4ml (09 Sunset Red)",Warehouse A,98,87,2025-02-06 23:43:00,11
25966,ORD_25967,7330,Metofin-ER 25 Tablet,Warehouse B,71,61,2025-02-06 17:29:00,10
25967,ORD_25968,22548,Loyal Pearl Powder (Cosmetics Grade) 100 GM (Pack of 2),Warehouse B,64,48,2025-02-06 12:55:00,16
25968,ORD_25969,21331,Uncle Tony Razor Blades 2's,Warehouse C,49,37,2025-02-06 05:22:00,12
25969,ORD_25970,7358,After Shave Splash - Arctic Ice,Warehouse B,99,81,2025-02-06 11:02:00,18
25970,ORD_25971,5901,St.Botanica Purple Conditioner - GO Colored 200 ml,Warehouse C,75,63,2025-02-06 05:39:00,12
25971,ORD_25972,26479,"Miss rose Hot and Soft Matte Lipstick, pink, 3.4 g",Warehouse C,73,56,2025-02-06 08:54:00,17
25972,ORD_25973,20553,"Thr3E Strokes Waterproof Eyeshadow, Black, Matte Finish, 2g",Warehouse B,17,3,2025-02-06 05:46:00,14
25973,ORD_25974,6442,Luljas 1% Cream,Warehouse A,76,69,2025-02-06 14:07:00,7
25974,ORD_25975,26699,"WALKENT 15.6"" Laptop Bag 27L (Craft) Anti-Theft, Waterproof, Expandable, External USB for Office College Men Women",Warehouse A,96,77,2025-02-06 11:24:00,19
25975,ORD_25976,22789,EHOP Remote Control Compatible for Panasonic Split AC 44A,Warehouse A,87,78,2025-02-06 06:55:00,9
25976,ORD_25977,6951,Coligra 120mg Tablet,Warehouse B,23,15,2025-02-06 10:35:00,8
25977,ORD_25978,22350,Eurelax 0.25mg Tablet,Warehouse C,22,9,2025-02-06 18:08:00,13
25978,ORD_25979,23226,Lornogic P 8mg/325mg Tablet,Warehouse C,33,22,2025-02-06 09:40:00,11
25979,ORD_25980,6638,CLAW Shoot Wireless 2.4Ghz USB Gamepad Controller for PC Supports Windows XP/7/8/10 with Rubberized Textured Grip and Dual...,Warehouse B,88,82,2025-02-06 18:51:00,6
25980,ORD_25981,23907,Cefleo-LB Tablet,Warehouse C,32,24,2025-02-06 05:29:00,8
25981,ORD_25982,22537,Western Digital WD Green 240 GB 6.35 cm (2.5 inch) SATA III Internal Solid State Drive (WDS240G2G0A),Warehouse C,65,51,2025-02-06 16:34:00,14
25982,ORD_25983,6873,Gaxim Tablet,Warehouse C,102,83,2025-02-06 10:21:00,19
25983,ORD_25984,20890,Olmicox 90mg Tablet,Warehouse A,56,44,2025-02-06 06:56:00,12
25984,ORD_25985,22543,Dyazo 13.3 inch Laptop Bag Sleeve Sleeve Bag Cover for 13 inch Apple Mac Book Air Pro Retina 13 13.3 inch MacBook 13.3 inc...,Warehouse A,29,20,2025-02-06 07:35:00,9
25985,ORD_25986,20899,Soap - Cocoa Butter,Warehouse A,24,19,2025-02-06 03:58:00,5
25986,ORD_25987,1620,Redgear MP35 Speed-Type Gaming Mousepad (Black/Red),Warehouse C,51,38,2025-02-06 16:23:00,13
25987,ORD_25988,6423,RIOGLIM 2MG TABLET,Warehouse A,103,95,2025-02-06 12:31:00,8
25988,ORD_25989,5753,Festive Pack,Warehouse C,96,88,2025-02-06 06:02:00,8
25989,ORD_25990,15079,"Angelie Premium Make up Cosmetic Foundation Powder Puff Sponge (Set of 2, Multicolor)",Warehouse B,55,48,2025-02-06 00:08:00,7
25990,ORD_25991,8352,Indap 1.5mg Tablet SR,Warehouse C,96,88,2025-02-06 15:57:00,8
25991,ORD_25992,12446,Techno Simba Buds - Bluetooth Wireless Earphones,Warehouse C,80,66,2025-02-06 18:32:00,14
25992,ORD_25993,14965,CLAVIER Polyurethane Hard Carrying Case Portable Protection Storage Bag for Earphone Headset Headphone Black,Warehouse C,53,39,2025-02-06 12:58:00,14
25993,ORD_25994,30324,STABILO Swing Cool Highlighter Pen Pastel - Pack of 6 (Assorted Colours),Warehouse A,23,9,2025-02-06 01:33:00,14
25994,ORD_25995,30322,"Plum Chamomile & White Tea Revival Face Wash | Mild Cleansing for Instant Glow | For Normal, Combination Skin | 100% Vega...",Warehouse A,16,1,2025-02-06 16:32:00,15
25995,ORD_25996,12448,"Redmi Note 9 (Arctic White, 4GB RAM, 64GB Storage) - 48MP Quad Camera & Full HD+ Display",Warehouse B,62,52,2025-02-06 22:33:00,10
25996,ORD_25997,15049,Ajmal Colaba Mukhallat Concentrated Perfume Oil Floral Oriental And Sacred Love Deodorant Floral Musky Fragrance 214 ml,Warehouse A,43,26,2025-02-06 11:49:00,17
25997,ORD_25998,10675,Dettol Liquid Handwash Bottle - Original Hand Wash- 900ml | Germ Defence Formula | 10x Better Germ Protection,Warehouse B,61,46,2025-02-06 07:39:00,15
25998,ORD_25999,34740,TheGiftKart Shockproof Crystal Clear Back Cover Case for OnePlus 5 | 360 Degree Protection | Protective Design | Transpare...,Warehouse B,76,62,2025-02-06 22:11:00,14
25999,ORD_26000,10663,"FriendZon 9H Nano Speedometer Screen Protector Scratch Guard Compatible with Bajaj Pulsar 125, 150, 180F, 220F",Warehouse B,56,42,2025-02-06 04:22:00,14
26000,ORD_26001,18076,Ajmal Colaba Mukhallat Concentrated Perfume Oil Floral Oriental And Sacrifice II For Him Deodorant Fruity Aromatic Fragrance 214 ml,Warehouse B,33,14,2025-02-06 22:38:00,19
26001,ORD_26002,14969,Makeup Revolution Colour Play Achieve Eyeshadow Palette 5.2 gm,Warehouse A,72,56,2025-02-06 20:26:00,16
26002,ORD_26003,30231,D-Cip 500 Tablet,Warehouse B,65,48,2025-02-06 04:05:00,17
26003,ORD_26004,3865,Doubledicestore Tempered Glass Screen Protector Compatible for Redmi Note 10 / Note 10S with 11D Full Coverage and Easy In...,Warehouse C,39,23,2025-02-06 08:19:00,16
26004,ORD_26005,16765,Merayo Metal Mesh Pen and Pencil Stationary Storage Tidy Desk Organizer Box with 6 Compartment for Home and Office Accesso...,Warehouse A,49,33,2025-02-06 22:23:00,16
26005,ORD_26006,7874,SUGAR Cosmetics Aquaholic Pore Exfoliating Scrub 50 ml,Warehouse B,72,53,2025-02-06 07:25:00,19
26006,ORD_26007,21113,Amvalor Chrono 300 Tablet CR,Warehouse B,15,5,2025-02-06 21:34:00,10
26007,ORD_26008,6433,Sitalor M 500 Tablet,Warehouse B,39,32,2025-02-06 00:34:00,7
26008,ORD_26009,23203,Leverest 5mg Tablet,Warehouse A,62,54,2025-02-06 06:58:00,8
26009,ORD_26010,6079,Arctic Fox Wired USB Gaming Mouse with Breathing Lights and DPI Upto 3600,Warehouse B,18,3,2025-02-06 10:46:00,15
26010,ORD_26011,23659,TopFinder® Waterproof Matte Finish Foundation With Blender -24h Beauty For Oily & Dusky Skin Tone Face Makeup Highlighter...,Warehouse B,37,27,2025-02-06 23:46:00,10
26011,ORD_26012,6634,Inuti 100 Tablet SR,Warehouse A,60,52,2025-02-06 22:58:00,8
26012,ORD_26013,26149,Estepod 200mg Tablet DT,Warehouse B,17,12,2025-02-06 17:19:00,5
26013,ORD_26014,8233,Theomox Clv 500mg/125mg Tablet,Warehouse B,99,94,2025-02-06 15:38:00,5
26014,ORD_26015,24758,"LINC Pentonic Gel Pen | Tip Size 0.7 mm | Comfortable Grip | Ideal for Students and Professionals | For School, Office & B...",Warehouse A,118,99,2025-02-06 23:41:00,19
26015,ORD_26016,6224,CP PLUS Wired 1080p HD 2.4MP Security Camera,Warehouse B,59,54,2025-02-06 19:52:00,5
26016,ORD_26017,25298,Onsitego 2 Year Extended Warranty for Small Household Appliances from Rs. 5001-6000 (Email Delivery - No Physical Kit),Warehouse C,51,36,2025-02-06 04:42:00,15
26017,ORD_26018,6723,Wells Almond Oil - 400 ml,Warehouse B,64,49,2025-02-06 11:04:00,15
26018,ORD_26019,21762,TheGiftKart Flip Back Cover Case for Samsung Galaxy S20 FE / S20 FE 5G | Dual-Color Leather Finish | Inbuilt Stand & Pocke...,Warehouse A,86,76,2025-02-06 09:58:00,10
26019,ORD_26020,22564,Qualinac SP Tablet,Warehouse C,104,87,2025-02-06 12:43:00,17
26020,ORD_26021,30784,"Maybelline New York Sensational Liquid Matte Lipstick 02, Soft Wine 7 gm",Warehouse A,89,75,2025-02-06 01:41:00,14
26021,ORD_26022,10442,Western Digital WD Purple 64GB Surveillance and Security Camera Memory Card for CCTV & WiFi Cameras (WDD064G1P0C),Warehouse C,73,59,2025-02-06 14:33:00,14
26022,ORD_26023,12345,"Soulflower Herbal Kumkumadi Face Wash With Saffron, Turmeric, Gudhal, Mulethi Cooling Aloe Vera instant brightening & glowing skin 120 ml",Warehouse C,93,78,2025-02-06 00:20:00,15
26023,ORD_26024,29895,Maryaj Wild Stripes EDP Aromatic Oriental Perfume And Ajmal Sacrifice II For Him Deodorant Fruity Aromatic Fragrance 300 ml,Warehouse B,105,93,2025-02-06 18:15:00,12
26024,ORD_26025,12607,Beard Colour For Men - Natural Black,Warehouse C,11,6,2025-02-06 08:42:00,5
26025,ORD_26026,35085,Lakme 9 To 5 Primer + Gloss Nail Color Mustard Master 6 Ml,Warehouse C,48,30,2025-02-06 14:59:00,18
26026,ORD_26027,1170,Ayuxone 1000mg Injection,Warehouse A,51,39,2025-02-06 20:51:00,12
26027,ORD_26028,35099,Molinac-MR Tablet,Warehouse B,19,1,2025-02-06 03:36:00,18
26028,ORD_26029,35103,"Fashion Colour Colour Correction Makeup Base Single Packing, 626C 3.5 gm",Warehouse B,89,79,2025-02-06 19:43:00,10
26029,ORD_26030,29827,JGD PRODUCTS for OnePlus 8T / OnePlus 9R Premium Transparent Hybrid Soft Slim Dust Proof Back Case Cover with Camera Prote...,Warehouse C,38,25,2025-02-06 22:28:00,13
26030,ORD_26031,4250,Olbet-Trio 40 Tablet,Warehouse A,34,21,2025-02-06 20:43:00,13
26031,ORD_26032,35335,Deworm Oral Suspension,Warehouse A,72,65,2025-02-06 23:08:00,7
26032,ORD_26033,14802,"Fashion Colour Lip Liner, Waterproof, Long Lasting, 10 Spicy Chill 0.35 gm",Warehouse B,23,17,2025-02-06 08:59:00,6
26033,ORD_26034,35361,"CrossBeats Newly launched shuffl Neckband Environmental Noise Cancelling 13mm Drivers EchoBlast™, BT v5.2, Fast Charging w...",Warehouse C,82,67,2025-02-06 13:55:00,15
26034,ORD_26035,14468,"Deltoid Turbo Face Masks In Grey Mesh With Pink, Blue & Green Bindings - Assorted, 3C2007, Medium",Warehouse A,79,61,2025-02-06 16:18:00,18
26035,ORD_26036,18562,"Print 20 Polaroid Style Photo (White, 3.5x4.25-inch) Print Media",Warehouse B,109,91,2025-02-06 14:32:00,18
26036,ORD_26037,29296,Loremfix 100mg Tablet,Warehouse C,113,99,2025-02-06 19:00:00,14
26037,ORD_26038,35530,Insight Cosmetics Non - Transfer Lip Color - 13 TOFFEE CREAM 4 ml,Warehouse B,78,64,2025-02-06 15:08:00,14
26038,ORD_26039,29267,Gerituss D Syrup,Warehouse B,98,84,2025-02-06 09:12:00,14
26039,ORD_26040,12750,HP 128GB Class 10 MicroSD Memory Card (U1 TF Card  128GB),Warehouse A,35,21,2025-02-06 08:36:00,14
26040,ORD_26041,35557,Cefunik 125mg Dry Syrup,Warehouse C,107,89,2025-02-06 08:18:00,18
26041,ORD_26042,18592,Ylang Ylang Essential Oil,Warehouse C,65,49,2025-02-06 23:05:00,16
26042,ORD_26043,4394,"Fashion Colour Non - Transfer Matt Waterproof Lipstick, 56 Ruby Red 2.6 gm",Warehouse C,40,25,2025-02-06 02:38:00,15
26043,ORD_26044,35558,Iverkem 3mg Tablet,Warehouse B,56,49,2025-02-06 07:19:00,7
26044,ORD_26045,18599,Epson T03Y 127 ml Ink Bottle (Black),Warehouse B,24,11,2025-02-06 15:55:00,13
26045,ORD_26046,946,LF Mahindra XUV 700 Car Accessories Navigation or Music System (Stereo) Touch Screen Guard (Company Fitted) - Clear,Warehouse C,29,18,2025-02-06 13:01:00,11
26046,ORD_26047,18613,Epson T7741 Black Ink Bottle C13T774198,Warehouse A,82,76,2025-02-06 02:50:00,6
26047,ORD_26048,12759,Shryoan Styling Brow Gel Soap 10g,Warehouse A,12,1,2025-02-06 18:49:00,11
26048,ORD_26049,12760,Elbile 150mg/100mg Tablet,Warehouse B,81,67,2025-02-06 23:44:00,14
26049,ORD_26050,29157,Ceoxia 50 Dry Syrup,Warehouse B,74,61,2025-02-06 20:27:00,13
26050,ORD_26051,16378,Essential Oil - Juniper Berry,Warehouse A,11,2,2025-02-06 07:26:00,9
26051,ORD_26052,29902,Nutriment Aloevera Cream All Skin Type 250 gm,Warehouse C,35,27,2025-02-06 04:20:00,8
26052,ORD_26053,35576,Lutigold 1% Cream,Warehouse B,39,31,2025-02-06 06:13:00,8
26053,ORD_26054,29904,Hycam 20mg Tablet DT,Warehouse C,25,15,2025-02-06 05:39:00,10
26054,ORD_26055,26774,Gidihist 8mg Tablet,Warehouse A,84,72,2025-02-06 17:24:00,12
26055,ORD_26056,18423,Skin Cottage Bath + Scrub (Tamrind) 1000 ml,Warehouse A,21,15,2025-02-06 17:34:00,6
26056,ORD_26057,10454,Archies Parfum 01 MEN DEO COMBO 400 ml,Warehouse A,40,26,2025-02-06 14:03:00,14
26057,ORD_26058,14592,BKN® Universal Mobile Stand for Table with Adjustable Height | 360 Degree Rotation Mobile Holder for Live Broadcast | Bed...,Warehouse C,40,29,2025-02-06 20:01:00,11
26058,ORD_26059,29550,Berina A41 Blue Hair Color Cream 60 gm,Warehouse A,89,70,2025-02-06 04:42:00,19
26059,ORD_26060,18432,"CrossBeats Ignite S3 Max Advanced Dual chip Bluetooth Calling Smart Watch, 1.85” 3D Curved UHD Display, 200+ smartwatch Fa...",Warehouse C,53,34,2025-02-06 17:09:00,19
26060,ORD_26061,18433,Dicloram 75mg Injection,Warehouse B,103,97,2025-02-06 16:11:00,6
26061,ORD_26062,29541,DigiTronix- CAR Bike Battery Charger/Lead Acid Battery 12V 1.5Amp Charger with Digital Display,Warehouse B,96,82,2025-02-06 17:37:00,14
26062,ORD_26063,35315,TheGiftKart Tough Armor Bumper Back Cover Case for Mi Redmi Note 11 Pro/Pro Plus 5G | Ring Holder & Kickstand in-Built | 3...,Warehouse C,58,41,2025-02-06 02:37:00,17
26063,ORD_26064,4227,ProElite Polyester Tablet sleeve Case Cover for upto 11.5 inch for iPad 10.2/iPad 10.9/Pro 11/ iPad 9.7/ Samsung/Lenovo/Ga...,Warehouse A,74,65,2025-02-06 00:04:00,9
26064,ORD_26065,12689,Revorest 0.5 mg/10 mg Tablet,Warehouse A,80,61,2025-02-06 19:47:00,19
26065,ORD_26066,35176,Apkos 40 Injection,Warehouse A,33,15,2025-02-06 10:26:00,18
26066,ORD_26067,1136,CEDO Redmi Pad (10.6 Inch) Tempered Glass | Screen Protector Tempered Glass for Xiaomi Redmi Pad (10.6 Inch),Warehouse C,16,5,2025-02-06 16:06:00,11
26067,ORD_26068,29783,Capizole 20mg Capsule,Warehouse C,83,70,2025-02-06 10:35:00,13
26068,ORD_26069,29924,"Sunny New & Improved pH Balanced Arnica Shampoo For Soft, Lustrous & Healthy Hair | Cantharis Imparts Cool & Healthy Scalp...",Warehouse B,86,74,2025-02-06 22:02:00,12
26069,ORD_26070,14783,"The Pink Foundry Acne Spot Corrector & Drying Treatment | Fast reduction of Pimples, Blackheads & Whiteheads | With Salicy...",Warehouse C,17,5,2025-02-06 13:27:00,12
26070,ORD_26071,3995,Charmacy Milano Star Bomb Eyeshadow 005 3.2 gm,Warehouse B,27,9,2025-02-06 17:02:00,18
26071,ORD_26072,4002,MONAST LC TABLET,Warehouse B,47,37,2025-02-06 23:16:00,10
26072,ORD_26073,35004,Vega Tail Comb (HMBC - 302) 19 gm,Warehouse B,48,42,2025-02-06 17:52:00,6
26073,ORD_26074,14755,Oflix 200mg Tablet,Warehouse A,32,21,2025-02-06 12:56:00,11
26074,ORD_26075,4005,7 O Clock Razor - Sterling,Warehouse C,105,99,2025-02-06 11:04:00,6
26075,ORD_26076,29968,Thiodase-A 100mg/4mg Tablet,Warehouse B,20,5,2025-02-06 21:25:00,15
26076,ORD_26077,18216,Spn 200mg Tablet,Warehouse C,96,82,2025-02-06 10:53:00,14
26077,ORD_26078,29935,Omega Tape Dispenser - Cello,Warehouse C,26,7,2025-02-06 18:20:00,19
26078,ORD_26079,10563,Essential Oil - Bergamot,Warehouse A,37,29,2025-02-06 00:54:00,8
26079,ORD_26080,35105,SANUO Invisible Double Eyelids Glue Transparent Styling Cream Big Eye Sticker Natural Makeup (pack of 2),Warehouse C,21,7,2025-02-06 11:28:00,14
26080,ORD_26081,18623,Charcoal Face Wash With Mandarin & Frankincense For Refreshing & Revitalise,Warehouse A,100,89,2025-02-06 00:52:00,11
26081,ORD_26082,29136,Skin Naturals - BB Cream,Warehouse A,65,46,2025-02-06 13:49:00,19
26082,ORD_26083,17778,Sartel R 40mg/2.5mg Tablet,Warehouse B,66,53,2025-02-06 20:58:00,13
26083,ORD_26084,30007,Synozolam 0.25mg Tablet,Warehouse B,31,21,2025-02-06 07:32:00,10
26084,ORD_26085,30785,Osteoseal Capsules,Warehouse C,60,42,2025-02-06 07:28:00,18
26085,ORD_26086,30444,Zifrocin 500 Tablet,Warehouse C,107,96,2025-02-06 23:32:00,11
26086,ORD_26087,34545,Baclonip 25mg Tablet,Warehouse B,64,51,2025-02-06 02:34:00,13
26087,ORD_26088,17824,"Fashion Colour Jersy Girl Kiss Proof No Transfer Lipstick, 3 Baby Lavender 2 gm",Warehouse C,25,6,2025-02-06 08:49:00,19
26088,ORD_26089,3675,Glimmer Nail Polish Cyan 5 ml,Warehouse A,24,17,2025-02-06 11:25:00,7
26089,ORD_26090,12393,"boAt AAVANTE Bar 1300 60W 2.0 Channel Bluetooth Soundbar Signature Sound, Multiple Connectivity Modes, Entertainment Mode...",Warehouse B,42,31,2025-02-06 04:20:00,11
26090,ORD_26091,30574,Vedene Syrup,Warehouse B,96,86,2025-02-06 22:48:00,10
26091,ORD_26092,34574,"JBL Endurance Race True Wireless in Ear Earbuds, Active Sports Earbuds with Mic, 30Hrs Playtime, IP67 Water & Dustproof, S...",Warehouse C,43,34,2025-02-06 15:12:00,9
26092,ORD_26093,3696,Nimucare P 100mg/500mg Tablet,Warehouse B,71,57,2025-02-06 05:10:00,14
26093,ORD_26094,1474,Cello Aspro Mavro Ball Pen | Black Ball Pen | Pack of 50 | Lightweight and Stylish Ball Pens | Ball Pen Set | Ideal for St...,Warehouse B,57,40,2025-02-06 13:39:00,17
26094,ORD_26095,17848,Pre Shave Foam - Classic Sensitive Skin,Warehouse A,53,37,2025-02-06 16:28:00,16
26095,ORD_26096,34576,Glimiyes M 2mg/500mg Tablet SR,Warehouse C,103,89,2025-02-06 09:02:00,14
26096,ORD_26097,1458,Tea Tree Skin Clearing Eye Mask,Warehouse C,43,24,2025-02-06 21:01:00,19
26097,ORD_26098,3724,Zorex Syrup,Warehouse B,55,45,2025-02-06 17:57:00,10
26098,ORD_26099,10770,Flormar Dewy Lip Booster 04 Ruby 4.5 ml,Warehouse B,17,9,2025-02-06 18:43:00,8
26099,ORD_26100,10769,"Invicto 10"" Portable LED Ring Light with 3 Color Modes Dimmable Lighting | for YouTube | Photo-Shoot | Video Shoot | Live ...",Warehouse A,64,56,2025-02-06 14:54:00,8
26100,ORD_26101,34601,"MI Poco M2 Pro (Green and Greener, 6GB RAM, 128GB Storage)",Warehouse C,23,17,2025-02-06 16:25:00,6
26101,ORD_26102,1454,Clinmi Skin Gel,Warehouse B,92,75,2025-02-06 19:44:00,17
26102,ORD_26103,15107,Aldust L 5mg Tablet,Warehouse A,33,24,2025-02-06 07:06:00,9
26103,ORD_26104,30487,Ajmal Blu Carbon Wisal Deodorant Spray (Pack of 3) 200 ml,Warehouse C,71,65,2025-02-06 15:14:00,6
26104,ORD_26105,30484,Vibihist 16mg Tablet,Warehouse B,96,82,2025-02-06 21:29:00,14
26105,ORD_26106,34606,"Aroma® NB119 Belief Bluetooth Wireless Headset In Ear Neckband with Long Lasting Playtime 48 Hr,Smart Voice Assistant,Ultr...",Warehouse B,73,66,2025-02-06 20:25:00,7
26106,ORD_26107,34617,Dynotrek Grade 15.6 Inch Laptop Sleeve Case Cover with Charger Pouch for Men Women Compatible ROG/Zenbook/MacBook 16/ OME...,Warehouse B,103,86,2025-02-06 20:07:00,17
26107,ORD_26108,12416,AND Eternal Radiance 100ML & Love Muse 50ML Pack of 2 Eau De Parfum for Women Crafted by Ajmal,Warehouse A,67,62,2025-02-06 10:02:00,5
26108,ORD_26109,34629,"Hoteon USB Desk Fan, Portable Table Cooling Fan with 3 Speeds, 4.6in Desktop Double Fan with Dual Modes, Powered by USB, S...",Warehouse B,56,41,2025-02-06 23:56:00,15
26109,ORD_26110,17797,ENERGY Concealer Brush Under Eye Mini Angled Flat Top Kabuki Nose Contour Brush for Concealing Blending Setting Buffing wi...,Warehouse B,15,4,2025-02-06 08:42:00,11
26110,ORD_26111,30635,"Maybelline New York Color Sensational Creamy Matte Lipstick, 630 Flaming Fuchsia, 3.9g And Maybelline New York Color Sensa...",Warehouse B,117,99,2025-02-06 03:57:00,18
26111,ORD_26112,1248,Duracell CHHOTA Power Alkaline AAA Batteries - 20 Pcs,Warehouse C,82,66,2025-02-06 02:25:00,16
26112,ORD_26113,35476,Levelast 250mg Tablet,Warehouse C,83,67,2025-02-06 18:13:00,16
26113,ORD_26114,29124,Hypercurl Mascara - Washable,Warehouse A,51,38,2025-02-06 09:11:00,13
26114,ORD_26115,4332,Cefix Syrup,Warehouse C,116,99,2025-02-06 20:39:00,17
26115,ORD_26116,29114,MADES Body Resort Clear Pink Pet Bottle Body Lotion 250 ml,Warehouse C,84,70,2025-02-06 13:24:00,14
26116,ORD_26117,4346,Kodak 108 cm (43 inches) Bezel-Less Design Series 4K Ultra HD Smart Android LED TV 43UHDX7XPROBL (Black),Warehouse B,78,62,2025-02-06 22:07:00,16
26117,ORD_26118,35482,ULTIMALE 30 MG TABLET,Warehouse C,70,58,2025-02-06 20:35:00,12
26118,ORD_26119,10405,"Vitamin C, E & Hyaluronic Acid De Pigmentation Cream",Warehouse A,23,17,2025-02-06 21:20:00,6
26119,ORD_26120,14548,Worcef LB 200mg Tablet,Warehouse C,58,44,2025-02-06 23:44:00,14
26120,ORD_26121,18462,Essential Souls Gel - Tea Tree 300 gm,Warehouse C,37,27,2025-02-06 06:52:00,10
26121,ORD_26122,4260,Sheaffer K Style Ballpoint Refill (Medium) – Blue,Warehouse A,85,79,2025-02-06 23:26:00,6
26122,ORD_26123,18465,Rabilock L 75mg/20mg Capsule,Warehouse C,111,99,2025-02-06 13:34:00,12
26123,ORD_26124,14532,TheGiftKart Back Cover for Redmi Note 10 Lite/Note 9 Pro/Pro Max/Poco M2 Pro (Poly Carbonate | Black | Armor),Warehouse A,65,50,2025-02-06 23:40:00,15
26124,ORD_26125,18472,"The Purple Tree Canvas Tote Bag For Women - 1 Pc , women tote bag , canvas tote bag , printed tote bag , printed canvas to...",Warehouse C,38,26,2025-02-06 03:58:00,12
26125,ORD_26126,4269,Generic face pack applicator brush,Warehouse C,48,38,2025-02-06 06:40:00,10
26126,ORD_26127,18473,"SPYKART 2022 Rearview Mirror Phone Holder for Car, Multifunctional Rearview Mirror Phone Holder, Universal 360° Car Rearvi...",Warehouse B,90,83,2025-02-06 07:59:00,7
26127,ORD_26128,29452,Amdrol 50 Injection,Warehouse C,10,3,2025-02-06 13:12:00,7
26128,ORD_26129,35400,"ZEBRONICS V260JP Joypad with vibration motors, dual analog sticks, USB interface, Digital / analog modes, 14 buttons, Comp...",Warehouse C,118,99,2025-02-06 01:39:00,19
26129,ORD_26130,1014,Dicnil 75mg Injection,Warehouse C,39,32,2025-02-06 02:19:00,7
26130,ORD_26131,12719,Olicom 40H Tablet,Warehouse A,98,85,2025-02-06 20:26:00,13
26131,ORD_26132,4339,Nourishment Radiance Body Butter,Warehouse B,109,94,2025-02-06 03:24:00,15
26132,ORD_26133,4287,"COSTAR Mateband Bluetooth Wireless Neckband Earphones - 24H Playtime, Dual Equalizer Bass Boost Drivers, Metal Magnetic Ea...",Warehouse A,22,13,2025-02-06 15:23:00,9
26133,ORD_26134,35459,WOW IMAGINE Samsung Galaxy A14 5G Slim Ultra Soft Rubberised Back Cover | Inner Velvet Fabric Lining | Matte Silicone Flex...,Warehouse C,90,79,2025-02-06 21:31:00,11
26134,ORD_26135,29400,Pilgrim Argan Oil Hair Serum for Dry Frizzy Hair | Hair Smoothing | Smoothing and Control of Frizzy/Dry Hair | Instant Shi...,Warehouse A,75,61,2025-02-06 06:46:00,14
26135,ORD_26136,12732,Dryness Care Conditioner,Warehouse B,9,2,2025-02-06 05:17:00,7
26136,ORD_26137,4309,s.Oliver For Her Eau de Toilette Natural Spray 30 ml,Warehouse A,62,49,2025-02-06 22:36:00,13
26137,ORD_26138,18516,"Revlon ColorStay Blot Face Powder, Mattifying, Blurring & Oil Absorbing Setting Powder, Absorb Sebum, Blurs Imperfections ...",Warehouse B,67,56,2025-02-06 09:16:00,11
26138,ORD_26139,4318,Hair Serum - Revitalising,Warehouse C,42,24,2025-02-06 05:37:00,18
26139,ORD_26140,18534,Ketonob 10mg Tablet DT,Warehouse B,90,78,2025-02-06 03:15:00,12
26140,ORD_26141,14473,Gerdzole 40 Tablet,Warehouse C,97,92,2025-02-06 16:35:00,5
26141,ORD_26142,5704,Plum Bodylovin' Vanilla Vibes Sugar Body Scrub 200 Gm,Warehouse B,40,25,2025-02-06 16:10:00,15
26142,ORD_26143,26369,Telmates 40mg Tablet,Warehouse C,37,25,2025-02-06 21:39:00,12
26143,ORD_26144,6300,Aclodac T 100mg/4mg Tablet,Warehouse C,55,47,2025-02-06 13:21:00,8
26144,ORD_26145,8313,Nua Clarifying Acne Patch Kit | 100% Hydrocolloid & Salicylic Acid Spot Acne Pimple Patches for Men & Women| Clear acne ov...,Warehouse A,87,78,2025-02-06 12:03:00,9
26145,ORD_26146,9399,Kitmox  Eye Drop,Warehouse C,40,33,2025-02-06 09:32:00,7
26146,ORD_26147,8052,"COOLCOLD Single Handed USB Gaming Keyboard, Wired 35 Keys Rainbow LED Backlight, One Hand Portable Mini Gaming Keypad, Erg...",Warehouse B,42,28,2025-02-06 01:57:00,14
26147,ORD_26148,25554,UNI-BALL Correction Pen (White),Warehouse C,47,34,2025-02-06 20:17:00,13
26148,ORD_26149,23560,Uziq 1gm Injection,Warehouse B,32,15,2025-02-06 01:08:00,17
26149,ORD_26150,22982,Oddy A4 Self Adhesive Paper Label Stickers for Laser & Inkjet Printers - 1 Labels per Sheet - Pack of 100 Sheets - for Shi...,Warehouse C,54,48,2025-02-06 16:38:00,6
26150,ORD_26151,25696,PureSense Natural Papaya Face Scrub with Niacinamide & Pomegranate | Removes Blackhead | Tan & Dirt | for a Clear Even ton...,Warehouse C,69,51,2025-02-06 02:24:00,18
26151,ORD_26152,5644,Zeemox CV 500mg/125mg Tablet,Warehouse C,19,14,2025-02-06 17:53:00,5
26152,ORD_26153,26277,Dark Temptation Deodorant,Warehouse A,102,85,2025-02-06 08:16:00,17
26153,ORD_26154,24138,Bemet-P 30mg/500mg Tablet,Warehouse C,92,87,2025-02-06 22:16:00,5
26154,ORD_26155,21958,"Mamaearth Anti Mosquito Fabric Roll On, 8ml",Warehouse B,35,30,2025-02-06 04:25:00,5
26155,ORD_26156,25555,Troxy 150mg Tablet,Warehouse C,26,16,2025-02-06 15:48:00,10
26156,ORD_26157,21453,Ceticad Plus Active Oral Suspension,Warehouse B,43,29,2025-02-06 13:19:00,14
26157,ORD_26158,21700,Ayushiv SINDOOR - SINDUR ORIGINAL - SINDOOR FOR POOJA - PURE SINDOOR FOR LORD HANUMAN (100 GM),Warehouse C,101,93,2025-02-06 04:49:00,8
26158,ORD_26159,22254,Arjun Chhal Churna,Warehouse C,67,56,2025-02-06 20:19:00,11
26159,ORD_26160,8766,TheGiftKart Shockproof Crystal Clear Back Cover Case for OnePlus 11R 5G | 360 Degree Protection | Protective Design | Tran...,Warehouse B,22,6,2025-02-06 14:44:00,16
26160,ORD_26161,8919,Desowen Cream,Warehouse C,31,13,2025-02-06 09:28:00,18
26161,ORD_26162,22620,"LG - 19M38HB, 19 Inch (47cm) 1366 X 768 Pixels, Led HD Ready Monitor, TN Panel with VGA, Hdmi Ports (Black)",Warehouse B,65,57,2025-02-06 16:36:00,8
26162,ORD_26163,6313,Seretochem Forte Tablet,Warehouse B,55,36,2025-02-06 09:23:00,19
26163,ORD_26164,26903,Pitta Balance - Pitta Control,Warehouse B,62,53,2025-02-06 13:27:00,9
26164,ORD_26165,23005,FEVRIDOL 650 MG TABLET ER,Warehouse A,46,29,2025-02-06 11:36:00,17
26165,ORD_26166,25723,Woman - Original Eau De Toilette Deodorant,Warehouse C,44,35,2025-02-06 20:34:00,9
26166,ORD_26167,6369,Batiste Dry Hair Shampoo - Fruity & Cheeky Cherry 200 ml,Warehouse B,11,4,2025-02-06 06:47:00,7
26167,ORD_26168,23561,Topilep 50 Tablet,Warehouse A,31,21,2025-02-06 07:41:00,10
26168,ORD_26169,8912,The Natural Wash Cold Pressed Virgin Almond Oil For Face Skin Body Hair And Scalp 100 Ml,Warehouse A,43,28,2025-02-06 16:22:00,15
26169,ORD_26170,20224,NOTE EYEBROW PENCIL 01 1.2 gm,Warehouse B,96,88,2025-02-06 07:50:00,8
26170,ORD_26171,23009,Altok 0.25mg Tablet,Warehouse B,31,18,2025-02-06 20:58:00,13
26171,ORD_26172,8646,Pentel EnerGel Click Roller Gel Pen - Pack of 4 (2 BLUE + 2 BLACK PENS),Warehouse B,23,13,2025-02-06 05:08:00,10
26172,ORD_26173,25587,Nitolone 25 Injection,Warehouse B,94,75,2025-02-06 18:36:00,19
26173,ORD_26174,20653,"Honor PAD X8 25.65 cm (10.1 inch) FHD Display, 3GB RAM, 32GB Storage, Mediatek MT8786, Android 12, Tuv Certified Eye Prote...",Warehouse B,65,46,2025-02-06 22:32:00,19
26174,ORD_26175,21398,Ciprovin 250mg Tablet,Warehouse A,108,92,2025-02-06 09:54:00,16
26175,ORD_26176,23365,Koseclav Dry Syrup,Warehouse A,20,12,2025-02-06 18:49:00,8
26176,ORD_26177,6100,Colbet Cream,Warehouse B,109,94,2025-02-06 04:41:00,15
26177,ORD_26178,22765,Gercip 200mg Injection,Warehouse B,17,7,2025-02-06 01:18:00,10
26178,ORD_26179,20857,Cadbury Bournvita 5 Star Magic (500 g),Warehouse A,40,31,2025-02-06 04:15:00,9
26179,ORD_26180,8702,Luxury Body Butter - White Lotus,Warehouse C,40,27,2025-02-06 06:05:00,13
26180,ORD_26181,23374,Arest Tablet,Warehouse C,53,46,2025-02-06 20:10:00,7
26181,ORD_26182,6187,AmazonBasics C Size Cell Everyday Alkaline Batteries (12-Pack) - Appearance May Vary,Warehouse A,30,16,2025-02-06 04:08:00,14
26182,ORD_26183,21311,Gentijet Eye Drop,Warehouse A,58,51,2025-02-06 11:41:00,7
26183,ORD_26184,24259,Xytel H 40mg/12.5mg Tablet,Warehouse B,14,3,2025-02-06 07:48:00,11
26184,ORD_26185,8742,Statcare-F 160mg/10mg Tablet,Warehouse B,76,63,2025-02-06 11:43:00,13
26185,ORD_26186,20528,"FEDUS Power Cord 1.5M Replacement Power Cable, India Plug IEC Computer Mains Power Cable Cord for Desktop 3 pin Power Cabl...",Warehouse A,62,50,2025-02-06 00:22:00,12
26186,ORD_26187,9327,Wipro Flex Box with Universal Socket and 4 meter long cord,Warehouse C,32,16,2025-02-06 00:35:00,16
26187,ORD_26188,24505,Telmeum-H Tablet,Warehouse C,112,97,2025-02-06 21:37:00,15
26188,ORD_26189,24987,Yves Rocher Relaxing Body Lotion Almond Orange Blossom 390 ml,Warehouse B,29,13,2025-02-06 08:45:00,16
26189,ORD_26190,7412,"Himalaya Gentle Daily Care Natural Protein Shampoo, protects from daily wear and tear , Gently cleanses & strengthens, Wit...",Warehouse B,38,19,2025-02-06 12:52:00,19
26190,ORD_26191,24481,Flormar Full Color Nail Enamel FC45 Peach Sparkler 8 ml,Warehouse A,37,24,2025-02-06 06:15:00,13
26191,ORD_26192,7884,Stepha 1000mg Injection,Warehouse A,94,78,2025-02-06 13:19:00,16
26192,ORD_26193,7857,Acnos Black Round Diamond Dial with Latest Generation Purple & Rosegold Magnet Belt Analogue Watch for Women Pack of - 2 (...,Warehouse B,24,17,2025-02-06 11:49:00,7
26193,ORD_26194,21036,Ebstic 10 Tablet,Warehouse C,40,35,2025-02-06 00:33:00,5
26194,ORD_26195,22211,Ruescort MF Ointment,Warehouse C,20,8,2025-02-06 08:59:00,12
26195,ORD_26196,22212,Vovituf MR 250mg/50mg/325mg Tablet,Warehouse C,66,61,2025-02-06 01:48:00,5
26196,ORD_26197,25622,WACOM One by CTL-672/K0-CX Medium 8.5-inch x 5.3-inch Graphic Tablet (Red and Black),Warehouse B,30,21,2025-02-06 21:40:00,9
26197,ORD_26198,23590,Starcet 5mg Tablet,Warehouse C,89,81,2025-02-06 16:02:00,8
26198,ORD_26199,22996,"Treaclemoon My Coconut Island Moisturizing Shower and Bath Gel with Natural Coconut Extracts, Paraben-Free - 500 ml",Warehouse B,55,41,2025-02-06 07:43:00,14
26199,ORD_26200,24071,"Makeup Revolution Soph Eyeshadow Palette, Multicolor, 26.4g Matte & Shimmery Finish",Warehouse C,87,74,2025-02-06 07:41:00,13
26200,ORD_26201,24842,Tresma 250mg Tablet,Warehouse A,88,83,2025-02-06 11:58:00,5
26201,ORD_26202,21711,"Smart watch New Launch Smart Watches ID116 Bluetooth Smartwatch Wireless Fitness Band for Boys, Girls, Men, Women & Kids |...",Warehouse A,73,56,2025-02-06 23:09:00,17
26202,ORD_26203,20205,HG Pril 5mg Tablet,Warehouse B,41,36,2025-02-06 19:56:00,5
26203,ORD_26204,8060,Vinayakart 2 Pcs 10ml Empty Mascara Tubes Wand Portable Cream Container Bottle Ideal Kit for DIY Cosmetics Castor Oil Trav...,Warehouse C,63,54,2025-02-06 09:11:00,9
26204,ORD_26205,22221,"Havells 240V 6A Four-Way 1440W Extension Board With Wire (White)- 1.5 Metre Cable, 10 Volt, 4 Universal sockets with Maste...",Warehouse B,20,10,2025-02-06 06:59:00,10
26205,ORD_26206,7256,POPIO Tempered Glass Compatible for iPhone 6 Plus / 6s Plus/iPhone 7 Plus/iPhone 8 Plus (Transparent) Full Screen Coverage...,Warehouse B,97,92,2025-02-06 07:53:00,5
26206,ORD_26207,5691,AMiRiTE- SMART GADGETS STORE AWC02 Flexible Shocked Proof Silicone TPU Watch Case Cover with Screen Protector Temper for S...,Warehouse A,47,40,2025-02-06 22:39:00,7
26207,ORD_26208,8343,"Nokia C12 Android 12 (Go Edition) Smartphone, All-Day Battery, 4GB RAM (2GB RAM + 2GB Virtual RAM) + 64GB Capacity | Light...",Warehouse A,93,81,2025-02-06 07:59:00,12
26208,ORD_26209,22267,Powerup Stay Charged® Dual USB Port Compatible for All Smartphones and Tablets 3.4Amp High Speed Car Charger - Black,Warehouse C,69,53,2025-02-06 01:47:00,16
26209,ORD_26210,25198,"Berrica Blueberry Skin Diet Cream with Raspberry & Vitamin A, C, E for Women | Repairs Skin Damage & Provides Skin Nutriti...",Warehouse B,66,56,2025-02-06 04:58:00,10
26210,ORD_26211,22899,Telmaset Beta 40mg/50mg Tablet,Warehouse C,75,69,2025-02-06 01:55:00,6
26211,ORD_26212,26379,Riminex Syrup,Warehouse C,11,5,2025-02-06 18:46:00,6
26212,ORD_26213,25800,Delcef 125mg Tablet,Warehouse A,31,18,2025-02-06 23:58:00,13
26213,ORD_26214,22667,Virdot 80mg Tablet,Warehouse B,62,57,2025-02-06 21:15:00,5
26214,ORD_26215,6980,MI 10000mAh 3i Lithium Polymer Power Bank Dual Input(Micro-USB and Type C) and Output Ports 18W Fast Charging (Metallic Blue),Warehouse B,79,71,2025-02-06 05:28:00,8
26215,ORD_26216,9396,Crucial MX500 1TB SATA 6.35 cm (2.5-inch) 7mm Internal SSD (CT1000MX500SSD1),Warehouse B,98,93,2025-02-06 18:32:00,5
26216,ORD_26217,9395,Ofbid OZ Suspension,Warehouse B,70,53,2025-02-06 21:31:00,17
26217,ORD_26218,6571,"ASUS Vivobook 16X (2022), 16-inch (40.64 cms) WUXGA, AMD Ryzen 5 5600H, Thin and Light Laptop (8GB/512GB SSD/Integrated Gr...",Warehouse C,38,31,2025-02-06 19:48:00,7
26218,ORD_26219,23983,EcoBerry Kajal/Eyeliner Bhringraj infused Deep Black Kohl | Coolant Cleanses | Lead Paraben Free No Artificial Colors 100%...,Warehouse B,50,42,2025-02-06 19:52:00,8
26219,ORD_26220,26958,Moximentin BD Dry Syrup,Warehouse B,31,14,2025-02-06 16:42:00,17
26220,ORD_26221,21962,Faces Canada Ultime Pro Brow Shaping Kit 01 4 Gm,Warehouse A,105,93,2025-02-06 10:08:00,12
26221,ORD_26222,6272,Protect & Care Deodorant - No Skin Irritation & 48h Freshness,Warehouse B,78,72,2025-02-06 09:18:00,6
26222,ORD_26223,23066,Azafran Organic Jasmine Floral Water 200 ml,Warehouse B,89,82,2025-02-06 09:41:00,7
26223,ORD_26224,22979,"Fashion Colour Vitamin C Foundation / White Perfect Foundation, Shade 02 40 gm",Warehouse C,89,81,2025-02-06 17:54:00,8
26224,ORD_26225,21639,Val BM Tablet,Warehouse C,13,7,2025-02-06 02:37:00,6
26225,ORD_26226,24868,"Lapster Universal Silicone 14.0"" Keyboard Protector Skin||Keyboard Dust Cover| Keyboard Skin for 14.0"" Laptop |14.0"" Keygu...",Warehouse A,104,89,2025-02-06 22:57:00,15
26226,ORD_26227,20999,Revolution Pro Supreme Matte Lip Pigment-Show 2.5 ml,Warehouse C,28,10,2025-02-06 09:08:00,18
26227,ORD_26228,14595,"NIVEA Talcum Powder for Men & Women, Pure, For Gentle Fragrance & Reliable Protection Against Body Odour, 100 g",Warehouse B,41,24,2025-02-06 20:46:00,17
26228,ORD_26229,21159,OpenTech® Tempered Glass Screen Protector Compatible with OnePlus 9RT 5G with Edge to Edge Coverage and Easy Installation kit,Warehouse C,31,15,2025-02-06 00:14:00,16
26229,ORD_26230,23555,POPIO Tempered Glass Screen Protector Compatible for Samsung Galaxy M42 5G / M12 / M02s / M02 / A02s with Full Screen Cove...,Warehouse C,21,9,2025-02-06 07:28:00,12
26230,ORD_26231,7521,Mirah Belle Lemon Hand Wash 2000 ml,Warehouse C,63,56,2025-02-06 05:00:00,7
26231,ORD_26232,26865,Sivanna Colors Natural Megic Color Blush - 01 8.5 gm,Warehouse C,23,13,2025-02-06 06:53:00,10
26232,ORD_26233,21960,Zapcase Back Case Cover for Mi Redmi Note 8 Pro | Compatible for Mi Redmi Note 8 Pro Back Case Cover | Clear Case for Mi R...,Warehouse A,35,17,2025-02-06 22:52:00,18
26233,ORD_26234,22632,Fenotorva 10 Capsule,Warehouse C,106,98,2025-02-06 07:10:00,8
26234,ORD_26235,21117,Mirah Belle Neroli Exfoliating Face Wash 200 ml,Warehouse C,59,44,2025-02-06 06:19:00,15
26235,ORD_26236,8329,Rabauro 20mg Tablet,Warehouse A,23,14,2025-02-06 03:23:00,9
26236,ORD_26237,8486,Rekcin 250mg Tablet,Warehouse B,81,64,2025-02-06 06:06:00,17
26237,ORD_26238,6820,Daily Life Forever52 Powder / Blush Brush Nx008 1's,Warehouse A,60,41,2025-02-06 00:37:00,19
26238,ORD_26239,21135,Sinargic Tablet,Warehouse C,51,38,2025-02-06 17:00:00,13
26239,ORD_26240,6374,"Lakme 9 to 5 Primer + Matte Lip Color, MR20 Ruby Rush, 3.6 g",Warehouse A,68,52,2025-02-06 12:25:00,16
26240,ORD_26241,22626,Recaine 20mg Tablet,Warehouse B,78,66,2025-02-06 17:49:00,12
26241,ORD_26242,24043,LINLO Tempered Glass Screen Protector Compatible for Samsung S21 FE 5G with Edge to Edge Coverage and Easy Installation Ki...,Warehouse B,35,24,2025-02-06 22:03:00,11
26242,ORD_26243,6824,Cexus Kid 125mg Tablet,Warehouse B,53,43,2025-02-06 10:26:00,10
26243,ORD_26244,23028,Ikonic Titanium Thermal Hair Brush - Thb 32 Black And Grey 1's,Warehouse A,105,90,2025-02-06 05:12:00,15
26244,ORD_26245,8615,Healotryp Forte Tablet,Warehouse B,104,88,2025-02-06 11:23:00,16
26245,ORD_26246,26254,Cello ColourUp Wax Crayon Jumbo - Pack of 24 bright shades | 2 Times Stronger body in Jumbo sized crayons | Non-Toxic,Warehouse B,7,1,2025-02-06 18:57:00,6
26246,ORD_26247,6989,Odeon Silky Smooth Blossom Body Lotion 400 ml,Warehouse B,77,61,2025-02-06 14:33:00,16
26247,ORD_26248,6613,Gsar 2mg Tablet,Warehouse B,90,76,2025-02-06 12:27:00,14
26248,ORD_26249,23466,Kedex  Eye Drop,Warehouse A,53,40,2025-02-06 10:33:00,13
26249,ORD_26250,21934,Vega Hot Curl Brush (Large) (H2 - PRL) 168 gm,Warehouse B,86,77,2025-02-06 09:48:00,9
26250,ORD_26251,8056,"Sanfe Sakura Body Wax Strips for Sensitive Skin with Complementary Cleansing Wipes - 10 Strips I Removes hair, Soft & Smoo...",Warehouse B,25,6,2025-02-06 21:27:00,19
26251,ORD_26252,24049,DULANE M 30MG/1500MCG TABLET,Warehouse C,72,58,2025-02-06 06:00:00,14
26252,ORD_26253,26334,Canto Zole 20mg Capsule,Warehouse B,58,47,2025-02-06 15:52:00,11
26253,ORD_26254,8653,Schwarzkopf Professional Bonacure Q10 Time Restore Shampoo | For Mature Hair | 250ml,Warehouse B,101,84,2025-02-06 02:22:00,17
26254,ORD_26255,24461,Vizocef 200mg Tablet DT,Warehouse A,36,25,2025-02-06 02:22:00,11
26255,ORD_26256,8076,Genopax 200mg Tablet,Warehouse C,73,61,2025-02-06 20:10:00,12
26256,ORD_26257,21601,Olmedol CD 40mg/10mg Tablet,Warehouse C,50,42,2025-02-06 20:22:00,8
26257,ORD_26258,23006,Lndip 20 Tablet,Warehouse C,37,29,2025-02-06 17:43:00,8
26258,ORD_26259,9196,Bella Voste Sugar Baby Nail Paints Shade 362 10 Ml,Warehouse A,14,5,2025-02-06 16:40:00,9
26259,ORD_26260,25539,URBN 10000 mAh Li-Polymer Ultra Compact Power Bank | 12W Fast Charge | Dual USB Output | Type C | Micro Input | Pocket Siz...,Warehouse A,69,61,2025-02-06 12:38:00,8
26260,ORD_26261,22269,"Maybelline New York Colossal Kajal, Super Black (Pack of 2 at 20% Off)",Warehouse A,101,86,2025-02-06 23:14:00,15
26261,ORD_26262,26388,Nervopil 400mg Tablet,Warehouse B,74,64,2025-02-06 19:59:00,10
26262,ORD_26263,26858,Levoflox 500 Infusion,Warehouse A,54,49,2025-02-06 10:51:00,5
26263,ORD_26264,5952,"MICROWARE HDMI to VGA Adapter Converter with 3.5mm Stereo Audio, Active Female HDMI to VGA Male 1080p Video Dongle Adaptor...",Warehouse A,79,72,2025-02-06 16:50:00,7
26264,ORD_26265,26962,C Pax 1000mg/500mg Injection,Warehouse B,97,81,2025-02-06 14:51:00,16
26265,ORD_26266,6102,Dynamic Triple Black - 8 OZ,Warehouse B,104,85,2025-02-06 05:00:00,19
26266,ORD_26267,25405,"(Renewed) boAt Rockerz 255 Pro Made in India in Ear Bluetooth Neckband with Upto 10 Hours Playback, ASAP Charge, IPX5, boA...",Warehouse B,25,15,2025-02-06 16:23:00,10
26267,ORD_26268,6403,Myglamm Wandurlust Sand Matt Nail Paint Banoffee Pie 11 Ml,Warehouse B,28,14,2025-02-06 07:55:00,14
26268,ORD_26269,6714,Gatispan 200mg Tablet,Warehouse B,17,3,2025-02-06 06:23:00,14
26269,ORD_26270,25170,Dex Rabato Tablet,Warehouse B,66,48,2025-02-06 03:55:00,18
26270,ORD_26271,24555,"Portronics Ruffpad 15M 15Inch (38.1cm) Re-Writable Multicolor LCD Writing Pad with Smart Lock,India's first notepad to sav...",Warehouse B,83,77,2025-02-06 18:18:00,6
26271,ORD_26272,6244,The Face Shop Fmgt Designing Eyebrow Pencil 03 Brown (0.3g),Warehouse C,63,56,2025-02-06 04:47:00,7
26272,ORD_26273,8784,Perfume Body Spray - Enchanted Spring For Women,Warehouse C,30,13,2025-02-06 06:54:00,17
26273,ORD_26274,20962,Morniff Plus 10mg/10mg/2.5mg Tablet,Warehouse B,32,22,2025-02-06 16:16:00,10
26274,ORD_26275,25178,"Rousrie (Pack of 50) Aesthetic Laptop Stickers for Journal Supplies kit, Phone case, Quotes Stickers for Scrapbook, Cute K...",Warehouse A,29,19,2025-02-06 01:45:00,10
26275,ORD_26276,25515,Ajmal Aurum EDP Fruity Floral Perfume 75ml for Women and Zeal EDP Aquatic Woody Perfume 100ml for Men +1 Perfume Tester FREE,Warehouse A,29,14,2025-02-06 20:00:00,15
26276,ORD_26277,24799,Google Pixel 6 Charger Original [Compatible] with Google Pixel 6 / Google Pixel 6A / Google Pixel 6 Pro Adapter/Google Pix...,Warehouse C,106,88,2025-02-06 06:34:00,18
26277,ORD_26278,6565,Miss Rose Matte Smudge Proof LipGloss 7701 - 002M 13,Warehouse C,16,9,2025-02-06 06:23:00,7
26278,ORD_26279,24183,Dexace 5mg Tablet,Warehouse A,87,68,2025-02-06 05:16:00,19
26279,ORD_26280,23416,Episol Plus 30 mg/100 mg Tablet,Warehouse C,83,78,2025-02-06 09:07:00,5
26280,ORD_26281,5733,Saregama Carvaan Mini Hindi 2.0- Music Player with Bluetooth/FM/AM/AUX (Mint Green),Warehouse A,36,20,2025-02-06 20:27:00,16
26281,ORD_26282,8222,Premium Cotton Buds,Warehouse C,38,27,2025-02-06 12:24:00,11
26282,ORD_26283,25908,"Hammer Ace 3.0 Bluetooth Calling Smart Watch with Largest 1.85"" IPS Display, Dual Mode, Spo2, Heart Rate, Strong Metallic ...",Warehouse A,98,93,2025-02-06 19:24:00,5
26283,ORD_26284,26108,Raktavardhini Syrup,Warehouse B,74,64,2025-02-06 00:47:00,10
26284,ORD_26285,26555,"House of Quirk Men's and Women's Plastic Frame Full Rim Horizontal Lazy High Definition Prism Periscope Glasses (Black, No...",Warehouse C,28,20,2025-02-06 19:36:00,8
26285,ORD_26286,25345,Gemblue Biocare Black Seed Scrub 500 ml,Warehouse C,69,50,2025-02-06 13:30:00,19
26286,ORD_26287,8537,St.Botanica Brightening Night Gel - Vitamin C 50 gm,Warehouse C,72,59,2025-02-06 17:16:00,13
26287,ORD_26288,7096,"Fashion Colour Light Corrective Concealer Stick, Shade 03 11 gm",Warehouse A,19,14,2025-02-06 06:40:00,5
26288,ORD_26289,6487,Doxinit 100mg Tablet,Warehouse B,64,52,2025-02-06 09:35:00,12
26289,ORD_26290,7398,Benzofen Gel,Warehouse C,51,44,2025-02-06 09:55:00,7
26290,ORD_26291,6154,Aziwok 250 Tablet,Warehouse C,101,89,2025-02-06 21:26:00,12
26291,ORD_26292,26013,Amoxprl CV 500mg/125mg Tablet,Warehouse A,22,14,2025-02-06 07:24:00,8
26292,ORD_26293,7664,Frevent Syrup,Warehouse C,77,68,2025-02-06 06:39:00,9
26293,ORD_26294,7065,Pocket Perfume - Romantic,Warehouse B,13,7,2025-02-06 12:33:00,6
26294,ORD_26295,23749,Parawin 250mg Syrup,Warehouse A,115,97,2025-02-06 22:06:00,18
26295,ORD_26296,22069,Megacold  Kid Syrup,Warehouse A,55,47,2025-02-06 21:33:00,8
26296,ORD_26297,25129,Neem Tulsi & Aloe Vera Handwash,Warehouse B,96,87,2025-02-06 02:03:00,9
26297,ORD_26298,7171,"OpenTech® Tempered Glass Screen Protector Compatible for Samsung Galaxy Watch 4 (44mm) / Watch 5 (44mm) (1.4"" inch) (Pack ...",Warehouse A,68,58,2025-02-06 08:31:00,10
26298,ORD_26299,20950,"Fashion Colour Kiss Lip No Transfer Lipstick, 82 Lavender 2.6 gm",Warehouse B,67,59,2025-02-06 19:25:00,8
26299,ORD_26300,21174,Ajmal Mukhallat Al Wafa Concentrated Perfume Oil Oriental Musky And Sacrifice II For Him Deodorant Fruity Aromatic Fragrance 212 ml,Warehouse C,46,34,2025-02-06 00:00:00,12
26300,ORD_26301,20325,Amazon Brand - Solimo Silicone Back Cover for Nothing Phone 1 | Compatible for Nothing Phone 1 Back Case Cover | Liquid Si...,Warehouse B,46,36,2025-02-06 11:12:00,10
26301,ORD_26302,23130,TheGiftKart Tough Armor Samsung Galaxy M33 Bumper Back Case Cover | Ring Holder & Kickstand in-Built | 360 Degree Protecti...,Warehouse C,52,37,2025-02-06 04:17:00,15
26302,ORD_26303,8498,Streetwear Nail Enamel (Matte) - Warm Brown 8 Ml,Warehouse B,26,7,2025-02-06 20:06:00,19
26303,ORD_26304,6744,Orniderm Plus Cream,Warehouse B,102,90,2025-02-06 02:45:00,12
26304,ORD_26305,5725,Serafam-A Tablet,Warehouse C,21,15,2025-02-06 23:15:00,6
26305,ORD_26306,5940,Tobomac 80 Injection,Warehouse C,102,86,2025-02-06 10:45:00,16
26306,ORD_26307,7790,Spigen Liquid Air Back Cover Case Compatible with iPhone 14 (TPU | Navy Blue),Warehouse C,39,32,2025-02-06 13:14:00,7
26307,ORD_26308,22299,"Affix Auto-Align Technology Tempered Glass Screen Guard for iPhone 14, iPhone 13 and for iPhone 13 Pro (6.1 Inch) | Easy I...",Warehouse C,34,21,2025-02-06 06:10:00,13
26308,ORD_26309,8102,Vomi OF 2mg Oral Drops,Warehouse B,78,71,2025-02-06 12:23:00,7
26309,ORD_26310,25830,Neurocetam 800 Tablet,Warehouse B,68,60,2025-02-06 03:49:00,8
26310,ORD_26311,7796,Nucolate-Plus Tablet,Warehouse A,102,90,2025-02-06 14:00:00,12
26311,ORD_26312,23422,Beardo Beard Wash Gel - The Black Velvette 100 ml,Warehouse C,108,99,2025-02-06 13:08:00,9
26312,ORD_26313,25824,Myodic-TH Tablet,Warehouse B,21,3,2025-02-06 08:05:00,18
26313,ORD_26314,23427,TheGiftKart Genuine Liquid Silicone Back Cover Case for Samsung Galaxy S23 Ultra 5G | Soft Micro-Fibre Lining Inside | Tot...,Warehouse C,25,12,2025-02-06 15:34:00,13
26314,ORD_26315,8668,TheGiftKart Ultra-Hybrid Crystal Clear Back Case Cover for iPhone 14 Pro MAX | Shockproof Design | Camera Protection Bump...,Warehouse B,20,15,2025-02-06 07:54:00,5
26315,ORD_26316,22887,Skin Awakening Moisture Boost Face Serum,Warehouse A,52,40,2025-02-06 09:34:00,12
26316,ORD_26317,6057,Sery Colorflirt Nail Paint Cherry Berry Red 10 ml,Warehouse A,65,51,2025-02-06 10:32:00,14
26317,ORD_26318,9152,Electvision Bluetooth Compatible for [aux to Bluetooth Converter] [Bluetooth for car Music System][Transmitter and Receive...,Warehouse C,47,30,2025-02-06 00:36:00,17
26318,ORD_26319,23620,SUGAR Cosmetics Aquaholic Instant Pore Cleansing Mask 70 gm,Warehouse C,73,65,2025-02-06 16:22:00,8
26319,ORD_26320,21369,Mancode Vitamin C Peel off Mask 100 gm,Warehouse A,83,72,2025-02-06 12:04:00,11
26320,ORD_26321,23436,Amline 2.5 Tablet,Warehouse B,73,59,2025-02-06 22:20:00,14
26321,ORD_26322,24552,"Prime deal 3-Pin Traveler Conversion Plug Convert EU US UK AU To India, Power Adaptor (White) - (Pack Of 4)",Warehouse B,103,95,2025-02-06 13:47:00,8
26322,ORD_26323,7318,Montgold Tablet,Warehouse A,73,60,2025-02-06 10:53:00,13
26323,ORD_26324,6961,"Laptop Pink Table Mate Multi Purpose Foldable, Adjustable Strong Table with 6 Heights, 3 Angles Adjustable for Laptop, Stu...",Warehouse B,18,1,2025-02-06 06:25:00,17
26324,ORD_26325,7040,"Coloressence Mesmerizing Lip Color, Poetry in Pink 4g",Warehouse B,42,24,2025-02-06 19:05:00,18
26325,ORD_26326,26166,"CASON CS6 Real 4K 30fps HD Dual Screen Action Camera for Vlogging with EIS+Gyro,Anti Shake Touch Screen Waterproof Sports ...",Warehouse C,101,88,2025-02-06 04:51:00,13
26326,ORD_26327,24988,Prilox 200mg Tablet,Warehouse C,72,67,2025-02-06 17:58:00,5
26327,ORD_26328,20473,Indofix O 200mg/200mg Tablet,Warehouse C,53,34,2025-02-06 12:05:00,19
26328,ORD_26329,20947,"POPIO Tempered Glass Screen Protector for Fossil Gen 6 42mm / 44mm (Men/Women), Michael Kors Gen 6 Bradshaw (Pack of 2)",Warehouse B,61,43,2025-02-06 12:03:00,18
26329,ORD_26330,25138,Skin Firming Concentrate,Warehouse A,88,75,2025-02-06 15:32:00,13
26330,ORD_26331,5828,Monvent LC 5mg/10mg Tablet,Warehouse C,70,59,2025-02-06 23:57:00,11
26331,ORD_26332,26103,Clomic S Ointment,Warehouse C,100,85,2025-02-06 07:20:00,15
26332,ORD_26333,6883,Jovees Detoxifying Face Wash - Activated Charcoal 120 ml,Warehouse A,62,56,2025-02-06 00:28:00,6
26333,ORD_26334,22361,Nutriment Ubtan Cream All Skin Type 250 gm,Warehouse C,76,68,2025-02-06 22:43:00,8
26334,ORD_26335,5887,Cerin 50mg Capsule,Warehouse B,17,4,2025-02-06 14:38:00,13
26335,ORD_26336,25315,Mycopil Cream,Warehouse B,12,5,2025-02-06 06:43:00,7
26336,ORD_26337,23702,Scabex S Lotion,Warehouse B,89,70,2025-02-06 18:56:00,19
26337,ORD_26338,5792,Vega Flat Brush (E1 - FB) 105 gm,Warehouse C,14,4,2025-02-06 23:42:00,10
26338,ORD_26339,21795,Pimple Clear & Germ Removal Face Wash,Warehouse B,76,69,2025-02-06 14:39:00,7
26339,ORD_26340,20372,Active Antacid,Warehouse A,102,91,2025-02-06 11:54:00,11
26340,ORD_26341,22528,Estib 10mg Tablet,Warehouse C,13,1,2025-02-06 18:11:00,12
26341,ORD_26342,9050,Odeon Charcoal & Tea Tree Face And Body Scrub 100 ml,Warehouse B,59,51,2025-02-06 02:07:00,8
26342,ORD_26343,9259,Zady Redimix 200mg Syrup,Warehouse B,15,7,2025-02-06 00:27:00,8
26343,ORD_26344,23249,Acer Extensa 15 Lightweight Laptop Intel Core i5 11th Gen Processor - (8 GB/ 512 GB SSD/ Windows 11 Home/ 1.7kg/ Black/ El...,Warehouse B,81,66,2025-02-06 01:14:00,15
26344,ORD_26345,7142,"Bennett Laptop Bag for Menं & Women 15.6 inch, 25 L Water Resistant Bag Laptop Apple/Dell/Lenovo/Asus/Hp/Samsung/Mi/MacBoo...",Warehouse B,110,92,2025-02-06 14:42:00,18
26345,ORD_26346,26503,Gastrox Oral Gel,Warehouse A,39,24,2025-02-06 10:39:00,15
26346,ORD_26347,6542,"Fashion Colour Two Way Pancake, Shade 04 10 gm",Warehouse C,30,15,2025-02-06 01:13:00,15
26347,ORD_26348,26689,Gear Classic 20L Faux Leather Water Resistant Anti Theft Laptop Bag/Backpack for Men/Women-Navy,Warehouse C,86,68,2025-02-06 04:33:00,18
26348,ORD_26349,8866,StayHappi Naproxen+Domperidone 500mg/10mg Tablet,Warehouse B,43,25,2025-02-06 11:28:00,18
26349,ORD_26350,21219,Rabedoze IT 20mg/150mg Capsule SR,Warehouse B,98,82,2025-02-06 06:26:00,16
26350,ORD_26351,20743,Hynix Sk 8gb 2rx8 Pc3l-12800s 1600mhz Laptop RAM Memory Hmt41gs6bfr8a-pb,Warehouse B,73,55,2025-02-06 05:40:00,18
26351,ORD_26352,20531,Pecan™ Premium Mini Metal Folding Portable Laptop Stand Non-Slip Base Tabletop Risers for 10-17 Inch Laptop & Keyboard & T...,Warehouse B,17,9,2025-02-06 20:29:00,8
26352,ORD_26353,21534,combo of white kajal lipstick black eye liner and black eye brow pencil,Warehouse C,42,23,2025-02-06 17:50:00,19
26353,ORD_26354,20520,"Handwash - Liquid, Hand Made",Warehouse C,31,17,2025-02-06 14:32:00,14
26354,ORD_26355,22389,Alefen-M Tablet,Warehouse A,30,19,2025-02-06 17:07:00,11
26355,ORD_26356,21981,Dulocin 20mg Tablet,Warehouse A,59,53,2025-02-06 00:46:00,6
26356,ORD_26357,22732,"Lotion - Face & Body, Bio Sandalwood",Warehouse C,65,48,2025-02-06 06:36:00,17
26357,ORD_26358,22387,"AJO M1 Bluetoth Wireless Smart Watch Fitness Band for Boys, Girls, Men, Women & Kids Sports Watch for All Smart Phones I H...",Warehouse C,60,50,2025-02-06 13:51:00,10
26358,ORD_26359,26614,Sumate 50mg Tablet,Warehouse A,64,47,2025-02-06 01:58:00,17
26359,ORD_26360,21488,"Menstrual Cup - Small Size, For Women Above 30 Years Of Age Or Who Have Given Birth",Warehouse C,85,75,2025-02-06 11:39:00,10
26360,ORD_26361,8540,Series After Shave Splash - Cool Wave,Warehouse B,30,12,2025-02-06 23:19:00,18
26361,ORD_26362,24356,Nomxime 100mg Tablet,Warehouse C,95,80,2025-02-06 12:03:00,15
26362,ORD_26363,8819,Pause 500mg Injection,Warehouse C,101,85,2025-02-06 02:47:00,16
26363,ORD_26364,21827,Uricrak 40mg Tablet,Warehouse C,111,94,2025-02-06 03:45:00,17
26364,ORD_26365,8544,Remote Compatible for Samsung AC Remote(White) 90,Warehouse A,36,24,2025-02-06 10:33:00,12
26365,ORD_26366,26598,"Logitech G102 USB Light Sync Gaming Mouse with Customizable RGB Lighting, 6 Programmable Buttons, Gaming Grade Sensor, 8K ...",Warehouse C,80,66,2025-02-06 11:29:00,14
26366,ORD_26367,23307,"Exotic Aromas Lavender Essential Oil & Rose Oil, Pack of 2",Warehouse A,67,62,2025-02-06 12:07:00,5
26367,ORD_26368,26494,"Sandal & Turmeric Soap 150gx4 + Soap-Glycerine 375gx3, Buy 2 Get 1 Free",Warehouse C,52,45,2025-02-06 03:47:00,7
26368,ORD_26369,8715,Dell Kb216 Wired Multimedia USB Keyboard with Super Quite Plunger Keys with Spill-Resistant  Black,Warehouse C,43,24,2025-02-06 11:13:00,19
26369,ORD_26370,20469,Nazorb-DS Oral Suspension,Warehouse C,81,68,2025-02-06 10:01:00,13
26370,ORD_26371,22027,Giloy Juice- Natural Immunity Booster,Warehouse C,47,33,2025-02-06 12:17:00,14
26371,ORD_26372,7677,Carbonado Gaming Backpack | For 17.3 inch Laptop Compatible for Carrying Gaming Laptop and Gaming Accessories | Unisex,Warehouse A,44,35,2025-02-06 22:09:00,9
26372,ORD_26373,7676,"Clapone 8X40 HD Professional Binocular for Long Distance Birds Watching Traveling Outdoor Sports, (Black Color)",Warehouse C,26,21,2025-02-06 16:16:00,5
26373,ORD_26374,20463,TRONA Foldable Bed Study Table Portable Multifunction Laptop-Table Lapdesk for Children Bed Foldabe Table Work Office Home...,Warehouse C,64,55,2025-02-06 00:02:00,9
26374,ORD_26375,25106,"LOXXO® Compatible with iPhone 14 Pro Max Case, Liquid Silicone Case, Full Body Protective Cover, Shockproof, Slim Phone Ca...",Warehouse A,70,53,2025-02-06 00:26:00,17
26375,ORD_26376,20459,"Fashion Colour Baked Blusher, Shade 01 8 gm",Warehouse C,103,98,2025-02-06 07:27:00,5
26376,ORD_26377,7415,PIGMENTO Tablets - A Natural Therapy For Vitiligo,Warehouse A,77,72,2025-02-06 01:18:00,5
26377,ORD_26378,22443,Yflox 200mg Tablet,Warehouse B,34,17,2025-02-06 04:54:00,17
26378,ORD_26379,24340,"Boult Audio Z15 with 32Hrs Playtime, Pro+Calling HD Mic, Type-C Lightning Boult Fast Charging (10mins=100Mins), BoomX Tech...",Warehouse A,94,77,2025-02-06 03:20:00,17
26379,ORD_26380,9300,"Fashion Colour Vivid Matte Lipstick, 21 Nude Pink 3.8 gm",Warehouse C,100,87,2025-02-06 11:30:00,13
26380,ORD_26381,25075,Lipicure-AS 75 Capsule,Warehouse A,25,9,2025-02-06 04:14:00,16
26381,ORD_26382,24651,Niza Spas 20mg/100mg Tablet,Warehouse A,68,51,2025-02-06 10:57:00,17
26382,ORD_26383,22423,Amla Powder,Warehouse A,94,84,2025-02-06 02:06:00,10
26383,ORD_26384,20765,"Samsung Galaxy A53 Black, 8GB RAM, 128GB Storage",Warehouse A,88,71,2025-02-06 04:42:00,17
26384,ORD_26385,21474,CTD-T AM 6.25/40/5 Tablet,Warehouse C,60,48,2025-02-06 20:16:00,12
26385,ORD_26386,26027,"Maybelline New York Super Stay 24H Full Coverage Liquid Foundation, Natural Ivory 112, 30ml and Maybelline New York Super ...",Warehouse C,32,27,2025-02-06 10:46:00,5
26386,ORD_26387,20796,Amazon Basics Tough Rugged Shockproof with Lock Cover Case Compatible with AirPods Pro 2 / AirPods Pro GEN-2 (2022),Warehouse C,91,79,2025-02-06 05:02:00,12
26387,ORD_26388,25351,DeBelle Gel Nail Lacquer Blackberry Mousse Indigo Nail Polish 8 ml,Warehouse B,55,49,2025-02-06 01:40:00,6
26388,ORD_26389,35298,Robustrion Anti-Scratch & Smudge Proof Premium Tempered Glass Screen Protector Guard for Lenovo Tab M10 FHD Plus 10.3 inc...,Warehouse A,36,20,2025-02-06 23:23:00,16
26389,ORD_26390,30004,"Clea Cleansing & Makeup Remover Wipes Wet Wipes for Face Moisturizing - Lemon & Tulsi (8 Wipes/Pack, Pack of 5)",Warehouse A,54,38,2025-02-06 08:09:00,16
26390,ORD_26391,1065,Colirite Oral Suspension,Warehouse B,40,25,2025-02-06 15:55:00,15
26391,ORD_26392,36757,"(Renewed) DELL Latitude 5490 Core i5 7th Gen Laptop, 16 GB RAM, 256GB SSD, Intel HD Graphics, 14 inch (36.83 cms) HD Scree...",Warehouse B,58,41,2025-02-06 08:05:00,17
26392,ORD_26393,4942,Reequil Fruit Aha Face Wash For Hyperpigmentation & Skin Brightening 200 ml,Warehouse B,74,63,2025-02-06 17:59:00,11
26393,ORD_26394,4943,"boAt Micro USB 55 Tangle-free, Sturdy Micro USB Cable with 3A Fast Charging & 480mbps Data Transmission (Black)",Warehouse B,21,14,2025-02-06 08:12:00,7
26394,ORD_26395,9917,ADISA Large Laptop Backpack Office Bag College Travel Back Pack with USB (Black),Warehouse B,72,59,2025-02-06 01:25:00,13
26395,ORD_26396,4976,Eascof Syrup,Warehouse B,102,96,2025-02-06 09:13:00,6
26396,ORD_26397,28040,"Parker Quink Roller Ball Refill (Blue), Pack of 1 (9000012124)",Warehouse A,97,78,2025-02-06 00:46:00,19
26397,ORD_26398,27441,Levowok 500mg Tablet,Warehouse B,48,35,2025-02-06 03:22:00,13
26398,ORD_26399,19350,Arifine 10mg Tablet,Warehouse C,51,33,2025-02-06 23:54:00,18
26399,ORD_26400,36318,Mcaffeine Naked & Raw Coffee Cappuccino Body Wash 300 ml,Warehouse A,111,93,2025-02-06 11:14:00,18
26400,ORD_26401,27466,Vandyke AHA 25% + BHA 2% + PHA 5% Peeling Solution | AHA BHA Exfoliant With PHA (30 ml),Warehouse C,78,68,2025-02-06 10:23:00,10
26401,ORD_26402,13929,Olive & Almond Body Oil For Nourished Glowing Skin,Warehouse C,78,65,2025-02-06 09:57:00,13
26402,ORD_26403,461,D.B.Z.® eyebrow stamp & Hairline Waterproof And Long Lasting Shaping 10 g (Assorted Color),Warehouse C,70,63,2025-02-06 10:50:00,7
26403,ORD_26404,28050,Amazon Brand - Solimo Back Cover Case for Samsung Galaxy J7 Nxt/Samsung Galaxy J7 | Compatible for Samsung Galaxy J7 Nxt/S...,Warehouse A,19,12,2025-02-06 21:39:00,7
26404,ORD_26405,13658,ACNE-LAK 4 in 1 Pimple Care FaceWash 100 ML (Pack of 1),Warehouse B,58,45,2025-02-06 11:45:00,13
26405,ORD_26406,10052,AMiRiTE- SMART GADGETS STORE AWC02 Flexible Shocked Proof Silicone TPU Watch Case Cover with Screen Protector Temper for A...,Warehouse C,43,27,2025-02-06 10:17:00,16
26406,ORD_26407,19358,"Boult Audio Probass X1-Air Bluetooth Wireless in Ear Earphones with Mic with Fast Charging, 10H Battery Life & Extra Bass,...",Warehouse B,83,75,2025-02-06 12:46:00,8
26407,ORD_26408,9624,Cologne Spray Base Camp - For Men,Warehouse C,25,13,2025-02-06 02:49:00,12
26408,ORD_26409,27452,Protera 40mg Injection,Warehouse B,47,29,2025-02-06 03:35:00,18
26409,ORD_26410,27455,WIPRO ESSENTIAL 4+4 EXTENSION,Warehouse B,44,36,2025-02-06 10:31:00,8
26410,ORD_26411,450,Monty-FX Tablet,Warehouse C,79,71,2025-02-06 08:56:00,8
26411,ORD_26412,28016,Diurab LV 75mg/20mg Capsule,Warehouse A,69,59,2025-02-06 16:22:00,10
26412,ORD_26413,5380,Nature Cell Lightening Excel Emulsion Bxl Milk Pack 50 Gm,Warehouse B,24,5,2025-02-06 19:30:00,19
26413,ORD_26414,19833,Acer 139 cm (55 inches) I Series 4K Ultra HD Android Smart LED TV AR55AR2851UDFL (Black),Warehouse C,106,87,2025-02-06 09:46:00,19
26414,ORD_26415,28074,"Laprite Premium Ultra Thin Keyboard Cover Protector for MacBook Air 13"" A2179, A2337 M1 Chip Year 2020 - Transparent",Warehouse B,62,52,2025-02-06 04:37:00,10
26415,ORD_26416,13934,"boAt Stone 620 Bluetooth Speaker with 12W RMS Stereo Sound, 10HRS Playtime, TWS Feature, IPX4, Multi-Compatibility Mode(Blue)",Warehouse B,84,67,2025-02-06 13:55:00,17
26416,ORD_26417,36777,Rollosert 25 Tablet,Warehouse C,47,35,2025-02-06 23:57:00,12
26417,ORD_26418,36254,Nocid OM 500mg/500mg Capsule,Warehouse B,31,26,2025-02-06 10:15:00,5
26418,ORD_26419,19300,Daily Nourish Styling Gel - Normal Hold,Warehouse C,49,31,2025-02-06 02:36:00,18
26419,ORD_26420,9905,"7 Days Bye Bye Blemishes Face Cream, For Pigmentation & Blemish Freckle Removal Cream Wholesale Skin Care Freckle Cream Pi...",Warehouse A,31,17,2025-02-06 01:14:00,14
26420,ORD_26421,14020,Nature's Essence The Whitening Diamond Facial single use kit 20 gm,Warehouse B,83,71,2025-02-06 18:27:00,12
26421,ORD_26422,9949,"Dyazo Mobile Stand Holder for Desk Sturdy, Anti-Slip , Height Angle Adjustable Mobile Holder Cellphone Holder Compatible w...",Warehouse C,97,80,2025-02-06 19:24:00,17
26422,ORD_26423,27398,"Khadi Natural Herbal Amla Bhringraj Shampoo For Men And Women 200ml (Pack Of 1),Green,200 ml (Pack of 1)",Warehouse B,85,80,2025-02-06 14:47:00,5
26423,ORD_26424,567,"tizum Hard EVA 8 x USB Flash Drives Carrying Case, Black",Warehouse C,37,20,2025-02-06 09:03:00,17
26424,ORD_26425,36852,Levo 5mg Tablet,Warehouse B,23,9,2025-02-06 23:55:00,14
26425,ORD_26426,27404,"Lux Fresh Splash Soap, 4x100g + 1Free",Warehouse B,31,17,2025-02-06 10:08:00,14
26426,ORD_26427,4958,Ecwin 7.5mg Tablet,Warehouse B,62,51,2025-02-06 19:10:00,11
26427,ORD_26428,19272,Aesmin P 100mg/325mg Tablet,Warehouse A,52,45,2025-02-06 02:20:00,7
26428,ORD_26429,36724,"boAt Airdopes 441 Pro True Wireless in Ear Earbuds with mic, Upto 150 Hours Playback, Signature Sound, IWP Technology, IPX...",Warehouse C,96,86,2025-02-06 20:04:00,10
26429,ORD_26430,524,Pain Calm Balm,Warehouse C,88,83,2025-02-06 21:51:00,5
26430,ORD_26431,36218,"Scalpe Pro Anti-dandruff Shampoo 100 ml each, Pack of 4",Warehouse B,113,98,2025-02-06 23:18:00,15
26431,ORD_26432,19289,Vanace P Syrup,Warehouse C,100,94,2025-02-06 10:06:00,6
26432,ORD_26433,36230,"Usha FP 3810 Food Processor 1000 Watts Copper Motor with 13 Accessories(Premium SS Finish), Black and Steel",Warehouse A,70,56,2025-02-06 09:21:00,14
26433,ORD_26434,27422,Atarax Drops,Warehouse B,38,32,2025-02-06 06:00:00,6
26434,ORD_26435,19797,Amazon Brand - Solimo Back Cover Case for Mi Redmi Note 8 | Compatible for Mi Redmi Note 8 Back Cover Case | 360 Degree Pr...,Warehouse C,102,96,2025-02-06 18:59:00,6
26435,ORD_26436,27519,TheGiftKart Ultra-Hybrid Crystal Clear Back Case Cover for iPhone 13 | Shockproof Design | Camera Protection Bump | Hard C...,Warehouse C,78,62,2025-02-06 07:18:00,16
26436,ORD_26437,28172,Bio Rejuvenating Vetiver,Warehouse B,27,8,2025-02-06 00:21:00,19
26437,ORD_26438,36248,"Sun Shield - Bio Micro Gold Matte Cream, SPF 30",Warehouse C,36,17,2025-02-06 21:51:00,19
26438,ORD_26439,501,"Epaal Magnetic USB Charging Cable for Charging Adapter Realme Watch 2 & 2 Pro Only (Black, 1 Meter Long)",Warehouse B,37,25,2025-02-06 22:47:00,12
26439,ORD_26440,36250,Lactoclaav DS Dry Syrup,Warehouse A,29,10,2025-02-06 21:53:00,19
26440,ORD_26441,36186,Amazon Basics 3-in-1 USB Type C Adapter with HDMI/USB 3.0 Port/Type-C Outputs (Black),Warehouse B,54,49,2025-02-06 01:17:00,5
26441,ORD_26442,36170,Ron 4mg Tablet,Warehouse B,42,29,2025-02-06 22:07:00,13
26442,ORD_26443,554,Beauty People Pure Matte Lipstick - Caramel - 204 3.8 gm,Warehouse C,73,58,2025-02-06 20:47:00,15
26443,ORD_26444,28229,"Panasonic eneloop CC61N Portable with USB Input Charger for AA & AAA Rechargeable Batteries, Input AC100‐240V 50‐60HzWhit...",Warehouse B,105,89,2025-02-06 16:47:00,16
26444,ORD_26445,5332,M.G.R.J® Soft & Flexible Silicone TPU Case Cover for Amazfit GTS 2 New Version (2022) / GTS 2 / GTS 2E Smart Watch (Black),Warehouse A,67,61,2025-02-06 17:12:00,6
26445,ORD_26446,28281,Ronflox 200mg Tablet,Warehouse C,29,24,2025-02-06 13:09:00,5
26446,ORD_26447,27397,Nycil Cool Herbal Prickly Heat Powder - Pack of 2,Warehouse A,91,75,2025-02-06 02:14:00,16
26447,ORD_26448,28280,Valsamen 40mg Tablet,Warehouse B,13,6,2025-02-06 21:49:00,7
26448,ORD_26449,36152,Bella Voste 4-In-1 Makeup Stick Bronzy Buzz (13) 5.5 Gm,Warehouse A,103,88,2025-02-06 16:11:00,15
26449,ORD_26450,27966,"Gizga Essentials Professional 6-in-1 Cleaning Kit for Cameras & Sensitive Electronics (Includes: Air Blower, Cotton Swabs,...",Warehouse A,89,83,2025-02-06 00:44:00,6
26450,ORD_26451,5086,Parker Vector Mettalix Silver Trim Fountain Pen With Free Quink Blue Ink Bottle (Ink - Blue),Warehouse B,23,6,2025-02-06 14:04:00,17
26451,ORD_26452,19219,Triphala Brahmi Oil,Warehouse C,39,30,2025-02-06 17:12:00,9
26452,ORD_26453,36340,Winble Back Cover For OnePlus 9R ( Silicone|Blue ),Warehouse B,59,53,2025-02-06 16:09:00,6
26453,ORD_26454,27429,Losanorm 25-H Tablet,Warehouse A,111,99,2025-02-06 17:11:00,12
26454,ORD_26455,36256,Underarm Roll On Deodorant For Women - Powder Dry,Warehouse B,38,29,2025-02-06 21:41:00,9
26455,ORD_26456,36924,House of Beauty Dry Brush 1's,Warehouse C,108,90,2025-02-06 09:46:00,18
26456,ORD_26457,19049,Voglem GM 2mg/500mg/0.2mg Tablet,Warehouse C,76,59,2025-02-06 16:43:00,17
26457,ORD_26458,36932,"3M Scotch Kids Scissors | 5"" Scissors | Blunt Tip | Right and Left Handed | Paper, crafts, school",Warehouse A,115,98,2025-02-06 01:51:00,17
26458,ORD_26459,27303,Betty Barclay Woman No.1 Eau de Toilette Natural Spray 15 ml,Warehouse C,23,18,2025-02-06 10:18:00,5
26459,ORD_26460,5312,Zee 2mg Tablet,Warehouse A,89,82,2025-02-06 01:13:00,7
26460,ORD_26461,28513,"TP-Link TL-SG105S 5-Port Desktop Gigabit Ethernet Switch/Hub, Ethernet Splitter, Plug & Play, no Configuration Required, S...",Warehouse A,52,45,2025-02-06 13:31:00,7
26461,ORD_26462,13494,Spafast 4mg Injection,Warehouse B,91,73,2025-02-06 15:02:00,18
26462,ORD_26463,19063,AEIDESS Tempered Glass/Screen Guard Compatible for Oneplus 11R with Edge to Edge Full Screen Coverage (Transparent) Instal...,Warehouse B,32,18,2025-02-06 15:10:00,14
26463,ORD_26464,28492,Illuminating Dewy Face Mist,Warehouse B,64,49,2025-02-06 20:11:00,15
26464,ORD_26465,35972,Krevia Binocular for Long Distance | Telescopic Durbin for Bird Watching Trekking Sprots | Range – 1000 Mts | Zoom-8x40 | ...,Warehouse B,68,50,2025-02-06 13:59:00,18
26465,ORD_26466,13497,LYLA Empty Makeup Powder Foundation Case Air Cushion Puff BB Cream Container 15g Gold,Warehouse B,106,87,2025-02-06 14:33:00,19
26466,ORD_26467,28482,Vond 4mg Tablet MD,Warehouse C,96,81,2025-02-06 11:21:00,15
26467,ORD_26468,12927,Ceflox-Dee Optic Eye/Ear Drops,Warehouse B,22,13,2025-02-06 21:41:00,9
26468,ORD_26469,36039,Panasonic 3411 Cordless Landline Phone Black,Warehouse A,40,26,2025-02-06 10:59:00,14
26469,ORD_26470,28403,Hair Removal Waxing Strips Kit - Normal Skin,Warehouse C,85,66,2025-02-06 20:49:00,19
26470,ORD_26471,36128,T Levo 500mg Tablet,Warehouse C,37,28,2025-02-06 14:52:00,9
26471,ORD_26472,19199,"Bounce Hair Recovery Complex, Biotin & Selenium - Green Apple Flavour",Warehouse B,28,23,2025-02-06 18:20:00,5
26472,ORD_26473,28321,"Zebronics Zeb-Kai Wireless Mouse - Bluetooth & 2.4GHz with USB Nano Receiver (Dual Connectivity), Power On/Off Switch, 150...",Warehouse B,114,98,2025-02-06 22:23:00,16
26473,ORD_26474,27358,Herbal Hair Care - For Men,Warehouse A,46,28,2025-02-06 16:41:00,18
26474,ORD_26475,13102,Ban Labs Cutfar Ointment - 25G (Pack of 2) | Cracked Heels repair | Chilblain Cream | foot cream |Cuts & Wounds |Rough Ski...,Warehouse C,84,70,2025-02-06 01:48:00,14
26475,ORD_26476,152,Coravog 0.3mg Tablet,Warehouse C,105,97,2025-02-06 23:25:00,8
26476,ORD_26477,5227,Syther Injection,Warehouse C,99,93,2025-02-06 05:17:00,6
26477,ORD_26478,36379,"Lapster 4.3v ultra fast USB charging cable compatible with most philips trimmer, shavers, body groomers & multi grooming m...",Warehouse B,94,86,2025-02-06 02:05:00,8
26478,ORD_26479,5331,Apple AirPods Pro (2nd Generation) ​​​​​​​,Warehouse C,50,31,2025-02-06 04:19:00,19
26479,ORD_26480,158,"D-Link DIR-825/IIN/J1 MU-MIMO Gigabit Wireless Router, Dual Band, 1200 Mbps Wi-Fi Speed, 5 Gigabit Port, 4 External Antenn...",Warehouse A,54,47,2025-02-06 12:07:00,7
26480,ORD_26481,27341,Kansel -DS Gel,Warehouse A,102,95,2025-02-06 14:41:00,7
26481,ORD_26482,14061,"Mars Ultra Shine Gold Sequins Lipstick Very Magenta, 3.6g (L287-01-NEW)",Warehouse B,104,98,2025-02-06 19:21:00,6
26482,ORD_26483,28521,Alcopod-CV Tablet,Warehouse A,57,51,2025-02-06 00:24:00,6
26483,ORD_26484,35980,"(Renewed) boAt Stone 190 Portable Wireless Speaker with 5W Premium Sound, Bluetooth V5.0, IPX7 Water & Splash Resistance, ...",Warehouse B,17,8,2025-02-06 19:13:00,9
26484,ORD_26485,27438,"LS LAPSTER Quality Assured Universal Silicone 15.6"" Keyboard Protector Skin|| Keyboard Dust Cover|| Keyboard Skin for 15....",Warehouse C,38,28,2025-02-06 20:48:00,10
26485,ORD_26486,27869,Oriflame Milk And Honey Gold Nourishing Hand And Body Cream (250g),Warehouse C,89,70,2025-02-06 06:56:00,19
26486,ORD_26487,19811,boAt Bassheads 242 in Ear Wired Earphones with Mic(Active Black),Warehouse A,81,74,2025-02-06 07:52:00,7
26487,ORD_26488,214,Oflibact OZ Oral Suspension,Warehouse B,31,19,2025-02-06 14:58:00,12
26488,ORD_26489,9899,Ajmal Vibrant Ether & Primitive Forests EDT Pack of 2 500 ml,Warehouse B,108,91,2025-02-06 21:19:00,17
26489,ORD_26490,28105,Avokold N Tablet,Warehouse C,101,83,2025-02-06 06:40:00,18
26490,ORD_26491,28103,"Heal n Cure Glow Cream - 20Gm Enriched With Kojic Acid, Alpha Arbutin, Glycolic Acid, Niacinamide | Best For Melasma, Pigm...",Warehouse C,49,32,2025-02-06 23:25:00,17
26491,ORD_26492,5393,"Boult Audio Truebuds Truly Wireless in Ear Earbuds with 32H Battery Life, Type-C Fast Charging, IPX7 Waterproof, Made in I...",Warehouse A,31,21,2025-02-06 09:14:00,10
26492,ORD_26493,13944,"Just Herbs Ayurvedic Resurfacing Body Polish Exfoliating Scrub For Skin Brightening,Tan Removal - All Skin Type",Warehouse B,37,20,2025-02-06 12:12:00,17
26493,ORD_26494,5014,Ajmal Nightingale And Persuade For Men & Women And Raindrops Femme Deodorants Pack of 3 200 ml,Warehouse B,90,77,2025-02-06 15:14:00,13
26494,ORD_26495,14035,Rabicer 20mg Injection,Warehouse A,39,32,2025-02-06 12:07:00,7
26495,ORD_26496,36133,Dapaone 10mg Tablet,Warehouse C,114,95,2025-02-06 07:12:00,19
26496,ORD_26497,5476,Mukhallat Al Wafa Concentrated Oriental Perfume Free From Alcohol For Unisex,Warehouse A,111,94,2025-02-06 00:16:00,17
26497,ORD_26498,12941,Amyvox 250mg/250mg Capsule,Warehouse B,48,36,2025-02-06 14:28:00,12
26498,ORD_26499,9572,"Maybelline New York Fit Me Matte + Poreless Powder, 110 Porcelain 8.5 gm",Warehouse C,43,33,2025-02-06 08:14:00,10
26499,ORD_26500,27322,SERY Mattish Lipstick First Kiss 3.5 gm,Warehouse B,39,25,2025-02-06 13:56:00,14
26500,ORD_26501,35982,Allure classic eye shadow Brush & Angular Brush Combo 1's,Warehouse C,60,42,2025-02-06 13:32:00,18
26501,ORD_26502,9818,"OneAssist 1 Year Extended Warranty Plan for Vacuum Cleaner (Price Range: 2501 to 5000) - Email Delivery Within 2 Hours, No...",Warehouse C,109,94,2025-02-06 10:23:00,15
26502,ORD_26503,35988,Gripe Water For Infants,Warehouse B,55,37,2025-02-06 21:08:00,18
26503,ORD_26504,14165,Nitrospan 6.4mg Tablet,Warehouse A,81,70,2025-02-06 05:57:00,11
26504,ORD_26505,35996,Insight Cosmetics Pro Concealer Palette - Concealer 15 gm,Warehouse C,82,72,2025-02-06 21:05:00,10
26505,ORD_26506,19455,Saregama Carvaan Mini Hindi 2.0- Music Player with Bluetooth/FM/AM/AUX (Regal Blue),Warehouse B,40,32,2025-02-06 20:31:00,8
26506,ORD_26507,641,The Natural Sun Defence Spf 50 Cream With Cucumber And Jojoba Oil Extract 50 Gm,Warehouse C,75,68,2025-02-06 17:22:00,7
26507,ORD_26508,14148,Faber-Castell Pitt Artist Pen - 1.5 mm - White,Warehouse B,78,66,2025-02-06 11:38:00,12
26508,ORD_26509,28434,"Sery Colorflirt Nail Paint Cider Spice, Brown 10 ml",Warehouse A,91,74,2025-02-06 22:40:00,17
26509,ORD_26510,19442,Aloe Veda Anti Hairfall Shampoo (Sulfate Free) 200 ml,Warehouse A,37,28,2025-02-06 08:04:00,9
26510,ORD_26511,10020,TheGiftKart Shockproof Crystal Clear Nothing Phone 1 Back Cover Case 360 Degree Protection Protective Design Transparent B...,Warehouse B,89,75,2025-02-06 10:50:00,14
26511,ORD_26512,13802,Tez P 100mg/325mg Tablet,Warehouse C,32,16,2025-02-06 14:39:00,16
26512,ORD_26513,28420,Gemblue Biocare Cucumber Face Mask 500 ml,Warehouse B,68,57,2025-02-06 23:53:00,11
26513,ORD_26514,27935,"Redgear A-15 Wired Gaming Mouse with RGB, Semi-Honeycomb Design and Upto 6400 dpi for Windows PC Gamers(White)",Warehouse A,76,63,2025-02-06 15:26:00,13
26514,ORD_26515,361,Beta Joy 10mg Tablet,Warehouse B,79,69,2025-02-06 03:36:00,10
26515,ORD_26516,20067,Azyter 500mg Tablet,Warehouse B,79,74,2025-02-06 13:00:00,5
26516,ORD_26517,593,Rabedom 10 mg/20 mg Tablet,Warehouse C,19,1,2025-02-06 04:44:00,18
26517,ORD_26518,28570,Valus A 100mg Tablet,Warehouse A,35,25,2025-02-06 20:20:00,10
26518,ORD_26519,19993,Shape Up Slimming Oil,Warehouse A,82,68,2025-02-06 04:55:00,14
26519,ORD_26520,5173,Levocasa 500mg Tablet,Warehouse B,43,29,2025-02-06 15:08:00,14
26520,ORD_26521,27219,Suntek 50mg Tablet,Warehouse A,94,78,2025-02-06 23:27:00,16
26521,ORD_26522,13309,Revolution Pro Supreme Matte Lip Pigment-Visionary 2.5 ml,Warehouse A,33,14,2025-02-06 15:43:00,19
26522,ORD_26523,27173,Ajmal Sacred Love & Raindrops & Wisal Deo & Neea EDP Pack of 3 20 ml,Warehouse B,72,55,2025-02-06 04:31:00,17
26523,ORD_26524,14184,SUGAR Cosmetics Goddess Of Flawless SPF30+ BB Cream - 42 Glace (Medium Beige) 25 ml,Warehouse A,100,92,2025-02-06 07:25:00,8
26524,ORD_26525,36693,"Hand Sanitizer - Orange, Pure Hands",Warehouse B,90,73,2025-02-06 00:20:00,17
26525,ORD_26526,13766,OA Cap 300mg Capsule,Warehouse A,19,8,2025-02-06 15:17:00,11
26526,ORD_26527,35895,Herbocleanse Plus Herbal Hand Sanitizer,Warehouse C,15,5,2025-02-06 17:49:00,10
26527,ORD_26528,13194,Sivanna Colors Make Up Studio Blush with Brush,Warehouse B,92,76,2025-02-06 14:08:00,16
26528,ORD_26529,28620,Odr 2mg/ml Injection,Warehouse C,50,37,2025-02-06 23:38:00,13
26529,ORD_26530,236,Zo-Clav-LB Tablet,Warehouse A,9,3,2025-02-06 18:56:00,6
26530,ORD_26531,19002,7SEVEN® Bluetooth Voice Command Remote for Xiaomi Redmi Mi Smart TV with Netflix & Prime Video Hot Keys XMRM-00A,Warehouse A,35,29,2025-02-06 06:56:00,6
26531,ORD_26532,28561,Fur Jaden Brown Leatherette Anti Theft Casual Laptop Backpack with 15.6 Inch Laptop Pocket,Warehouse A,12,2,2025-02-06 00:19:00,10
26532,ORD_26533,27077,Anu Oil - Ayurvedic Nasal Drop,Warehouse C,27,9,2025-02-06 15:32:00,18
26533,ORD_26534,13140,"Linc Ocean Classic Gel Pen, Blue, 25 pcs",Warehouse C,86,67,2025-02-06 17:23:00,19
26534,ORD_26535,37084,Tea Tree Foot Reflexology Aroma Massage Oil,Warehouse A,19,5,2025-02-06 18:44:00,14
26535,ORD_26536,36657,Suredone O Ointment,Warehouse A,83,76,2025-02-06 23:36:00,7
26536,ORD_26537,27108,Beauty People Matte Lucious Liquid Lip Colorpeachalucious - L29,Warehouse B,112,96,2025-02-06 00:03:00,16
26537,ORD_26538,9459,Roscad 20 Tablet,Warehouse B,24,14,2025-02-06 01:38:00,10
26538,ORD_26539,13745,Rozutin 10 Tablet,Warehouse C,33,16,2025-02-06 15:56:00,17
26539,ORD_26540,4544,Lumether 40mg/120mg Tablet DT,Warehouse A,57,40,2025-02-06 14:41:00,17
26540,ORD_26541,36527,"Dyazo 2.4 Amp 1 Meter Nylon Braided 3 In 1 Mobile Charging Usb Cable Compatible For All Smartphone, Iphones And Type C Dev...",Warehouse A,108,92,2025-02-06 08:45:00,16
26541,ORD_26542,4548,Aeoss ® 10 Pcs Open Pry Screwdriver Repair Tool Kit Set Compatible for iPhone 6 Plus 5 5s 5c 4 iPod. (100 Plus 5 Star Revi...,Warehouse A,26,21,2025-02-06 11:35:00,5
26542,ORD_26543,13746,Fernitin 500mg Tablet,Warehouse B,64,57,2025-02-06 11:24:00,7
26543,ORD_26544,35677,Rabikron-Plus Capsule SR,Warehouse B,29,11,2025-02-06 21:09:00,18
26544,ORD_26545,5245,WOW IMAGINE Ultra Slim Soft Rubberised Back Cover Case for Samsung Galaxy A14 5G | Inner Velvet Fabric Lining | Matte Sili...,Warehouse B,47,34,2025-02-06 02:26:00,13
26545,ORD_26546,28916,Vincefo CV 500mg/125mg Tablet,Warehouse C,67,60,2025-02-06 23:08:00,7
26546,ORD_26547,13147,Beauty People Glamour On The Go Nail Paint Remover Padsgrapes 1's,Warehouse A,29,21,2025-02-06 18:32:00,8
26547,ORD_26548,27195,Facial Kit - Five-In-One,Warehouse C,33,18,2025-02-06 12:04:00,15
26548,ORD_26549,19496,NOTE MINERAL EYESHADOW 306 2 gm,Warehouse B,76,58,2025-02-06 21:04:00,18
26549,ORD_26550,240,Waterlily & Oil Shower Gel Body Wash - Pampering Care With Refreshing Scent Of Waterlily Flower,Warehouse B,37,25,2025-02-06 04:56:00,12
26550,ORD_26551,14601,Carvix 6.25 Tablet,Warehouse C,25,20,2025-02-06 01:01:00,5
26551,ORD_26552,10077,boAt Rugged v3 Extra Tough Unbreakable Braided Micro USB Cable 1.5 Meter (Black),Warehouse C,82,63,2025-02-06 14:53:00,19
26552,ORD_26553,12870,Nature'S Cell Anti Puffiness Under Eye Gel Bxl Seaweed Eye Gel 15 Gm,Warehouse B,81,69,2025-02-06 12:03:00,12
26553,ORD_26554,763,BTN TRADERS Beauty Professional Luxury Makeup Brush Set with Storage Box - 12 Pc's Multicolour Brushes Makeup Kit for Girl...,Warehouse B,82,73,2025-02-06 10:36:00,9
26554,ORD_26555,28650,"Bella Vita Organic Glowey Face Pack, Scrub & Face Wash 3 In 1 100 gm",Warehouse A,78,65,2025-02-06 04:32:00,13
26555,ORD_26556,14250,Robustrion Anti-Scratch & Smudge Proof Tempered Glass Screen Protector for Realme Pad 10.4 inch,Warehouse A,61,53,2025-02-06 23:28:00,8
26556,ORD_26557,20015,"Dry Shampoo - Instant Hair Refresh, Coconut & Exotic Tropical",Warehouse C,113,97,2025-02-06 12:58:00,16
26557,ORD_26558,13301,DeBelle Gel Nail Lacquer Plum Toffee Plum Maroon Nail Polish 8 ml,Warehouse C,92,80,2025-02-06 05:17:00,12
26558,ORD_26559,241,Somafresh Plus Tablet,Warehouse C,22,16,2025-02-06 02:25:00,6
26559,ORD_26560,35798,"Crack Cream - For Dry, Cracked Heels & Feet",Warehouse A,49,41,2025-02-06 16:01:00,8
26560,ORD_26561,14256,"Ultra Clean Sanitary Pads For Women, XL+",Warehouse C,30,23,2025-02-06 10:55:00,7
26561,ORD_26562,28644,DeBelle Gel Nail Lacquer Almond Blush Orange Brown Nail Polish 8 ml,Warehouse B,65,55,2025-02-06 14:25:00,10
26562,ORD_26563,27586,Uva/Uvb Lotion Bxl Carrot Uva40 Cream)Carrot Protection Cream Spf 40 50 Gm,Warehouse C,74,63,2025-02-06 03:56:00,11
26563,ORD_26564,27250,Sandal Saffron Bath Salt,Warehouse B,46,39,2025-02-06 14:46:00,7
26564,ORD_26565,13434,"IRONFIX® Square Earphone case Earphone Pouch | Earphones case | Headphone Pouch |Eearphone Cover, Carrying Case for Earpho...",Warehouse B,42,34,2025-02-06 09:03:00,8
26565,ORD_26566,35764,Cool Active Deo,Warehouse A,100,85,2025-02-06 12:43:00,15
26566,ORD_26567,13699,Warcilin 125mg Dry Syrup,Warehouse B,97,89,2025-02-06 12:40:00,8
26567,ORD_26568,12849,Xiaomi Notebook Pro QHD+IPS AntiGlare Display Intel Core I5-11300H 11th Gen 14 Inch Thin & Light Laptop (16GB/512GB SSD/Ir...,Warehouse C,38,25,2025-02-06 15:11:00,13
26568,ORD_26569,27134,Levowind 500mg Tablet,Warehouse B,92,84,2025-02-06 23:28:00,8
26569,ORD_26570,12847,Napsrom 500mg/10mg Tablet,Warehouse C,87,76,2025-02-06 12:30:00,11
26570,ORD_26571,18885,Feclip P Oral Suspension,Warehouse C,96,77,2025-02-06 14:34:00,19
26571,ORD_26572,27868,Adlynlife 22mm Smart Watch Straps/Smart Watch Band Compatible for Realme Watch S/Realme S Pro (Grey),Warehouse B,10,1,2025-02-06 15:40:00,9
26572,ORD_26573,12895,Ifix-CL Dry Syrup,Warehouse C,97,86,2025-02-06 01:44:00,11
26573,ORD_26574,12886,Nicka K TRUE MATTE LIP COLOR TURKISH ROSE 3.5 gm,Warehouse B,55,45,2025-02-06 11:59:00,10
26574,ORD_26575,35864,Rabstat 40mg Tablet,Warehouse B,99,91,2025-02-06 14:07:00,8
26575,ORD_26576,19500,7SEVEN® Compatible Lg Smart Tv Remote Suitable for Any LG LED OLED LCD UHD Plasma Android Television and AKB75095303 repla...,Warehouse A,96,88,2025-02-06 05:39:00,8
26576,ORD_26577,18992,Poly by Plantronics - Blackwire 3225 USB-A Wired Headset - Dual-Ear (Stereo) Wired Over Ear Headphones with Mic - Connect ...,Warehouse B,23,15,2025-02-06 14:16:00,8
26577,ORD_26578,18783,"70mai Pro Plus+ A500S Dash Cam, 3K, ADAS, Built-in GPS Logger, Route Recorder, App Playback & Share, Optional Parking Moni...",Warehouse B,39,32,2025-02-06 00:14:00,7
26578,ORD_26579,10199,Nakumol-SP Tablet,Warehouse A,38,20,2025-02-06 13:31:00,18
26579,ORD_26580,35688,Alcostar MR 100mg/325mg/250mg Tablet,Warehouse A,57,46,2025-02-06 15:34:00,11
26580,ORD_26581,28745,"Yantralay School Of Gadgets 3-Way Monopod Grip Tripod Foldable Selfie Stick Compatible with Go Pro Hero 11/10/9/8,DJI OSM...",Warehouse C,20,9,2025-02-06 17:44:00,11
26581,ORD_26582,36701,Essential Oil - Lemongrass,Warehouse A,81,66,2025-02-06 21:40:00,15
26582,ORD_26583,37,"Samsung Galaxy A23 5G, Light Blue (8GB, 128GB Storage) with Offer",Warehouse C,71,64,2025-02-06 10:38:00,7
26583,ORD_26584,830,"Mi Tv Remote Suitable for Mi TV 4A (32""/43"")",Warehouse C,77,62,2025-02-06 03:01:00,15
26584,ORD_26585,13752,"AGLEY  OIL FREE GEL WATER PROOF SOFT LIPSTICK WATER PROOF  (RED, 3.6 g)",Warehouse B,90,73,2025-02-06 11:52:00,17
26585,ORD_26586,27106,Belora Paris Leave No Evidence Liquid Matte Lipstick Bright Brick 4.5 gm,Warehouse A,63,49,2025-02-06 02:04:00,14
26586,ORD_26587,13756,Belora Paris Paint & Pout- Lip & Cheek - Monkey Brown 1 ml,Warehouse C,74,55,2025-02-06 22:22:00,19
26587,ORD_26588,18870,Ajmal 3 Raindrops Femme And 1 Nightingale Deodorants Pack of 4 200 ml,Warehouse A,79,71,2025-02-06 16:21:00,8
26588,ORD_26589,18871,Volkmox-CV 500mg/125mg Tablet,Warehouse C,80,74,2025-02-06 17:29:00,6
26589,ORD_26590,12836,Cotbolt Silicone Protective Case Cover for LG an MR21GA Magic Remote Shockproof for LG Smart TV Remote 2021 Protective Ski...,Warehouse A,76,63,2025-02-06 22:41:00,13
26590,ORD_26591,35732,MAC Sheertone Blush Pinch Me,Warehouse C,46,41,2025-02-06 21:54:00,5
26591,ORD_26592,12840,Ajmal 2 Persuade & Nightingale Deodorant Pack of 3 Deodorants 200 ml,Warehouse B,80,73,2025-02-06 12:54:00,7
26592,ORD_26593,9494,"HP x5600B 64GB OTG (Type B) usb3.2 Pen Drive, Grey & Black",Warehouse B,27,17,2025-02-06 23:47:00,10
26593,ORD_26594,36619,"Revlon Summer Florals, Wax Flower, 8ml",Warehouse C,89,72,2025-02-06 03:23:00,17
26594,ORD_26595,27679,Pen-Drive 100mg Tablet,Warehouse A,56,39,2025-02-06 06:20:00,17
26595,ORD_26596,28,Pharcef-O 200 Tablet DT,Warehouse A,40,33,2025-02-06 12:07:00,7
26596,ORD_26597,19641,Amazon Brand - Solimo Back Cover Case for Mi Redmi 8A Dual | Compatible for Mi Redmi 8A Dual Back Cover Case | 360 Degree ...,Warehouse C,32,27,2025-02-06 18:54:00,5
26597,ORD_26598,18810,Pierre Cardin Paris - Truly Matte Foundation 865-Fair,Warehouse B,110,91,2025-02-06 18:26:00,19
26598,ORD_26599,14312,Terbipure IT 100mg/250mg Tablet,Warehouse A,69,50,2025-02-06 05:09:00,19
26599,ORD_26600,12827,Lotus Herbals Lip Therapy Velvety Rose 4 Gm,Warehouse B,100,83,2025-02-06 21:19:00,17
26600,ORD_26601,9476,OCTRIX 5V/4A Micro USB Vooc Super Fast Data Sync Charging Cable Compatible for Oppo F9 F9 Pro Oppo F11 Pro and All Oppo Sm...,Warehouse C,38,19,2025-02-06 21:54:00,19
26601,ORD_26602,19642,Pilot Pen Cartridge Blue ink Pack of 12 pcs for V7 with Key-Chain,Warehouse B,103,94,2025-02-06 01:45:00,9
26602,ORD_26603,28796,Ajmal 2 Persuade & Magnetize Deo & Prose EDP Pack of 3 20 ml,Warehouse C,107,89,2025-02-06 19:22:00,18
26603,ORD_26604,18842,AILKE BEST FACE SHINE CREAM 15G PACK OF 2,Warehouse B,55,36,2025-02-06 23:13:00,19
26604,ORD_26605,36618,"royalkart Self Adhesive Hook and Loop Tape | Mounting Tape For Household Purposes,School,Office,Kids| (5m Hook + 5m Loop)(...",Warehouse A,91,74,2025-02-06 14:22:00,17
26605,ORD_26606,18835,"Khadi Ark Natural Potato Powder for Healthy Skin Lightening, Whitening Skin tone and Reduce Dark Spots, Fine Line, Wrinkle...",Warehouse A,43,35,2025-02-06 06:36:00,8
26606,ORD_26607,28786,TRS BEAUTY 18 Color Eyeshadow Palette with Mirror (Multi item 1),Warehouse C,94,82,2025-02-06 16:01:00,12
26607,ORD_26608,20092,Pepticool 40 Tablet,Warehouse C,85,76,2025-02-06 03:08:00,9
26608,ORD_26609,27060,"Colors Queen Lip Crayon Lipstick| Color It All |Ultra Matte, Lightweight, Non Transferable,Waterproof & Long Lasting | Hot...",Warehouse B,33,22,2025-02-06 16:26:00,11
26609,ORD_26610,28744,Streetwear Nail Enamel - Marron Magik 8 Ml,Warehouse B,68,58,2025-02-06 15:50:00,10
26610,ORD_26611,28755,Iptozol 100mg Capsule,Warehouse C,84,68,2025-02-06 02:00:00,16
26611,ORD_26612,36597,Cefix Dry Syrup Delicious Pineapple,Warehouse A,48,42,2025-02-06 20:04:00,6
26612,ORD_26613,36640,Vega Natural Bristle Bath Brush (NBA - 1/3) 184 gm,Warehouse C,21,10,2025-02-06 07:44:00,11
26613,ORD_26614,37115,Lanfix-O Tablet,Warehouse C,11,6,2025-02-06 03:54:00,5
26614,ORD_26615,27023,Magastin F 10mg/200mg Tablet,Warehouse A,40,29,2025-02-06 21:26:00,11
26615,ORD_26616,9780,ABTRIX WITH AB Wall Mount Remote Control Holder Clear Acrylic Media Organizer Storage Box Coffee Table and Nightstand Conv...,Warehouse A,11,5,2025-02-06 11:21:00,6
26616,ORD_26617,20137,Logithro 500 Tablet,Warehouse C,53,38,2025-02-06 00:58:00,15
26617,ORD_26618,28956,Ayurfresh Toothpaste,Warehouse B,21,3,2025-02-06 15:12:00,18
26618,ORD_26619,14362,Nixidox Capsule,Warehouse A,57,42,2025-02-06 13:02:00,15
26619,ORD_26620,35648,"Mobistyle Oneplus nord 2T Cover Hybrid PC+TPU Soft Grip, Enhanced Camera Guard Back Cover Compatible for Oneplus nord 2T (...",Warehouse C,44,32,2025-02-06 06:44:00,12
26620,ORD_26621,288,"Hussell Car Charger Adapter - 30W, Qualcomm 3.0 Portable USB Quick Charge Technology & Dual Ports - Compatible with All Sm...",Warehouse A,71,61,2025-02-06 05:12:00,10
26621,ORD_26622,10251,Tough Lee Back Cover for Oneplus 9 Pro (Silicone | Transparent),Warehouse A,99,88,2025-02-06 07:12:00,11
26622,ORD_26623,14404,Atulya Castor Coldpress Oil 200 ml,Warehouse A,84,75,2025-02-06 17:26:00,9
26623,ORD_26624,18723,"HP Micro SD Card 64GB with Adapter U3 (Write Speed 60MB/s & Read Speed 100 MB/s Records 4K UHD and Fill HD Video, Purple)",Warehouse B,52,42,2025-02-06 19:37:00,10
26624,ORD_26625,19548,Urban Gabru Rebel Revolutionizing Men Re-Stylable Clay Hair Wax - Ultra Strong Hold 85 gm,Warehouse A,75,59,2025-02-06 07:39:00,16
26625,ORD_26626,5203,"Ajmal 1 Shadow Homme, 1 Wisal, 1 Magnetize And 1 Persuade Deodorants Pack of 4 200 ml",Warehouse A,52,33,2025-02-06 05:00:00,19
26626,ORD_26627,13729,Oxyderm Cream,Warehouse A,107,88,2025-02-06 10:57:00,19
26627,ORD_26628,27002,WOW IMAGINE Shock Proof Clear Back Case Mobile Cover for Samsung Galaxy F23 5G (Hard | Hybrid PC + TPU | Full Armour Devic...,Warehouse B,110,93,2025-02-06 03:12:00,17
26628,ORD_26629,36585,Ultra Smooth Shaving Foam,Warehouse A,62,51,2025-02-06 20:33:00,11
26629,ORD_26630,28992,Esium 40 Tablet,Warehouse B,109,91,2025-02-06 19:20:00,18
26630,ORD_26631,13737,Fashion Colour Big Eye Waterproof Curl Mascara 8 gm,Warehouse C,33,14,2025-02-06 14:58:00,19
26631,ORD_26632,36543,Heptilose Oral Solution,Warehouse A,47,42,2025-02-06 17:29:00,5
26632,ORD_26633,36576,YellowInc Case Cover Compatible with OnePlus Nord Buds (Earbuds Not Included) (Red),Warehouse B,32,23,2025-02-06 09:57:00,9
26633,ORD_26634,18749,Cetrone 1000mg Injection,Warehouse A,84,75,2025-02-06 21:53:00,9
26634,ORD_26635,36540,Fashion Colour Baby Wipes Pack Of 3 1's,Warehouse C,102,87,2025-02-06 02:39:00,15
26635,ORD_26636,13378,Microflamp SD Tablet,Warehouse B,33,17,2025-02-06 22:14:00,16
26636,ORD_26637,35691,BESTOR® LCD Writing Tablet/12 inches Erasable Doodle Pad | Electronic Writing Scribble Board for Kids | Kids Learning Toy...,Warehouse A,18,7,2025-02-06 09:51:00,11
26637,ORD_26638,851,Khadi Essentials Vitamin C Brightening Oil Free Face Serum 30 ml,Warehouse B,95,86,2025-02-06 07:53:00,9
26638,ORD_26639,27791,AMiRiTE AGW01 20MM Stainless Steel Metal Bands Compatible for Samsung Galaxy Galaxy Watch5 Pro (45mm) Galaxy Watch5 (44mm...,Warehouse C,95,81,2025-02-06 06:01:00,14
26639,ORD_26640,28735,Ajmal Sacrifice for HER EDP Floral Musky Perfume 50ml for Women and Khallab EDP Woody Oudh Perfume 50ml for Unisex +1 Perf...,Warehouse C,57,41,2025-02-06 20:01:00,16
26640,ORD_26641,27658,Gemblue Biocare Diamond Face Scrub 500 ml,Warehouse B,39,20,2025-02-06 21:50:00,19
26641,ORD_26642,19210,Inlife Fish Oil Omega 3 Fatty Acids Supplements EPA DHA for Men Women 500mg Capsules,Warehouse A,54,40,2025-02-06 03:44:00,14
26642,ORD_26643,9962,Charcoal Body Wash For Men - Sage & Patchouli,Warehouse B,54,41,2025-02-06 03:13:00,13
26643,ORD_26644,16244,Rosawal 10mg Tablet,Warehouse B,78,69,2025-02-06 04:08:00,9
26644,ORD_26645,11783,"AmazonBasics Monitor Stand, Height Adjustable Arm Mount- Steel",Warehouse A,79,71,2025-02-06 18:34:00,8
26645,ORD_26646,16161,"Rich Creme Hair Colour - Shade 4 Natural Brown, Multi Application Pack",Warehouse C,45,36,2025-02-06 10:40:00,9
26646,ORD_26647,16253,Rodnim Gold 100mg/325mg Tablet,Warehouse C,79,66,2025-02-06 01:55:00,13
26647,ORD_26648,11675,"LG Ultragear Gaming 24 Inch (60.3 Cm) Full HD (1920 x 1080) Pixels LCD Monitor 165Hz, 1ms, Freesync Premium, HDMI x 2, Dis...",Warehouse C,33,20,2025-02-06 03:04:00,13
26648,ORD_26649,2468,Ajmal Carbon Raindrops Raindrops Deodorant Spray (Pack of 3) 200 ml,Warehouse A,98,86,2025-02-06 01:03:00,12
26649,ORD_26650,16305,Perimol 20mg/325mg Tablet,Warehouse B,77,58,2025-02-06 21:13:00,19
26650,ORD_26651,32846,RAEGR MagFix Arc M1050 |3 in 1| 23W Mag-Safe Compatible Wireless Charging Stand Compatible with Mag-Safe on iPhone 14/13 /...,Warehouse A,62,49,2025-02-06 16:21:00,13
26651,ORD_26652,16303,Megawin PG 750mcg/75mg Tablet,Warehouse A,90,84,2025-02-06 01:28:00,6
26652,ORD_26653,16444,Theracef SB 250mg/125mg Injection,Warehouse A,72,56,2025-02-06 00:35:00,16
26653,ORD_26654,32858,Numeth P 750mcg/75mg Capsule,Warehouse C,26,13,2025-02-06 09:23:00,13
26654,ORD_26655,16468,Doxnum 100mg Tablet,Warehouse B,78,63,2025-02-06 04:13:00,15
26655,ORD_26656,32640,Amoxept 625 Tablet,Warehouse A,84,74,2025-02-06 21:47:00,10
26656,ORD_26657,11731,"EDYELL C5S True Wireless Earbuds, ENC Nosie Cancelling HD Mic, LED Power Display, 120 Hours Playtime 3500mah Charging Cas...",Warehouse A,107,91,2025-02-06 01:53:00,16
26657,ORD_26658,16255,Dermanex Cream,Warehouse C,104,92,2025-02-06 12:34:00,12
26658,ORD_26659,2331,"HP Wired Mouse 100 with 1600 DPI Optical Sensor, USB Plug-and -Play,ambidextrous Design, Built-in Scrolling and 3 Handy Bu...",Warehouse B,34,22,2025-02-06 17:27:00,12
26659,ORD_26660,34064,Armcid 40mg Injection,Warehouse A,35,16,2025-02-06 22:15:00,19
26660,ORD_26661,2560,"GiftMax® LED Video Soft Light Panel, for Studio Photography | Video Recording | Conference | YouTube,2700K-5700K CRI95+ | ...",Warehouse B,42,36,2025-02-06 09:05:00,6
26661,ORD_26662,32592,Cabisunate 60mg Injection,Warehouse C,75,61,2025-02-06 12:07:00,14
26662,ORD_26663,11593,Vega Pumice Stone (PD - 09) 73 gm,Warehouse B,11,4,2025-02-06 11:15:00,7
26663,ORD_26664,32948,Pullup Pant Style Adult Diapers - XL-XXL,Warehouse A,15,7,2025-02-06 04:59:00,8
26664,ORD_26665,11590,"Beauty Plus Suruchi Bindi Small Size, Maroon color Bindi for Women & Girls 240 Bindi",Warehouse C,35,28,2025-02-06 08:20:00,7
26665,ORD_26666,2591,"Mobilife Selfie Stick,Selfie Stick with Reinforced Tripod Stand,Selfie Stick Tripod for Mobile Phone 3 in 1 Bluetooth Self...",Warehouse C,17,7,2025-02-06 21:39:00,10
26666,ORD_26667,16217,"Parker Vector Standard Calligraphy CT Fountain Pen (Black), 1 Count (Pack of 1) (9000017373)",Warehouse A,22,3,2025-02-06 12:40:00,19
26667,ORD_26668,32975,3-In-1-Shower Gel,Warehouse A,54,35,2025-02-06 22:18:00,19
26668,ORD_26669,32523,Prozine Syrup,Warehouse B,108,97,2025-02-06 19:10:00,11
26669,ORD_26670,32513,POPIO Tempered Glass Compatible for iPhone 13 / iPhone 13 Pro/iPhone 14 (Transparent) Edge to Edge Full Screen Coverage wi...,Warehouse B,83,77,2025-02-06 11:35:00,6
26670,ORD_26671,2255,"ASUS TUF Gaming A15, 15.6-inch (39.62 cms) FHD 144Hz, AMD Ryzen 7 4800H, 4GB NVIDIA GeForce RTX 3050, Gaming Laptop (8GB/5...",Warehouse A,66,54,2025-02-06 22:39:00,12
26671,ORD_26672,32231,Pilgrim Korean Volcanic Lava Ash Foaming Face Wash with Built In Brush for Deep Cleansing | Korean Skin Care Products | 10...,Warehouse C,46,40,2025-02-06 23:37:00,6
26672,ORD_26673,15811,Cepodac 200 Tablet,Warehouse A,28,9,2025-02-06 13:01:00,19
26673,ORD_26674,16609,Bonjour Paris Just Matte Lip Crayon - Red Rose 3.2 gm,Warehouse B,59,41,2025-02-06 19:43:00,18
26674,ORD_26675,32241,"Herb Bleach For Sensitive Skin With Haldi, Chandan, Aloe Vera, Nimbu",Warehouse B,51,36,2025-02-06 23:29:00,15
26675,ORD_26676,20178,Canon M50 Mark II 15-45mm f3.5-6.3 is STM,Warehouse C,58,46,2025-02-06 16:29:00,12
26676,ORD_26677,33155,Qrovas 10mg Tablet,Warehouse C,15,8,2025-02-06 21:37:00,7
26677,ORD_26678,1755,Moxi CL 500mg/125mg Tablet,Warehouse C,44,27,2025-02-06 20:38:00,17
26678,ORD_26679,11013,Cdr 250mg Tablet,Warehouse A,103,98,2025-02-06 04:41:00,5
26679,ORD_26680,3029,Ofler 200mg Tablet,Warehouse C,84,78,2025-02-06 04:15:00,6
26680,ORD_26681,31789,Rushwak Crystal Hair Remover for Women and Men Upgraded Nano-crystalline Dots Technology Crystal Hair Eraser for Women Pai...,Warehouse A,24,16,2025-02-06 17:43:00,8
26681,ORD_26682,17059,HUDACRUSH BEAUTY Creamy Matte Liquid Lipstick Set of 12 Pcs Multicolor Lipsticks for Women,Warehouse B,15,5,2025-02-06 08:09:00,10
26682,ORD_26683,33167,Manco 500mcg Injection,Warehouse C,98,90,2025-02-06 19:00:00,8
26683,ORD_26684,16615,"Wayona USB Type C Charger Cable Fast Charging USB C Cable/Cord for Samsung Galaxy S10e S10 S9 S8 Plus S10+, Note 10 Note 9...",Warehouse B,35,29,2025-02-06 13:10:00,6
26684,ORD_26685,32471,Amijet 500mg Injection,Warehouse B,75,70,2025-02-06 08:00:00,5
26685,ORD_26686,32469,Rabtry LS 75mg/20mg Capsule SR,Warehouse A,64,53,2025-02-06 05:17:00,11
26686,ORD_26687,32467,CEDO Flip Redmi Note 9 Pro/Note 9 Pro Max/Note 10 Lite Flip Cover | Leather Finish | Inside Pockets & Inbuilt Stand | Shoc...,Warehouse C,16,11,2025-02-06 06:50:00,5
26687,ORD_26688,32460,Urclar OD 500mg Tablet,Warehouse B,50,42,2025-02-06 10:07:00,8
26688,ORD_26689,2646,Caviter Rhe Tablet,Warehouse C,55,36,2025-02-06 01:13:00,19
26689,ORD_26690,33049,Lipcy 500 mg/50 mg/500 mg Tablet MR,Warehouse C,68,58,2025-02-06 19:41:00,10
26690,ORD_26691,32436,Cefrone 1000mg Injection,Warehouse A,36,30,2025-02-06 12:15:00,6
26691,ORD_26692,16150,Activ Beaute Anti Pollution Detox Face Wash 50 ml,Warehouse C,84,69,2025-02-06 08:56:00,15
26692,ORD_26693,2669,"Muuchstac Skin Lightening Oil 30 ml & Ocean Blue Foam Face Wash 100 ml Combo for Men Skin care Kit for Skin Lightening, Da...",Warehouse A,67,55,2025-02-06 04:51:00,12
26693,ORD_26694,16670,Jovees Bridal brightening Face Mask for Fair and Glowing Skin | 100 gm,Warehouse B,110,98,2025-02-06 07:55:00,12
26694,ORD_26695,32347,Moximik CV 500mg/125mg Tablet,Warehouse A,63,46,2025-02-06 17:23:00,17
26695,ORD_26696,16137,"Duracell Specialty 1616 Lithium Coin Battery 3V, Pack of 5 (DL1616/CR1616) Designed for use in keyfobs, Scales, wearables ...",Warehouse B,33,28,2025-02-06 12:22:00,5
26696,ORD_26697,11513,"Fashion Colour Super Matte Lipstick, Naughty Chocalate 4 gm",Warehouse A,72,67,2025-02-06 16:17:00,5
26697,ORD_26698,32318,Losapot AM 50mg/5mg Tablet,Warehouse A,62,46,2025-02-06 00:46:00,16
26698,ORD_26699,16697,Teal & Terra Hydrating Face Cream With Argan Oil & Cocoa Butter 50 gm,Warehouse B,19,4,2025-02-06 07:10:00,15
26699,ORD_26700,2714,MI Xiaomi Wireless Home Security Camera 2i 2022 Edition | Full HD Picture | 360 View | 2MP | AI Powered Motion Detection |...,Warehouse C,32,14,2025-02-06 14:47:00,18
26700,ORD_26701,33094,Orsokuf LS Syrup,Warehouse C,66,59,2025-02-06 15:41:00,7
26701,ORD_26702,32278,Matra Ubtan Face Pack - Haldi Chandan 100 gm,Warehouse A,15,2,2025-02-06 09:09:00,13
26702,ORD_26703,33104,Amoxyril CV 250mg/125mg Tablet,Warehouse B,97,89,2025-02-06 17:16:00,8
26703,ORD_26704,16722,Duracell CHHOTA Power Alkaline AA Batteries - 20 Pcs,Warehouse C,11,2,2025-02-06 09:08:00,9
26704,ORD_26705,16102,Bioxime 200mg Tablet,Warehouse B,53,35,2025-02-06 03:23:00,18
26705,ORD_26706,2237,"USB C GaN Charger 30W, Cytron PD 3.0 PPS Fast Charger for iPhone 14/ 14 Plus/14 Pro/14 Pro Max/13 Pro/13 Pro Max, Samsung ...",Warehouse B,60,44,2025-02-06 03:14:00,16
26706,ORD_26707,15937,ZOUK Black Floral Printed Handmade Vegan Leather Women's Office Bag for 15.6 inch Laptop with Double Handles - FloMotif,Warehouse A,31,26,2025-02-06 04:36:00,5
26707,ORD_26708,11359,Acfin RB 200mg/20mg Capsule,Warehouse C,29,15,2025-02-06 11:33:00,14
26708,ORD_26709,32142,Permiscab Cream,Warehouse A,78,71,2025-02-06 13:54:00,7
26709,ORD_26710,11420,Zeal 20mg Tablet,Warehouse C,37,30,2025-02-06 13:27:00,7
26710,ORD_26711,2835,Revlon So Fierce Vinyl Eye Liner - Righteous Rum 1.2 Gm,Warehouse B,84,76,2025-02-06 22:50:00,8
26711,ORD_26712,15975,Drofran M 80mg/250mg Tablet,Warehouse C,73,62,2025-02-06 05:03:00,11
26712,ORD_26713,32025,"Junkyard Vinyl Stickers for laptops Art n Craft, and Other Gadgets (Pack of 50)",Warehouse C,29,13,2025-02-06 09:17:00,16
26713,ORD_26714,16927,"truke BTG Beta True Wireless in Ear Earbuds with 13mm Big Speaker Drivers, 38H Playtime, Fast Charging, True Gaming Mode, ...",Warehouse A,64,45,2025-02-06 13:51:00,19
26714,ORD_26715,2869,"Ant Esports KM500W Gaming Backlit Keyboard and Mouse Combo, LED Wired Gaming Keyboard, Ergonomic & Wrist Rest Keyboard, Pr...",Warehouse A,55,44,2025-02-06 15:45:00,11
26715,ORD_26716,2877,Apple iPhone 12 (64GB) - White,Warehouse C,105,96,2025-02-06 11:46:00,9
26716,ORD_26717,2878,"Syncwire 8.5 Inch LCD Writing Tablet E-Notepad Ruff Pad Doodle Board Drawing Tablet, Erasable Reusable Electronic Drawing ...",Warehouse C,65,47,2025-02-06 19:14:00,18
26717,ORD_26718,32004,Acedol Plus Syrup,Warehouse C,101,96,2025-02-06 13:57:00,5
26718,ORD_26719,32003,Simply Inked Scary Times Semi-Permanent Tattoo Designer Semi-Permanent Tattoo for Girls Boys Men Women waterproof Sticker ...,Warehouse C,30,17,2025-02-06 06:32:00,13
26719,ORD_26720,16911,"Zebronics ASC100 3.5mm AUX Male to Male cable with 1 meter length, stereo audio support, reinforced collars, for smartphon...",Warehouse B,64,47,2025-02-06 19:01:00,17
26720,ORD_26721,16913,Amione 100mg Tablet,Warehouse A,25,13,2025-02-06 14:28:00,12
26721,ORD_26722,33279,Alsert 50mg Tablet,Warehouse B,55,40,2025-02-06 07:02:00,15
26722,ORD_26723,15973,Orden Oral Solution,Warehouse C,99,92,2025-02-06 20:52:00,7
26723,ORD_26724,15971,Osia Osia Bourbon Rose 125 gm,Warehouse A,72,58,2025-02-06 16:28:00,14
26724,ORD_26725,33303,"Lenovo Tab M10 HD 2nd Gen (10.1 inch(25cm), 4 GB, 64 GB, Wi-Fi+LTE with Calling), Platinum Grey with Metallic Body and Oct...",Warehouse C,87,74,2025-02-06 16:57:00,13
26725,ORD_26726,17649,"Action Pro (Made in India Helmet Chin Mount, Motorcycle Helmet Strap Compatible with GoPro Hero 11 10 9 8 7 6 5 4 3+ 3 SJC...",Warehouse A,64,58,2025-02-06 22:18:00,6
26726,ORD_26727,34328,"Fashion Colour Kiss Lip No Transfer Lipstick, 100 Ruby Red 2.6 gm",Warehouse A,91,80,2025-02-06 15:00:00,11
26727,ORD_26728,17681,Mazz 200mg/5ml Syrup,Warehouse A,32,14,2025-02-06 09:18:00,18
26728,ORD_26729,14571,Glimmer Premium Nail Enamel Cheeky Red 10 ml,Warehouse C,51,38,2025-02-06 17:38:00,13
26729,ORD_26730,18370,"Samsung Galaxy S21 FE 5G (Olive, 8GB, 128GB Storage)",Warehouse A,68,53,2025-02-06 15:59:00,15
26730,ORD_26731,35214,"APC Back-UPS Pro BR1500G-IN, 1500VA / 865W, 230V UPS System, High-Performance Premium Power Backup & Protection for Home O...",Warehouse A,68,53,2025-02-06 08:59:00,15
26731,ORD_26732,4158,"Fashion Colour Jersy Girl Kiss Proof No Transfer Lipstick, 24 Ladies Night 2 gm",Warehouse C,61,47,2025-02-06 21:43:00,14
26732,ORD_26733,35249,"PUNVIT New Edition Silicone Strap for Noise Colorfit Pro 2 [Only Not for Any Other Models, Black]",Warehouse A,104,99,2025-02-06 23:06:00,5
26733,ORD_26734,4170,Ximep Dry Syrup,Warehouse B,48,37,2025-02-06 13:09:00,11
26734,ORD_26735,14632,"Twirey Eyebrow Painless Facial Hair Remover Razor for Face, Women and Men(pack of 1 x 3)",Warehouse A,53,46,2025-02-06 11:54:00,7
26735,ORD_26736,35265,m-fit 7 Feet Mobile Tripod Stand s-25 Portable and Foldable Camera & Mobile - Mobile Tripod Stand with Mobile Clip Holder ...,Warehouse A,102,83,2025-02-06 02:40:00,19
26736,ORD_26737,27386,Moroccan Argan Oil Firming & Illuminating Under Eye Serum,Warehouse C,107,96,2025-02-06 23:33:00,11
26737,ORD_26738,12675,I AM EYECONIC FINE GLITTER AFTER EVERY SUNSET 4 gm,Warehouse C,116,99,2025-02-06 12:21:00,17
26738,ORD_26739,2201,Ongesic MR 100mg/325mg/250mg Tablet,Warehouse C,95,82,2025-02-06 00:14:00,13
26739,ORD_26740,16036,Gentasun 40mg Injection,Warehouse B,28,18,2025-02-06 06:45:00,10
26740,ORD_26741,33376,Itradence 100mg Capsule,Warehouse A,90,75,2025-02-06 09:24:00,15
26741,ORD_26742,2220,Khadi Essentials Rasik Body Cleanser - Fresh Blueberry & Mulberry 200 ml,Warehouse B,90,85,2025-02-06 01:01:00,5
26742,ORD_26743,33384,Toriron 100mg Soft Gelatin Capsule,Warehouse B,63,55,2025-02-06 23:35:00,8
26743,ORD_26744,33397,Berina Hair Straightener Cream 110 gm,Warehouse B,82,75,2025-02-06 14:11:00,7
26744,ORD_26745,11947,Osia Osia Lemon Grass And Aloe Vera 125 gm,Warehouse B,66,55,2025-02-06 03:29:00,11
26745,ORD_26746,16991,Myglamm Jet Set Eyes Kajal Eyeliner - Bleu 0.35 Gm,Warehouse B,15,1,2025-02-06 20:19:00,14
26746,ORD_26747,31893,"Ambrane Wired in Ear Earphones with in-line Mic for Clear Calling, 12mm Dynamic Drivers for BoostedBass™, 3.5mm Jack, Mult...",Warehouse B,75,57,2025-02-06 04:15:00,18
26747,ORD_26748,11960,"Fashion Colour Professional Makeup Kit, Bke01 - 2 36 gm",Warehouse A,95,80,2025-02-06 10:03:00,15
26748,ORD_26749,33442,"Rapidotzz Band Straps - Pack of 1 (Black-Grey, Unisex) | Removable Straps ONLY for Amazfit Huami Bip, Amazfit Bip Lite | M...",Warehouse C,73,65,2025-02-06 17:46:00,8
26749,ORD_26750,33458,Flemnil Liquid,Warehouse C,30,12,2025-02-06 05:42:00,18
26750,ORD_26751,15864,Purifying Turmeric Natural Ayurvedic Soap,Warehouse B,20,2,2025-02-06 21:51:00,18
26751,ORD_26752,31867,Colors Queen Perfect Balance Primer | Oil Free Primer Which Provides Soothing and Hydrating Makeup Base | Waterproof Long ...,Warehouse C,51,36,2025-02-06 21:10:00,15
26752,ORD_26753,33485,Gliptor 20mg Tablet,Warehouse C,26,20,2025-02-06 18:23:00,6
26753,ORD_26754,17008,Fliptor 40mg Tablet,Warehouse C,18,11,2025-02-06 07:44:00,7
26754,ORD_26755,33486,Beauty People Smart Nails - All That Jazz 3 - D Nail Polish Jazz - Me - Red - 1025 12 ml,Warehouse A,23,4,2025-02-06 19:58:00,19
26755,ORD_26756,17016,Soulflower Aroma Oil - Verry Berry 30 ml,Warehouse A,49,41,2025-02-06 18:52:00,8
26756,ORD_26757,17035,Actnim P 100mg/325mg Tablet,Warehouse C,43,35,2025-02-06 13:08:00,8
26757,ORD_26758,15828,iPhone Original 20W Super Fast PD Smart Charger with Cable Lighting Compatible for iPhone 14| 14 Plus| 13| iPhone 13 Pro| ...,Warehouse C,46,39,2025-02-06 03:13:00,7
26758,ORD_26759,31815,Filanil Forte 150mg/2mg Tablet,Warehouse A,109,97,2025-02-06 14:23:00,12
26759,ORD_26760,31814,Ajmal Diza EDP Fruity Floral Perfume And Sacred Love Deodorant Floral Musky Fragrance 300 ml,Warehouse A,89,83,2025-02-06 17:13:00,6
26760,ORD_26761,33349,Urchil Forte 300mg Tablet,Warehouse C,22,4,2025-02-06 03:52:00,18
26761,ORD_26762,33326,CEDO Samsung A51 Back Cover | Matte Soft Silicon Flexible | Camera Bump Protection | All Side Shock Proof Rubberised Back ...,Warehouse C,103,94,2025-02-06 11:55:00,9
26762,ORD_26763,16931,Sony Premium MDR-XB55AP in-Ear Extra Bass Wired Headphones with Mic (Blue),Warehouse B,19,1,2025-02-06 23:51:00,18
26763,ORD_26764,32028,Moroccan Extra Penetrating Oil,Warehouse A,113,95,2025-02-06 23:34:00,18
26764,ORD_26765,32216,Revolution Pro Lipstick Collection Bare 16 gm,Warehouse A,75,65,2025-02-06 06:54:00,10
26765,ORD_26766,32214,Amclox DL 250mg/250mg Capsule,Warehouse A,101,91,2025-02-06 05:21:00,10
26766,ORD_26767,2795,Medimade Pink Rose Premium Soap (Pack of 3) 1's,Warehouse B,62,44,2025-02-06 00:32:00,18
26767,ORD_26768,33195,L.A Girl HD PRO Conceal Almond 8 gm,Warehouse A,53,44,2025-02-06 11:33:00,9
26768,ORD_26769,34076,boAt BassHeads 100 in-Ear Wired Headphones with Mic (White),Warehouse B,74,60,2025-02-06 06:27:00,14
26769,ORD_26770,33370,Airtel DigitalTV DTH Remote SD/HD/HD Recording Compatible for Television (Shining Black ),Warehouse A,27,10,2025-02-06 19:11:00,17
26770,ORD_26771,11028,"7 in 1 USB-C Hub (3 x USB-A 3.0 Ports, 1 x USB-C Power Delivery, 1 x SD,1 x TF-Card,1 x 4K HDMI) Compatible with Windows,M...",Warehouse C,97,78,2025-02-06 21:01:00,19
26771,ORD_26772,3270,Nebizok 2.5 Tablet,Warehouse B,84,70,2025-02-06 19:00:00,14
26772,ORD_26773,17300,Lotus Herbals Natural Kajal Black 4 Gm,Warehouse C,18,9,2025-02-06 04:39:00,9
26773,ORD_26774,31424,Cefthor 200mg Tablet,Warehouse A,112,93,2025-02-06 23:08:00,19
26774,ORD_26775,31413,Amazon Brand - Solimo Basic Case for Samsung S10e (Silicone_Transparent),Warehouse A,90,79,2025-02-06 17:08:00,11
26775,ORD_26776,31408,Passion Indulge FACE SCRUBB 250 gm,Warehouse A,72,61,2025-02-06 08:45:00,11
26776,ORD_26777,11132,Lefrex 500mg Tablet,Warehouse A,23,8,2025-02-06 20:19:00,15
26777,ORD_26778,3252,Cefimec AZ 200mg/250mg Tablet,Warehouse A,39,21,2025-02-06 19:49:00,18
26778,ORD_26779,3253,Minimalist Hyaluronic Acid Face Serum 30 ml,Warehouse A,96,79,2025-02-06 12:39:00,17
26779,ORD_26780,17333,Moisturising Bar - Gel + Creme,Warehouse B,92,86,2025-02-06 14:32:00,6
26780,ORD_26781,31348,CRUST Smart Mini UPS for WiFi Router and Modem. Upto 4 Hours Power Backup. Replaceable EV Grade Li-Ion Battery. Supports 9...,Warehouse B,15,8,2025-02-06 04:49:00,7
26781,ORD_26782,31340,Beauty People Natural HD Matte Lip Crayon Debonair - 113 4 gm,Warehouse C,91,79,2025-02-06 09:46:00,12
26782,ORD_26783,1888,Olmerex CH 20mg/12.5mg Tablet,Warehouse C,106,89,2025-02-06 20:14:00,17
26783,ORD_26784,17342,Micromax X778 Marsala,Warehouse A,78,66,2025-02-06 13:51:00,12
26784,ORD_26785,12111,Miss Rose Professional Make-up 2 In 1 Lip Liner Pencil Lipstick Lip Beauty Makeup Waterproof Nude Color Cosmetics Lipliner...,Warehouse C,108,97,2025-02-06 08:08:00,11
26785,ORD_26786,15616,Hexaflox Tablet,Warehouse C,97,79,2025-02-06 21:08:00,18
26786,ORD_26787,31307,Cilatop T 10mg/40mg Tablet,Warehouse A,95,76,2025-02-06 21:32:00,19
26787,ORD_26788,33639,Ocra 5mg Tablet,Warehouse C,18,6,2025-02-06 07:23:00,12
26788,ORD_26789,11170,Zocin 100mg Tablet,Warehouse C,88,74,2025-02-06 21:15:00,14
26789,ORD_26790,33749,Ajmal Wisal & Shadow Homme & Sacrificeiihim & Carbon Deo & Ascend EDP Pack of 5 20 ml,Warehouse C,84,74,2025-02-06 02:04:00,10
26790,ORD_26791,29084,"Fashion Colour Kiss Lip No Transfer Lipstick, 63 Umber 2.6 gm",Warehouse A,26,21,2025-02-06 07:18:00,5
26791,ORD_26792,11174,Amiliv 500 Injection,Warehouse B,40,33,2025-02-06 17:25:00,7
26792,ORD_26793,12007,Onride 4mg Tablet,Warehouse A,28,10,2025-02-06 02:25:00,18
26793,ORD_26794,2026,"Sounce Silicone Protective Case Cover for OnePlus Buds Z TWS, Anti Fall Anti Dust, with Hook Earphone Case [Case Cover onl...",Warehouse C,67,56,2025-02-06 21:52:00,11
26794,ORD_26795,11260,Apricot Body Wash & Scrub,Warehouse A,35,24,2025-02-06 02:59:00,11
26795,ORD_26796,33591,Rapex 200mg Tablet,Warehouse A,106,89,2025-02-06 00:39:00,17
26796,ORD_26797,2013,RE' EQUIL Hair Fall Control Serum - 100ml,Warehouse B,34,26,2025-02-06 11:05:00,8
26797,ORD_26798,31700,AmazonBasics Braided USB Type-C to Type-C 60W Fast Charging Data cable with Transparent Shell and LED indicator (Black/Whi...,Warehouse B,95,77,2025-02-06 00:16:00,18
26798,ORD_26799,31696,"Portronics SoundDrum Plus a 15W POR-1040 Bluetooth 5.0 Portable Stereo Speaker Comes with Boosted Bass, Equaliser Functio...",Warehouse B,89,79,2025-02-06 02:32:00,10
26799,ORD_26800,11237,Bonjour Paris Coat Me Satin Matte Nail Polish - Transparent Top Coat 9 ml,Warehouse C,20,5,2025-02-06 18:42:00,15
26800,ORD_26801,3089,Voorkoms® Krishna with Shank in Flute Combo Tattoo Waterproof Men and women Temporary Body Tattoo,Warehouse C,38,31,2025-02-06 12:27:00,7
26801,ORD_26802,17298,Cremazen Plus Oral Suspension,Warehouse A,94,85,2025-02-06 01:38:00,9
26802,ORD_26803,1902,Lucky Traders Empty Luxurious Air Cushion Puff Box BB Cream Container Makeup Case Portable I Style,Warehouse B,97,83,2025-02-06 18:58:00,14
26803,ORD_26804,1903,Cefadrox-CV 500/125 Tablet,Warehouse B,101,94,2025-02-06 22:47:00,7
26804,ORD_26805,33787,"Brand Conquer Glass LCD Writing Tablet | Bropang Drawing Board, Doodle Board, Writing Pad | Reusable & Portable | Ewriter ...",Warehouse C,81,72,2025-02-06 21:14:00,9
26805,ORD_26806,36372,Oxy-Infusion Boost Brightening Face Mask,Warehouse A,100,81,2025-02-06 14:03:00,19
26806,ORD_26807,28329,"Intern INT-38C Right hand Acoustic Guitar Kit, With Bag, Strings, Pick And Strap, Black, small",Warehouse A,103,86,2025-02-06 00:56:00,17
26807,ORD_26808,17452,TheGiftKart Flip Back Cover Case for Redmi 10 / Redmi 10 Power | Dual-Color Leather Finish | Inbuilt Stand & Pockets | Wal...,Warehouse A,68,57,2025-02-06 22:24:00,11
26808,ORD_26809,147,LOHAYA Remote for OnePlus Y Series HD Ready LED Smart Android TV [32 inches [32Y1] 43 inches [43Y1] | 1+ Android TV Remote...,Warehouse B,42,32,2025-02-06 10:37:00,10
26809,ORD_26810,28337,Dualmont-LC Tablet,Warehouse C,67,49,2025-02-06 11:15:00,18
26810,ORD_26811,14070,"Samsung Galaxy Watch5 LTE (44 mm, Sapphire, Compatible with Android only)",Warehouse C,103,98,2025-02-06 03:13:00,5
26811,ORD_26812,9583,"SERY Soft Matte Lip Crayon|Creamy Matte Texture Lipstick, Light Weight, Long Lasting,Transfer-Proof, Highly Pigmented , Si...",Warehouse B,61,51,2025-02-06 23:29:00,10
26812,ORD_26813,5109,WildHorn Leather 15 inch Laptop Messenger Bag for Men I Padded Laptop Compartment I Carry Handles with Adjustable Strap I ...,Warehouse C,42,33,2025-02-06 12:03:00,9
26813,ORD_26814,5108,Superdrug Argan Hair Therapy Replenishing Treatment Masque 17 ml,Warehouse C,19,5,2025-02-06 08:36:00,14
26814,ORD_26815,19754,SYGA Barber Stainless Steel Straight Edge Barber Razor Folding Shaving Shaver Without Blade for Men,Warehouse A,65,55,2025-02-06 19:04:00,10
26815,ORD_26816,624,"Acko 1 Year Extended Warranty for ACs from Rs-40,000 to Rs-60,000 (Email Delivery)",Warehouse A,70,64,2025-02-06 14:29:00,6
26816,ORD_26817,19174,"65W Power Warp Charging Cable for OnePlus 9RT, 10 Pro, 9 Pro, 8, 8 Pro, 7, 7T, 7 Pro Nord CE 2 5G, Nord CE 2 Lite 5G, 10R ...",Warehouse A,63,47,2025-02-06 01:51:00,16
26817,ORD_26818,36874,Bella Voste Eyeshadow Pretty Pearl 01 2.6 gm,Warehouse C,60,43,2025-02-06 22:04:00,17
26818,ORD_26819,19183,Candid-B Cream,Warehouse B,55,50,2025-02-06 09:06:00,5
26819,ORD_26820,5438,"Mercedes-Benz Woman Eau De Toilette, 90ml",Warehouse C,42,23,2025-02-06 22:27:00,19
26820,ORD_26821,617,Spantra Tomato & Strawberry Sugar Scrub 125 gm,Warehouse A,105,96,2025-02-06 21:14:00,9
26821,ORD_26822,5323,Drdklo MR 250mg/50mg/325mg Tablet,Warehouse A,62,48,2025-02-06 13:16:00,14
26822,ORD_26823,14073,Dinsey Baby - Bio Green Apple Mickey Tearproof Shampoo,Warehouse A,18,2,2025-02-06 12:33:00,16
26823,ORD_26824,19766,Flucorax 150mg Capsule,Warehouse A,105,93,2025-02-06 12:43:00,12
26824,ORD_26825,4877,Muscarin Syrup,Warehouse A,73,63,2025-02-06 12:52:00,10
26825,ORD_26826,2439,"SanDisk 64GB Ultra Dual Drive Luxe Type USB C Flash Drive (5Y - SDDDC4-064G-I35, Silver)",Warehouse A,79,62,2025-02-06 08:59:00,17
26826,ORD_26827,29868,"MYVN 65W Super Vooc Charge, Data Sync Fast charging Type-C Cable Compatible for Realme XT, Realme XT 730G, Realme X2, Real...",Warehouse A,100,87,2025-02-06 13:31:00,13
26827,ORD_26828,14426,Yves Rocher Repair 2 In 1 Balm Mask 200 ml,Warehouse A,90,83,2025-02-06 05:02:00,7
26828,ORD_26829,33753,Zedodec 25mg Injection,Warehouse C,49,44,2025-02-06 09:08:00,5
26829,ORD_26830,31478,Wildcraft Turnaround Polyester 14 inch 27 Ltrs Blue Laptop Bag (8903340000000),Warehouse B,25,7,2025-02-06 04:42:00,18
26830,ORD_26831,31460,Amblitz Spiral Notebook - A4-500 Pages - Unruled,Warehouse C,99,81,2025-02-06 15:03:00,18
26831,ORD_26832,3215,Bio Apricot Refreshing Body Wash,Warehouse C,41,32,2025-02-06 13:41:00,9
26832,ORD_26833,31442,Relaxing Body Massage Oil For Pain Relief,Warehouse A,112,93,2025-02-06 10:53:00,19
26833,ORD_26834,33635,Wayona Usb Type C 65W 6Ft/2M Long Fast Charging Cable Compatible For Samsung S22 S20 Fe S21 Ultra A33 A53 A01 A73 A70 A51 ...,Warehouse C,34,16,2025-02-06 18:15:00,18
26834,ORD_26835,3221,Plum Hello Aloe Caring Day Moisturizer 60 ml,Warehouse A,18,2,2025-02-06 07:13:00,16
26835,ORD_26836,33889,Novacet 5mg Syrup,Warehouse B,53,38,2025-02-06 01:51:00,15
26836,ORD_26837,30924,Reben 20mg Tablet,Warehouse B,68,61,2025-02-06 12:50:00,7
26837,ORD_26838,10937,"Newlike Silicone Samsung Galaxy A53 5G, [Bumper] Exclusive - Transparent Back Cover Clear Thin Case - for Samsung Galaxy A...",Warehouse B,102,89,2025-02-06 13:10:00,13
26838,ORD_26839,34272,Tetrasung 250mg Capsule,Warehouse B,20,10,2025-02-06 19:56:00,10
26839,ORD_26840,3502,Zebronics Zeb-Bang Bluetooth Wireless Over Ear Headphones with Mic (Orange),Warehouse A,66,53,2025-02-06 00:03:00,13
26840,ORD_26841,17609,MADES Hair Care Wonder Volume Shampoo Luxurious Lifting 250 ml,Warehouse B,75,70,2025-02-06 19:39:00,5
26841,ORD_26842,17624,Lizocan 600mg Tablet,Warehouse C,101,95,2025-02-06 00:32:00,6
26842,ORD_26843,34305,"DEVCOMM Phone Bluetooth Stereo System Audio Aux Receiver USB Adapter 3.5mm for Car Speakers Under 200 (1 Pack, Black)",Warehouse B,101,87,2025-02-06 11:17:00,14
26843,ORD_26844,10918,Ajmal Yearn EDP & Deep Earth Edt Pack of 2 350 ml,Warehouse A,14,8,2025-02-06 15:16:00,6
26844,ORD_26845,17637,"Spigen Full Coverage Tempered Glass Screen Protector Guard for MacBook Air 13.6 inch (M2, 2022) - 1 Pack",Warehouse B,29,19,2025-02-06 06:30:00,10
26845,ORD_26846,17515,Portronics Konnect L POR-1081 Fast Charging 3A Type-C Cable 1.2Meter with Charge & Sync Function for All Type-C Devices (G...,Warehouse C,29,23,2025-02-06 09:13:00,6
26846,ORD_26847,12203,Sony Bravia 126 cm (50 inches) 4K Ultra HD Smart LED Google TV KD-50X74K (Black),Warehouse B,93,79,2025-02-06 04:42:00,14
26847,ORD_26848,31059,"Revivify -Â WhiteÂ ExpertÂ BrighteningÂ SerumÂ Cream, SPF 25, PA+++",Warehouse B,50,38,2025-02-06 09:04:00,12
26848,ORD_26849,3342,Nazomod Syrup,Warehouse A,29,21,2025-02-06 17:32:00,8
26849,ORD_26850,11094,Mahadrakshadi Syrup,Warehouse B,90,74,2025-02-06 15:10:00,16
26850,ORD_26851,17387,"iQOO 9 SE 5G (Space Fusion, 8GB RAM, 128GB Storage) | Qualcomm Snapdragon 888 | 66W Flash Charge",Warehouse B,76,71,2025-02-06 13:59:00,5
26851,ORD_26852,33935,Mach3 - Manual Shaving Razor,Warehouse A,86,69,2025-02-06 13:23:00,17
26852,ORD_26853,11081,"Pilot O5 Roller Ball Pen Pack of 5 (4 Blue, 1 Black)",Warehouse A,99,82,2025-02-06 10:52:00,17
26853,ORD_26854,15552,Anshri Ice Cube Roller For Face I Skin Care Ice Roller | Face Neck Eyes Roller | Natural Glow | Reusable Facial Treatment ...,Warehouse A,58,49,2025-02-06 01:47:00,9
26854,ORD_26855,33958,Lovelong Spray,Warehouse B,76,63,2025-02-06 01:23:00,13
26855,ORD_26856,15549,"IKALL K100 1.8 Inch Display Keypad Mobile (Dual Sim, 1000 mAh Battery) (Black)",Warehouse B,46,27,2025-02-06 03:00:00,19
26856,ORD_26857,31200,Coscopin Paed  Syrup,Warehouse B,90,81,2025-02-06 22:49:00,9
26857,ORD_26858,34094,MYVN Silicone Case Compatible with Samsung Galaxy Buds 2 Case (2021) / Galaxy Buds Pro Case (2021) / Galaxy Buds Live Case...,Warehouse B,26,15,2025-02-06 08:58:00,11
26858,ORD_26859,31189,Caspan 40mg Injection,Warehouse C,65,55,2025-02-06 19:37:00,10
26859,ORD_26860,3361,"Fashion Colour Pro Matte Liquid Foundation, Chestnut 30 ml",Warehouse C,75,70,2025-02-06 06:04:00,5
26860,ORD_26861,15730,Joyzol 2.5mg Tablet,Warehouse A,40,23,2025-02-06 13:46:00,17
26861,ORD_26862,15521,"Hp Wired On Ear Headphones With Mic With 3.5 Mm Drivers, In-Built Noise Cancelling, Foldable And Adjustable For Laptop/Pc/...",Warehouse B,80,65,2025-02-06 17:35:00,15
26862,ORD_26863,34022,TheGiftKart Sleek Back Cover Case for Google Pixel 7 | Slim Fit Protective Design | Ultra Matte Finish | Camera Protection...,Warehouse A,58,52,2025-02-06 08:36:00,6
26863,ORD_26864,17578,House of Beauty Collagen Serum 30 ml,Warehouse A,50,39,2025-02-06 15:17:00,11
26864,ORD_26865,17622,"Apple Watch Series 8 [GPS 45 mm] Smart Watch w/Starlight Aluminium Case with Starlight Sport Band. Fitness Tracker, Blood ...",Warehouse C,46,38,2025-02-06 00:26:00,8
26865,ORD_26866,1934,Feveryl Drop,Warehouse B,108,97,2025-02-06 23:22:00,11
26866,ORD_26867,17527,Boujee Beauty Flat Foundation Brush B317 135 gm,Warehouse C,79,66,2025-02-06 02:26:00,13
26867,ORD_26868,31628,Cansol 5% Gel,Warehouse C,50,37,2025-02-06 09:12:00,13
26868,ORD_26869,31612,"Fashion Colour Mousse Foundation Lightweight, Shade 02 30 ml",Warehouse B,82,63,2025-02-06 23:46:00,19
26869,ORD_26870,17197,"Just Herbs Ayurvedic & Vegan Rose Lip Scrub & Lip Mask duo pack for Chapped, Pigmented & Dark lips,30gm",Warehouse B,90,83,2025-02-06 07:40:00,7
26870,ORD_26871,33733,Cepoman O 200mg/200mg Tablet,Warehouse A,99,86,2025-02-06 16:09:00,13
26871,ORD_26872,3145,"100 Pack Mascara Wands Bulk Disposable Eyelash Brushes Lash Extensions Makeup Brush Applicator Tool Bulk, Gold/Pink",Warehouse C,37,28,2025-02-06 06:04:00,9
26872,ORD_26873,17249,"WONDER Double Side Foam Tape 2 inch Width,48mmX5 Mtr Set of 2",Warehouse C,33,28,2025-02-06 10:23:00,5
26873,ORD_26874,30933,"Argan Oil - Hair & Skin Therapy, Oil-Moisturizing & Conditioning",Warehouse B,75,59,2025-02-06 05:49:00,16
26874,ORD_26875,15683,Brother DCP-B7500D Multi-Function Monochrome Laser Printer with Auto Duplex Printing (Toner Box Technology) (Grey),Warehouse A,45,40,2025-02-06 12:56:00,5
26875,ORD_26876,15670,Acesol Plus Tablet,Warehouse A,92,81,2025-02-06 08:47:00,11
26876,ORD_26877,11116,boAt Dual Port Rapid 120V Car Charger (Qualcomm Certified) Smart Charging for Cellular Phones with Quick Charge 3.0 + Free...,Warehouse A,86,69,2025-02-06 18:33:00,17
26877,ORD_26878,33841,Gleways M Forte 2mg/1000mg Tablet SR,Warehouse B,15,5,2025-02-06 13:37:00,10
26878,ORD_26879,15711,"Apple Watch Series 8 [GPS + Cellular 41 mm] Smart Watch w/Silver Aluminium Case with White Sport Band. Fitness Tracker, Bl...",Warehouse B,25,18,2025-02-06 20:47:00,7
26879,ORD_26880,11104,Denmont-LC Tablet,Warehouse C,23,11,2025-02-06 04:49:00,12
26880,ORD_26881,31282,OSYFEN PLUS 400MG/325MG/100MG TABLET,Warehouse A,37,26,2025-02-06 15:51:00,11
26881,ORD_26882,15727,Daily Nourish Hair Cream,Warehouse C,73,59,2025-02-06 19:16:00,14
26882,ORD_26883,3475,Glofty-CF Dry Syrup,Warehouse C,14,6,2025-02-06 13:41:00,8
26883,ORD_26884,12229,Tough Lee Back Cover Case for Oneplus 9R 5G (Silicon|Transparent) (Will Not Fit Oneplus 9RT),Warehouse A,25,7,2025-02-06 06:45:00,18
26884,ORD_26885,15414,Rewind 20mg Tablet,Warehouse A,94,78,2025-02-06 17:35:00,16
26885,ORD_26886,1689,Samsung 138 cm (55 inches) Crystal 4K Series Ultra HD Smart LED TV UA55AUE60AKLXL (Black),Warehouse A,40,27,2025-02-06 05:46:00,13
26886,ORD_26887,17536,SH.HUDA Matte Finish 15 Color Lip Color Lipstick Palette for Women,Warehouse B,73,62,2025-02-06 21:38:00,11
26887,ORD_26888,17540,Brondy AM Syrup,Warehouse C,95,76,2025-02-06 04:15:00,19
26888,ORD_26889,15404,Glaridep Forte Tablet,Warehouse A,69,58,2025-02-06 17:42:00,11
26889,ORD_26890,15397,Dyloop 20mg Tablet,Warehouse C,81,76,2025-02-06 08:06:00,5
26890,ORD_26891,34199,Vega Cuticle Trimmer (CTP - 01N) 16 gm,Warehouse B,17,1,2025-02-06 00:49:00,16
26891,ORD_26892,12239,"Party Propz Baby Shower Props for Photoshoot, Photo Booth, Decorations 29Pcs, Sticks Attached for Mom to Be Shoot, Materni...",Warehouse A,32,19,2025-02-06 02:01:00,13
26892,ORD_26893,30964,Cefritz S Injection,Warehouse A,69,52,2025-02-06 23:05:00,17
26893,ORD_26894,36381,Solotis 8 Tablet,Warehouse B,71,66,2025-02-05 12:19:00,5
26894,ORD_26895,8000,Mucusnil Tablet ER,Warehouse C,36,28,2025-02-05 16:33:00,8
26895,ORD_26896,27899,Levolxa 500mg Tablet,Warehouse B,62,49,2025-02-05 01:48:00,13
26896,ORD_26897,5132,Revolution Skincare Pore Cleansing Charcoal Nose Strips 1's,Warehouse B,67,52,2025-02-05 00:31:00,15
26897,ORD_26898,5832,Noxy CV DS Dry Syrup,Warehouse B,24,7,2025-02-05 09:23:00,17
26898,ORD_26899,11332,"Bonjour Paris Oil - Free Concealer Cum Pan Stick for Face ,Fair Skin 4.2 gm",Warehouse C,18,7,2025-02-05 18:38:00,11
26899,ORD_26900,5124,Tydem Oral Drops,Warehouse A,94,85,2025-02-05 10:25:00,9
26900,ORD_26901,36356,Bronkonil Syrup,Warehouse B,51,45,2025-02-05 06:53:00,6
26901,ORD_26902,33071,"3-In-1 Orange Blossom Body Wash - For Hair, Face & Body",Warehouse C,21,11,2025-02-05 07:34:00,10
26902,ORD_26903,5838,Mirabelle Korea Rose Essential Facial Sheet Mask 25 Ml,Warehouse A,44,32,2025-02-05 13:29:00,12
26903,ORD_26904,21841,Propar 40mg Tablet ER,Warehouse A,50,45,2025-02-05 12:32:00,5
26904,ORD_26905,9838,Hand Wash Liquid Refill - Skincare,Warehouse C,13,1,2025-02-05 18:12:00,12
26905,ORD_26906,5111,Ketmento-ZP Shampoo,Warehouse C,91,73,2025-02-05 17:51:00,18
26906,ORD_26907,17004,Acmeglim-M1 Forte Tablet SR,Warehouse C,93,82,2025-02-05 11:55:00,11
26907,ORD_26908,24661,"Mars Perfeet Face Illuminator Liquid Highlighter Gold Rush, 35ml (HL09-02)",Warehouse A,36,22,2025-02-05 19:59:00,14
26908,ORD_26909,11788,Vita Ex Gold Plus Tablets - With Pure Shilajit & Swarna Bhasma,Warehouse A,42,23,2025-02-05 20:36:00,19
26909,ORD_26910,20504,Defastar 6mg Tablet,Warehouse C,56,45,2025-02-05 06:32:00,11
26910,ORD_26911,16970,KC-Dom 50 Dry Syrup Mixed Fruit,Warehouse C,76,68,2025-02-05 21:20:00,8
26911,ORD_26912,13323,Hydro Replenish Light Aloe Vera Gel,Warehouse B,46,29,2025-02-05 21:08:00,17
26912,ORD_26913,19478,Fit Me Matte+Poreless Liquid Foundation,Warehouse C,29,16,2025-02-05 03:53:00,13
26913,ORD_26914,16665,"POPIO Tempered Glass Screen Protector Compatible for iPhone 14 Plus with Edge to Edge Coverage and Easy Installation kit, ...",Warehouse B,34,28,2025-02-05 12:11:00,6
26914,ORD_26915,13458,"DJI OM 5-Handheld 3-Axis Smartphone Gimbal Stabilizer with Grip Tripod, Built-in Extension Rod, Shot Guide for Vlogging, Y...",Warehouse C,27,17,2025-02-05 14:23:00,10
26915,ORD_26916,13312,India Grooming Club Royale Revitalising After Shave Lotion (ASL) 100 ml,Warehouse B,17,7,2025-02-05 04:13:00,10
26916,ORD_26917,9409,Clindaviz 600mg Injection,Warehouse A,13,3,2025-02-05 12:17:00,10
26917,ORD_26918,20332,R Codex Syrup,Warehouse C,87,76,2025-02-05 19:38:00,11
26918,ORD_26919,32354,S Mocy 500mg Capsule,Warehouse C,69,57,2025-02-05 19:35:00,12
26919,ORD_26920,32351,Spigen Rugged Armor Back Cover Case Compatible For Google Pixel 7 Pro (TPU | Matte Black),Warehouse B,92,75,2025-02-05 17:43:00,17
26920,ORD_26921,27178,"Tenda U3 WiFi Dongle 300Mbps USB Wireless Adapter, 2.4GHz, 2 Internal Antennas, USB 2.0, WPS, Soft AP Mode, Supports Windo...",Warehouse B,54,41,2025-02-05 04:51:00,13
26921,ORD_26922,36959,"Blue Heaven LONG LASH MASCARA,KAJAL (Pack of 2)",Warehouse A,94,84,2025-02-05 19:08:00,10
26922,ORD_26923,33146,Clavtop 500mg/125mg Tablet,Warehouse C,50,37,2025-02-05 16:36:00,13
26923,ORD_26924,25002,"Lowfe Smartwatch W26 Charging Cable, Watch Charger Magnetic 2 pin, Watch Charger, W26+ Charger 4mm Adapter Length 45 cm fo...",Warehouse B,87,79,2025-02-05 05:19:00,8
26924,ORD_26925,22759,Fujifilm Instax Mini 11 Instant Camera (Charcoal Grey),Warehouse C,75,67,2025-02-05 15:55:00,8
26925,ORD_26926,13904,Duracell CHHOTA Power Alkaline AAA Batteries (Pack of 2) 8 Pcs,Warehouse B,85,78,2025-02-05 00:07:00,7
26926,ORD_26927,13106,Hydra Lip Care Honey,Warehouse C,53,44,2025-02-05 07:04:00,9
26927,ORD_26928,9806,Mild Care - Germ Protection Handwash Refill,Warehouse B,54,46,2025-02-05 01:13:00,8
26928,ORD_26929,32605,"Juarez Pf-100 6-Inch Studio Microphone Pop Filter Shield Mask, Double Mesh Wind Screen With 360° Flexible Gooseneck And Qu...",Warehouse B,75,57,2025-02-05 10:28:00,18
26929,ORD_26930,28010,Flutas 400mg Tablet,Warehouse B,92,80,2025-02-05 11:20:00,12
26930,ORD_26931,11813,Herbal Lavender Fairness Moisturiser SLS & Paraben Free,Warehouse A,73,67,2025-02-05 00:04:00,6
26931,ORD_26932,33115,Pikkme Leather Magnetic Vintage Flip Wallet Case Cover for Vivo Y12 / Y15 / Y17 / U10 (Blue),Warehouse C,20,6,2025-02-05 15:57:00,14
26932,ORD_26933,467,Fashion Colour Light Corrective Concealer Stick Satin Foundation (Shade 002) Satin Finish,Warehouse B,38,30,2025-02-05 21:36:00,8
26933,ORD_26934,36298,L.A Girl HD PRO FACE PRESSED Powder PORCELAIN 7 gm,Warehouse A,109,99,2025-02-05 09:21:00,10
26934,ORD_26935,9867,Ogracef AZ 200mg/250mg Tablet,Warehouse B,80,71,2025-02-05 07:04:00,9
26935,ORD_26936,6924,"STRIFF Mpad Mouse Mat 230X190X3mm Gaming Mouse Pad, Non-Slip Rubber Base, Waterproof Surface, Premium-Textured, Compatible...",Warehouse C,81,65,2025-02-05 23:28:00,16
26936,ORD_26937,33100,Maped Universal Scissors (Black),Warehouse B,70,60,2025-02-05 12:34:00,10
26937,ORD_26938,26562,Bio Almond Ultra Rich Oil Body Wash,Warehouse B,95,83,2025-02-05 23:18:00,12
26938,ORD_26939,2294,ROMIDE 20MG TABLET,Warehouse B,87,68,2025-02-05 13:20:00,19
26939,ORD_26940,36337,Organic Harvest Tea Tree Essential Oil 30 ml,Warehouse C,45,35,2025-02-05 16:18:00,10
26940,ORD_26941,22755,Affix Auto-Align Technology Tempered Glass Screen Guard for iPhone 11 and for iPhone XR (6.1 Inch) | Easy Installation Fra...,Warehouse C,106,99,2025-02-05 16:24:00,7
26941,ORD_26942,20458,Cyzax 2mg Tablet,Warehouse B,76,70,2025-02-05 05:00:00,6
26942,ORD_26943,9804,Wyon 150mg Tablet,Warehouse B,13,4,2025-02-05 02:47:00,9
26943,ORD_26944,7693,Comet Busters The Bindi Book 2-960 bindis (Velvet Multisized and Multicolored Bindis),Warehouse A,73,58,2025-02-05 07:43:00,15
26944,ORD_26945,9802,"Wayona Nylon Braided (2 Pack) Lightning to USB Syncing and Fast Charging Data Cable Compatible for iPhone 13, 12, 11, X, ...",Warehouse C,80,72,2025-02-05 14:38:00,8
26945,ORD_26946,13107,L'Oreal Paris Men's Expert Total Clean Carbon 5 In 1 Shower Gel (300 ml),Warehouse A,40,33,2025-02-05 16:09:00,7
26946,ORD_26947,26607,"Motorola a50 (Rose Gold) - Dual Sim Keypad Mobile with Expandable Memory Upto 32GB, Rear Camera, 1750 mAh Big Battery, 6 I...",Warehouse A,69,50,2025-02-05 05:30:00,19
26947,ORD_26948,5155,Pikkme Mi Redmi 9A / 9i / 9A Sport Back Cover Soft Matte Liquid Silicone TPU | Camera Protection | Shockproof Slim Back Ca...,Warehouse A,43,26,2025-02-05 11:39:00,17
26948,ORD_26949,23289,Mtxe 10 Tablet,Warehouse B,71,56,2025-02-05 11:53:00,15
26949,ORD_26950,27847,Natraj Assorted Vinyl Leather Cover 200 Pocket 4 X 6 inch Album Multicolour,Warehouse C,18,8,2025-02-05 23:08:00,10
26950,ORD_26951,31936,"Archer Tech Lab Aphros 100 Keyboard Wrist Rest, PU Leather, Soft Memory Foam for Stable Wrist Position, Anti Skid Base Fee...",Warehouse C,40,26,2025-02-05 05:26:00,14
26951,ORD_26952,27834,Dulomed 10mg Tablet,Warehouse B,62,57,2025-02-05 17:56:00,5
26952,ORD_26953,2326,Keshar Chandan Natural Fairness Face Pack,Warehouse A,58,52,2025-02-05 02:43:00,6
26953,ORD_26954,9789,Etrobax 90 Tablet,Warehouse B,96,89,2025-02-05 19:10:00,7
26954,ORD_26955,33023,"VEIKK VK640 Drawing Tablet 6x4 inch Portable Pen Tablet with 8192 Levels Battery-Free Stylus Graphic Tablet, 6 Shortcuts f...",Warehouse C,30,18,2025-02-05 13:12:00,12
26955,ORD_26956,24684,Saregama Carvaan Mini 2.0 Gurbani- Music Player with Bluetooth/FM/AM/AUX (Saffron Orange),Warehouse A,44,39,2025-02-05 05:58:00,5
26956,ORD_26957,27146,Granilet 1mg Syrup,Warehouse A,41,36,2025-02-05 00:05:00,5
26957,ORD_26958,2558,"MARVIK 22MM Smart Watch Strap Belt for Boat Xtend, Boat Wave Lite, Boat Wave, Noise Colorfit Pulse Grand, Pulse Buzz, Fir...",Warehouse C,101,87,2025-02-05 12:35:00,14
26958,ORD_26959,8643,"Elle 18 Combo set of 4 Colour Pop Matte Lip Colour Misty Magenta,Pink Stylist,Maroon City,Berry Tea",Warehouse A,17,6,2025-02-05 05:13:00,11
26959,ORD_26960,32558,Kabaj Churna,Warehouse A,23,11,2025-02-05 15:43:00,12
26960,ORD_26961,20131,Soloxim-OF Tablet,Warehouse B,33,20,2025-02-05 11:07:00,13
26961,ORD_26962,37099,"LAKMÉ Absolute Liquid Highlighter, Ivory, 25 g",Warehouse B,6,1,2025-02-05 15:29:00,5
26962,ORD_26963,11564,"SKY BUYER Bluetooth Smart Touchscreen Smart Watch Bluetooth 1.3 HD Screen Smart Watch with Daily Activity Tracker, Heart R...",Warehouse C,90,84,2025-02-05 07:19:00,6
26963,ORD_26964,13374,Skin Cottage Moist Body Bath (Goat Milk) 1000 ml,Warehouse C,17,3,2025-02-05 15:15:00,14
26964,ORD_26965,9461,Gabaplus 10mg Tablet,Warehouse B,46,39,2025-02-05 09:29:00,7
26965,ORD_26966,13379,Fmine 50 Tablet,Warehouse C,22,8,2025-02-05 21:59:00,14
26966,ORD_26967,5633,"Stupefying 6 in 1 Military Pen with Compass, Torch, Tools, Phone Stand and Stylus Pen (Pck of 1)",Warehouse B,62,50,2025-02-05 08:11:00,12
26967,ORD_26968,21634,Olyflox-OZ Tablet,Warehouse C,69,57,2025-02-05 03:31:00,12
26968,ORD_26969,37117,Allure Blush Brush - (105) 1's,Warehouse B,72,55,2025-02-05 15:53:00,17
26969,ORD_26970,14,Isoron 20mg Soft Gelatin Capsule,Warehouse A,28,11,2025-02-05 23:21:00,17
26970,ORD_26971,2578,Clavoxin Dry Syrup,Warehouse B,104,89,2025-02-05 05:21:00,15
26971,ORD_26972,37057,Ronryl TM Syrup,Warehouse C,96,86,2025-02-05 10:01:00,10
26972,ORD_26973,32411,Amazon Brand - Solimo Basic Case for Apple iPhone X (Silicone_Transparent),Warehouse C,102,87,2025-02-05 19:09:00,15
26973,ORD_26974,16653,Epitra 500 Tablet,Warehouse B,67,56,2025-02-05 10:15:00,11
26974,ORD_26975,6782,Glic CI M 80mg/500mg Tablet,Warehouse C,111,94,2025-02-05 22:55:00,17
26975,ORD_26976,26926,"Avene Micellar Lotion, White, 200 ml",Warehouse A,35,30,2025-02-05 00:23:00,5
26976,ORD_26977,26944,"Seagate Expansion 5TB External HDD - USB 3.0 for Windows and Mac with 3 yr Data Recovery Services, Portable Hard Drive (ST...",Warehouse B,69,54,2025-02-05 10:09:00,15
26977,ORD_26978,27085,Ngdic MR 250mg/50mg/325mg Tablet,Warehouse B,68,63,2025-02-05 12:44:00,5
26978,ORD_26979,27079,Bath Soap - Fruity Orange Flavour,Warehouse A,74,68,2025-02-05 06:32:00,6
26979,ORD_26980,20076,SERY Mattish Lipstick Glam Godess 3.5 gm,Warehouse B,23,13,2025-02-05 17:09:00,10
26980,ORD_26981,7852,Regrace LS 2 mg/2 mg Tablet,Warehouse B,20,5,2025-02-05 01:42:00,15
26981,ORD_26982,7888,Gmt 1mg/500mg Tablet SR,Warehouse B,46,33,2025-02-05 10:44:00,13
26982,ORD_26983,13418,Vega Graduated Dressing Comb (HMSC - 32D) 46 gm,Warehouse C,22,3,2025-02-05 15:36:00,19
26983,ORD_26984,26951,"Amazon Basics USB A to Lightning MFi Certified Charging Cable (White, 1.2 meter)",Warehouse C,98,89,2025-02-05 23:16:00,9
26984,ORD_26985,36290,Lavender Luxury Shower Gel,Warehouse A,63,44,2025-02-05 08:26:00,19
26985,ORD_26986,20118,AMD Ryzen 3 3200G with RadeonVega 8 Graphics Desktop Processor 4 Cores up to 4GHz 6MB Cache Socket AM4 (YD320GC5FHBOX),Warehouse C,13,2,2025-02-05 17:14:00,11
26986,ORD_26987,9460,CZN L 5mg Tablet,Warehouse A,62,44,2025-02-05 00:21:00,18
26987,ORD_26988,8625,Tifix 50mg Suspension,Warehouse B,104,90,2025-02-05 22:12:00,14
26988,ORD_26989,27136,Amic 250mg Injection,Warehouse C,98,91,2025-02-05 14:41:00,7
26989,ORD_26990,19944,Fezora® Wireless Powerful 120 WATTS Car Vaccum Cleaner with Custom Head Extension and Charging Cable - 2000 MAH Suction Po...,Warehouse B,69,60,2025-02-05 14:57:00,9
26990,ORD_26991,13537,Uribact 750mg Tablet,Warehouse C,80,68,2025-02-05 14:49:00,12
26991,ORD_26992,32679,Moviz XP Tablet,Warehouse B,23,15,2025-02-05 02:48:00,8
26992,ORD_26993,19959,Omax 20mg Capsule,Warehouse A,51,37,2025-02-05 13:18:00,14
26993,ORD_26994,9552,Osobid 500mg Tablet,Warehouse B,89,71,2025-02-05 19:30:00,18
26994,ORD_26995,11500,Ajmal Aurum Aurum Silver Shade Deodorant Spray (Pack of 3) 200 ml,Warehouse C,43,30,2025-02-05 21:38:00,13
26995,ORD_26996,2510,Scotrox 500 Tablet,Warehouse B,22,16,2025-02-05 13:04:00,6
26996,ORD_26997,7835,"Brite Henna Mehndi, 1kg - Green",Warehouse B,81,76,2025-02-05 02:06:00,5
26997,ORD_26998,27027,Angelie Professional Flat Face Pack Brush Combo of 2Pcs,Warehouse A,116,98,2025-02-05 04:54:00,18
26998,ORD_26999,27113,"Casio SA-47A Electronic Keyboard, Black (32 Keys)",Warehouse B,70,58,2025-02-05 11:49:00,12
26999,ORD_27000,2541,5in1 Baked Blusher & Highlighter Shimmer Highlighter Brick For Instant Glow Wash Off Makeup Palette Highlighter,Warehouse C,104,94,2025-02-05 10:37:00,10
27000,ORD_27001,2688,Dilo-DX Syrup,Warehouse C,39,30,2025-02-05 03:19:00,9
27001,ORD_27002,20056,Lini Injection,Warehouse A,41,34,2025-02-05 15:18:00,7
27002,ORD_27003,5657,Ant Esports 690 NEO VS 4GB (1*4GB) DDR3 1600 MHz CL 11-11-11-28 U-DIMM Desktop Memory - AE4GD3U16M16C,Warehouse B,36,30,2025-02-05 11:35:00,6
27003,ORD_27004,21616,Kronostar 200mg Tablet,Warehouse A,100,85,2025-02-05 18:51:00,15
27004,ORD_27005,32669,Toning Lotion,Warehouse C,32,16,2025-02-05 12:52:00,16
27005,ORD_27006,32661,Fexpo 120mg Tablet,Warehouse C,100,92,2025-02-05 13:04:00,8
27006,ORD_27007,36915,"Laboratory Reagent CH3, CO, CH3",Warehouse B,108,98,2025-02-05 03:33:00,10
27007,ORD_27008,32313,Essence Eyeliner Pen Extra Longlasting 20057,Warehouse C,74,59,2025-02-05 23:53:00,15
27008,ORD_27009,5672,Siarox 150mg Tablet,Warehouse A,37,29,2025-02-05 23:39:00,8
27009,ORD_27010,13287,"Zayn & Myza Transfer - Proof Power Matte Lipstick, Apricot Blush 3.2 gm",Warehouse C,40,35,2025-02-05 04:22:00,5
27010,ORD_27011,32646,HP v150w 32GB USB 2.0 flash Drive (Blue),Warehouse A,69,62,2025-02-05 15:06:00,7
27011,ORD_27012,32644,Forpentadol 50mg Tablet,Warehouse A,49,36,2025-02-05 06:23:00,13
27012,ORD_27013,32638,"Targus 15.6"" Geolite Essential TSS98401GL Laptop Case",Warehouse B,70,58,2025-02-05 22:57:00,12
27013,ORD_27014,27117,Ciprobard 500mg Tablet,Warehouse A,24,18,2025-02-05 09:39:00,6
27014,ORD_27015,20216,Fillace TP 100mg/325mg Tablet,Warehouse B,16,9,2025-02-05 18:44:00,7
27015,ORD_27016,32835,Duomorphic 2mg/500mg Tablet,Warehouse B,24,17,2025-02-05 19:15:00,7
27016,ORD_27017,21675,Mytra 100mg Capsule,Warehouse A,16,5,2025-02-05 02:57:00,11
27017,ORD_27018,25,Ajmal Evoke & Wisal Dhahab Deo & Prose EDP Pack of 3 20 ml,Warehouse B,79,64,2025-02-05 11:36:00,15
27018,ORD_27019,22,"Ossum Delight, Perfume Body Mist With Aqua, Long-Lasting Freshness, Made For Women, 115ml",Warehouse C,77,62,2025-02-05 18:54:00,15
27019,ORD_27020,2601,"MARVIK Smart Watch D116 for Xiaomi Mi Note 9 Smart Watch Bluetooth SmartWatch with Activity Tracker, Heart Rate Sensor, Sl...",Warehouse C,78,69,2025-02-05 08:12:00,9
27020,ORD_27021,2987,House of Aroma Essential Oil - Vetiver 10 ml,Warehouse B,71,57,2025-02-05 19:26:00,14
27021,ORD_27022,34100,On-Dalcare Tablet MD,Warehouse A,31,25,2025-02-05 08:43:00,6
27022,ORD_27023,6661,"Samsung Galaxy A14 5G (Dark Red, 8GB, 128GB Storage) | Triple Rear Camera (50 MP Main) | Upto 16 GB RAM with RAM Plus | Tr...",Warehouse A,71,53,2025-02-05 21:31:00,18
27023,ORD_27024,7715,(Renewed) Boya BYM1 Omnidirectional Lavalier Condenser Microphone with 20ft Audio Cable (Black),Warehouse B,47,37,2025-02-05 15:35:00,10
27024,ORD_27025,36497,Oil - Kesh Kanti,Warehouse C,26,7,2025-02-05 13:22:00,19
27025,ORD_27026,31986,"Chambor Gel Effect Base and Top Coat, Clear No.503, 10 ml",Warehouse B,108,93,2025-02-05 00:22:00,15
27026,ORD_27027,21537,Edoflam SP 100mg/325mg/15mg Tablet,Warehouse A,82,76,2025-02-05 08:52:00,6
27027,ORD_27028,27702,Lenovo Casual Laptop Briefcase T210 (Toploader) 39.62 cm (15.6-inch) Water Repellent Black,Warehouse A,88,81,2025-02-05 01:34:00,7
27028,ORD_27029,5243,Mulberry & Rose Facewash,Warehouse A,64,57,2025-02-05 07:43:00,7
27029,ORD_27030,9722,Gidinik 16mg Tablet,Warehouse A,34,25,2025-02-05 09:13:00,9
27030,ORD_27031,32012,Astigo 3 Pin Laptop Power Cable ISI Certified Black - 1.5 Meter,Warehouse B,97,91,2025-02-05 12:28:00,6
27031,ORD_27032,32940,DeLegarde™ Traditional Round Bindis Tikka for Girls Bindi Women Ladies (Multi Colour) Size 4mm 2 Pack,Warehouse C,65,52,2025-02-05 01:13:00,13
27032,ORD_27033,19613,"boAt Stone 620 Bluetooth Speaker with 12W RMS Stereo Sound, 10HRS Playtime, TWS Feature, IPX4, Multi-Compatibility Mode(Red)",Warehouse C,45,35,2025-02-05 13:31:00,10
27033,ORD_27034,32923,"DIGITEK® (LP E12) Lithium-ion Rechargeable Battery Pack for DSLR Camera, Compatibility - EOS M Series, 100D, Kiss M, Kiss ...",Warehouse A,43,26,2025-02-05 17:20:00,17
27034,ORD_27035,32930,Ipacare 1000mg Injection,Warehouse C,59,50,2025-02-05 02:07:00,9
27035,ORD_27036,7710,Medimade Hydrating Conditioner With Moroccan Argan Oil 300 ml,Warehouse A,72,60,2025-02-05 08:44:00,12
27036,ORD_27037,5226,Aceclolight Tablet,Warehouse C,57,45,2025-02-05 07:14:00,12
27037,ORD_27038,16191,"Proffisy Aluminum Laptop Cooling Pad with One Big Quiet Cooling Fan, Laptop Cooler Stand with 7 Height Adjustable, Noteboo...",Warehouse B,28,14,2025-02-05 09:40:00,14
27038,ORD_27039,27808,SERY Mattish Lipstick CHot Pink 3.5 gm,Warehouse A,84,71,2025-02-05 12:52:00,13
27039,ORD_27040,21528,Nutriment Fruit Cream All Skin Type 250 gm,Warehouse C,36,24,2025-02-05 02:57:00,12
27040,ORD_27041,27802,"KAZIMA Combo of Rosemary Oil and Peppermint Oil - 100% Pure Essential Oil for Hair Growth, Skin Care, Aromatherapy, Muscle...",Warehouse C,96,85,2025-02-05 12:57:00,11
27041,ORD_27042,32989,"FACES CANADA 4 IN 1 Quad Eyeshadow Palette - Idyllic Nudes 01, 4.8g | Shimmer & Matte Shades | Satin Matte Finish Eye Shad...",Warehouse A,34,28,2025-02-05 04:58:00,6
27042,ORD_27043,7992,"SWAPKART Flexible Mobile Tabletop Stand, Metal Built, Heavy Duty Foldable Lazy Bracket Clip Mount Multi Angle Clamp for Al...",Warehouse A,71,56,2025-02-05 23:09:00,15
27043,ORD_27044,20416,Verilux®Touch Stylus S Pen Replacement Stylus Pen Refill Tool Kit for Samsung Galaxy Note 10 / Note10+Plus / Note20 / Note...,Warehouse A,27,13,2025-02-05 08:44:00,14
27044,ORD_27045,20410,TheGiftKart Flip Cover Back Case for Poco X5 5G / Mi Redmi Note 12 5G | Genuine Leather Finish | Designer Button | Inbuilt...,Warehouse B,13,4,2025-02-05 13:28:00,9
27045,ORD_27046,21809,Sony Bravia 108 cm (43 inches) 4K Ultra HD Smart LED Google TV KD-43X75K (Black) (2022 Model) | with Alexa Compatibility,Warehouse A,43,31,2025-02-05 07:42:00,12
27046,ORD_27047,20409,SanDisk Ultra Dual 64GB USB 3.0 OTG Pen Drive (Gold),Warehouse B,85,74,2025-02-05 02:26:00,11
27047,ORD_27048,383,"APC Back-UPS BX600C-IN 600VA / 360W, 230V, UPS System, an Ideal Power Backup & Protection for Home Office, Desktop PC & Ho...",Warehouse B,30,12,2025-02-05 11:09:00,18
27048,ORD_27049,9775,"boAt Stone 620 Bluetooth Speaker with 12W RMS Stereo Sound, 10HRS Playtime, TWS Feature, IPX4, Multi-Compatibility Mode(Bl...",Warehouse A,111,92,2025-02-05 02:10:00,19
27049,ORD_27050,13830,Ceftichek 250mg/125mg Injection,Warehouse C,88,81,2025-02-05 03:52:00,7
27050,ORD_27051,13120,TheGiftKart Back Cover Case for OnePlus Nord CE 2 LITE 5G | Tough Armor Bumper | Ring Holder & Kickstand in-Built | 360 De...,Warehouse C,108,96,2025-02-05 07:31:00,12
27051,ORD_27052,36435,Virtual Reality Headset Glasses Anti-Radiation Adjustable Screen Headband Virtual Reality Box Compatible with Any Phone 2K...,Warehouse C,102,84,2025-02-05 11:43:00,18
27052,ORD_27053,9324,Rabel LS 75mg/20mg Capsule,Warehouse B,85,78,2025-02-05 19:16:00,7
27053,ORD_27054,21798,Melose Eye Drop,Warehouse A,17,7,2025-02-05 00:06:00,10
27054,ORD_27055,19577,I AM EYECONIC 3D GLITTER AFTER EVERY SUNSET 4 gm,Warehouse C,47,40,2025-02-05 10:45:00,7
27055,ORD_27056,5247,"HP 280 USB Wireless Mouse, 2.4GHz Connection, Ergonomically Designed Mouse That Provides All-Day Comfort with Upto 18 Mont...",Warehouse C,9,3,2025-02-05 12:37:00,6
27056,ORD_27057,30812,ENVIE® (ECR 20 MC+4xAA2800) Standard Rechargeable Battery Charger for AA & AAA Ni-mh/Ni-Cd with 4xAA2800 Rechargeable Batt...,Warehouse B,97,89,2025-02-05 08:32:00,8
27057,ORD_27058,7352,Ajmal Impress Concentrated Perfume Oil Citrus And Avid Homme Deodorant Aquatic Woody Fragrance 210 ml,Warehouse A,83,72,2025-02-05 14:56:00,11
27058,ORD_27059,20884,Axxeum Silicon Lightning USB Data Charging Cable Protector and Saver for Both Ends for All Android and iPhone Smartphones...,Warehouse A,92,87,2025-02-05 06:22:00,5
27059,ORD_27060,34956,Classmate Octane- Blue Ball Pens (pack Of 5) | Smooth & Fast Writing Ball Pens | Comfortable To Hold & Write| School & Off...,Warehouse B,61,42,2025-02-05 20:23:00,19
27060,ORD_27061,12554,Natural SMC M/F Face Beauty cream,Warehouse A,57,39,2025-02-05 07:14:00,18
27061,ORD_27062,24220,Monast LC Kid 2.5mg/4mg Tablet,Warehouse C,92,85,2025-02-05 22:17:00,7
27062,ORD_27063,21207,Superdrug Strawberry & Cream Face Mask 15 ml,Warehouse C,35,28,2025-02-05 08:13:00,7
27063,ORD_27064,6709,"Gaiatop Small Table Fan, 4 Inch Ultra-quiet, 40° Adjustment for Better Cooling, 3 Speeds Portable Mini Powerful Desktop Ta...",Warehouse B,19,5,2025-02-05 09:33:00,14
27064,ORD_27065,18362,Olacalm 20mg Tablet MD,Warehouse A,108,93,2025-02-05 00:48:00,15
27065,ORD_27066,10484,"ZEBRONICS Zeb-MA5222 USB Charger Adapter with 1 Metre Micro USB Cable, 2 USB Ports, for Mobile Phone/Tablets (White)",Warehouse A,95,87,2025-02-05 21:42:00,8
27066,ORD_27067,1771,Famal Kit,Warehouse B,30,19,2025-02-05 11:19:00,11
27067,ORD_27068,24254,"100% Pure Castor Oil, Cold Pressed, To Support Hair Growth, Good Skin & Strong Nails",Warehouse B,38,33,2025-02-05 00:02:00,5
27068,ORD_27069,25931,Parker Quink Ink Bottle (Black),Warehouse A,31,19,2025-02-05 23:30:00,12
27069,ORD_27070,140,DeBelle Gel Nail Lacquer Cherry Macaron Powder Pink Nail Polish 8 ml,Warehouse C,48,38,2025-02-05 18:46:00,10
27070,ORD_27071,15493,"Arata Aloe Vera Under Eye Gel For Dark Circles, Fine Lines & Puffiness 10 ml",Warehouse C,83,78,2025-02-05 17:26:00,5
27071,ORD_27072,3522,"Fashion Colour Soft Lip Mousse, 14 Coral Orange 8 gm",Warehouse B,65,54,2025-02-05 21:55:00,11
27072,ORD_27073,6447,Efix 200mg Tablet,Warehouse C,58,41,2025-02-05 18:50:00,17
27073,ORD_27074,22130,"Dyazo 6ft Nylon Braided 3.5mm Aux Cable, Male to Male Audio Auxiliary cable Compatible for Speakers, headphones, Car, & Mo...",Warehouse C,22,17,2025-02-05 12:59:00,5
27074,ORD_27075,29693,"Duracell 36W Fast Car Charger Adapter with Dual USB Port. Qualcomm Certified 3.0, Quick Charge. Compatible with iPhone, Al...",Warehouse A,103,85,2025-02-05 22:28:00,18
27075,ORD_27076,24232,Format 500mg Tablet SR,Warehouse C,100,90,2025-02-05 12:17:00,10
27076,ORD_27077,10495,"MyGlamm Treasure It Suede Matte Lipstick – First Crush, 4 gm | Long lasting Matte Lipstick | With Vitamin E And Cocoa Seed...",Warehouse B,110,99,2025-02-05 22:47:00,11
27077,ORD_27078,10493,POPIO Tempered Glass Screen Protector Compatible for Samsung Galaxy F41 ; M31 ; M21 : M21s with Full Screen Coverage (exce...,Warehouse C,33,19,2025-02-05 13:41:00,14
27078,ORD_27079,34983,Meconia 2500 Injection,Warehouse C,34,23,2025-02-05 08:25:00,11
27079,ORD_27080,14221,Maryaj Edp Tuxedo For Him 100 Ml,Warehouse C,38,32,2025-02-05 03:14:00,6
27080,ORD_27081,4123,"Lenovo B0919NL1HZ Tab M8 HD 2nd Gen (8 inch(20cm), 3GB, 32 GB, Wi-Fi+LTE with Calling), Iron Grey",Warehouse B,48,39,2025-02-05 05:05:00,9
27081,ORD_27082,21915,OFIXO Hard Shell Case for Over The Ear Headphones with Full Protection Compatible with all branded and non-branded headpho...,Warehouse A,54,37,2025-02-05 11:25:00,17
27082,ORD_27083,13787,Hair Pack - Brahmi,Warehouse C,23,8,2025-02-05 18:50:00,15
27083,ORD_27084,27747,Dromet-M 80mg/250mg Tablet,Warehouse A,102,96,2025-02-05 20:32:00,6
27084,ORD_27085,19564,Benzo 0.25 MD Tablet,Warehouse C,65,56,2025-02-05 21:20:00,9
27085,ORD_27086,31978,7SEVEN Compatible LG TV Remote Suitable for LG Non Magic Smart tv Remote Control (Mouse & Voice Non-Support) MR20GA Prime ...,Warehouse B,80,63,2025-02-05 22:51:00,17
27086,ORD_27087,2384,Sung-Ho - Herbal Inhalant,Warehouse C,78,63,2025-02-05 08:19:00,15
27087,ORD_27088,2269,LOHAYA Air Conditioner Remote Compatible Daikin Split AC Remote Control [ Compatible for Daikin AC Remote ] [ AC-132A ],Warehouse C,111,94,2025-02-05 01:28:00,17
27088,ORD_27089,9857,Bonjour Paris Photo Match Liquid Concealer - Rose Blush 4 ml,Warehouse B,69,51,2025-02-05 14:08:00,18
27089,ORD_27090,23317,Egyptian Geranium Oil & Witch Hazel Face Wash,Warehouse A,80,68,2025-02-05 21:14:00,12
27090,ORD_27091,5083,AmazonBasics 67-Inch Monopod (Black),Warehouse B,17,7,2025-02-05 10:19:00,10
27091,ORD_27092,27982,M.G.R.J® Portable Carrying Case Cover for Bose SoundLink Flex Bluetooth Portable Speaker (Hard|EVA|Black),Warehouse B,8,1,2025-02-05 11:20:00,7
27092,ORD_27093,9850,Cadiflux 40mg Tablet,Warehouse B,41,26,2025-02-05 08:26:00,15
27093,ORD_27094,9854,LA Mika 500mg Injection,Warehouse A,53,46,2025-02-05 20:02:00,7
27094,ORD_27095,17013,Voizgesic SP 100mg/325mg/15mg Tablet,Warehouse C,51,41,2025-02-05 18:55:00,10
27095,ORD_27096,20433,Eukarit 200mg Capsule,Warehouse A,61,55,2025-02-05 13:44:00,6
27096,ORD_27097,26702,Samsung 108 cm (43 inches) Crystal 4K Series Ultra HD Smart LED TV UA43AUE60AKLXL (Black),Warehouse C,67,56,2025-02-05 06:36:00,11
27097,ORD_27098,27810,"Body Spray - Perfumed, Innovator",Warehouse A,99,93,2025-02-05 20:02:00,6
27098,ORD_27099,32990,ProElite Smart Flip Case Cover for Samsung Galaxy Tab S8 Plus/S7 Plus/S7 FE 12.4 Inch SM-X800/X806/T970/T975/T976/T735 wit...,Warehouse B,98,81,2025-02-05 21:41:00,17
27099,ORD_27100,20364,"ESR Clear Case Compatible with iPhone 14 Pro Max Case, Shockproof Thin Silicone Cover, TPU,Yellowing-Resistant Slim Transp...",Warehouse B,58,39,2025-02-05 16:42:00,19
27100,ORD_27101,21785,"ENVIE® (ECR 11MC+2800+1100) SprintX Ultra Fast Rechargeable Batteries Charger for AA & AAA Ni-mh, with 2xAA2800 & 2AAA1100...",Warehouse C,72,61,2025-02-05 19:37:00,11
27101,ORD_27102,26710,"Ant Value H81Mad3-N Gaming Matx Motherboard Lga1150 Intel 4Th Generation I3/I5/I7 Ddr3, M.2 Nvme, USB 3.0 Ports, Hdmi Port",Warehouse B,66,57,2025-02-05 18:43:00,9
27102,ORD_27103,9344,Rabisea L 75mg/20mg Capsule SR,Warehouse B,111,97,2025-02-05 09:17:00,14
27103,ORD_27104,7680,Gold Edition - Eau De Toilette Deodorant For Woman,Warehouse C,79,68,2025-02-05 09:14:00,11
27104,ORD_27105,25102,URBN 20000 mAh Li-Polymer Ultra Compact Power Bank | 12W Fast Charge | Dual USB Output | Type C & Micro Input (Blue),Warehouse A,46,27,2025-02-05 23:50:00,19
27105,ORD_27106,21850,Exermet P 30mg/500mg Tablet,Warehouse A,30,24,2025-02-05 02:16:00,6
27106,ORD_27107,33093,"Fashion Colour Oil Free Foundation Waterproof, Shade 03 40 ml",Warehouse B,73,63,2025-02-05 09:57:00,10
27107,ORD_27108,27961,"SanDisk Ultra Dual USB Drive 3.1, SDDDC2 32GB, Black, USB 3.1/Type C Reversible Connector, Retractable Design, Type-C OTG-...",Warehouse A,66,52,2025-02-05 07:57:00,14
27108,ORD_27109,27955,ZOUL Type C to Type C Fast Charging Cable 65W USB C to USB C Nylon Braided Cord Compatible with Oneplus 9 Samsung Galaxy S...,Warehouse A,31,23,2025-02-05 11:21:00,8
27109,ORD_27110,24647,Gmol-Ace Tablet,Warehouse A,97,82,2025-02-05 03:03:00,15
27110,ORD_27111,27953,"Stbotanica Vitamin C Brightening Hand And Nail Cream, Deeply Nourish Dry Hand & Skin With Olive & Jojoba Oils, Cocoa & Shea Butter 50 gm",Warehouse A,29,17,2025-02-05 19:16:00,12
27111,ORD_27112,22746,Lakme Absolute Matte Revolution Lip Color 103 Maroon Fantasy 3.5 Gm,Warehouse A,79,68,2025-02-05 15:58:00,11
27112,ORD_27113,27949,Charcoal Face Scrub With Charcoal & Walnut For Deep Exfoliation - For Oily Skin & Normal Skin,Warehouse C,89,83,2025-02-05 14:34:00,6
27113,ORD_27114,20478,"BROLAVIYA Overhead Video Mobile Stand with 10inch Ring Light, Metal Arm,1/4"" Male Adaptor for Camera,Gopro,Mobile Bracket ...",Warehouse B,100,85,2025-02-05 17:22:00,15
27114,ORD_27115,5071,REMOTEX Air Conditioner Remote Compatible for Voltas Smart Split Ac Remote Control with WiFi Function (Please Match The Im...,Warehouse C,75,65,2025-02-05 07:54:00,10
27115,ORD_27116,20624,Epinorm Syrup,Warehouse C,47,34,2025-02-05 16:36:00,13
27116,ORD_27117,36301,TheGiftKart Back Cover for Realme 7 / Narzo 30 4G / Narzo 20 Pro (Poly Carbonate | Black),Warehouse C,58,49,2025-02-05 08:42:00,9
27117,ORD_27118,20505,Axizole DSR 30mg/20mg Capsule,Warehouse B,19,14,2025-02-05 22:29:00,5
27118,ORD_27119,5271,Mefic Plus Oral Suspension,Warehouse A,79,62,2025-02-05 21:52:00,17
27119,ORD_27120,7725,Ajmal 2 Wisal & 2 Wisal Dhahab Deo & Aretha EDP Pack of 5 20 ml,Warehouse B,20,8,2025-02-05 15:52:00,12
27120,ORD_27121,25004,BRUSTRO Technical Pen Black Set of 6.,Warehouse A,25,19,2025-02-05 11:02:00,6
27121,ORD_27122,291,"Mi Beard Trimmer for men, full body Waterproof IPX7, 90 mins runtime, Fast Charging, 40 length settings, cordless+ corded ...",Warehouse A,108,92,2025-02-05 09:32:00,16
27122,ORD_27123,23199,Marshmallow Pineapple Fluff Massage Cream,Warehouse B,107,92,2025-02-05 03:43:00,15
27123,ORD_27124,16277,Caboki Hair building fiber is absolutely natural & unnoticeable Dark Brown 25gm,Warehouse A,60,45,2025-02-05 06:23:00,15
27124,ORD_27125,32883,Foolzy 11Pcs Makeup Brush Set Professional Kabuki Foundation Blending Blush Concealer Eye Face Liquid Powder Cream Cosmeti...,Warehouse A,74,63,2025-02-05 13:36:00,11
27125,ORD_27126,36598,Activ Beaute Advanced Soothing Sensitive Skin Day Cream 25 gm,Warehouse B,102,89,2025-02-05 18:42:00,13
27126,ORD_27127,23200,Oxyglow Face Wash - Skin Whitening 150 ml,Warehouse A,16,3,2025-02-05 22:38:00,13
27127,ORD_27128,32083,Divinectar Skin Repair Face Serum - Black Rice 30 ml,Warehouse B,12,1,2025-02-05 14:00:00,11
27128,ORD_27129,9682,Terlami 250mg Tablet,Warehouse B,31,26,2025-02-05 12:52:00,5
27129,ORD_27130,32043,Hello Zone Exclusive Matte Finish Soft Back Case Cover for Google Pixel 4a - Black,Warehouse A,56,38,2025-02-05 22:12:00,18
27130,ORD_27131,2400,Plum Green Tea Gentle Revival Face Scrub 75 Gm,Warehouse C,83,72,2025-02-05 18:46:00,11
27131,ORD_27132,16865,The Natural Wash Rice Water Hair Vitalizer 50 ml,Warehouse A,46,32,2025-02-05 15:56:00,14
27132,ORD_27133,36548,Logitech Wireless Presenter R400 (Black),Warehouse B,49,32,2025-02-05 17:44:00,17
27133,ORD_27134,7971,Artisid 25mg Capsule,Warehouse B,14,5,2025-02-05 10:33:00,9
27134,ORD_27135,312,"Menstrual Cup - Hygienic, Before Delivery / Upto Age 25 Years, Size S(Small)",Warehouse B,93,86,2025-02-05 16:57:00,7
27135,ORD_27136,19741,My Dream For Him - Perfumed Deodorant Natural Spray,Warehouse C,20,10,2025-02-05 21:13:00,10
27136,ORD_27137,2411,Bergamot Essentail Oil - 100% Pure & Natural,Warehouse C,31,12,2025-02-05 19:06:00,19
27137,ORD_27138,11418,Daily Multivitamin Tablets For Women & Men,Warehouse C,83,73,2025-02-05 15:57:00,10
27138,ORD_27139,32112,"Tecno POP 7 Pro (Uyuni Blue, 2GB RAM,64GB Storage) | Type C Port | 12MP Dual Camera | Up to 4GB RAM with Memory Fusion",Warehouse A,38,19,2025-02-05 12:48:00,19
27139,ORD_27140,23225,"ONUMTZ 2 in 1 OTG Adapter Cable Micro USB+USB C to USB 2.0 Female Connector Cable, OTG Pen Drive to Mobile Connector Type ...",Warehouse C,108,90,2025-02-05 21:21:00,18
27140,ORD_27141,19687,"FEDUS 5 Meter 16.4 Feet Long Switch Board Extension, Pack 1 Extension Boards with Switch,Extension Board with Long Wire, E...",Warehouse C,32,22,2025-02-05 12:31:00,10
27141,ORD_27142,36501,Fitglim 2mg Tablet,Warehouse A,67,56,2025-02-05 04:55:00,11
27142,ORD_27143,16250,Onsitego 2 Year Extended Warranty for Small Household Appliances from Rs. 501-1000 (Email Delivery - No Physical Kit),Warehouse B,28,23,2025-02-05 02:01:00,5
27143,ORD_27144,5782,"Sery Stay On Matte Liquid Lipstick Delightful Nude, Pink (LSO - 09) 5 ml",Warehouse B,36,24,2025-02-05 09:25:00,12
27144,ORD_27145,36509,Lotas-HT Tablet,Warehouse A,103,85,2025-02-05 19:51:00,18
27145,ORD_27146,13749,Anti-Acne Neem Face Pack - With Clove & Turmeric,Warehouse A,81,71,2025-02-05 23:40:00,10
27146,ORD_27147,11396,"CROSSVOLT Tempered Glass Screen Protector Compatible for Samsung Galaxy Watch 5 And Samsung Galaxy Watch 4 (44mm) (1.4"" in...",Warehouse C,96,88,2025-02-05 20:47:00,8
27147,ORD_27148,6716,Epsolin ER 300 Tablet,Warehouse B,63,48,2025-02-05 14:05:00,15
27148,ORD_27149,36516,Soincef-OZ 200mg/500mg Tablet,Warehouse C,98,82,2025-02-05 03:54:00,16
27149,ORD_27150,32037,Damita 10mg Tablet,Warehouse B,75,70,2025-02-05 23:57:00,5
27150,ORD_27151,32038,Marquis - Paris Deo Red for Men,Warehouse C,106,95,2025-02-05 21:28:00,11
27151,ORD_27152,27266,OnePlus Red Cable Care (12-Month Extended Warranty & 120GB Cloud Storage) (Email Delivery),Warehouse C,21,6,2025-02-05 03:50:00,15
27152,ORD_27153,31767,Ajmal Bombay Dreams EDP Floral Fruity Perfume And Aurum Concentrated Perfume Oil Fruity Floral 110 ml,Warehouse B,73,66,2025-02-05 09:12:00,7
27153,ORD_27154,27269,"Amazon Basics Laptop Cooling Pad, USB Powered Portable Gaming Laptop Cooler Stand | Quiet 2 Fans with Blue LED Light | 2 V...",Warehouse A,24,18,2025-02-05 15:07:00,6
27154,ORD_27155,31693,Apetin Drop,Warehouse A,58,41,2025-02-05 17:21:00,17
27155,ORD_27156,26425,"CASENED Tempered Glass Camera Lens Protector For Iphone 14/14 Plus, 9H Premium Tempered Glass, Aviation Aluminum Camera Pr...",Warehouse B,105,92,2025-02-05 22:25:00,13
27156,ORD_27157,9219,"Beardo Origin Perfume For Men, 100 ml | EAU DE PARFUM | Long Lasting Perfume for Men | Strong Aqua and Musky Tones | Ideal...",Warehouse C,46,39,2025-02-05 21:55:00,7
27157,ORD_27158,3085,"OnePlus Nord CE 2 Lite 5G (Black Dusk, 6GB RAM, 128GB Storage)",Warehouse B,20,8,2025-02-05 00:29:00,12
27158,ORD_27159,14162,Formistar-GV 1mg/500mg/0.2mg Tablet,Warehouse C,47,37,2025-02-05 05:13:00,10
27159,ORD_27160,12983,Stbotanica Moroccan Argan Oil Creamy Face Wash 100 ml,Warehouse C,61,45,2025-02-05 10:24:00,16
27160,ORD_27161,33315,AEIDESS Tempered Glass Screen Protector Compatible For Samsung Galaxy M33 5G with Edge to Edge Coverage and Easy Installat...,Warehouse C,38,30,2025-02-05 23:15:00,8
27161,ORD_27162,625,Dotburg M 80mg/250mg Tablet,Warehouse C,52,42,2025-02-05 13:04:00,10
27162,ORD_27163,11214,"Vivo Y16 (Stellar Black, 4GB RAM, 64GB Storage) with No Cost EMI/Additional Exchange Offers",Warehouse C,82,71,2025-02-05 15:04:00,11
27163,ORD_27164,9239,Marquis - Paris Deo Blue for Men,Warehouse B,100,91,2025-02-05 03:52:00,9
27164,ORD_27165,11885,Rolnac P 100mg/325mg Tablet,Warehouse B,92,75,2025-02-05 00:19:00,17
27165,ORD_27166,5921,Biodegradable Panty Liners,Warehouse B,81,68,2025-02-05 16:01:00,13
27166,ORD_27167,3129,"Enchanteur Romantic Perfumed Soap, 75g (Buy 3 Get 1) with Roses & Jasmine Extracts",Warehouse A,86,73,2025-02-05 11:06:00,13
27167,ORD_27168,31654,Spaxin 200mg Tablet,Warehouse A,94,89,2025-02-05 03:20:00,5
27168,ORD_27169,20563,"ENVIE® (ECR 11 MC) SprintX Ultra Fast Charger for Rechargeable Batteries AA & AAA Ni-mh, with LCD Display, Smart Charge Co...",Warehouse B,48,36,2025-02-05 11:55:00,12
27169,ORD_27170,19132,Altriz 5 Tablet,Warehouse B,33,27,2025-02-05 11:24:00,6
27170,ORD_27171,7620,Lakeer Detail Pen Knife With 5 Interchangeable Sharp Blades For Carving & Mat Cutting,Warehouse B,48,33,2025-02-05 06:40:00,15
27171,ORD_27172,3128,"Yves Rocher Sensual Body Lotion, Bourbon Vanilla, 390ml",Warehouse C,54,44,2025-02-05 03:30:00,10
27172,ORD_27173,3127,"Brinton Doux Deep Cleanser, Face Cleansing Cream, 125 ml | For All Skin Types",Warehouse C,80,71,2025-02-05 00:53:00,9
27173,ORD_27174,9236,"boAt Aavante Bar 900 Bluetooth Soundbar with 30W RMS, 2.0 Channel, Multiple Connectivity, EQ Modes, Sleek Finish, Easy Acc...",Warehouse C,99,81,2025-02-05 13:39:00,18
27174,ORD_27175,17170,Parabig-M Forte Tablet,Warehouse C,36,25,2025-02-05 20:36:00,11
27175,ORD_27176,22682,Rextel 40 Tablet,Warehouse B,59,50,2025-02-05 18:28:00,9
27176,ORD_27177,4826,Miss Rose Professsional Makeup Glow Powder Metalises 7001 - 010M 12 2.5 gm,Warehouse C,54,44,2025-02-05 00:00:00,10
27177,ORD_27178,36079,"Magnova Store Mobile Holder For Car Stand Magnova Magnetic Phone Mount for Car, [Stronger 6X Magnets] 360°Rotation Univers...",Warehouse B,56,40,2025-02-05 20:21:00,16
27178,ORD_27179,26545,"SYGA Replacement Ear Pads Compatible with JBL Tune 500BT / T500BT / T450BT Wireless Headphones, 1 Pair Replacement Earpads...",Warehouse A,51,44,2025-02-05 17:35:00,7
27179,ORD_27180,23443,Levolday DPS 0.5% Eye Drop,Warehouse A,42,23,2025-02-05 07:05:00,19
27180,ORD_27181,669,Itkon 200 Capsule,Warehouse A,82,68,2025-02-05 19:38:00,14
27181,ORD_27182,14124,Walnut Face Scrub,Warehouse B,101,93,2025-02-05 01:52:00,8
27182,ORD_27183,11207,Binatone Concept 700 Corded Landline Phone (Black),Warehouse A,108,90,2025-02-05 17:00:00,18
27183,ORD_27184,10066,Cetrafit M Syrup,Warehouse C,82,71,2025-02-05 22:45:00,11
27184,ORD_27185,28335,Gemblue Biocare Fruit Face and Body cream 500 ml,Warehouse B,97,78,2025-02-05 22:42:00,19
27185,ORD_27186,28391,Cutishine Anti Acne Face Wash 70 ml,Warehouse B,45,35,2025-02-05 04:15:00,10
27186,ORD_27187,19331,Vaadi Herbals Shower Gel - Refreshing Lemon & Basil 300 ml,Warehouse C,34,18,2025-02-05 05:26:00,16
27187,ORD_27188,36065,Ajmal Aurum Sacredlove Silvershade Deodorant Spray (Pack of 3) 200 ml,Warehouse B,82,67,2025-02-05 12:55:00,15
27188,ORD_27189,4869,Yeppen Perfect BB Cream - For Men,Warehouse A,85,74,2025-02-05 16:08:00,11
27189,ORD_27190,36055,Rozden F 160mg/10mg Tablet,Warehouse A,74,56,2025-02-05 05:27:00,18
27190,ORD_27191,36057,"Just Herbs Ayurvedic Gulab Jal/Rose Water Spray Facial Mist Toner For Glowing Skin, Pores Minimising - Men & Women 100ml",Warehouse C,66,54,2025-02-05 13:45:00,12
27191,ORD_27192,4872,Defriq 6 Tablet,Warehouse B,21,3,2025-02-05 09:26:00,18
27192,ORD_27193,17176,INEFABLE Mi Band 5 and 6 Strap Original Band Strap M5/M6 - Pack of 1 - Black - (Device Not Included - Not Compatible with ...,Warehouse A,11,2,2025-02-05 12:04:00,9
27193,ORD_27194,36063,"Nutreze Herbs & Naturals Lipsticks for women, Shimmery Pink Colour Change gel Lipstick, Combo Pack Gel Lipsticks (Red-Pin...",Warehouse A,53,44,2025-02-05 05:11:00,9
27194,ORD_27195,8495,Plum Candy Melts Vegan Lip Balm Berry Feast 12 Gm,Warehouse C,19,5,2025-02-05 05:02:00,14
27195,ORD_27196,14115,Pantra P 40mg Tablet,Warehouse C,38,32,2025-02-05 09:54:00,6
27196,ORD_27197,36115,Etoart 90 Tablet,Warehouse B,93,82,2025-02-05 20:01:00,11
27197,ORD_27198,16009,Metride-PL 2 Tablet SR,Warehouse A,16,3,2025-02-05 07:06:00,13
27198,ORD_27199,4918,"Portronics Toad 22 2.4Ghz Wireless Optical Mouse for Laptops/PC with USB Nano Dongle, Optical Orientation, Adjustable DPI,...",Warehouse C,107,96,2025-02-05 22:18:00,11
27199,ORD_27200,17208,Fm Frt D'Amour Pink Blackberry Edp,Warehouse B,105,95,2025-02-05 23:39:00,10
27200,ORD_27201,14032,Wellzone SB 1000mg/500mg Injection,Warehouse C,55,40,2025-02-05 13:52:00,15
27201,ORD_27202,11906,Faber-Castell Kindergarten Grip Crayons - Pack of 10 (Assorted),Warehouse B,73,58,2025-02-05 15:45:00,15
27202,ORD_27203,22681,Azicyn 500mg Tablet,Warehouse A,69,63,2025-02-05 14:41:00,6
27203,ORD_27204,36040,TCL 108 cm (43 inches) 4K Ultra HD Certified Android Smart LED TV 43P615 (Black),Warehouse B,66,50,2025-02-05 01:07:00,16
27204,ORD_27205,640,Naturale Coconut Nourishing Soap Bar,Warehouse A,43,33,2025-02-05 07:55:00,10
27205,ORD_27206,36019,UV Clav CV Dry Syrup,Warehouse B,65,46,2025-02-05 13:51:00,19
27206,ORD_27207,19175,RIGGEAR Crystal Hybrid Transparent Back Cover Case for Google Pixel 6A (TPU+PC | Black Clear Bumper),Warehouse B,62,50,2025-02-05 02:18:00,12
27207,ORD_27208,26404,Amazon Basics Ultra Hybrid Clear Camera Protection Back Cover Case for iPhone 12 Pro Max - (Polycarbonate|Transparent),Warehouse C,107,94,2025-02-05 03:39:00,13
27208,ORD_27209,33306,Power 10 Formula Syn-Ake,Warehouse A,24,16,2025-02-05 21:42:00,8
27209,ORD_27210,9995,Amazon Basics Laptop Cooling Pad with LED Lighting Effect | USB Powered Gaming Laptop Cooler Stand | Quiet 6 Fans with 2-L...,Warehouse B,31,15,2025-02-05 03:02:00,16
27210,ORD_27211,24513,S-Vidone Ointment,Warehouse A,96,90,2025-02-05 09:55:00,6
27211,ORD_27212,36025,theKiteco. Bluetooth Selfie Stick with LED Light 3-in-1 Multi-Functional Extendable Bluetooth Selfie Stick Tripod (Bluetoo...,Warehouse C,27,15,2025-02-05 21:39:00,12
27212,ORD_27213,28383,Snuflox 200mg Tablet,Warehouse B,42,23,2025-02-05 10:59:00,19
27213,ORD_27214,3113,Omez-O Oral Suspension Mint Sugar Free,Warehouse C,26,9,2025-02-05 08:38:00,17
27214,ORD_27215,3117,"TheGiftKart Crystal Clear Back Cover Case for Samsung Galaxy S21 FE 5G | 360 Degree Protection | Shock Proof Design | PC, ...",Warehouse C,29,10,2025-02-05 05:04:00,19
27215,ORD_27216,31629,Ranitol DC 20mg/150mg Tablet,Warehouse B,36,26,2025-02-05 22:28:00,10
27216,ORD_27217,8522,BhringAmla Hair Oil + Shampoo With Bhringraj & Amla (250 ml each),Warehouse B,20,14,2025-02-05 01:29:00,6
27217,ORD_27218,17250,Theofresh 100mg Capsule,Warehouse A,99,82,2025-02-05 21:12:00,17
27218,ORD_27219,13674,"boAt Airdopes 141 Pro True Wireless in Ear Earbuds with 45H Playtime, Quad Mics Enx Tech, 12mm Drivers, ASAP Charge, Beast...",Warehouse A,27,20,2025-02-05 04:05:00,7
27219,ORD_27220,33162,"realme 10 Pro+ 5G (Nebula Blue, 128 GB) (8 GB RAM)",Warehouse C,47,38,2025-02-05 15:38:00,9
27220,ORD_27221,734,Moxivib 250mg Capsule,Warehouse A,75,70,2025-02-05 18:49:00,5
27221,ORD_27222,31804,Fiximfresh 100mg Tablet,Warehouse C,66,61,2025-02-05 23:23:00,5
27222,ORD_27223,20516,Pikkme Galaxy M12 / F12 / A12 Leather Magnetic Flip Wallet Case Cover for Samsung Galaxy M12 / F12 / A12 (Brown),Warehouse A,64,47,2025-02-05 04:36:00,17
27223,ORD_27224,9889,Spigen Tough Armor Back Cover Case for Samsung Galaxy S23 Ultra (Poly Carbonate + TPU | Black),Warehouse B,38,20,2025-02-05 18:16:00,18
27224,ORD_27225,23537,"Dell Pro Laptop Briefcase Messenger Bag with Handle & Detachable Shoulder Strap | PO1520C - for upto 15.6"" Laptop/Macbook...",Warehouse B,10,2,2025-02-05 09:05:00,8
27225,ORD_27226,9272,"Amazon Brand - Solimo 360 Degree Protection Black Border Back Cover for Realme XT - Acrylic, TPU, Black",Warehouse C,45,31,2025-02-05 02:14:00,14
27226,ORD_27227,33402,Thiact 100mg Injection,Warehouse B,69,63,2025-02-05 08:59:00,6
27227,ORD_27228,14213,Mtef 100mg Tablet,Warehouse A,56,41,2025-02-05 02:03:00,15
27228,ORD_27229,31812,Rotin 10mg Tablet,Warehouse A,87,78,2025-02-05 21:21:00,9
27229,ORD_27230,36259,Elmask Derma Roller Microneedle Roller for Face Body Beard Hair Growth 540 Titanium (0.5 mm),Warehouse A,76,70,2025-02-05 23:46:00,6
27230,ORD_27231,15898,Ozimentin 1000mg/200mg Injection,Warehouse B,111,98,2025-02-05 23:52:00,13
27231,ORD_27232,33392,Spigen Ultra Hybrid Back Cover Case for iPhone 13 (TPU + Poly Carbonate | Matte Black),Warehouse C,98,90,2025-02-05 03:55:00,8
27232,ORD_27233,4739,Etidale 0.25mg Tablet MD,Warehouse C,67,49,2025-02-05 05:05:00,18
27233,ORD_27234,16081,AGC 500mg Injection,Warehouse C,56,38,2025-02-05 05:31:00,18
27234,ORD_27235,10080,"IFB 6 Kg 5 Star Front Load Washing Machine 2X Power Steam (DIVA AQUA SXS 6008, Silver, In-built Heater, 4 years Comprehens...",Warehouse C,45,40,2025-02-05 12:46:00,5
27235,ORD_27236,9224,Vtoxter 90 Tablet,Warehouse C,117,99,2025-02-05 16:34:00,18
27236,ORD_27237,24619,Cinarmax 25mg Tablet,Warehouse C,25,9,2025-02-05 05:00:00,16
27237,ORD_27238,26318,Avspas Oral Drop,Warehouse B,53,46,2025-02-05 22:58:00,7
27238,ORD_27239,19023,Prezzie Villa Pack of 4 Designer Bullet Pencils Avenger Superhero Design Assorted Colours Birthday Gift Return Gifts for K...,Warehouse A,47,32,2025-02-05 11:28:00,15
27239,ORD_27240,23385,Sulpride 25 Tablet,Warehouse A,103,92,2025-02-05 17:50:00,11
27240,ORD_27241,11846,Simmtronics 4GB DDR3 Desktop RAM 1333 MHz (PC 10600) with 3 Year Warranty,Warehouse A,48,40,2025-02-05 09:42:00,8
27241,ORD_27242,13018,Dot & Key Night Reset Sleep Treatment Cream 60 ml,Warehouse B,89,75,2025-02-05 23:02:00,14
27242,ORD_27243,36190,Lakme Absolute White Intense Wet & Dry Compact Golden Creme 04 9 Gm,Warehouse B,86,77,2025-02-05 02:32:00,9
27243,ORD_27244,36204,L'Oreal Paris Color Riche Free The Nudes 313 No Cry 3.7 Gm,Warehouse B,11,5,2025-02-05 23:00:00,6
27244,ORD_27245,28546,INEFABLE Mi Band 5 and 6 Strap Original Band Strap M5/M6 - Pack of 1 - Navy Blue - (Device Not Included - Not Compatible w...,Warehouse B,41,34,2025-02-05 05:46:00,7
27245,ORD_27246,19316,"pTron Bassbuds Eon Truly Wireless in Ear Earbuds with Mic,ENC, 13mm Driver, Immersive Sound, BT 5.3, Quick Pairing, Touch ...",Warehouse A,112,99,2025-02-05 09:58:00,13
27246,ORD_27247,2117,Homatropine Eye Drop,Warehouse C,58,43,2025-02-05 20:46:00,15
27247,ORD_27248,26321,"Jabra Elite 3 in Ear Bluetooth Truly Wireless in Ear Earbuds, Noise Isolating with mic for Clear Calls, Rich Bass, Customi...",Warehouse B,51,37,2025-02-05 01:01:00,14
27248,ORD_27249,1793,Duracell Chhota Power AA Battery Set of 10 Pcs,Warehouse A,110,96,2025-02-05 03:45:00,14
27249,ORD_27250,36262,"Soap - Tulasi, Hand Made",Warehouse A,60,53,2025-02-05 11:01:00,7
27250,ORD_27251,26311,"Ajmal Jannatul Firdaus Concentrated Oriental Perfume 10ml for Unisex & Ajmal Sacred Love Femme Deodorant, 200 ml & Ajmal I...",Warehouse A,25,20,2025-02-05 14:52:00,5
27251,ORD_27252,28092,Casio MJ-12GST GST Calculator (Black),Warehouse C,49,43,2025-02-05 04:37:00,6
27252,ORD_27253,33179,Halobid 10mg Tablet,Warehouse B,40,29,2025-02-05 01:39:00,11
27253,ORD_27254,517,Ronifix 100 LB Tablet DT,Warehouse A,78,70,2025-02-05 04:30:00,8
27254,ORD_27255,22637,MQ Clav Dry Syrup,Warehouse B,90,81,2025-02-05 06:50:00,9
27255,ORD_27256,31788,"Plixio Aluminum Tabletop Laptop Stand Ergonomic Foldable Portable Laptop Stand Holder Compatible for MacBook, HP, Dell, Le...",Warehouse A,88,74,2025-02-05 22:41:00,14
27256,ORD_27257,12902,"Sony NWZ-B183F Walkman 4GB Digital Music Player with FM, 20 hours of battery life (Black)",Warehouse A,40,29,2025-02-05 04:47:00,11
27257,ORD_27258,25146,Natural Shine Henna,Warehouse A,37,21,2025-02-05 15:11:00,16
27258,ORD_27259,8020,"Brustro Artists Gold Taklon Set of 10 Brushes for Acrylics, Oil and Watercolour.",Warehouse B,70,51,2025-02-05 15:05:00,19
27259,ORD_27260,35889,The Face Shop Herb Day 365 Cleansing Foam Lemon 170 ml,Warehouse A,103,94,2025-02-05 16:43:00,9
27260,ORD_27261,13952,Bathing Soap - Sandal & Almond Milk,Warehouse A,96,91,2025-02-05 06:48:00,5
27261,ORD_27262,4751,"Bodywash - 3-In-1, Jasmine Blossom",Warehouse B,80,62,2025-02-05 08:30:00,18
27262,ORD_27263,3170,Plenacid Antacid Suspension Sugar Free,Warehouse C,64,47,2025-02-05 09:33:00,17
27263,ORD_27264,9896,Onsitego 1 Year Extended Warranty for Small Home & Kitchen Appliances from Rs. 2501-3000 (Email Delivery - No Physical Kit),Warehouse A,98,87,2025-02-05 09:30:00,11
27264,ORD_27265,6649,Mars Matte Lip Color Liquid Fire Lipsticks 116GM Each | Matte Finish | Sudge & Water Proof |Get Your Liquid Fire Now! | (0...,Warehouse A,69,64,2025-02-05 01:55:00,5
27265,ORD_27266,8068,"Apple 2022 iPad Air M1 Chip (10.9-inch/27.69 cm, Wi-Fi, 64GB) - Blue (5th Generation)",Warehouse B,84,68,2025-02-05 08:54:00,16
27266,ORD_27267,13961,"Western Digital WD Blue SN570 NVMe 250GB, Upto 3300MB/s, with Free 1 Month Adobe Creative Cloud Subscription, 5 Y Warrant...",Warehouse A,79,66,2025-02-05 01:03:00,13
27267,ORD_27268,9203,"ASUS ROG Strix G17, 17.3""(43.94 cms)FHD 144Hz, AMD Ryzen 7 4800H, RTX 3050ÂTi 4GB Graphics, Gaming Laptop (16GB/1TB SSD/Wi...",Warehouse A,54,40,2025-02-05 09:46:00,14
27268,ORD_27269,35914,Caladene Lotion,Warehouse A,78,65,2025-02-05 19:38:00,13
27269,ORD_27270,19019,Ultra Light Aquagel Sunscreen SPF 25,Warehouse A,18,4,2025-02-05 08:46:00,14
27270,ORD_27271,7577,"Wings X Fire Wireless Gaming in Ear Earbuds,TWS Headphones with RGB Lights case, 40ms Low Latency, Bluetooth 5.3, 40 Hours...",Warehouse C,55,43,2025-02-05 20:06:00,12
27271,ORD_27272,28566,"Amazon Basics 2nd Gen Stylus Pen | Supports Palm Rejection, Tilt Sensor, Precise for Writing/Drawing| for iPad 6/ 7/ 8/ 9t...",Warehouse C,111,97,2025-02-05 04:36:00,14
27272,ORD_27273,17055,Amazon Brand - Solimo Soft and Flexible Back Cover for Samsung Galaxy A51 (Transparent),Warehouse A,68,50,2025-02-05 09:05:00,18
27273,ORD_27274,22724,Zuvas 20 Tablet,Warehouse C,89,80,2025-02-05 09:31:00,9
27274,ORD_27275,33161,FireBoltt 360 SpO2 Smart Watch Charger 2 Pin USB Fast Charger Magnetic Charging Cable Adapter (Smart Watch Charger 2 pin),Warehouse C,112,97,2025-02-05 08:40:00,15
27275,ORD_27276,14217,Spigen Ultra Hybrid Magfit Back Cover Case Compatible with MagSafe Designed for iPhone 14 Pro (TPU + Poly Carbonate | Zero...,Warehouse A,73,59,2025-02-05 06:42:00,14
27276,ORD_27277,744,Dot & Key Hand Cream (Sanitizer + Moisturizer) - Mandarin & Lemon 50 ml,Warehouse B,67,50,2025-02-05 23:50:00,17
27277,ORD_27278,13947,Nacpar 50mg/500mg Tablet,Warehouse B,66,48,2025-02-05 18:28:00,18
27278,ORD_27279,4732,RISSACHI 26-55 Inches Fixed LED LCD Plasma Wall Mount Bracket with Heavy-Duty Max VESA 400 x 400 50 Kg Weight Capacity,Warehouse A,30,21,2025-02-05 13:35:00,9
27279,ORD_27280,9884,"Steamer For Cold And Cough Nano-Cure Facial Iconic Cleanser with Nano-Ionic Technology, Steam breath machine for Adults/Ki...",Warehouse B,78,71,2025-02-05 06:46:00,7
27280,ORD_27281,2109,Kyozone 1000mg/500mg Injection,Warehouse A,58,44,2025-02-05 16:33:00,14
27281,ORD_27282,26471,Ariwa Syrup,Warehouse A,44,31,2025-02-05 00:32:00,13
27282,ORD_27283,14026,Nicka K Pop Neon Nine Color Palette - Watermelon Splash 8 gm,Warehouse B,26,18,2025-02-05 18:42:00,8
27283,ORD_27284,19261,"Fullerene Propolis Mask Facial Gel Smear Mask For Brighten Skin Moisturizing Skincare Honey Mask Serum, Mask Packing Pouc...",Warehouse A,69,55,2025-02-05 15:11:00,14
27284,ORD_27285,27354,Nanorapid Nano Gel,Warehouse B,95,76,2025-02-05 22:03:00,19
27285,ORD_27286,22896,Elonac-TH Tablet,Warehouse B,95,90,2025-02-05 10:03:00,5
27286,ORD_27287,5447,Piloshoonya Ras,Warehouse B,86,67,2025-02-05 11:12:00,19
27287,ORD_27288,16440,talotech Neckband Earphones Wireless Bluetooth In Ear Headphone 100Hrs Playtime Wireless Headset with Display Hi-Fi Stereo...,Warehouse C,22,8,2025-02-05 15:03:00,14
27288,ORD_27289,2737,Exitopam LS 0.25mg/5mg Tablet,Warehouse A,99,81,2025-02-05 10:56:00,18
27289,ORD_27290,5441,"Conbre Portable Laptop Stand for Desk, Fold-Up, Adjustable, Ventilated, Aluminum Foldable Laptop Ergonomic Compatibility w...",Warehouse B,32,15,2025-02-05 16:15:00,17
27290,ORD_27291,2769,SH-12 Wireless Bluetooth Over the Ear Headphone with Mic (Black),Warehouse C,96,80,2025-02-05 02:46:00,16
27291,ORD_27292,22832,Nails On Board Handmade Press On Gel Nails- Holographic Black 50 gm,Warehouse A,79,64,2025-02-05 11:23:00,15
27292,ORD_27293,22868,Revolution Pro Skin Finish Warm Glow 11 gm,Warehouse C,87,76,2025-02-05 06:02:00,11
27293,ORD_27294,9374,Nimupride Tablet,Warehouse B,36,19,2025-02-05 01:51:00,17
27294,ORD_27295,24810,Steclo TH 100mg/4mg Tablet,Warehouse B,116,99,2025-02-05 10:02:00,17
27295,ORD_27296,19815,"Triohomes Plain Kukmkum Bindi | Tikali | Large Binid Tikka Gift-Able For Women & Girl Bindi (10Mm Multicolor, Red, Maroon ...",Warehouse B,35,27,2025-02-05 06:05:00,8
27296,ORD_27297,13203,Qxim CV 200mg/125mg Tablet,Warehouse C,103,97,2025-02-05 11:00:00,6
27297,ORD_27298,13684,Doubledicestore Tempered Glass Screen Protector Compatible for xiaomi redmi k20/k20 pro with 9H Edge to Edge Coverage and ...,Warehouse C,80,75,2025-02-05 17:10:00,5
27298,ORD_27299,19929,Astexit Tablet,Warehouse B,24,10,2025-02-05 19:51:00,14
27299,ORD_27300,5690,Triglycilarc 2mg/500mg/15mg Tablet SR,Warehouse A,87,72,2025-02-05 00:32:00,15
27300,ORD_27301,16463,Dell WM126-Black Wireless Mouse | Compact & Travel Friendly Design | Ambidextrous | Up-to 1 Year Battery Life | Dell Unive...,Warehouse A,38,29,2025-02-05 20:43:00,9
27301,ORD_27302,9574,"Milani No Pore Zone Mattifyng Face Primer, Mattifying Face Primer (MIL0457002)",Warehouse C,24,12,2025-02-05 18:07:00,12
27302,ORD_27303,19930,Amkette iGrip Drive Long Arm Car Phone Holder for Dashboard and Windshield | Quick Release Function | Telescopic Adjustabl...,Warehouse A,68,60,2025-02-05 22:52:00,8
27303,ORD_27304,5686,ZHIZUKA Telescope Zoom 90X HD Focus Astronomical Refractor with Portable Tripod Stand. F36050M High Power TeleScope Gift f...,Warehouse C,100,95,2025-02-05 16:27:00,5
27304,ORD_27305,2507,Fexokem-M Oral Suspension,Warehouse C,15,1,2025-02-05 18:59:00,14
27305,ORD_27306,2728,"Professional Feel Diamond + Gold Facial kit, Sp. Combo For Women (250 + 250 gm)",Warehouse C,98,91,2025-02-05 11:52:00,7
27306,ORD_27307,24952,Alclav 500 mg/125 mg Tablet,Warehouse A,34,17,2025-02-05 04:35:00,17
27307,ORD_27308,13260,Ajmal Silver Shade EDP Citrus Woody Perfume And Shadow Homme Deodorant Citrus Woody Fragrance 300 ml,Warehouse B,88,74,2025-02-05 17:11:00,14
27308,ORD_27309,21596,Overnac XL Tablet,Warehouse A,102,95,2025-02-05 07:43:00,7
27309,ORD_27310,32711,Mungyo Bold Point Paint Marker (White),Warehouse A,46,29,2025-02-05 19:10:00,17
27310,ORD_27311,13613,Beard Wash For Growth - Almond & Thyme,Warehouse C,95,79,2025-02-05 09:35:00,16
27311,ORD_27312,16413,Azafran Organics Soya Rich Triple Action Condit 100 gm,Warehouse A,84,74,2025-02-05 23:58:00,10
27312,ORD_27313,32235,VLCC Natural Sciences Pro Radiance D-White Complex SPF 25 PA+++ Brightening Face Cream 50 gm,Warehouse A,108,97,2025-02-05 21:36:00,11
27313,ORD_27314,9613,Basizone S 500mg/500mg Injection,Warehouse C,58,40,2025-02-05 06:21:00,18
27314,ORD_27315,11436,"Hoss® Type C Extension Cable, USB 3.1 Gen 2 (10Gbps) USB C Male to Female Extension Fast Charging Cable Compatible with Th...",Warehouse C,38,33,2025-02-05 02:15:00,5
27315,ORD_27316,27511,Smopod DS 100mg Dry Syrup,Warehouse B,86,74,2025-02-05 16:21:00,12
27316,ORD_27317,19263,Ajmal 1 Wisal And 3 Persuade Deodorants Pack of 4 200 ml,Warehouse A,60,53,2025-02-05 22:13:00,7
27317,ORD_27318,24981,Beardo Hair Growth Vitalizer Sulphate Free Shampoo 200 ml,Warehouse A,29,21,2025-02-05 10:23:00,8
27318,ORD_27319,5731,Speaking Tree - Soothing Lavender Specially Formulated and Cold processed Handmade Soap for Perfectly Clean Skin (Pack of 3),Warehouse C,107,89,2025-02-05 16:32:00,18
27319,ORD_27320,9367,L'Oreal Paris 6 Oil Nourish Shampoo 704 Gm,Warehouse A,59,40,2025-02-05 22:30:00,19
27320,ORD_27321,32768,Uncle Tony Razor Blades 4's,Warehouse A,108,97,2025-02-05 06:53:00,11
27321,ORD_27322,24805,Ayurvedic Prickly Heat Powder - Sandal,Warehouse A,66,54,2025-02-05 01:51:00,12
27322,ORD_27323,11673,"mCaffeine Green Tea Face Scrub with Vitamin C & Walnut for Women & Men | Removes Dirt, Blackheads & Gently Exfoliates Skin...",Warehouse B,88,69,2025-02-05 23:37:00,19
27323,ORD_27324,26788,"LIRAMARK Webcam Cover Slide, Ultra Thin Laptop Camera Cover Slide Blocker for Computer MacBook Pro iMac PC Tablet (Pack of 6)",Warehouse A,101,87,2025-02-05 00:26:00,14
27324,ORD_27325,9636,Reequil Unveil Underarm Brightening & Exfoliation Cream 30 gm,Warehouse B,70,57,2025-02-05 11:53:00,13
27325,ORD_27326,36721,Clobesol-N Cream,Warehouse A,85,78,2025-02-05 12:28:00,7
27326,ORD_27327,22847,"Red Onion Hair Shampoo - With Biotin, Argan Oil, Caffeine, Protein, 27 Hair Boosters",Warehouse C,19,6,2025-02-05 23:55:00,13
27327,ORD_27328,21736,Lycin Injection,Warehouse C,70,53,2025-02-05 18:26:00,17
27328,ORD_27329,11444,XX Revolution press shadow palette xxtinguish 1.2 gm,Warehouse A,38,19,2025-02-05 16:11:00,19
27329,ORD_27330,7772,Travel Pouch,Warehouse A,23,15,2025-02-05 16:53:00,8
27330,ORD_27331,9626,Wormingo Syrup,Warehouse C,47,40,2025-02-05 06:29:00,7
27331,ORD_27332,13652,Cloxide 25mg Tablet,Warehouse B,49,44,2025-02-05 15:17:00,5
27332,ORD_27333,32760,Ajmal 2 Raindrops Femme And 2 Nightingale Deodorants Pack of 4 200 ml,Warehouse C,52,42,2025-02-05 06:52:00,10
27333,ORD_27334,16395,Gabalent 300 Capsule,Warehouse B,63,58,2025-02-05 05:35:00,5
27334,ORD_27335,2792,Talc Powder - Lime,Warehouse A,73,67,2025-02-05 08:07:00,6
27335,ORD_27336,23069,Superthin Condoms,Warehouse B,105,92,2025-02-05 19:41:00,13
27336,ORD_27337,21573,Telzi 40 Tablet,Warehouse A,79,64,2025-02-05 21:01:00,15
27337,ORD_27338,5327,"Zayn & Myza Transfer - Proof Power Matte Lipstick, Fuchsia Hype 3.2 gm",Warehouse A,26,21,2025-02-05 07:47:00,5
27338,ORD_27339,21753,"Pebble Newly Launched Cosmos Prime BT Calling Smart Watch with Largest 1.91"" Bezel-Less Edge-to-Edge Display, 600 Nits Bri...",Warehouse B,52,43,2025-02-05 00:43:00,9
27339,ORD_27340,26764,Fruit Salt - Lemon,Warehouse C,43,37,2025-02-05 22:16:00,6
27340,ORD_27341,11705,Moxious D Eye Drop,Warehouse B,46,28,2025-02-05 12:31:00,18
27341,ORD_27342,23189,"Archer Tech Lab Recurve 300 Wired Gaming Mouse,12000 DPI with 1000Hz Polling Rate 8 Buttons, Thumb Rest Support, 6 Mode RG...",Warehouse C,53,45,2025-02-05 12:24:00,8
27342,ORD_27343,26770,"Loofah/Sponge Scrubber/Body Bath - Dual Side, Hangable, Purple, BH-070 PRP",Warehouse A,40,34,2025-02-05 23:34:00,6
27343,ORD_27344,23184,Mytecit-L Tablet,Warehouse C,13,2,2025-02-05 19:50:00,11
27344,ORD_27345,36675,Arbozil-CT 40/12.5 Tablet,Warehouse A,33,19,2025-02-05 21:07:00,14
27345,ORD_27346,13198,CEDO Samsung A14 (5G) Case Back Cover Shockproof Bumper Crystal Clear | 360 Degree Protection TPU+PC | Camera Protection |...,Warehouse C,108,98,2025-02-05 13:45:00,10
27346,ORD_27347,24796,Scalp & Hair Medicine - Anti Hairfall Shampoo,Warehouse C,98,91,2025-02-05 23:58:00,7
27347,ORD_27348,32749,AllExtreme EXHSMH1 Universal Bike Mobile Holder USB Charger Waterproof Heavy Duty Fast Charging 360 Degree Adjustable X-Gr...,Warehouse B,13,8,2025-02-05 13:15:00,5
27348,ORD_27349,13632,Megamika 500mg Injection,Warehouse C,42,31,2025-02-05 08:09:00,11
27349,ORD_27350,11660,Pazobet D 30mg/40mg Capsule SR,Warehouse A,68,58,2025-02-05 08:45:00,10
27350,ORD_27351,26470,Spigen Ultra Hybrid Back Cover Case for Samsung Galaxy S23 Ultra (Poly Carbonate + TPU | Crystal Clear),Warehouse B,103,90,2025-02-05 12:27:00,13
27351,ORD_27352,14014,boAt PartyPal 20 15 Watt Wireless Bluetooth Party Speaker (Black),Warehouse A,83,74,2025-02-05 10:54:00,9
27352,ORD_27353,14008,Cancyt 100mg Injection,Warehouse A,61,44,2025-02-05 03:24:00,17
27353,ORD_27354,33371,Srorab LS 75mg/20mg Capsule SR,Warehouse B,85,79,2025-02-05 09:12:00,6
27354,ORD_27355,8519,"boAt Rockerz 205 Pro in Ear Bluetooth Neckband with Beast Mode™(Low Latency Upto 65ms), ENx™ Tech for Clear Voice Calls,30...",Warehouse A,67,56,2025-02-05 03:42:00,11
27355,ORD_27356,9212,Flavozom 200mg Tablet,Warehouse B,89,74,2025-02-05 20:54:00,15
27356,ORD_27357,16041,INTIMATE FAIRNESS CREAM/BANGKOK CLEAR BB CREAM/SKIN NATURAL BB CREAM,Warehouse C,81,74,2025-02-05 21:06:00,7
27357,ORD_27358,12925,"LOXXO® Camera Lens Protector Compatible for iPhone 14 Pro/iPhone 14 Pro Max, [Anti-Scratch] Premium Tempered Glass Film Al...",Warehouse A,90,75,2025-02-05 15:42:00,15
27358,ORD_27359,5409,"Safari Quill Laptop Backpack 26 Ltrs Water Resistant Fabric - Blue, L (QUILL19CBBLU)",Warehouse B,84,74,2025-02-05 05:37:00,10
27359,ORD_27360,26457,EGOTUDE Dual Layer Hard Back Translucent Hybrid Cover Case for iPhone SE 2020 / iPhone 8 / iPhone 7 (Black),Warehouse B,106,90,2025-02-05 04:46:00,16
27360,ORD_27361,7599,Ebernext Cream,Warehouse C,65,49,2025-02-05 22:03:00,16
27361,ORD_27362,31706,Portronics Konnect B+ 8 Pin Usb Cable 3.0 Amp Output with Charge & Data Sync with 1m (Black),Warehouse C,59,54,2025-02-05 23:05:00,5
27362,ORD_27363,28447,Modorex AB Syrup,Warehouse A,79,68,2025-02-05 10:42:00,11
27363,ORD_27364,14054,HUMBLE USB Power Adapter Fitness Band Charging Cable Designed For MI Band 4 - Black,Warehouse C,114,98,2025-02-05 05:35:00,16
27364,ORD_27365,6993,Rabez IT 20 mg/150 mg Capsule,Warehouse B,93,85,2025-02-05 12:50:00,8
27365,ORD_27366,2222,Natural Moisturising Lotion,Warehouse A,20,9,2025-02-05 09:53:00,11
27366,ORD_27367,23386,"realme Pad Mini WiFi Tablet | 3GB RAM 32GB ROM (Expandable), 22.1cm (8.7 inch) Cinematic Display | 6400 mAh Battery | Dual...",Warehouse C,112,96,2025-02-05 14:03:00,16
27367,ORD_27368,31751,Perfume Body Spray - Tag Her For Women,Warehouse A,37,25,2025-02-05 17:23:00,12
27368,ORD_27369,33363,Rupali Cream Foundation Air Cushion Bb Cream Mushroom Foundation Waterproof Concealer Full Coverage Acne Pimple Dark Spots...,Warehouse A,88,77,2025-02-05 19:58:00,11
27369,ORD_27370,11926,Envapen 5mg Tablet,Warehouse A,22,12,2025-02-05 09:57:00,10
27370,ORD_27371,14017,Fastorab D 10mg/20mg Capsule SR,Warehouse C,71,54,2025-02-05 21:17:00,17
27371,ORD_27372,4960,Sanitary Pads - Ultra-Dry (With Wings),Warehouse A,91,76,2025-02-05 07:03:00,15
27372,ORD_27373,33212,Erox CV 250mg/125mg Tablet,Warehouse A,94,79,2025-02-05 09:13:00,15
27373,ORD_27374,10058,"Tukzer Stylus Pen, iPad Pencil with Palm Rejection Tilt Sensor| 2nd Gen for 2018-2023 iPad 6/7/8/9th Gen; iPad 10.2"", Pro ...",Warehouse B,30,11,2025-02-05 17:56:00,19
27374,ORD_27375,23490,"SanDisk Cruzer Glide 3.0 USB Flash Drive, CZ600 128GB, USB3.0, Black with red Slider, Retractable Design, 5Y",Warehouse B,30,17,2025-02-05 20:41:00,13
27375,ORD_27376,31739,"Mobilife Long Selfie Stick,Extra-long Selfie Stick with Large Reinforced Tripod Stand Upto 61 inch/156 cm,Super Long Mult...",Warehouse B,109,90,2025-02-05 16:46:00,19
27376,ORD_27377,35964,Skin Friendly Deodorant - Sweet,Warehouse C,20,5,2025-02-05 11:53:00,15
27377,ORD_27378,23487,Amazon Brand - Solimo Back case for Apple iPhone SE (2020) (Acrylic_Transparent),Warehouse C,83,78,2025-02-05 10:34:00,5
27378,ORD_27379,22639,Dermozeel Cream,Warehouse C,53,37,2025-02-05 18:47:00,16
27379,ORD_27380,17128,Tiniba 800mg Infusion,Warehouse A,63,48,2025-02-05 05:16:00,15
27380,ORD_27381,7634,Zevacef 100mg Dry Syrup,Warehouse A,23,6,2025-02-05 10:05:00,17
27381,ORD_27382,33319,Zyntus D Syrup,Warehouse A,47,29,2025-02-05 18:25:00,18
27382,ORD_27383,19255,Albezole 400mg Tablet,Warehouse B,99,82,2025-02-05 14:36:00,17
27383,ORD_27384,16424,Levmon LC Oral Suspension,Warehouse B,41,32,2025-02-05 05:37:00,9
27384,ORD_27385,9387,Amx 125mg Tablet,Warehouse A,94,82,2025-02-05 02:09:00,12
27385,ORD_27386,19887,Chyawanprash - Immunity Booster,Warehouse A,14,6,2025-02-05 21:09:00,8
27386,ORD_27387,5419,CP PLUS 3 MP Full HD Smart Wi-fi CCTV Camera | 360° Pan & Tilt | View & Talk | Motion Alert | Night Vision | SD Card (Up t...,Warehouse B,44,31,2025-02-05 00:55:00,13
27387,ORD_27388,11478,Kohmol P 100mg/325mg Tablet,Warehouse C,93,78,2025-02-05 13:13:00,15
27388,ORD_27389,27366,Apple iPhone 14 Plus (256 GB) - Blue,Warehouse A,70,61,2025-02-05 15:57:00,9
27389,ORD_27390,27362,Rapicob Forte Injection,Warehouse C,49,34,2025-02-05 09:25:00,15
27390,ORD_27391,13937,Macgyl Syrup,Warehouse B,64,47,2025-02-05 21:29:00,17
27391,ORD_27392,25223,"XERGY USB 5V 5050 RGB LED Flexible Strip Light Multi-Color Changing Lighting Kit , TV Background Lighting with Mini Contro...",Warehouse B,22,12,2025-02-05 13:40:00,10
27392,ORD_27393,12970,"Logitech USB G G203 Wired Gaming Mouse, 8000 DPI, Rainbow Optical Effect LIGHTSYNC RGB, 6 Programmable Buttons, On-Board M...",Warehouse A,49,30,2025-02-05 14:52:00,19
27393,ORD_27394,14034,Amozo Ultra Hybrid Camera and Drop Protection Back Cover Case for iPhone 13 (Polycarbonate| Back Transparent - Sides Black),Warehouse A,64,56,2025-02-05 04:21:00,8
27394,ORD_27395,28232,V Sko Injection,Warehouse A,90,82,2025-02-05 23:23:00,8
27395,ORD_27396,11211,Creme Bleach - Natural Radiance5,Warehouse C,27,8,2025-02-05 00:20:00,19
27396,ORD_27397,33320,"truke Fit 1+ Bluetooth 5.1 Truly Wireless in Ear Earbuds with mic, Dedicated Gaming Mode, 48hrs of Playtime, IPX4, Touch C...",Warehouse C,39,26,2025-02-05 16:02:00,13
27397,ORD_27398,35985,Respicure-D Syrup,Warehouse B,38,33,2025-02-05 22:52:00,5
27398,ORD_27399,8032,Ajmal Silver Shade EDP Citrus Woody Perfume And Sacrifice II For Him Deodorant Fruity Aromatic Fragrance 300 ml,Warehouse A,66,58,2025-02-05 01:48:00,8
27399,ORD_27400,11253,"Ambrane Unbreakable 3 in 1 Fast Charging Braided Multipurpose Cable for Speaker with 2.1 A Speed - 1.25 meter, Black",Warehouse A,72,57,2025-02-05 19:53:00,15
27400,ORD_27401,25160,Fertova 50mg Tablet,Warehouse A,49,43,2025-02-05 11:32:00,6
27401,ORD_27402,31586,"Skudgear Artist Glove for Drawing Tablet,Original Anti-Fouling Artist Two-Finger Glove for Pencil Sketching, Watercolours ...",Warehouse C,95,85,2025-02-05 22:15:00,10
27402,ORD_27403,31592,"Kratos Thump Wired Earphones, Powerful Bass, HD Sound Quality Earphones, Tangle Free Cable, Comfortable in Ear Fit, with m...",Warehouse A,26,14,2025-02-05 09:39:00,12
27403,ORD_27404,33325,Citifex O 200mg/200mg Tablet,Warehouse C,34,15,2025-02-05 04:33:00,19
27404,ORD_27405,3067,Parker Vector Sports Special Edition Roller Ball Pen + Ball Pen with swiss knife (Ink - Blue),Warehouse B,35,26,2025-02-05 02:31:00,9
27405,ORD_27406,28461,Glimy 2 Tablet,Warehouse A,74,69,2025-02-05 08:17:00,5
27406,ORD_27407,12994,Qubo Outdoor Security Camera (White) from Hero Group | Made in India | IP65 All-Weather | 2MP 1080p Full HD | CCTV Wi-Fi C...,Warehouse B,48,37,2025-02-05 00:45:00,11
27407,ORD_27408,14051,Fexodive 180mg Tablet,Warehouse A,49,40,2025-02-05 13:11:00,9
27408,ORD_27409,23455,"Jovees Gold Face Wash, 100ml",Warehouse B,84,69,2025-02-05 04:05:00,15
27409,ORD_27410,31707,"Fashion Colour Lip Crayon, Waterproof, Long Lasting, 4 Cherry Kiss 2.8 gm",Warehouse A,71,62,2025-02-05 13:20:00,9
27410,ORD_27411,10459,Charmacy Milano Gradient Shadows Palatte 03 7.2 gm,Warehouse C,87,76,2025-02-05 03:30:00,11
27411,ORD_27412,29639,PMPEARL Metal Wax Spatula with Plastic Finish Handle (Multicolour),Warehouse C,108,90,2025-02-05 12:41:00,18
27412,ORD_27413,30906,Zole-IT 100 Capsule,Warehouse A,72,58,2025-02-05 18:26:00,14
27413,ORD_27414,11156,Oshea Herbals BB Cream 000 Light Warm,Warehouse C,116,97,2025-02-05 00:38:00,19
27414,ORD_27415,799,Silicone Waterproof Replacement Watch Straps Band For REDMI SMART BAND PRO,Warehouse C,57,48,2025-02-05 17:16:00,9
27415,ORD_27416,11968,Glopan 40mg Tablet,Warehouse A,23,12,2025-02-05 11:40:00,11
27416,ORD_27417,26129,OpenTech® Tempered Glass Screen Protector Compatible for Fossil Gen 6 (Pack of 2) with Easy Installation kit,Warehouse C,35,19,2025-02-05 04:38:00,16
27417,ORD_27418,21933,Silicon Makeup brush Cleaner Tool ( multicolor),Warehouse A,29,22,2025-02-05 23:01:00,7
27418,ORD_27419,14273,Glowing Gold Facial Kit,Warehouse A,99,92,2025-02-05 03:20:00,7
27419,ORD_27420,35485,Cetlief-F Tablet,Warehouse B,101,84,2025-02-05 13:38:00,17
27420,ORD_27421,6089,Fragrance Body Spray - Imperial,Warehouse A,60,50,2025-02-05 17:04:00,10
27421,ORD_27422,12050,Flormar BB Cream BB01 Fair 35 ml,Warehouse A,86,68,2025-02-05 10:23:00,18
27422,ORD_27423,21970,Honda 4mg Tablet MD,Warehouse A,106,98,2025-02-05 16:28:00,8
27423,ORD_27424,15707,"Spigen Carabiner Key Ring Clip, Bottle Opener Keychain, Car Keychain Clip",Warehouse C,24,10,2025-02-05 01:24:00,14
27424,ORD_27425,33481,Rosbav 10mg Tablet,Warehouse C,72,62,2025-02-05 05:01:00,10
27425,ORD_27426,816,Mcaffeine Gua Sha - Green Quartz 1's,Warehouse C,105,95,2025-02-05 10:52:00,10
27426,ORD_27427,8436,KYOSEI Advanced Tempered Glass Compatible with Google Pixel 6a with Military-Grade Anti-Explosion Edge-to-Edge Coverage Sc...,Warehouse C,109,98,2025-02-05 05:07:00,11
27427,ORD_27428,35747,Kefprox 200 Tablet,Warehouse C,92,74,2025-02-05 09:34:00,18
27428,ORD_27429,4456,MAYCREATE® Hair Clips for Women Flower Hair Comb Pins Slide Hair Clips for Girls Crystal Barrettes Bridal Charm Hair Acces...,Warehouse B,37,23,2025-02-05 18:06:00,14
27429,ORD_27430,35780,Gamabiol Lotion,Warehouse A,99,83,2025-02-05 04:31:00,16
27430,ORD_27431,20740,Tolol H 50mg Tablet,Warehouse C,57,52,2025-02-05 05:21:00,5
27431,ORD_27432,35785,"EVM 128GB SSD 2.5"" INCH SATA",Warehouse A,66,59,2025-02-05 21:54:00,7
27432,ORD_27433,29119,NOKIA 125 DS,Warehouse B,54,48,2025-02-05 17:05:00,6
27433,ORD_27434,20727,Extra Moisturising Body Lotion,Warehouse B,106,97,2025-02-05 09:23:00,9
27434,ORD_27435,17288,Soulflower Jasmine Night Soap 150 gm,Warehouse B,43,25,2025-02-05 11:21:00,18
27435,ORD_27436,26150,Damkof D Syrup,Warehouse B,93,80,2025-02-05 01:31:00,13
27436,ORD_27437,33631,Lax 10mg Tablet,Warehouse A,43,37,2025-02-05 17:47:00,6
27437,ORD_27438,11986,"Lava Yuva 2 Pro (Glass White, 4GB RAM, 64GB Storage)| 2.3 Ghz Octa Core Helio G37| 13 MP AI Triple Camera |Fingerprint Sen...",Warehouse A,74,62,2025-02-05 18:56:00,12
27438,ORD_27439,18731,"ANCHOR 1440W 4 Way Power Strip with Individual Switch (240V, multicolour)",Warehouse A,95,88,2025-02-05 12:19:00,7
27439,ORD_27440,25258,Amazon Brand - Solimo Soft & Flexible Shockproof Silicone Mobile Back Cover with Cushioned Edges for OnePlus 9 - Transparent,Warehouse C,39,28,2025-02-05 16:39:00,11
27440,ORD_27441,4514,Beauty People High Shine Nail Polish 1091 12 ml,Warehouse C,86,67,2025-02-05 02:36:00,19
27441,ORD_27442,17369,Rabyork 20mg Tablet,Warehouse B,105,93,2025-02-05 13:24:00,12
27442,ORD_27443,28779,realme Buds 2 Neo Wired in Ear Earphones with Mic (Blue),Warehouse B,28,10,2025-02-05 15:09:00,18
27443,ORD_27444,18846,Noxcold DX Syrup,Warehouse C,47,32,2025-02-05 08:21:00,15
27444,ORD_27445,26190,"Lotus Makeup Ecostay Intensive Serum Foundation, Fawn, Nude, 20 ml",Warehouse A,105,97,2025-02-05 04:42:00,8
27445,ORD_27446,29076,Tlone 40 Injection,Warehouse A,65,48,2025-02-05 14:29:00,17
27446,ORD_27447,25257,"Tukzer Case Cover for Samsung Galaxy Tab A7 10.4"" (2020) - [SM-T500 / T505/ T507] Ultra Slim Microfibre Lining, Lightweigh...",Warehouse A,95,88,2025-02-05 03:12:00,7
27447,ORD_27448,14370,Moroccan Argan Oil Ultra Nourishing Body Wash,Warehouse C,51,32,2025-02-05 16:31:00,19
27448,ORD_27449,23617,Facial Band - FCB2801,Warehouse C,51,42,2025-02-05 21:36:00,9
27449,ORD_27450,12812,Trabzid-XL Capsule SR,Warehouse A,57,48,2025-02-05 00:48:00,9
27450,ORD_27451,35683,Ahalac Liquid Laxative,Warehouse A,24,9,2025-02-05 23:57:00,15
27451,ORD_27452,35652,Listril SM Tablet,Warehouse B,88,78,2025-02-05 07:03:00,10
27452,ORD_27453,33580,"ON 2-In-1 Pocket Perfume - Woman, Day & Night",Warehouse A,103,87,2025-02-05 21:16:00,16
27453,ORD_27454,4476,Geminor MP 1 Tablet SR,Warehouse C,15,5,2025-02-05 18:40:00,10
27454,ORD_27455,17337,Soulflower Conditioning Onion Ratanjot Hair Cleansing Bar 150 gm,Warehouse A,15,8,2025-02-05 23:55:00,7
27455,ORD_27456,26193,"Dicto T-500 S8 Series Smart Watch Sleep Monitor, Distance Tracker, Calendaring, Sedentary Reminder, Text Messaging, Pedome...",Warehouse C,74,64,2025-02-05 15:56:00,10
27456,ORD_27457,12800,"Tukzer 8-Inch LED USB Selfie Ring Light with Clamp Mount, 3 Light Modes & 10 Level Brightness, for Laptop/ PC/ Monitor/ De...",Warehouse A,90,82,2025-02-05 04:05:00,8
27457,ORD_27458,18808,Nutritivo Pomegranate Radiant Glow Skin Balancing Face Wash,Warehouse A,71,52,2025-02-05 04:30:00,19
27458,ORD_27459,12801,"DR VAKU® 2 IN 1 PD QC 20W Dual Port Fast Charger Type C Adapter for iPhone 14, iPhone 13, iPhone 12 Series, Samsung Galaxy...",Warehouse C,88,81,2025-02-05 11:25:00,7
27459,ORD_27460,23625,Telartin AM 40mg/5mg Tablet,Warehouse B,23,7,2025-02-05 04:59:00,16
27460,ORD_27461,28906,L.A Girl HD PRO Conceal Dark Cocoa 8 gm,Warehouse A,108,89,2025-02-05 04:36:00,19
27461,ORD_27462,28837,Detoxie Hand & Cuticle Cream 50 gm,Warehouse A,40,32,2025-02-05 08:26:00,8
27462,ORD_27463,10207,Lebral 500mg Syrup,Warehouse B,34,28,2025-02-05 09:26:00,6
27463,ORD_27464,18816,Schwarzkopf Taft Power Hair Spray Mega Strong 5 (D & D) 250 ml,Warehouse C,106,95,2025-02-05 02:10:00,11
27464,ORD_27465,25267,Met M 2mg/500mg Tablet,Warehouse A,71,53,2025-02-05 12:39:00,18
27465,ORD_27466,8103,Drosil MR 250mg/50mg/325mg Tablet,Warehouse A,66,48,2025-02-05 21:50:00,18
27466,ORD_27467,14333,"CableCreation RCA to 3.5mm Male Audio Cable, 3.5mm to 2RCA Cable Male RCA Cable,Y Splitter Stereo Jack Cable for Home Thea...",Warehouse C,46,35,2025-02-05 10:47:00,11
27467,ORD_27468,15749,"VEMIGON Hard PC Case Compatible with Apple Watch Series 8 and 7 45mm with Tempered Glass Screen Protector, Full Coverage, ...",Warehouse A,32,16,2025-02-05 11:18:00,16
27468,ORD_27469,1997,"Lava Hero Punch(Charcoal Grey),Stylish Design, 3 Day Battery Backup, FM with Recording, Keypad Mobile, Basic Mobile",Warehouse C,88,77,2025-02-05 12:54:00,11
27469,ORD_27470,7530,Dencip 250mg Tablet,Warehouse A,75,66,2025-02-05 17:48:00,9
27470,ORD_27471,26236,"Make Up For Life 18 Hour Liquid Lipstick-122, Peach, 8 Ml",Warehouse B,48,38,2025-02-05 17:40:00,10
27471,ORD_27472,29072,Nepavac Eye Drop,Warehouse C,110,97,2025-02-05 04:32:00,13
27472,ORD_27473,24384,Corcont 2.6mg Tablet,Warehouse A,56,40,2025-02-05 02:48:00,16
27473,ORD_27474,18867,Jovees Herbal Grape Fairness Face Wash For Women/Men | Brightening and Glowing Skin | For All Skin Types| Paraben and Alco...,Warehouse B,89,77,2025-02-05 17:39:00,12
27474,ORD_27475,28726,Spigen Liquid Crystal Back Cover Case for iPhone 14 Pro (TPU | Crystal Clear),Warehouse C,19,6,2025-02-05 05:40:00,13
27475,ORD_27476,24383,Skin Lightening Shiner Bleach With Diamond Dust,Warehouse C,102,90,2025-02-05 17:50:00,12
27476,ORD_27477,3319,Active Salt Toothpaste - Germ Fighting Toothpaste for Healthy Gums & Teeth,Warehouse B,88,78,2025-02-05 18:18:00,10
27477,ORD_27478,22616,Nindia 10mg Tablet,Warehouse A,96,84,2025-02-05 12:36:00,12
27478,ORD_27479,1308,"Fashion Colour Super Matte Lipstick, Magnetic Mauve 4 gm",Warehouse A,94,85,2025-02-05 09:10:00,9
27479,ORD_27480,30587,Oks 200mg Tablet,Warehouse A,43,29,2025-02-05 11:11:00,14
27480,ORD_27481,30579,Gemblue Biocare Charcoal Facial Foam 150 ml,Warehouse A,48,32,2025-02-05 00:23:00,16
27481,ORD_27482,7199,Fujifilm Instax Mini Instant Monochrome Film,Warehouse A,112,99,2025-02-05 13:27:00,13
27482,ORD_27483,10599,"ZEBRONICS Zeb-Bang Pro Bluetooth Wireless On Ear Headphones with Mic V5.0, 30H Backup, Foldable, Call Function, Voice Assi...",Warehouse C,62,56,2025-02-05 02:57:00,6
27483,ORD_27484,34701,Seon 4mg Tablet MD,Warehouse A,22,10,2025-02-05 17:08:00,12
27484,ORD_27485,34766,Benpod 100 Tablet DT,Warehouse B,55,37,2025-02-05 21:05:00,18
27485,ORD_27486,15040,Almond Shampoo - Shiny Hair,Warehouse A,43,34,2025-02-05 02:57:00,9
27486,ORD_27487,10589,"YOZTI 10"" LED Ring Light with 7 Feet Long Tripod Stand (84 Inch) Combo for Tiktok MX Instagram Reels YouTube Video Shootin...",Warehouse B,28,20,2025-02-05 05:25:00,8
27487,ORD_27488,1663,"Activated Charcoal Face Wash For Acne, Pimples & Dark Spots",Warehouse B,84,72,2025-02-05 15:25:00,12
27488,ORD_27489,15000,Arive 10mg Tablet,Warehouse A,18,1,2025-02-05 23:32:00,17
27489,ORD_27490,30014,Venpres CHM 12.5mg/50mg/40mg Tablet,Warehouse C,21,8,2025-02-05 22:11:00,13
27490,ORD_27491,18206,Facial Kit - Detox Bamboo Charcoal,Warehouse A,98,91,2025-02-05 10:36:00,7
27491,ORD_27492,12463,ANTONIA Cover Case Compatible for AirPods Gen 1 & 2 | Black Color- Silicone Shock Proof Protection Sleeve Skin with Button...,Warehouse A,24,6,2025-02-05 21:36:00,18
27492,ORD_27493,25765,Angipin 50mg/5mg Tablet,Warehouse C,70,54,2025-02-05 19:53:00,16
27493,ORD_27494,34645,Q Plas 300mg Tablet,Warehouse B,30,19,2025-02-05 23:13:00,11
27494,ORD_27495,12264,Coco Soul Face Scrub -With Coconut & Ayurveda- Paraben & Sulphate Free 100gm,Warehouse C,46,31,2025-02-05 13:30:00,15
27495,ORD_27496,30611,Vmac-AZ Tablet,Warehouse B,24,16,2025-02-05 23:16:00,8
27496,ORD_27497,18162,"Versace Pour Femme Dylan Blue Eau De Parfum for Women, 100Ml",Warehouse C,80,75,2025-02-05 09:12:00,5
27497,ORD_27498,21153,Rrb 15mg Tablet,Warehouse C,104,99,2025-02-05 05:47:00,5
27498,ORD_27499,15370,ZOUK Black Printed Handmade Vegan Leather Women's Office Bag for 15.6 inch Laptop with Double Handles - Lattice Lace,Warehouse B,111,93,2025-02-05 06:07:00,18
27499,ORD_27500,3930,Nebawol 2.5mg Tablet,Warehouse B,53,38,2025-02-05 21:14:00,15
27500,ORD_27501,17789,"Color Naturals - Shade 3.16, Burgundy",Warehouse B,19,11,2025-02-05 07:24:00,8
27501,ORD_27502,30640,Colorbar Lux Nail Lacquer Cbn1157 12 Ml,Warehouse B,76,71,2025-02-05 18:14:00,5
27502,ORD_27503,8986,Boujee Beauty 1xsmall Sponge + 1xlarge Sponge (Charcoal Black) S01b 1's,Warehouse B,94,77,2025-02-05 21:43:00,17
27503,ORD_27504,12442,Yves Rocher Sebo Vegetal Purifying Scrub 75 ml,Warehouse C,69,52,2025-02-05 16:43:00,17
27504,ORD_27505,30076,Dufox-OZ Syrup,Warehouse B,48,35,2025-02-05 12:58:00,13
27505,ORD_27506,14971,Bio Herbcolor 4N Brown 50 Gm +110 Ml 160 Ml,Warehouse B,95,85,2025-02-05 14:11:00,10
27506,ORD_27507,18208,K Spas 20mg/250mg Tablet,Warehouse A,19,1,2025-02-05 17:47:00,18
27507,ORD_27508,8254,Migrellium-Pro Capsule,Warehouse C,35,24,2025-02-05 08:59:00,11
27508,ORD_27509,30025,Pro 4 Razor Value Kit For Men,Warehouse A,41,29,2025-02-05 18:03:00,12
27509,ORD_27510,35729,"Fire-Boltt Rage Full Touch 1.28” Display & 60 Sports Modes with IP68 Rating Smartwatch, Sp02 Tracking, Over 100 Cloud Base...",Warehouse A,76,62,2025-02-05 23:49:00,14
27510,ORD_27511,18721,Zotec 500mg Tablet,Warehouse A,68,59,2025-02-05 03:05:00,9
27511,ORD_27512,20661,Parker Moments Vector Chrome Trim Roller Ball Pen (Silver),Warehouse B,87,71,2025-02-05 18:12:00,16
27512,ORD_27513,21347,Lenphor Get Set Brow Brown 1 Ml,Warehouse C,12,1,2025-02-05 09:49:00,11
27513,ORD_27514,35733,"Swiss Beauty Bold Matte Lipliner Pencil Set | Long Stay | Smudge Free | Waterproof | Creamy Lip Liner Pencil| Multi Color,...",Warehouse C,27,13,2025-02-05 00:04:00,14
27514,ORD_27515,35570,TYAGEN-II Sunisa 3 in 1 CC and BB Water Proof Foundation Concealer Cream with Air Cushion Mushroom (Natural),Warehouse C,82,70,2025-02-05 13:23:00,12
27515,ORD_27516,29048,Esnopan 40 Injection,Warehouse B,68,50,2025-02-05 11:24:00,18
27516,ORD_27517,18857,Wayona Type C Nylon Braided Usb C Quick Charger Fast Charging Cable For Tablets Samsung Galaxy S10E/S10+/S10/S9/S9+/Note ...,Warehouse B,44,25,2025-02-05 21:36:00,19
27517,ORD_27518,22286,Schwarzkopf Taft Ultimate Hair Lacquer Ultimately Strong 6 250 ml,Warehouse C,53,46,2025-02-05 08:00:00,7
27518,ORD_27519,17376,"Stbotanica Anti Oxidant Boost Under Eye Gel, Anti Wrinkle, Skin Firming, Puffiness & Dark Circles 30 ml",Warehouse C,98,86,2025-02-05 06:53:00,12
27519,ORD_27520,11095,"Swiss Beauty Sculpt Lift Contour Palette, Shade-02, 14gm",Warehouse A,79,64,2025-02-05 19:08:00,15
27520,ORD_27521,29039,Charmacy Milano Star Bomb Eyeshadow 001 3.2 gm,Warehouse A,93,76,2025-02-05 00:12:00,17
27521,ORD_27522,25247,Abcef O 200mg/200mg Tablet,Warehouse B,59,46,2025-02-05 03:06:00,13
27522,ORD_27523,12034,Samsung 25W USB Travel Adapter for Cellular Phones - White,Warehouse B,51,41,2025-02-05 22:10:00,10
27523,ORD_27524,22553,Ace Plus 100mg/325mg Tablet,Warehouse A,12,5,2025-02-05 04:38:00,7
27524,ORD_27525,33632,Etoscot 90 Tablet,Warehouse A,38,26,2025-02-05 13:28:00,12
27525,ORD_27526,20725,Flormar Dewy Lip Glaze 17 Elegant Pink 4.5 ml,Warehouse A,56,50,2025-02-05 09:32:00,6
27526,ORD_27527,29058,Tofix 50mg Suspension,Warehouse A,84,67,2025-02-05 15:27:00,17
27527,ORD_27528,35553,Self Holding Rollers - Large,Warehouse B,77,71,2025-02-05 04:09:00,6
27528,ORD_27529,22619,"Portronics Harmonics Z3 Wireless Bluetooth 5.3 Neckband in Ear Earphones with mic, 30Hrs Playtime, Magnetic Latch, IPX5 Wa...",Warehouse B,39,28,2025-02-05 20:42:00,11
27529,ORD_27530,23697,"Zayn & Myza Breathable Nail Enamel With Raspberry & Almond Oil, Almond Latte 6 ml",Warehouse B,53,38,2025-02-05 08:09:00,15
27530,ORD_27531,29497,Cypine 5mg Tablet,Warehouse C,78,68,2025-02-05 16:01:00,10
27531,ORD_27532,20777,Moxve LP Eye Drop,Warehouse A,86,67,2025-02-05 02:16:00,19
27532,ORD_27533,34187,"GM 3040 Square 2 Pin Flex Box 5 Mtr. with Handle, Indicator & International Socket",Warehouse A,34,18,2025-02-05 15:58:00,16
27533,ORD_27534,7191,"Noise NoiseFit Halo with Textured Strap, Bluetooth Calling Smart Watch, 1.43"" AMOLED Display, Premium Metallic Build, Alwa...",Warehouse C,21,13,2025-02-05 17:08:00,8
27534,ORD_27535,30651,Getrol 5mg Tablet,Warehouse C,35,19,2025-02-05 19:10:00,16
27535,ORD_27536,30034,Rushikanti Multani Mitti With Aloevera,Warehouse B,26,10,2025-02-05 00:14:00,16
27536,ORD_27537,30032,R.K's Aroma Essential Oil - Curry Leaf 10 ml,Warehouse C,68,56,2025-02-05 22:32:00,12
27537,ORD_27538,6393,GMM V 2mg/500mg/0.2mg Tablet,Warehouse B,113,97,2025-02-05 12:41:00,16
27538,ORD_27539,30655,Oritra 200 Capsule,Warehouse C,90,74,2025-02-05 13:07:00,16
27539,ORD_27540,21158,VMT Stock Xundd Back Cover Case Compatible with OnePlus 11R 5G (Armor | Clear PC and TPU),Warehouse C,8,3,2025-02-05 16:17:00,5
27540,ORD_27541,28889,Spigen EZ Fit Tempered Glass Screen Protector for iPhone 14 Pro Max - 2 Pack (Sensor Protection),Warehouse C,97,81,2025-02-05 11:36:00,16
27541,ORD_27542,9147,"Callmate 30000mAh High Capacity Power Bank, 15W Fast Charging | Digital Display | 2 USB Output Ports and 2 Input | LED Tor...",Warehouse C,63,53,2025-02-05 10:53:00,10
27542,ORD_27543,12807,"Zebronics Zeb-Transformer Gaming Keyboard and Mouse Combo (USB, Braided Cable)",Warehouse B,93,86,2025-02-05 17:30:00,7
27543,ORD_27544,22483,"Fire-Boltt Pioneer 1.95"" Smart Watch, High Resolution 320 * 385 Bluetooth Calling with 500 + Watch Faces, Always On, Rotat...",Warehouse B,22,17,2025-02-05 13:28:00,5
27544,ORD_27545,15657,Btaz 500 Tablet,Warehouse C,27,20,2025-02-05 05:24:00,7
27545,ORD_27546,20648,Gemblue Biocare Apricot Exfoliating Face Scrub 500 ml,Warehouse C,88,83,2025-02-05 23:28:00,5
27546,ORD_27547,6095,Helpotus Syrup,Warehouse C,81,68,2025-02-05 19:31:00,13
27547,ORD_27548,17254,Epripride Capsule SR,Warehouse B,107,94,2025-02-05 18:02:00,13
27548,ORD_27549,35810,"FACTOR NOTES Notebook: 90 GSM, B6, Ruled, 112 Pages Journal Diary (Cycle)",Warehouse A,75,64,2025-02-05 19:56:00,11
27549,ORD_27550,26287,"ZEBRONICS Zeb-Vita Plus Mini 16 w Soundbar Supporting LED Display, USB, SD Card, AUX, FM, TWS & Call Function (Black)",Warehouse C,103,87,2025-02-05 17:19:00,16
27550,ORD_27551,35804,Esslox 500mg Tablet,Warehouse A,36,30,2025-02-05 06:33:00,6
27551,ORD_27552,12672,Diclogem MR 250mg/50mg/325mg Tablet,Warehouse B,47,36,2025-02-05 06:17:00,11
27552,ORD_27553,23550,Glucreta S 5mg/100mg Tablet,Warehouse B,90,85,2025-02-05 10:09:00,5
27553,ORD_27554,8167,Up Or Down Body Mist - For Man,Warehouse B,89,77,2025-02-05 19:39:00,12
27554,ORD_27555,33711,SHIMMERY SHINY RADIANT GLOW WHITE POWDERY HIGHLIGHTER 10g,Warehouse C,72,63,2025-02-05 05:58:00,9
27555,ORD_27556,766,Regenerist - Advanced Anti-Ageing Revitalising Hydration Skin Cream Moisturizer SPF 15,Warehouse B,74,68,2025-02-05 11:43:00,6
27556,ORD_27557,7552,Azafran Organics Everyday Gentle Face Scrub 50 gm,Warehouse A,18,11,2025-02-05 07:39:00,7
27557,ORD_27558,35454,Elecsera Green Tea Natural Extract Long Lasting Soft Matte Lipstick Pack of 6,Warehouse A,26,7,2025-02-05 19:49:00,19
27558,ORD_27559,14562,Dot & Key Time Reverse Sleep Mask 60 ml,Warehouse A,81,68,2025-02-05 02:03:00,13
27559,ORD_27560,14586,Kacelo 200mg Tablet SR,Warehouse A,48,34,2025-02-05 18:54:00,14
27560,ORD_27561,18910,Cifley 200 LB Tablet DT,Warehouse B,39,20,2025-02-05 11:33:00,19
27561,ORD_27562,26090,Ocag 200mg Tablet,Warehouse B,59,53,2025-02-05 01:29:00,6
27562,ORD_27563,31498,Khadi Essentials Mohak Body Butter - Theobromine Chocolate & Honey 100 gm,Warehouse B,102,86,2025-02-05 14:36:00,16
27563,ORD_27564,12687,"UrbanMade Desk Mat Blotter for Laptop Large Extended Mouse Pad for Office Table Mat, Office Accessories for Desk, Keyboar...",Warehouse B,27,16,2025-02-05 17:34:00,11
27564,ORD_27565,1051,Bonjour Paris Silk Matte Lipstick- Red Rose 4.2 gm,Warehouse B,64,52,2025-02-05 19:40:00,12
27565,ORD_27566,3377,Sony MDR-XB55AP Premium in-Ear Extra Bass Wired Headphones with Mic (Black),Warehouse B,110,96,2025-02-05 22:53:00,14
27566,ORD_27567,26083,Aclocare PS Tablet,Warehouse B,66,51,2025-02-05 10:08:00,15
27567,ORD_27568,35832,Bond 4mg Tablet,Warehouse C,53,45,2025-02-05 11:18:00,8
27568,ORD_27569,28638,"Seyal Eucalyptus Essential Oil (Nilgiri Tel) 100% Pure & Natural Therapeutic Grade, Perfect For Cold and Cough | Steam Inh...",Warehouse A,85,68,2025-02-05 13:54:00,17
27569,ORD_27570,8173,"Lava Hero 600i (Blue Green) with Sleek and Stylish Design, 10 Regional Languages Input Support, Auto Call Recording, Wirel...",Warehouse C,92,78,2025-02-05 01:13:00,14
27570,ORD_27571,6015,"Makeup Revolution Loose Baking Powder, Banana, 32 g",Warehouse A,49,40,2025-02-05 13:04:00,9
27571,ORD_27572,20760,Evalex Syrup,Warehouse A,79,61,2025-02-05 12:34:00,18
27572,ORD_27573,14506,Lensulid SP 100mg/325mg/15mg Tablet,Warehouse A,58,40,2025-02-05 00:10:00,18
27573,ORD_27574,22506,Organic Cotton Tampons - Heavy,Warehouse C,60,52,2025-02-05 07:59:00,8
27574,ORD_27575,871,Amla Hair Oil - Anti-Dandruff Treatment,Warehouse A,99,80,2025-02-05 17:10:00,19
27575,ORD_27576,33804,Ondan 2mg Syrup,Warehouse B,31,24,2025-02-05 13:51:00,7
27576,ORD_27577,29127,"Luxor 5 Subject Spiral Premium Exercise Notebook, Single Ruled - (18cm X 24cm), 250 Pages, Pack of 3",Warehouse A,90,82,2025-02-05 11:23:00,8
27577,ORD_27578,29155,Citri A 10mg Tablet,Warehouse B,83,70,2025-02-05 20:23:00,13
27578,ORD_27579,23545,Gentleman Classic Deodorant,Warehouse B,66,59,2025-02-05 04:36:00,7
27579,ORD_27580,35461,Depig Cream,Warehouse B,46,38,2025-02-05 20:48:00,8
27580,ORD_27581,6126,"Quantum USB Wired Mouse, 1200 DPI Optical Sensor, Plug & Play Ergonomic Mouse for Comfortable All-Day Grip with 3-Button D...",Warehouse A,64,52,2025-02-05 13:32:00,12
27581,ORD_27582,4446,Ajmal Persuade & Nightingale Deo & Aretha EDP Pack of 3 20 ml,Warehouse C,18,6,2025-02-05 07:22:00,12
27582,ORD_27583,24335,Charmacy Milano Soft Satin Matte Lipstick (Red Salsa) 3.8 gm,Warehouse B,57,40,2025-02-05 05:49:00,17
27583,ORD_27584,4438,"slayisha bling Rainbow Colors Water Activated Matte Finish Eyeliner -6 Colors, White Pigment to Change Into Pastel Liner",Warehouse C,38,32,2025-02-05 01:45:00,6
27584,ORD_27585,8806,Kanakasavam,Warehouse A,79,72,2025-02-05 14:10:00,7
27585,ORD_27586,4360,NOTE ULTRA RICH COLOR EYE PENCIL 06 1.1 gm,Warehouse B,59,42,2025-02-05 01:06:00,17
27586,ORD_27587,15644,Hunky Dory 10pcs Lady Makeup Double-Side Oval Shape Eye Shadow | Lips Sponge Brushes Cosmetic Beauty Tool (Pack of 10),Warehouse C,55,41,2025-02-05 03:51:00,14
27587,ORD_27588,23726,"Logitech MK240 Nano Wireless USB Keyboard and Mouse Set, 12 Function Keys 2.4GHz Wireless, 1000DPI, Spill-Resistant Desig...",Warehouse C,68,53,2025-02-05 18:16:00,15
27588,ORD_27589,1791,Police To Be Tattooart Man Eau de Toilette 125ml,Warehouse B,94,83,2025-02-05 05:31:00,11
27589,ORD_27590,17253,Adosice Tablet,Warehouse C,37,29,2025-02-05 17:04:00,8
27590,ORD_27591,11070,Imizonic Plus 2 mg/25 mg Tablet,Warehouse B,61,51,2025-02-05 17:30:00,10
27591,ORD_27592,18638,Bella Voste Eyeshadow Satin Lust 02 2.6 gm,Warehouse B,75,59,2025-02-05 05:35:00,16
27592,ORD_27593,4440,"Adult Diaper Pants Classic, Extra Large",Warehouse A,29,19,2025-02-05 12:43:00,10
27593,ORD_27594,18978,"ZEBRONICS Zeb-Warrior 4, 2.0 Speaker for PC, Laptops, Desktop with 5 RGB Light Modes, USB Powered, AUX Input, Volume Contr...",Warehouse C,32,27,2025-02-05 20:23:00,5
27594,ORD_27595,33452,Joflix OZ 200mg/500mg Tablet,Warehouse C,39,29,2025-02-05 05:53:00,10
27595,ORD_27596,14608,"rts All in One Combo Card Reader for Pen Drive/Cameras/mobiles/PC/Laptop/Notebook/Tablet/or Docking Station/MP3s/PDAs,Colo...",Warehouse B,74,63,2025-02-05 02:34:00,11
27596,ORD_27597,8465,Ajmal Mukhallat Raaqi Concentrated Perfume Oil Floral Fruity And Sacred Love Deodorant Floral Musky Fragrance 210 ml,Warehouse C,28,17,2025-02-05 10:57:00,11
27597,ORD_27598,8809,"ESR Screen Protector Compatible with iPad 10.2 inch 9th Gen 2021/iPad 8th Gen 2020/iPad 7th Gen 2019, Scratch-Resistant 9H...",Warehouse C,12,1,2025-02-05 18:41:00,11
27598,ORD_27599,31504,"Mouthwash Liquid - Freshburst, Removes 99.9% Germs",Warehouse A,88,74,2025-02-05 18:23:00,14
27599,ORD_27600,3344,Levipride 25mg Tablet,Warehouse A,31,19,2025-02-05 12:56:00,12
27600,ORD_27601,35284,AND Ethereal Dreamer Eau De Parfum 50ML & Dainty Glam Body Mist 200ML Pack of 2 for Women Crafted by Ajmal,Warehouse B,66,59,2025-02-05 14:29:00,7
27601,ORD_27602,20656,Aclonac-MR Tablet,Warehouse C,46,27,2025-02-05 17:26:00,19
27602,ORD_27603,33415,TheGiftKart Sleek Back Cover Case for iPhone 11 | Slim Fit Protective Design | Ultra Matte Finish | Camera Protection Bump...,Warehouse A,78,72,2025-02-05 19:39:00,6
27603,ORD_27604,35385,I AM EYECONIC FINE GLITTER DRIPPY 4 gm,Warehouse C,86,80,2025-02-05 19:36:00,6
27604,ORD_27605,35386,VARS LONDON Charming eyes liquid white color sketch eyeliner,Warehouse C,86,81,2025-02-05 12:52:00,5
27605,ORD_27606,3349,Pierre Cardin Paris -Torture Pumping Volume & Long Lash Mascara,Warehouse B,69,51,2025-02-05 13:45:00,18
27606,ORD_27607,23653,Prolixr Beauty Shield Vitamin C Face Serum 30 ml,Warehouse C,12,7,2025-02-05 05:17:00,5
27607,ORD_27608,919,"CableCreation Short Micro B to USB C Hard Drive Cable 1FT, USB 3.1 Type C to Micro B Cable 10Gbps,USB C to External Hard D...",Warehouse B,104,87,2025-02-05 08:51:00,17
27608,ORD_27609,7496,"ProElite Smart Flip Case Cover for Samsung Galaxy Tab A7 Lite 8.7"" SM-T220/225 Translucent Back with Stylus Pen, Dark Blue",Warehouse B,110,96,2025-02-05 10:31:00,14
27609,ORD_27610,11110,Ajmal Blu & Silver Shade & Evoke silver Edition Homme & Shadow Homme Deo & Ascend EDP Pack of 5 20 ml,Warehouse C,58,49,2025-02-05 16:18:00,9
27610,ORD_27611,9139,"Vitamin C, E & Hyaluronic Acid Brightening Eye Mask",Warehouse B,84,76,2025-02-05 17:36:00,8
27611,ORD_27612,35598,INDUS VALLEY Bio Organic Sun Guard Aloe Vera Gel With Lemon & Orange For Ultimate Refreshing Feel (175ml),Warehouse B,72,59,2025-02-05 03:51:00,13
27612,ORD_27613,10229,Cardiwell 100mg Tablet,Warehouse C,108,92,2025-02-05 13:59:00,16
27613,ORD_27614,31294,"Gizga Essentials Laptop Bag Sleeve Case Cover Pouch with Handle for 14.1 Inch Laptop for Men & Women, Padded Laptop Compar...",Warehouse A,109,92,2025-02-05 01:03:00,17
27614,ORD_27615,4363,The Skin Story New Keratin Repair & Strengthen Shampoo 450 ml,Warehouse B,61,56,2025-02-05 05:56:00,5
27615,ORD_27616,23651,elago GB5 Case Compatible with Samsung Galaxy Buds 2 Pro Case (2022) / Galaxy Buds 2 Case (2021) / Galaxy Buds Pro Case (2...,Warehouse A,27,10,2025-02-05 12:41:00,17
27616,ORD_27617,12020,Aster 3+3 Universal Multi Plug Socket Extension Board / Power Adapter with Individual Switches and Fuse Protection (White)...,Warehouse C,113,94,2025-02-05 02:55:00,19
27617,ORD_27618,28822,"Groovs Liquid Matte Minis Lipstick Nude Edition, (2-ml each)- (Pack of 4)",Warehouse C,21,15,2025-02-05 01:18:00,6
27618,ORD_27619,12790,Zither Gadgets2use Hybrid Sim Adapter (Pack of 2),Warehouse A,65,58,2025-02-05 20:38:00,7
27619,ORD_27620,28985,"Shea Moisture Jamaican Black Castor Oil Strengthen And Restore Treatment Masque, 340 g",Warehouse A,40,21,2025-02-05 20:13:00,19
27620,ORD_27621,28795,Notemp-AC Tablet,Warehouse C,83,76,2025-02-05 20:05:00,7
27621,ORD_27622,6558,Ajmal Mukhallat Raaqi Concentrated Perfume Oil Floral Fruity Attar And Mukhallat AL Wafa Concentrated Perfume Oil Oriental Musky Attar 22 ml,Warehouse A,66,51,2025-02-05 02:17:00,15
27622,ORD_27623,20719,Joecool 40mg Tablet,Warehouse C,17,4,2025-02-05 06:32:00,13
27623,ORD_27624,21357,"IONIX Multi-Color LCD Writing Tablet 8.5 Inch Screen, Toys, Kids Toy, 8.5"" Inch Colorful Toddler Doodle Board Drawing Tabl...",Warehouse C,57,47,2025-02-05 16:21:00,10
27624,ORD_27625,35589,Flumak 150mg Capsule,Warehouse B,48,29,2025-02-05 01:39:00,19
27625,ORD_27626,8779,"Redmi 11 Prime (Playful Green, 6BG RAM 128GB ROM) | Prime Design | High Performance Helio G99 | 50 MP AI Triple Cam | 5000...",Warehouse B,102,88,2025-02-05 23:07:00,14
27626,ORD_27627,31306,Sirona Discreet Disposal Bags for Tampons and Condoms 50's,Warehouse A,38,22,2025-02-05 00:44:00,16
27627,ORD_27628,3271,Frolic 500mg Tablet,Warehouse A,80,71,2025-02-05 03:50:00,9
27628,ORD_27629,28922,"Sounce WARP/Dash Charging Cable, Type C Cable 3FT 5V 4A Fast Charge Data Cable for OnePlus 8/8T, OnePlus 7, OnePlus 6T/ 6,...",Warehouse B,29,18,2025-02-05 23:40:00,11
27629,ORD_27630,28864,Ajmal Distraction And Persuade For Men & Women And Avid Deodorants Pack of 3 200 ml,Warehouse B,33,21,2025-02-05 19:51:00,12
27630,ORD_27631,4592,MYVN Compatible with OnePlus 11/11R/10/10pro/10r/8T/9/9pro/9r/nord 2 Fast Charging Cable 6.5A Warp Charge USB C to USB C C...,Warehouse C,20,7,2025-02-05 23:18:00,13
27631,ORD_27632,2023,Slazenger Gift Set Blue For Men 275 ml,Warehouse B,66,58,2025-02-05 03:02:00,8
27632,ORD_27633,35678,"STRIFF Laptop Tabletop Stand, Fold-Up, Adjustable, Ventilated, Portable Holder For Desk, Aluminum Foldable Laptop Ergonomi...",Warehouse B,20,10,2025-02-05 12:29:00,10
27633,ORD_27634,28862,FATMUG Laptop Bag For Men - Convertible Backpack For Office And Travel (Navy Blue Oxford Fabric),Warehouse A,75,59,2025-02-05 19:31:00,16
27634,ORD_27635,33611,"Samsung Galaxy S23 Ultra 5G (Phantom Black, 12GB, 256GB Storage)",Warehouse C,77,69,2025-02-05 20:13:00,8
27635,ORD_27636,35788,Spigen Tough Armor Back Cover Case for Samsung Galaxy S23 Ultra (Poly Carbonate + TPU | Gunmetal),Warehouse B,63,51,2025-02-05 23:10:00,12
27636,ORD_27637,10173,Migo 10mg Tablet,Warehouse A,62,49,2025-02-05 19:29:00,13
27637,ORD_27638,14254,"JBL Commercial CSLM20 Auxiliary Omnidirectional Lavalier Microphone, Earphone For calls, Video Conferences, And Monitorin...",Warehouse A,108,92,2025-02-05 04:56:00,16
27638,ORD_27639,3350,"Sounce Gaming Mouse Pad, Large Extended Desk Mouse Pad, Non-Slip Spill-Resistant Mousepad with Special-Textured Surface, A...",Warehouse C,20,12,2025-02-05 20:13:00,8
27639,ORD_27640,24374,Yoxadine Syrup,Warehouse A,37,21,2025-02-05 11:59:00,16
27640,ORD_27641,35427,Brustro Professional High Gloss Varnish 200 Ml,Warehouse A,63,51,2025-02-05 12:06:00,12
27641,ORD_27642,25219,"Smart Watch - ID116 Plus Bluetooth 1.3"" LED with Blood Oxygen Monitoring, Continuous Heart Rate Sensor, Full Touch Screen,...",Warehouse C,29,17,2025-02-05 21:35:00,12
27642,ORD_27643,23792,Myclin O Ear Drop,Warehouse C,104,98,2025-02-05 20:11:00,6
27643,ORD_27644,3357,Razzpro-D Capsule SR,Warehouse B,88,75,2025-02-05 16:13:00,13
27644,ORD_27645,14255,Telmiwock  80mg Tablet,Warehouse C,89,72,2025-02-05 08:43:00,17
27645,ORD_27646,20753,Mexapan 40mg Tablet,Warehouse B,49,32,2025-02-05 04:18:00,17
27646,ORD_27647,1012,Levosil M 5mg/10mg Tablet,Warehouse C,30,25,2025-02-05 02:33:00,5
27647,ORD_27648,18607,Elle18 Lipstick Lilac Galaxy (Matte),Warehouse B,30,17,2025-02-05 12:13:00,13
27648,ORD_27649,28668,Neset CR Tablet,Warehouse B,80,65,2025-02-05 10:11:00,15
27649,ORD_27650,17324,Kangaro 23/24-H Staple Pin,Warehouse A,39,33,2025-02-05 18:02:00,6
27650,ORD_27651,25227,Nimzen-Cold & Flu Tablet,Warehouse C,52,44,2025-02-05 11:23:00,8
27651,ORD_27652,23784,"Cezo 40X60 Magnification Zoom HD,Monocular Telescope for Adults and Children,High Power Telescope Gadget,Outdoor Telescope...",Warehouse A,41,29,2025-02-05 21:39:00,12
27652,ORD_27653,33778,SHOPEE Rear Lens Cap & Camera Body Cap Cover for Sony E Mount A7 IV A1 ZV-1 ZV-E10 A7C A7R IV III A7 III II A7S III II A66...,Warehouse C,17,5,2025-02-05 00:53:00,12
27653,ORD_27654,11055,RAS Luxury Oils Face Mask |Trio|Face Glowing Kit | For Skin Brightning | A Perfect Gift Set,Warehouse B,14,5,2025-02-05 18:11:00,9
27654,ORD_27655,10117,"Fashion Colour Baked Blusher, Shade 02 8 gm",Warehouse C,104,86,2025-02-05 03:25:00,18
27655,ORD_27656,33779,Iglax Tablet,Warehouse A,34,28,2025-02-05 02:02:00,6
27656,ORD_27657,14352,Simmtronics 2GB DDR2 Desktop RAM 800 MHz (PC 6400) with 3 Year Warranty,Warehouse A,48,38,2025-02-05 16:13:00,10
27657,ORD_27658,20742,"Texet LMA4-VX Lamination/Laminating Machine with Jam Release Control, Ideal for Any Document, Fully Automatic Portable All...",Warehouse B,93,87,2025-02-05 09:08:00,6
27658,ORD_27659,14391,Glowdec 50mg Injection,Warehouse B,46,33,2025-02-05 16:19:00,13
27659,ORD_27660,10168,"Vivo Y16 (Drizzling Gold, 3GB RAM, 64GB Storage) with No Cost EMI/Additional Exchange Offers",Warehouse C,102,93,2025-02-05 09:41:00,9
27660,ORD_27661,6560,Amozo Ultra Hybrid Camera and Drop Protection Back Case Cover for iPhone 12 / iPhone 12 Pro (Polycarbonate|Transparent),Warehouse C,83,69,2025-02-05 21:56:00,14
27661,ORD_27662,31384,"Olivia Instant Waterproof Makeup Stick, Shade - Natural 03, Concealer, SPF 12 (15g)",Warehouse B,67,60,2025-02-05 13:22:00,7
27662,ORD_27663,26179,Joronac MR 250mg/50mg/325mg Tablet,Warehouse A,97,91,2025-02-05 13:01:00,6
27663,ORD_27664,35610,Mexacof Syrup,Warehouse C,38,25,2025-02-05 01:32:00,13
27664,ORD_27665,25822,Evanzyme 192mg/25mg/40mg Tablet,Warehouse C,36,29,2025-02-05 20:15:00,7
27665,ORD_27666,35435,Portronics My buddy plus Adjustable Laptop cooling Table (Brown),Warehouse B,79,63,2025-02-05 19:49:00,16
27666,ORD_27667,10574,Long Drive 60mg Tablet,Warehouse C,90,76,2025-02-05 00:56:00,14
27667,ORD_27668,1101,Vegetal Safe Hair Color Soft Black 100gm - Certified Organic Chemical and Allergy Free Bio Natural Hair Color with No Ammo...,Warehouse B,85,79,2025-02-05 14:23:00,6
27668,ORD_27669,29334,"Fashion Colour Super Matte Lipstick, Plum Kiss 4 gm",Warehouse B,42,36,2025-02-05 13:53:00,6
27669,ORD_27670,33818,"Clea Cleansing & Makeup Remover Wipes Wet Wipes for Face Moisturizing For Dry Skin (Rose-Milk, 100 Wipes)",Warehouse A,13,1,2025-02-05 12:45:00,12
27670,ORD_27671,4330,Naxen 750mg Tablet CR,Warehouse C,49,40,2025-02-05 22:33:00,9
27671,ORD_27672,14648,Everfresh+ Anti-Germ Gel Toothpaste - Red Hot,Warehouse A,85,79,2025-02-05 10:47:00,6
27672,ORD_27673,1883,REDTECH Fire_Boltt Ring Smart Watch Charging Cable USB Fast Charger Magnetic Charging Cable Adapter (Charger only),Warehouse B,60,55,2025-02-05 12:25:00,5
27673,ORD_27674,14637,Sandal & Vanilla Soap,Warehouse A,56,41,2025-02-05 00:00:00,15
27674,ORD_27675,18532,CraftDev A500MB Portable Paper Trimmer 12 Inch Cut,Warehouse A,42,27,2025-02-05 13:33:00,15
27675,ORD_27676,22403,Ultra Soft Air Fresh Sanitary Pads - XL Plus,Warehouse C,90,79,2025-02-05 17:07:00,11
27676,ORD_27677,35225,Nourishing Almond Body Lotion,Warehouse A,63,54,2025-02-05 17:40:00,9
27677,ORD_27678,3419,Orixone S 500mg/250mg Injection,Warehouse B,88,79,2025-02-05 00:56:00,9
27678,ORD_27679,17496,Prin Shampoo,Warehouse B,62,56,2025-02-05 12:34:00,6
27679,ORD_27680,17498,Parker Moments Vector Gold Trim Roller Ball Pen (Silver),Warehouse B,42,24,2025-02-05 07:46:00,18
27680,ORD_27681,25371,Pikkme Samsung Galaxy M12 / F12 / A12 Flip Case | Vintage Leather Finish | Inside TPU | Wallet Stand | Magnetic Closing | ...,Warehouse A,88,72,2025-02-05 09:19:00,16
27681,ORD_27682,35239,"INSIGHT Non Transfer Lip Color, 4ml (LG40=30)",Warehouse B,77,60,2025-02-05 19:48:00,17
27682,ORD_27683,10357,"SPIN CART 3 in 1 Screen Cleaning Kit for Laptops, Mobiles, LCD, LED, Computers and TV",Warehouse C,85,70,2025-02-05 04:36:00,15
27683,ORD_27684,4338,Belora Paris BB Naturelle Cream SPF Honey 30 gm,Warehouse A,30,14,2025-02-05 12:26:00,16
27684,ORD_27685,35251,Sounce 3.5 mm Headphone Jack Adapter Connector Only Supported Music Control Audio Adapter for iPhone 13Mini/13/13 Pro/13 P...,Warehouse C,83,67,2025-02-05 22:07:00,16
27685,ORD_27686,12662,KZ ZSN Pro HiFi Auxiliary Wired In Ear Earphone with Mic (Gray),Warehouse B,40,33,2025-02-05 03:47:00,7
27686,ORD_27687,21288,Esomewin D 30mg/40mg Capsule SR,Warehouse B,39,33,2025-02-05 09:43:00,6
27687,ORD_27688,1868,Meritrip Drb Tablet,Warehouse C,106,97,2025-02-05 09:45:00,9
27688,ORD_27689,23816,Xofex 200mg Tablet,Warehouse B,71,61,2025-02-05 03:50:00,10
27689,ORD_27690,35131,Bultra 500mg Injection,Warehouse A,77,61,2025-02-05 05:34:00,16
27690,ORD_27691,1132,Deborah Milano Nail Polish Remover Acetone Free,Warehouse A,95,84,2025-02-05 01:02:00,11
27691,ORD_27692,14683,"AmazonBasics Magnetic Framed Dry Erase White Board, 17 x 23 Inch",Warehouse B,103,90,2025-02-05 17:49:00,13
27692,ORD_27693,10981,Epson EcoTank L3252 Wi-Fi All-in-One Ink Tank Printer (Black),Warehouse B,87,70,2025-02-05 16:41:00,17
27693,ORD_27694,17531,Glucoryl-M 3 Forte Tablet PR,Warehouse A,58,47,2025-02-05 18:15:00,11
27694,ORD_27695,25394,"Tombow Mono Zero Eraser with Extra Refill, Black",Warehouse A,96,85,2025-02-05 23:51:00,11
27695,ORD_27696,26006,"Sunny Health & Fitness Hair Color With Unique Blend of Henna, Amla, Shikakai & Bhringraj Herbs, Penetrates Every Strand & ...",Warehouse B,65,52,2025-02-05 06:09:00,13
27696,ORD_27697,33900,Lemon Soap,Warehouse B,87,81,2025-02-05 07:15:00,6
27697,ORD_27698,3447,Matdryl Syrup,Warehouse C,29,13,2025-02-05 10:05:00,16
27698,ORD_27699,10400,Disney Pixar Cars - Bio Nutty Almond Nourishing Soap,Warehouse B,44,31,2025-02-05 19:03:00,13
27699,ORD_27700,25994,Esokap 40 Tablet,Warehouse A,43,30,2025-02-05 11:32:00,13
27700,ORD_27701,8394,Mamaearth Onion Oil Scalp Serum with Onion Oil & Niacinamide for Healthy Hair Growth – 50ml,Warehouse C,58,41,2025-02-05 18:12:00,17
27701,ORD_27702,30972,Nipacox 120mg Tablet,Warehouse A,37,20,2025-02-05 05:46:00,17
27702,ORD_27703,1152,Predvone 4mg Tablet,Warehouse B,86,79,2025-02-05 01:27:00,7
27703,ORD_27704,21237,Antibacteria Pads - Extra Long,Warehouse C,110,95,2025-02-05 22:16:00,15
27704,ORD_27705,7382,Xflo 50mg Suspension,Warehouse B,31,21,2025-02-05 14:50:00,10
27705,ORD_27706,4234,TheGiftKart Back Cover Case for OnePlus Nord CE 5G (2021) (Crystal Clear | Shockproof | Hybrid TPU & PC | Transparent Back...,Warehouse A,57,44,2025-02-05 18:17:00,13
27706,ORD_27707,10434,Hair growth Oil With Dandruff & Hair Fall Treatment - Argan & Almond,Warehouse C,23,5,2025-02-05 05:51:00,18
27707,ORD_27708,4263,"Sony HT-S40R Real 5.1ch Dolby Audio Soundbar for TV with Subwoofer & Wireless Rear Speakers, 5.1ch Home Theatre System (60...",Warehouse B,78,65,2025-02-05 04:44:00,13
27708,ORD_27709,29468,AmazonBasics Magnetic Wireless Charger | 15W Max Fast Charging Square Pad | Compatible with iPhone 13/13 Pro/13 Mini/13 Pr...,Warehouse B,89,76,2025-02-05 09:02:00,13
27709,ORD_27710,24288,Bio Wheatgerm - Youthful Nourishing Night Cream For Normal To Dry Skin,Warehouse A,66,57,2025-02-05 22:13:00,9
27710,ORD_27711,1176,Fair'e Mulethi-Khus Skin Brightening Gel,Warehouse A,103,90,2025-02-05 13:36:00,13
27711,ORD_27712,22078,Sefdix 500mg Capsule,Warehouse B,90,78,2025-02-05 05:06:00,12
27712,ORD_27713,20838,Prickly Heat Powder - Cool Herbal With Neem & Pudina,Warehouse C,40,28,2025-02-05 20:20:00,12
27713,ORD_27714,17545,Pilot V7 Liquid Ink Roller Ball Pen (Pack of 2 Blue Pen),Warehouse C,27,16,2025-02-05 04:33:00,11
27714,ORD_27715,25970,POPIO Tempered Glass Compatible for Apple iPhone 5 / Apple iPhone 5S / Apple iPhone SE 2016 (Transparent) Edge to Edge Ful...,Warehouse C,105,98,2025-02-05 12:28:00,7
27715,ORD_27716,15558,Orka OZ 200mg/500mg Tablet,Warehouse C,74,60,2025-02-05 12:09:00,14
27716,ORD_27717,18453,SKYVIK TRUHOLD Car Dashboard Phone Cradle with Ultimate Grip and Viewing Angle,Warehouse B,102,91,2025-02-05 08:31:00,11
27717,ORD_27718,22368,Micogel F Cream,Warehouse A,45,32,2025-02-05 22:13:00,13
27718,ORD_27719,4207,Ofler 200mg Infusion,Warehouse C,49,31,2025-02-05 11:21:00,18
27719,ORD_27720,10451,Levobact 500 Tablet,Warehouse A,85,74,2025-02-05 14:32:00,11
27720,ORD_27721,17580,"Uniball Eye Ball Point Pen - Blue Ink, Pack of 5",Warehouse C,14,4,2025-02-05 08:27:00,10
27721,ORD_27722,1183,Myglamm Lit Lip & Eye Sparkles - Your Grace 1.1 Gm,Warehouse A,58,43,2025-02-05 09:05:00,15
27722,ORD_27723,1182,POPIO Screen Guard for OnePlus 7 Pro/OnePlus 7T Pro (Transparent) Edge to Edge Full Screen Coverage with Easy Installation...,Warehouse B,105,89,2025-02-05 00:06:00,16
27723,ORD_27724,10448,Flormar Jelly Look Nail Enamel JL07 Ruby 11 ml,Warehouse A,32,25,2025-02-05 19:58:00,7
27724,ORD_27725,12615,Zifithro 200mg/250mg Tablet,Warehouse A,10,2,2025-02-05 21:36:00,8
27725,ORD_27726,24263,Colorbar Moon Lava Eye Shadow Liquid Mle001 3.5 Gm,Warehouse B,58,52,2025-02-05 07:16:00,6
27726,ORD_27727,29533,Lez 250mg Tablet,Warehouse B,23,5,2025-02-05 09:34:00,18
27727,ORD_27728,10441,Ajmal Wild Waters Edt Of 2 & Distraction Deodorant Pack of 2 450 ml,Warehouse B,61,55,2025-02-05 01:10:00,6
27728,ORD_27729,29551,"Boult Audio Airbass Z10 Bluetooth Truly Wireless in Ear Earbuds with Mic with 30H Playtime & Fast Charging with Type-C, Ip...",Warehouse C,73,62,2025-02-05 09:27:00,11
27729,ORD_27730,15542,"Fabtec Car Body Cover Compatible with Maruti Swift (2012-2017) with Mirror & Antenna Pockets (Heavy Duty, Full Sized, Trip...",Warehouse B,41,30,2025-02-05 15:23:00,11
27730,ORD_27731,1808,Oasulate 500mg Tablet,Warehouse C,21,9,2025-02-05 04:51:00,12
27731,ORD_27732,25944,"Amazon Basics 4 Port USB 2.0 HUB, 0.3m Length, 37.5 Grams",Warehouse A,85,70,2025-02-05 18:22:00,15
27732,ORD_27733,6184,"Casio Men's G-Shock Black Dial Digital Watch - DW-5600BB-1DR, G363",Warehouse A,117,98,2025-02-05 11:57:00,19
27733,ORD_27734,35073,Huflox-O Tablet,Warehouse B,46,40,2025-02-05 08:36:00,6
27734,ORD_27735,17520,CAD Q PLUS TABLET,Warehouse B,52,44,2025-02-05 06:09:00,8
27735,ORD_27736,22409,Elvozine-AM Capsule,Warehouse C,17,6,2025-02-05 05:48:00,11
27736,ORD_27737,35178,Artiluf 80mg/480mg Tablet,Warehouse C,74,62,2025-02-05 15:05:00,12
27737,ORD_27738,34134,AND Ethereal Dreamer Pack of 2 Eau De Parfum 100ML each for Women Crafted by Ajmal,Warehouse A,100,82,2025-02-05 20:06:00,18
27738,ORD_27739,10533,A rtistque Liquid TPU Silicone Matte Shockproof Flexible with Camera Protection Soft Back Cover Case for Samsung Galaxy M5...,Warehouse C,104,96,2025-02-05 11:11:00,8
27739,ORD_27740,7334,Fecure MF Oral Suspension,Warehouse C,83,69,2025-02-05 00:43:00,14
27740,ORD_27741,18300,Hair Smoothening Shampoo 350 Ml,Warehouse C,50,34,2025-02-05 15:46:00,16
27741,ORD_27742,25879,Wet Wipes - Germ Protection On the Go,Warehouse A,56,46,2025-02-05 22:26:00,10
27742,ORD_27743,25876,Mucocef-O 200mg Tablet,Warehouse C,31,22,2025-02-05 01:49:00,9
27743,ORD_27744,25872,"Sery Stay On Matte Liquid Lipstick Wander Lust, Nude (LSO - 06) 5 ml",Warehouse C,85,74,2025-02-05 04:55:00,11
27744,ORD_27745,34883,"proffisy MLT D101S Toner Cartridge for Samsung ML 2161, SCX 3401,2160,2162G,2165,2166W,2168,3405,3400,SF 760P,SF 761 (Indi...",Warehouse B,45,36,2025-02-05 23:37:00,9
27745,ORD_27746,4294,BRUSTRO kneadable Art Eraser Pack of 6 with Blending Stump Set,Warehouse A,83,77,2025-02-05 10:18:00,6
27746,ORD_27747,10872,The Face Shop Herb Day 365 Mung Bean Cleansing Foam 170 ml,Warehouse A,70,57,2025-02-05 19:40:00,13
27747,ORD_27748,34176,T Cef 250mg Injection,Warehouse A,88,80,2025-02-05 21:58:00,8
27748,ORD_27749,29848,Scrubber - Braided Back,Warehouse A,35,20,2025-02-05 17:30:00,15
27749,ORD_27750,21181,IFITech Bulb Shape Indoor HD 2304*1296 (3 Megapixels) CCTV WiFi Camera | Motion Sensor LED Light | Pan/Tilt & 110� Wide An...,Warehouse C,24,14,2025-02-05 06:53:00,10
27750,ORD_27751,8238,"Redgear Cosmo 7,1 USB Gaming Wired Over Ear Headphones with Mic with Virtual Surround Sound,50Mm Driver, RGB LEDs & Remote...",Warehouse A,20,1,2025-02-05 02:24:00,19
27751,ORD_27752,10554,Lokcid-O Gel Mint Sugar Free,Warehouse B,45,27,2025-02-05 10:27:00,18
27752,ORD_27753,22136,Ajmal 2 Nightingale & Distraction Deodorant Pack of 3 Deodorants 200 ml,Warehouse C,53,46,2025-02-05 22:40:00,7
27753,ORD_27754,24208,KINDED Liquid Concealer for Face Makeup Full Coverage Colour Corrector Contour Waterproof HD Pro Master Series for Dry & O...,Warehouse C,103,85,2025-02-05 18:18:00,18
27754,ORD_27755,14846,"Duracell Ultra Alkaline AA Batteries, Pack of 20",Warehouse C,26,8,2025-02-05 18:49:00,18
27755,ORD_27756,4183,TheGiftKart Crystal Clear Back Cover Case for OnePlus 7T | 360 Degree Protection | Shock Proof Design | Transparent Back C...,Warehouse A,61,55,2025-02-05 21:59:00,6
27756,ORD_27757,30876,The Moms Co. Age Control Day Cream 50 ml,Warehouse C,110,99,2025-02-05 14:27:00,11
27757,ORD_27758,29672,"Cosmic Byte H11 Gaming Wired Over-ear Headset with Microphone (Black/Orange, Pack Of 1)",Warehouse C,84,69,2025-02-05 21:26:00,15
27758,ORD_27759,14772,AmazonBasics CL3 Rated (in-Wall Installation) Toslink Cable - 10 Feet,Warehouse B,70,58,2025-02-05 17:16:00,12
27759,ORD_27760,35002,Neemraj Anti-Dandruff Shampoo,Warehouse C,107,98,2025-02-05 09:55:00,9
27760,ORD_27761,8365,"Swiss Beauty MakeUp Fixer Natural Aloe Vera with Vitamin-E, Face MakeUp, White, 50ml & Swiss Beauty Professional Liquid Co...",Warehouse A,71,55,2025-02-05 05:48:00,16
27761,ORD_27762,7369,Tough Lee Tempered Glass Screen Guard Protector for Oneplus Nord CE 2 Lite 5G (Black) Edge to Edge Full Screen Coverage wi...,Warehouse B,103,94,2025-02-05 06:47:00,9
27762,ORD_27763,1222,"Wayona Nylon Braided 3A Lightning to USB A Syncing and Fast Charging Data Cable for iPhone, Ipad (3 FT Pack of 1, Black)",Warehouse C,27,8,2025-02-05 19:21:00,19
27763,ORD_27764,10466,"NutriGlow NATURAL'S Advanced Pro Formula Diamond Radiance Facial Kit for Advanced Cellular Age Balance & Skin Cell Repair,...",Warehouse A,29,15,2025-02-05 09:08:00,14
27764,ORD_27765,7371,Nusetron 2mg Syrup,Warehouse B,70,61,2025-02-05 08:22:00,9
27765,ORD_27766,22146,mCaffeine Coffee Lip Scrub 12 gm,Warehouse C,104,86,2025-02-05 00:28:00,18
27766,ORD_27767,1298,Bericort 6mg Syrup,Warehouse A,90,82,2025-02-05 15:32:00,8
27767,ORD_27768,1299,Lakme 9To5 Primer + Gloss Nail Colour Red Splash 6 Ml,Warehouse B,23,13,2025-02-05 06:17:00,10
27768,ORD_27769,18283,boAt Rugged V3 Braided Micro USB Cable (Pearl White),Warehouse C,92,82,2025-02-05 21:20:00,10
27769,ORD_27770,23918,"Meyaar Stainless Steel Band Compatible with Fire-Boltt Visionary BSW046, Fire-Boltt Ring BSW005, FireBoltt Ring Pro BSW02...",Warehouse C,41,28,2025-02-05 19:47:00,13
27770,ORD_27771,22055,Faces Canada Ultime Pro Longstay Liquid Matte Lipstick Rosy Crush 17 6 gm,Warehouse C,77,64,2025-02-05 09:54:00,13
27771,ORD_27772,35186,AmazonBasics 6 Feet DisplayPort to DisplayPort Cable - (Not HDMI Cable) (Gold),Warehouse A,29,11,2025-02-05 03:29:00,18
27772,ORD_27773,10388,Imagic Professional Eyebrow gel DARK BROWN shade 5,Warehouse B,84,72,2025-02-05 05:32:00,12
27773,ORD_27774,20798,Vomicon 4 Tablet MD,Warehouse A,75,68,2025-02-05 15:22:00,7
27774,ORD_27775,33854,Jovees Premium Age Defence Cream 50 gm,Warehouse A,92,85,2025-02-05 13:50:00,7
27775,ORD_27776,30916,Zimat 10mg Tablet,Warehouse A,73,59,2025-02-05 22:43:00,14
27776,ORD_27777,7376,"Loofah/Sponge Scrubber/Body Bath  - Jute, Brown, BH-022 BRN",Warehouse B,73,58,2025-02-05 23:41:00,15
27777,ORD_27778,17592,"Ajjas - Waterproof GPS Tracker for Bike, Scooty, Car, Bus, Device + 1 Month Sim Data & Free Mobile App (Features with Acci...",Warehouse B,60,47,2025-02-05 00:14:00,13
27778,ORD_27779,17687,SYGA Headphones EarPads Cushions Replacement - Compatible with Bose QuietComfort 15 QC15 QC25 QC2 QC35/ Ae2 Ae2i Ae2w Soun...,Warehouse A,41,24,2025-02-05 00:44:00,17
27779,ORD_27780,14886,Warnac-MR Tablet,Warehouse C,53,38,2025-02-05 21:05:00,15
27780,ORD_27781,4093,Vega Paddle Brush (E18 - PB) 185 gm,Warehouse B,66,51,2025-02-05 02:56:00,15
27781,ORD_27782,34130,Redmi Note 12 5G Matte Black 6GB RAM 128GB ROM | 1st Phone with 120Hz Super AMOLED and Snapdragon® 4 Gen 1 | 48MP AI Tripl...,Warehouse C,89,73,2025-02-05 09:09:00,16
27782,ORD_27783,1272,Ronzille Glitter Metallic liquid eyeliner Pink,Warehouse B,79,61,2025-02-05 17:55:00,18
27783,ORD_27784,18357,"Fabtec Car Body Cover Compatible with Maruti Swift (2018-2021) with Mirror & Antenna Pockets (Heavy Duty, Full Sized, Trip...",Warehouse C,99,94,2025-02-05 23:32:00,5
27784,ORD_27785,34923,"Intern INT-38C Lindenwood Acoustic Guitar Kit (Sunburst) With Carry Bag, Picks, Strings Set And Guitar Strap (Small)",Warehouse B,110,98,2025-02-05 15:18:00,12
27785,ORD_27786,4101,Ethiglo Skin Whitening Face Wash 200ml : Pack of 2,Warehouse A,25,18,2025-02-05 00:48:00,7
27786,ORD_27787,1737,"ZDQTRA silicone makeup brush cleaning washing mat tool for home saloon,Non-Toxic Odorless portable painting makeup brush c...",Warehouse A,29,24,2025-02-05 10:20:00,5
27787,ORD_27788,10525,Amty 10mg Tablet,Warehouse A,103,88,2025-02-05 00:35:00,15
27788,ORD_27789,6434,"CYRILL by Spigen Color Brick Back Cover Case Compatible for Google Pixel 6a (TPU, PC | Kale)",Warehouse B,89,73,2025-02-05 00:54:00,16
27789,ORD_27790,4106,"Toothpaste - Whitening, Cavity Protection, 150 G",Warehouse B,35,21,2025-02-05 10:33:00,14
27790,ORD_27791,29766,MOROFY Stainless Steel Adjustable Link Band for Apple Watch Ultra Band 49mm 45mm 44mm 42mm With Butterfly Folding Clasp Br...,Warehouse B,22,12,2025-02-05 12:21:00,10
27791,ORD_27792,25469,Sizowin-S 1gm/0.5gm Injection,Warehouse C,65,60,2025-02-05 01:51:00,5
27792,ORD_27793,4113,mCaffeine Naked & Raw Sun Protection Coffee Face Serum 40 ml,Warehouse B,20,6,2025-02-05 08:30:00,14
27793,ORD_27794,18348,Ajmal Avid Wisal Dahab Wisal Dahab Deodorant Spray (Pack of 3) 200 ml,Warehouse C,36,30,2025-02-05 15:56:00,6
27794,ORD_27795,10898,Mioneuron G 300mg/1500mcg Capsule,Warehouse C,49,30,2025-02-05 23:31:00,19
27795,ORD_27796,3548,Nematobus-IR 6mg/400mg Tablet,Warehouse C,44,31,2025-02-05 10:06:00,13
27796,ORD_27797,23921,Lorcin 1mg Tablet,Warehouse B,88,83,2025-02-05 08:02:00,5
27797,ORD_27798,17696,"VIKASGIFTGALLERY EVA Unicorn Owl Print Pencil Case Organizer, Multicolour",Warehouse B,94,82,2025-02-05 05:51:00,12
27798,ORD_27799,29485,TheGiftKart Rugged Carbon Fibre TPU Armor Back Cover Case for Samsung Galaxy M21 / M21 2021 Edition / M30s (Blue),Warehouse B,98,82,2025-02-05 14:03:00,16
27799,ORD_27800,14751,OJ Oval Shape Maroon color Bindi with One Stone Plain Sticker Forehead Bindi Bindiya Traditional Bindis Velvet Bindi With ...,Warehouse B,94,83,2025-02-05 20:11:00,11
27800,ORD_27801,8207,Action Pro™ MADE IN INDIA (6-Month Warranty) Universal 360 Tripod Adapter | Phone Tripod Mount | Cell Phone Holder Mount A...,Warehouse A,40,22,2025-02-05 07:15:00,18
27801,ORD_27802,10762,Glitaz 15mg Tablet,Warehouse C,47,36,2025-02-05 00:52:00,11
27802,ORD_27803,10694,"boAt Stone 260 4W Bluetooth Speaker with Upto 9 Hours Playback, IPX5 and Carabiner(Prism)",Warehouse A,83,66,2025-02-05 22:54:00,17
27803,ORD_27804,3728,"Western Digital WD 1TB My Passport Portable Hard Disk Drive, USB 3.0 with  Automatic Backup, 256 Bit AES Hardware Encrypti...",Warehouse C,85,77,2025-02-05 03:44:00,8
27804,ORD_27805,34499,"Aromacare Pearl Glow Night Cream For All Skin Type, 15g",Warehouse A,57,52,2025-02-05 01:41:00,5
27805,ORD_27806,12358,Glorimet G Forte 2 Tablet,Warehouse A,106,92,2025-02-05 00:43:00,14
27806,ORD_27807,12357,Diatrin Tablets - Controls Sugar Naturally,Warehouse C,39,29,2025-02-05 17:21:00,10
27807,ORD_27808,15186,Ajmal Neutron EDP Citrus Fruity Perfume 100ml for Men and Wisal Dhahab EDP Fruity Floral Perfume 50ml for Men +1 Perfume T...,Warehouse C,64,59,2025-02-05 14:38:00,5
27808,ORD_27809,18037,Zidime CV Dry Syrup,Warehouse B,17,4,2025-02-05 00:52:00,13
27809,ORD_27810,25832,L.A Girl HD PRO Face Pressed Powder Nude Beige 7 gm,Warehouse C,41,32,2025-02-05 13:01:00,9
27810,ORD_27811,15365,The Face Shop Rice Water Bright Foaming Cleanser 150 Ml,Warehouse C,76,67,2025-02-05 12:55:00,9
27811,ORD_27812,34329,Pink/Rosa Beauty Bathing Bar,Warehouse A,31,23,2025-02-05 13:55:00,8
27812,ORD_27813,10626,"BlueRigger Digital Optical Audio Toslink Cable (10 Feet / 3 Meter) With 8 Channel (7.1) Audio Support (for Home Theatre, X...",Warehouse C,118,99,2025-02-05 06:54:00,19
27813,ORD_27814,23955,Oraimo 18W USB & Type-C Dual Output Super Fast Charger Wall Adapter PE2.0&Quick Charge 3.0 & Power Delivery 3.0 Fast Charg...,Warehouse B,23,14,2025-02-05 03:35:00,9
27814,ORD_27815,1344,Geflox 200mg Tablet,Warehouse B,15,8,2025-02-05 08:51:00,7
27815,ORD_27816,25833,"Panasonic Alkaline 9V Battery, Pack of 1",Warehouse A,38,20,2025-02-05 04:28:00,18
27816,ORD_27817,21089,Cefoxy 100mg Tablet DT,Warehouse A,47,34,2025-02-05 05:35:00,13
27817,ORD_27818,34512,Clear Face Care Gel,Warehouse B,71,64,2025-02-05 17:18:00,7
27818,ORD_27819,30490,Azibrik 500mg Tablet,Warehouse C,65,47,2025-02-05 15:42:00,18
27819,ORD_27820,30323,OJ Big Size Maratha Chandrakor Bindi Teeka Marathi Maharashtrian Tilak Tikka Koli Red Color For Womens Girls & Boys Tradit...,Warehouse B,95,77,2025-02-05 17:07:00,18
27820,ORD_27821,25709,Carebiotic Plus Ear Drop,Warehouse B,47,28,2025-02-05 14:41:00,19
27821,ORD_27822,12301,Ajmal Nightingale & Distraction & Magnetize & Persuade Deo & Ascend EDP Pack of 3 20 ml,Warehouse B,54,35,2025-02-05 23:16:00,19
27822,ORD_27823,30314,Fixbase T 250mg/31.25mg Injection,Warehouse B,40,23,2025-02-05 12:14:00,17
27823,ORD_27824,17895,Cisplasure 10mg Injection,Warehouse A,36,31,2025-02-05 13:45:00,5
27824,ORD_27825,10691,"Miss Claire Soft Matte Lip Cream, 51 Orange, 6 g",Warehouse C,56,48,2025-02-05 11:22:00,8
27825,ORD_27826,34526,"Fashion Colour Proffessional Makeup Kit, FC2022 - 02 130.5 gm",Warehouse B,31,24,2025-02-05 01:15:00,7
27826,ORD_27827,1586,MACPLUS Makeup Brush Set With Storage Barrel - Pack of 12 (Black),Warehouse C,73,58,2025-02-05 01:46:00,15
27827,ORD_27828,3722,"Smart Zone Foldable Wooden Laptop Bed Tray Table, Multifunction Lap Tablet Desk with Cup Holder, Perfect for Eating Breakf...",Warehouse B,65,52,2025-02-05 08:59:00,13
27828,ORD_27829,22192,Negesic P Suspension,Warehouse C,98,88,2025-02-05 16:18:00,10
27829,ORD_27830,15231,Ofron 50 Oral Suspension,Warehouse A,62,53,2025-02-05 04:18:00,9
27830,ORD_27831,30443,WIFFY BEST BEAUTY PROFESSIONAL FACE MAKEUP FIXER,Warehouse B,40,31,2025-02-05 08:06:00,9
27831,ORD_27832,10844,"AmazonBasics 80cms (32 inch) HD Ready Smart LED Fire TV with Front Firing Speakers 20W, 2023 Model, Black",Warehouse A,41,26,2025-02-05 07:13:00,15
27832,ORD_27833,4001,"SanDisk Ultra Dual Drive Go USB Type C Pendrive for Mobile, Navy Blue, 32GB, 5Y Warranty",Warehouse C,75,65,2025-02-05 10:21:00,10
27833,ORD_27834,17949,Opicough-N Syrup,Warehouse B,71,59,2025-02-05 11:39:00,12
27834,ORD_27835,17758,Parker Frontier GT Fountain Pen,Warehouse C,21,15,2025-02-05 08:00:00,6
27835,ORD_27836,34867,Hydro Toner,Warehouse B,70,65,2025-02-05 20:12:00,5
27836,ORD_27837,25496,Sri Sri Tattva Amrutadi Vati 500 mg Tablet 60's,Warehouse A,35,26,2025-02-05 05:43:00,9
27837,ORD_27838,18245,ED Save Plus Tablet,Warehouse B,69,50,2025-02-05 01:10:00,19
27838,ORD_27839,29877,Soulflower Orange peppermint Soap for men 150 gm,Warehouse C,81,65,2025-02-05 21:59:00,16
27839,ORD_27840,18242,Dryness Defense Protein Shampoo,Warehouse B,85,72,2025-02-05 06:59:00,13
27840,ORD_27841,34790,"Tacson S10 Mini Portable Wireless Bluetooth Speaker with Smart LED Light, for MP3 Music Player,connectivity SD Card, All S...",Warehouse A,34,17,2025-02-05 05:55:00,17
27841,ORD_27842,14914,Apazine Plus Oral Suspension,Warehouse A,33,24,2025-02-05 12:37:00,9
27842,ORD_27843,29925,Viclob Ointment,Warehouse C,79,60,2025-02-05 19:51:00,19
27843,ORD_27844,29934,Syncwire 20W/30W Charging Type C Cable Compatible with OnePlus Nord CE/ 10 Pro/ 9RT/ 9 Pro/ 9/ 9R/ Nord 2/ Nord/ 8 Pro/ 8...,Warehouse A,96,84,2025-02-05 08:26:00,12
27844,ORD_27845,24184,"O3+ Italian Moor Mud Peel Off Mask Kit with Black and White Algae Mask for Tan Removal, Detoxification and Glow Boosting (...",Warehouse A,19,11,2025-02-05 13:24:00,8
27845,ORD_27846,15557,Zedott 10 DT Tablet,Warehouse C,35,21,2025-02-05 14:00:00,14
27846,ORD_27847,12503,Hlija 3PCS Rear Back Camera Lens Protector Tempered Glass for iPhone 13 Pro/13 Pro Max - HD Clear Full Coverage Guard,Warehouse A,51,41,2025-02-05 21:37:00,10
27847,ORD_27848,17738,Pierre Cardin Paris - Porcelain Edition Rouge Lipstick 241-Medium Brown,Warehouse C,87,79,2025-02-05 12:13:00,8
27848,ORD_27849,23928,Ajmal Blu & Aurum & Evoke silver Edition Homme & Shadow Homme Deo & Yearn EDP Pack of 4 20 ml,Warehouse B,101,91,2025-02-05 22:49:00,10
27849,ORD_27850,10850,TheGiftKart Rugged Carbon Fibre TPU Armor Back Cover Case for Samsung Galaxy M21 / M21 2021 Edition / M30s (Black),Warehouse B,63,58,2025-02-05 05:35:00,5
27850,ORD_27851,22307,L.A. Colors Day to Night 12 Color Eyeshadow - Nightfall 8 gm,Warehouse B,48,41,2025-02-05 08:50:00,7
27851,ORD_27852,10587,Mucoral 2 % Viscous Oral Topical Solution,Warehouse C,47,36,2025-02-05 17:37:00,11
27852,ORD_27853,29977,Restol 650mg Tablet,Warehouse A,95,89,2025-02-05 12:46:00,6
27853,ORD_27854,34258,"Samsung Galaxy A14 5G (Black, 6GB, 128GB Storage) | Triple Rear Camera (50 MP Main) | Upto 12 GB RAM with RAM Plus | Trave...",Warehouse C,13,4,2025-02-05 00:01:00,9
27854,ORD_27855,34778,Ajmal Avid & Blu & Sacrifice II Deo & Neea EDP Pack of 4 20 ml,Warehouse A,17,3,2025-02-05 09:39:00,14
27855,ORD_27856,15395,Cartibest-DN Tablet,Warehouse C,72,53,2025-02-05 21:41:00,19
27856,ORD_27857,17765,Cucumber Sheet Mask,Warehouse B,101,94,2025-02-05 10:00:00,7
27857,ORD_27858,34254,Asoformin P 15mg/500mg Tablet,Warehouse A,70,55,2025-02-05 01:27:00,15
27858,ORD_27859,15406,Rosloy-CV 5mg/75mg Tablet,Warehouse A,113,95,2025-02-05 02:22:00,18
27859,ORD_27860,34231,Betahub 8mg Tablet,Warehouse C,49,40,2025-02-05 12:44:00,9
27860,ORD_27861,34789,Normact,Warehouse C,46,29,2025-02-05 02:33:00,17
27861,ORD_27862,10841,Vivatin MH Cream,Warehouse A,82,67,2025-02-05 21:31:00,15
27862,ORD_27863,10845,Vega Flat Brush (R4 - FBS) 60 gm,Warehouse B,38,22,2025-02-05 22:12:00,16
27863,ORD_27864,34229,Levotis M 5mg/10mg Tablet,Warehouse B,34,17,2025-02-05 08:05:00,17
27864,ORD_27865,25620,Recefix AZ 200mg/250mg Tablet,Warehouse C,10,1,2025-02-05 04:30:00,9
27865,ORD_27866,21168,Silzo 1% Dusting Powder,Warehouse B,99,84,2025-02-05 21:06:00,15
27866,ORD_27867,10730,Acfeo TH 100mg/4mg Tablet,Warehouse B,8,3,2025-02-05 07:22:00,5
27867,ORD_27868,15129,Beauty People Matte Lucious Liquid Lip Colorsubtle - Red - L28 ,Warehouse C,106,92,2025-02-05 21:04:00,14
27868,ORD_27869,10802,Itel 50mg Tablet,Warehouse B,69,62,2025-02-05 00:56:00,7
27869,ORD_27870,15324,Zoxotrox TZ 250mg/31.25mg Injection,Warehouse A,32,14,2025-02-05 21:59:00,18
27870,ORD_27871,17866,TheGiftKart Rugged Carbon Fibre TPU Armor Back Cover Case for OnePlus 7T (Blue),Warehouse C,99,81,2025-02-05 10:19:00,18
27871,ORD_27872,34353,"Amazon Basics High Speed HDMI Cable (Gold-Plated, A Male to A Male) - Supports 4K @60Hz and Audio Return (3 Feet)",Warehouse B,28,20,2025-02-05 23:51:00,8
27872,ORD_27873,18065,Moxycon 125mg Dry Syrup,Warehouse B,103,98,2025-02-05 22:02:00,5
27873,ORD_27874,15137,Lamictin 100mg Tablet DT,Warehouse B,28,19,2025-02-05 22:25:00,9
27874,ORD_27875,30165,HSR Car Accessories Multifunction Phone GPS Holder Anti-Slip Silicone Pad and Car Mobile Holders for Car Dashboard,Warehouse B,59,48,2025-02-05 09:37:00,11
27875,ORD_27876,34374,Vaypod CV 200mg/125mg Tablet,Warehouse B,106,91,2025-02-05 02:57:00,15
27876,ORD_27877,8301,Quantum RJ45 Ethernet Patch/LAN Cable with Gold Plated Connectors Supports Upto 1000Mbps -5.9Feet (1.8 Meters) - (White),Warehouse A,107,90,2025-02-05 02:39:00,17
27877,ORD_27878,8947,Clapbox Cajon Bag with Carry Handle and Shoulder Straps Universal Size,Warehouse B,42,30,2025-02-05 20:58:00,12
27878,ORD_27879,17891,Telca Premium Case Cover Compatible With boAt Airdopes 141 / 148 ONLY SILICON COVER,Warehouse A,91,77,2025-02-05 21:59:00,14
27879,ORD_27880,3691,"Wet n Wild Eyeshadow & Liquid Lipstick Combo (Comfort Zone, Rebel Rose), Multicolor, 2 Pieces Matte Finish",Warehouse A,26,20,2025-02-05 23:08:00,6
27880,ORD_27881,22235,Ajmal Asher Concentrated Perfume Oil Oriental Attar And Jannatul Firdaus Concentrated Perfume Oil Oriental Attar 22 ml,Warehouse C,44,32,2025-02-05 21:55:00,12
27881,ORD_27882,17855,AmazonBasics 8-Feet Digital Audio Coaxial Cable for DVD Player (Black & Orange),Warehouse B,101,86,2025-02-05 07:41:00,15
27882,ORD_27883,18079,IG-Pod-O Tablet,Warehouse A,58,46,2025-02-05 19:08:00,12
27883,ORD_27884,30239,Silphex 500mg Capsule,Warehouse A,85,70,2025-02-05 00:39:00,15
27884,ORD_27885,21057,The Skin Story Face Scrub - Moringa 100 gm,Warehouse C,53,43,2025-02-05 21:45:00,10
27885,ORD_27886,34579,TheGiftKart Ultra-Hybrid Crystal Clear Back Cover Case for Samsung Galaxy S23 5G | 360 Degree Protection | Shockproof Desi...,Warehouse A,96,79,2025-02-05 07:52:00,17
27886,ORD_27887,24130,Insight Cosmetics Non Transfer Matte Lipstick - Craving 4.2 gm,Warehouse A,72,62,2025-02-05 14:20:00,10
27887,ORD_27888,29861,Mouzym Tablet,Warehouse B,24,8,2025-02-05 07:45:00,16
27888,ORD_27889,21245,Lakme 9 To 5 Eye Color Quartet Eye Shadow Smokey Glam 7 Gm,Warehouse B,93,82,2025-02-05 19:34:00,11
27889,ORD_27890,10870,"Noise Beads Bluetooth Truly Wireless in Ear Earbuds with 18 Hours of Playtime, Metallic Finish, Hypersync, Full Touch Cont...",Warehouse C,50,45,2025-02-05 13:26:00,5
27890,ORD_27891,4238,XPG ADATA GAMMIX D30 DDR4 16GB (1x16GB) 3200MHz U-DIMM Desktop Memory - AX4U3200316G16A-SR30,Warehouse C,90,85,2025-02-05 16:26:00,5
27891,ORD_27892,2107,"Gift Set - SG + EDT + Deo, Blue 8",Warehouse B,80,65,2025-02-05 00:48:00,15
27892,ORD_27893,20848,"Hollister Wave 2 for Him Eau De Toilette, 100ml",Warehouse C,40,29,2025-02-05 23:37:00,11
27893,ORD_27894,24105,Q Ciprox 500mg Tablet,Warehouse A,58,51,2025-02-05 16:20:00,7
27894,ORD_27895,3898,"Redmi 10A (Sea Blue, 4GB RAM, 64GB Storage) | 2 Ghz Octa Core Helio G25 | 5000 mAh Battery | Finger Print Sensor | Upto 5G...",Warehouse C,36,25,2025-02-05 07:46:00,11
27895,ORD_27896,35095,BEAUTRISTRO 2 IN 1 Back Body Bath Brush with Bristles and Loofah Back Scrubber with Curved Long Handled for Skin Exfoliati...,Warehouse C,17,6,2025-02-05 15:23:00,11
27896,ORD_27897,3896,"Redmi Note 10S (Deep Sea Blue, 6GB RAM, 64GB Storage) - Super Amoled Display | 64 MP Quad Camera | 6 Month Free Screen Rep...",Warehouse C,88,78,2025-02-05 13:29:00,10
27897,ORD_27898,15356,Batiste Dry Hair Shampoo - Clean & Classic Original 50 ml + Floral & Flirty Blush 50 ml,Warehouse C,53,37,2025-02-05 11:26:00,16
27898,ORD_27899,30166,Noir Tobacco Vanilla Aftershave,Warehouse B,33,17,2025-02-05 00:57:00,16
27899,ORD_27900,30446,Sony Bravia 164 cm (65 inches) 4K Ultra HD Smart LED Google TV KD-65X74K (Black),Warehouse A,69,51,2025-02-05 05:43:00,18
27900,ORD_27901,30370,"ESR Pencil Case Compatible with iPad 10th Generation (2022, 10.9 inch), Built-in Pencil Holder, Flexible Back Cover, Trifo...",Warehouse C,49,35,2025-02-05 10:46:00,14
27901,ORD_27902,17966,Piodin 10 Ointment,Warehouse A,28,13,2025-02-05 21:05:00,15
27902,ORD_27903,1551,Up Or Down Eau De Toilette - For Man,Warehouse A,28,11,2025-02-05 03:45:00,17
27903,ORD_27904,17932,Fitbit Versa 4 Fitness Watch (Black / Graphite Aluminium) with 6-Month Premium Membership,Warehouse B,43,29,2025-02-05 03:17:00,14
27904,ORD_27905,30394,Reequil Atorep Barrier Cream For Atopic Skin 50 gm,Warehouse C,23,10,2025-02-05 17:16:00,13
27905,ORD_27906,30465,Nordec 25mg Injection,Warehouse B,82,70,2025-02-05 11:47:00,12
27906,ORD_27907,10754,Rosact A Gold 75mg/10mg/75mg Capsule,Warehouse A,45,30,2025-02-05 10:22:00,15
27907,ORD_27908,1582,Incense Man Deodorant,Warehouse A,58,41,2025-02-05 08:12:00,17
27908,ORD_27909,17997,Capipan 40mg Injection,Warehouse A,44,39,2025-02-05 01:21:00,5
27909,ORD_27910,34376,Lakme 9To5 Weightless Mousse Foundation Nude Brown 25 Gm,Warehouse B,81,74,2025-02-05 00:56:00,7
27910,ORD_27911,18049,Oltop 2.5 Tablet MD,Warehouse A,108,95,2025-02-05 14:20:00,13
27911,ORD_27912,15095,"HP w300 1080P 30 FPS FHD Webcam with Built-in Dual Digital Mic, Plug and Play Setup, Wide-Angle View for Video Calling on ...",Warehouse B,54,42,2025-02-05 00:13:00,12
27912,ORD_27913,17963,"Revolution Pro New Neutrals Blushed Eyeshadow Palette, Matte & Shimmery Finish, Blushed, 18g (Multicolor)",Warehouse B,109,92,2025-02-05 09:06:00,17
27913,ORD_27914,18124,Amlozaar Tablet,Warehouse C,74,57,2025-02-05 08:35:00,17
27914,ORD_27915,34334,Dauneon 20mg Injection,Warehouse B,64,52,2025-02-05 00:27:00,12
27915,ORD_27916,24019,Toppik Hairline Optimizer,Warehouse C,107,92,2025-02-05 19:16:00,15
27916,ORD_27917,12402,"FlorecerGlycerine for Face |100% Pure & Natural Glycerine liquid for face, Beauty and Skin Care | Pure & Unscented Glyceri...",Warehouse C,108,98,2025-02-05 20:30:00,10
27917,ORD_27918,24021,Astelong 10mg Tablet,Warehouse B,108,99,2025-02-05 01:29:00,9
27918,ORD_27919,34616,Fragrance Body Spray For Men (1000 sprays) - Status,Warehouse B,97,91,2025-02-05 16:31:00,6
27919,ORD_27920,3684,Mancode 2 in 1 Beard Wash and conditioner 200 ml,Warehouse A,47,31,2025-02-05 01:24:00,16
27920,ORD_27921,1461,Plum Grape Seed & Sea Buckthorn Mild Foam Scrub 75 ml,Warehouse A,102,90,2025-02-05 11:12:00,12
27921,ORD_27922,34435,Zofer 8mg Injection,Warehouse C,45,26,2025-02-05 23:42:00,19
27922,ORD_27923,21051,Login 2mg Tablet,Warehouse B,78,64,2025-02-05 14:07:00,14
27923,ORD_27924,34341,Lysoflam Tablet,Warehouse A,45,26,2025-02-05 21:11:00,19
27924,ORD_27925,30187,Levodius 500mg Tablet,Warehouse C,99,87,2025-02-05 20:56:00,12
27925,ORD_27926,24041,Karidip MR 250mg/50mg/325mg Tablet,Warehouse A,101,93,2025-02-05 04:24:00,8
27926,ORD_27927,24136,Olkem-Beta 50 Tablet ER,Warehouse C,57,43,2025-02-05 11:35:00,14
27927,ORD_27928,1624,Serose-DP Tablet,Warehouse B,68,55,2025-02-05 21:21:00,13
27928,ORD_27929,35984,Cheryl's Cosmeceuticals O2C2 Radiance Lotion - Face Cream - For All Skin Type,Warehouse A,99,83,2025-02-04 12:11:00,16
27929,ORD_27930,35983,Clomight Cream,Warehouse B,38,24,2025-02-04 20:16:00,14
27930,ORD_27931,4801,Lavender Pure Essential Oil,Warehouse C,112,95,2025-02-04 07:17:00,17
27931,ORD_27932,19086,Fexomax M 10mg/120mg Tablet,Warehouse C,64,56,2025-02-04 20:30:00,8
27932,ORD_27933,10041,"Hoteon 2500W Extension Board with USB Slots, Individual Switch & Safety Shutter, 4 USB Ports(3.4A) 4 Way Outlets Power Str...",Warehouse C,102,88,2025-02-04 12:00:00,14
27933,ORD_27934,35902,Cianfit LB 200mg Tablet,Warehouse B,104,91,2025-02-04 23:08:00,13
27934,ORD_27935,19103,"Makeup Revolution 125 Matte Lipstick, Fling, 3 ml",Warehouse C,78,62,2025-02-04 03:47:00,16
27935,ORD_27936,10033,Spigen Liquid Crystal Back Cover Case for iPhone 14 Plus (TPU | Crystal Clear),Warehouse A,20,8,2025-02-04 07:01:00,12
27936,ORD_27937,19084,"Fashion Colour Kiss Lip No Transfer Lipstick, 20 Sunny Orange 2.6 gm",Warehouse B,84,75,2025-02-04 10:44:00,9
27937,ORD_27938,26339,Maxi Sanitary Napkin - Large,Warehouse B,71,65,2025-02-04 19:05:00,6
27938,ORD_27939,19044,Cefospas Tablet,Warehouse A,40,23,2025-02-04 03:15:00,17
27939,ORD_27940,26337,Fzin 5mg Tablet,Warehouse A,87,75,2025-02-04 12:29:00,12
27940,ORD_27941,20597,Ajmal 3 Distraction & 1 Persuade Deodorant Pack of 4 Deodorant 200 ml,Warehouse B,46,40,2025-02-04 04:42:00,6
27941,ORD_27942,27715,"TheGiftKart Back Cover for Poco X3 PRO/Poco X3 (Polycarbonate, TPU/Black)",Warehouse B,23,15,2025-02-04 13:33:00,8
27942,ORD_27943,28599,Hydrating Seaweed Pack,Warehouse A,53,40,2025-02-04 20:13:00,13
27943,ORD_27944,9197,Diclodyne 1% Gel,Warehouse B,93,81,2025-02-04 04:54:00,12
27944,ORD_27945,10095,Condoms - Air,Warehouse A,42,36,2025-02-04 20:33:00,6
27945,ORD_27946,4744,"Ant Esports GM700 Lightweight Wireless RGB Gaming Mouse, Rechargeable with Honeycomb Shell,11 Led Light Modes, 4 Adjustabl...",Warehouse B,45,35,2025-02-04 05:23:00,10
27946,ORD_27947,22779,FUR JADEN 15.6 Anti Theft Laptop Backpack with USB Charging Port Unisex Bag for College Office Suitable for Men Women,Warehouse A,24,10,2025-02-04 20:57:00,14
27947,ORD_27948,19043,"ZEBRONICS Zeb-Buds 30 3.5mm Stereo Wired in Ear Earphone with Microphone for Calling, Volume Control, 14mm Drivers, Stylis...",Warehouse C,95,79,2025-02-04 04:41:00,16
27948,ORD_27949,8064,Redgear MP80 Speed-Type Gaming Mousepad (Black/Red),Warehouse C,21,6,2025-02-04 00:54:00,15
27949,ORD_27950,35922,Cyprogen 4mg Tablet,Warehouse C,100,94,2025-02-04 17:44:00,6
27950,ORD_27951,35936,"Nokia C12 Android 12 (Go Edition) Smartphone, All-Day Battery, 4GB RAM (2GB RAM + 2GB Virtual RAM) + 64GB Capacity | Dark ...",Warehouse C,74,55,2025-02-04 20:43:00,19
27951,ORD_27952,20386,Cilbest 5mg Tablet,Warehouse A,75,58,2025-02-04 02:45:00,17
27952,ORD_27953,26357,"Garnier Skin Naturals, Eye Mask, Hydrating & Revitalising, Hydra Bomb Eye Serum Mask, 1 pc, 6g",Warehouse C,47,35,2025-02-04 09:28:00,12
27953,ORD_27954,19579,Sytrix 1000mg Injection,Warehouse B,34,25,2025-02-04 13:41:00,9
27954,ORD_27955,13775,SB Sox 20mg Tablet,Warehouse A,43,26,2025-02-04 01:33:00,17
27955,ORD_27956,28573,Lonate 5gm Injection,Warehouse C,19,5,2025-02-04 01:49:00,14
27956,ORD_27957,9821,Zentra 100mg Injection,Warehouse B,82,68,2025-02-04 01:20:00,14
27957,ORD_27958,695,N150 Man Blue Wave Eau De Toilette,Warehouse B,83,69,2025-02-04 11:23:00,14
27958,ORD_27959,36265,Toripil 90mg Tablet,Warehouse B,45,35,2025-02-04 07:53:00,10
27959,ORD_27960,7668,Zarmet-GMP2 Tablet SR,Warehouse A,27,9,2025-02-04 16:08:00,18
27960,ORD_27961,28084,"Nokia G21 Android Smartphone, Dual SIM, 3-Day Battery Life, 6GB RAM + 128GB Storage, 50MP Triple AI Camera | Nordic Blue",Warehouse B,101,82,2025-02-04 04:33:00,19
27961,ORD_27962,13853,"Fire-Boltt Ninja Calling 1.69"" (4.29cm) Bluetooth Calling smartwatch with Voice Assistant, Metal Body 200 Watch Faces, Mul...",Warehouse C,24,10,2025-02-04 10:01:00,14
27962,ORD_27963,19332,Ajmal Evoke silverhim Aurum Deodorants (Pack of 2) 200 ml,Warehouse B,24,8,2025-02-04 11:47:00,16
27963,ORD_27964,7657,AND Ethereal Dreamer EDP & Serene Bliss Body Mist Pack of 2 250 ml,Warehouse A,69,57,2025-02-04 20:23:00,12
27964,ORD_27965,7658,Voltaflam Gel,Warehouse C,79,66,2025-02-04 15:15:00,13
27965,ORD_27966,13847,Deborah Milano Eyeshadow&Kajal Pencil - 09 Pearly Gold 2 gm,Warehouse B,64,48,2025-02-04 07:49:00,16
27966,ORD_27967,19351,(Renewed) boAt Rockerz 550 Bluetooth Over-Ear Wireless Headphone with Ergonomic Aesthetics Plush Padded Earcups Immersive ...,Warehouse B,15,8,2025-02-04 03:49:00,7
27967,ORD_27968,490,Paroxysm Spy Pen Hidden Mini Camera with Audio/Video Recorder 32GB Supportable Multifunction Home Security Rechargeable Bu...,Warehouse C,82,74,2025-02-04 21:24:00,8
27968,ORD_27969,5032,"Redmi 20000mAh Power Bank, USB Type C, Micro USB Ports, Dual USB Output, 18W Fast Charging, Low Power Mode, (White)",Warehouse A,74,67,2025-02-04 01:13:00,7
27969,ORD_27970,26601,Chandan Kesar Haldi Face Pack,Warehouse A,40,34,2025-02-04 20:08:00,6
27970,ORD_27971,7667,Mupimesh Ointment,Warehouse C,79,66,2025-02-04 03:42:00,13
27971,ORD_27972,23349,Pimacid 40mg Tablet,Warehouse B,64,46,2025-02-04 05:32:00,18
27972,ORD_27973,483,Fulor 150 Tablet,Warehouse B,32,14,2025-02-04 13:57:00,18
27973,ORD_27974,26355,Clean-Tear Eye Drop,Warehouse C,35,19,2025-02-04 09:30:00,16
27974,ORD_27975,9882,Apple Watch SE (2nd Gen) GPS 44mm Midnight Aluminium Case with Midnight Sport Band - Regular,Warehouse B,79,73,2025-02-04 21:25:00,6
27975,ORD_27976,7690,Jaidol-TP Tablet,Warehouse B,66,55,2025-02-04 03:38:00,11
27976,ORD_27977,36377,L.A Girl Lip Gloss Shimmer Grapefruit (Shimmery),Warehouse B,54,47,2025-02-04 10:46:00,7
27977,ORD_27978,19233,Mefvin P Oral Suspension,Warehouse C,95,89,2025-02-04 02:38:00,6
27978,ORD_27979,28256,OpenTech® Tempered Glass Screen Protector Compatible for iPhone SE 2 / iPhone SE 2020 Edge to Edge Coverage with Easy Inst...,Warehouse A,107,99,2025-02-04 12:39:00,8
27979,ORD_27980,344,Eyevir Eye Ointment,Warehouse B,41,29,2025-02-04 22:21:00,12
27980,ORD_27981,5916,Hire hair band for women & girls hair ties rubber band for hair ponytail holder thick soft no break no damage for all type...,Warehouse C,75,56,2025-02-04 19:06:00,19
27981,ORD_27982,35950,"Loofah/Sponge Scrubber/Body Bath  - Black, BH-020 BLK",Warehouse A,113,99,2025-02-04 00:04:00,14
27982,ORD_27983,36461,Seven Seas Light weight | Concealer with Full Coverage | Easily Blendable Concealer for face makeup (Nude),Warehouse A,98,86,2025-02-04 04:51:00,12
27983,ORD_27984,19053,"Motorola a70 keypad Mobile Dual Sim with Expandable Memory Upto 32GB,Camera, 2.4 inch Screen with 1750 mAh Battery, Dark Blue",Warehouse C,29,17,2025-02-04 14:16:00,12
27984,ORD_27985,10057,Deep Pore Cleansing & Brightening Haldi & Tulsi Face Wash 100 Ml,Warehouse A,101,82,2025-02-04 00:54:00,19
27985,ORD_27986,27745,Arirazo 5mg Tablet MD,Warehouse B,102,88,2025-02-04 00:42:00,14
27986,ORD_27987,357,Ajmal 2 Persuade And 1 Evoke Silver Edition For Him Deodorants Pack of 3 200 ml,Warehouse C,82,71,2025-02-04 08:03:00,11
27987,ORD_27988,13141,Vega Shampoo Comb (DC - 1268H) 53 gm,Warehouse A,45,32,2025-02-04 22:28:00,13
27988,ORD_27989,19162,Hexiflu T 10mg/2mg Tablet,Warehouse B,40,34,2025-02-04 06:21:00,6
27989,ORD_27990,5985,Cucumber Cell Rejuvenating Moisturising Gel,Warehouse A,20,8,2025-02-04 22:08:00,12
27990,ORD_27991,5201,Beauty People Metallic Glitter Eyeliner Green Mile 1's,Warehouse A,97,87,2025-02-04 08:02:00,10
27991,ORD_27992,18214,Ofcia 200mg Tablet,Warehouse B,27,14,2025-02-04 00:04:00,13
27992,ORD_27993,14936,Fashion Colour Gold Serum 30 ml,Warehouse A,69,62,2025-02-04 15:24:00,7
27993,ORD_27994,36775,Lefumax 20mg Tablet,Warehouse A,53,34,2025-02-04 20:06:00,19
27994,ORD_27995,1018,Beclin 100mg Tablet,Warehouse A,62,52,2025-02-04 22:19:00,10
27995,ORD_27996,36774,"HAMMONDS FLYCATCHER Genuine Leather Laptop Bag for Men/Office Bag for Men, Brown | Fits Upto 16 Inch Laptop/MacBook | Leat...",Warehouse A,18,10,2025-02-04 19:10:00,8
27996,ORD_27997,28340,Vortica 5mg Tablet,Warehouse A,43,37,2025-02-04 14:00:00,6
27997,ORD_27998,8054,Divine Nutritive Hydrating Lotion SPF 20,Warehouse A,34,23,2025-02-04 23:43:00,11
27998,ORD_27999,14101,AmazonBasics AAAA Everyday Alkaline Batteries (4-Pack) - Appearance May Vary,Warehouse B,25,16,2025-02-04 07:55:00,9
27999,ORD_28000,28349,Omilive 20 Capsule,Warehouse B,40,27,2025-02-04 08:00:00,13
28000,ORD_28001,28358,Blonaser 2 Tablet,Warehouse C,105,97,2025-02-04 17:26:00,8
28001,ORD_28002,13798,"ZEBRONICS Zeb-Envy Bluetooth Wireless Over Ear Headphones with Mic with 33 hrs Playback time, Voice Assistant, with Detach...",Warehouse C,78,59,2025-02-04 17:46:00,19
28002,ORD_28003,9757,"Gizga Essentials Earphone Earpod Cleaning Pen, AirPod, Earbuds, Headphones, Wireless Earphones, 3-in-1 Multifunctional Cle...",Warehouse A,41,26,2025-02-04 23:06:00,15
28003,ORD_28004,6251,"Toothpaste - Active Salt Saver Pack, Salt & Minerals",Warehouse A,15,3,2025-02-04 15:34:00,12
28004,ORD_28005,29965,"Samsung Galaxy A33 5G (Light Blue, 8GB RAM, 128GB Storage) | 48 MP No Shake Cam | Voice Focus | 16 GB RAM with RAM Plus | ...",Warehouse A,41,34,2025-02-04 08:43:00,7
28005,ORD_28006,12493,Verfate-OX Oral Suspension,Warehouse A,30,17,2025-02-04 15:50:00,13
28006,ORD_28007,12494,"Vita Glow Advanced Skin Whitening Cream 30g, Made In Tibet",Warehouse B,100,89,2025-02-04 16:48:00,11
28007,ORD_28008,3997,"Fashion Colour Jersy Girl Kiss Proof No Transfer Lipstick, 12 Deep Berries 2 gm",Warehouse A,97,88,2025-02-04 07:36:00,9
28008,ORD_28009,18225,"HIFFIN 3-Way Monopod Grip Arm Tripod Foldable Selfie Stick, Stabilizer Mount Holder for GoPro Hero 9/8/7/6/5, SJCAM SJ6, S...",Warehouse C,91,77,2025-02-04 11:40:00,14
28009,ORD_28010,8247,NV Prime Car/Bike Waterproof NXT GEN GPS Tracker with 5 Years Warranty,Warehouse C,116,97,2025-02-04 08:33:00,19
28010,ORD_28011,10569,Rabdose-LS Capsule SR,Warehouse A,26,15,2025-02-04 18:13:00,11
28011,ORD_28012,88,Laz AX 500 mg/60 mg Tablet,Warehouse A,97,83,2025-02-04 21:38:00,14
28012,ORD_28013,13295,Envie Beetle Charger with Envie 4xAA Ni-Cd 1000 Mah Batteries,Warehouse C,71,61,2025-02-04 22:14:00,10
28013,ORD_28014,34844,Panbery 40 Tablet,Warehouse A,56,42,2025-02-04 12:15:00,14
28014,ORD_28015,19424,"Fashion Colour Kiss Lip No Transfer Lipstick, 34 Rose Carmine 2.6 gm",Warehouse C,91,85,2025-02-04 07:20:00,6
28015,ORD_28016,36933,Derma Care Cracked Foot Repair Cream,Warehouse B,32,17,2025-02-04 16:41:00,15
28016,ORD_28017,14909,Special Bathing Brush No 25,Warehouse B,23,18,2025-02-04 03:03:00,5
28017,ORD_28018,27766,Neurovin NG 300mg/10mg Tablet,Warehouse B,117,98,2025-02-04 03:42:00,19
28018,ORD_28019,651,Amigozz Pocket Size Spiral Sticky Note Pad,Warehouse A,32,16,2025-02-04 19:52:00,16
28019,ORD_28020,28404,Colorbar Lux Nail Lacquer Cbn1356 12 Ml,Warehouse C,37,18,2025-02-04 21:25:00,19
28020,ORD_28021,36110,"Redgear Shadow Vox Gaming Auxiliary, USB Unidirectional Microphone with RGB Lighting, Adjustable Tripod and Echo & Gain Co...",Warehouse A,49,37,2025-02-04 17:27:00,12
28021,ORD_28022,678,Skin Lotion - Lightening,Warehouse B,17,1,2025-02-04 04:35:00,16
28022,ORD_28023,4817,"Amazfit Bip U Smart Watch, SpO2 & Stress Monitor, 3.63 cm(1.43"") HD Color Display, 60+ Sports Modes, Breathing Training, 5...",Warehouse C,89,83,2025-02-04 02:42:00,6
28023,ORD_28024,5817,Zarkan Stone Tilak Style Bindi (Multicolour) -Box of 12 Pieces,Warehouse B,35,27,2025-02-04 11:35:00,8
28024,ORD_28025,26421,TheGiftKart Shockproof Crystal Clear Back Cover Case for OnePlus 9 5G | 360 Degree Protection | Protective Design | Transp...,Warehouse A,40,31,2025-02-04 20:26:00,9
28025,ORD_28026,20564,POPIO Tempered Glass Screen Protector Compatible for Redmi Note 11T 5G / Xiaomi Poco M4 Pro 5G (Black) with Edge to Edge C...,Warehouse C,83,77,2025-02-04 06:40:00,6
28026,ORD_28027,5933,Paracip 500 Tablet,Warehouse C,29,23,2025-02-04 13:16:00,6
28027,ORD_28028,26642,Ajmal 2 Magnetize & Persuade Deodorant Pack of 3 Deodorants 200 ml,Warehouse A,81,76,2025-02-04 06:23:00,5
28028,ORD_28029,7628,Podinour 100 Oral Suspension,Warehouse A,26,16,2025-02-04 15:41:00,10
28029,ORD_28030,19213,"Girls Choice TYA 6155 Multicolour Makeup Kit and 7 Black Makeup Brushes Set, 3in1 Eyeliner,Mascara,Eyebrow Pencil with 2 P...",Warehouse B,56,46,2025-02-04 17:10:00,10
28030,ORD_28031,26446,TNW-The Natural Wash Black Seed Hair Serum for Frizzy & Unmanageable Hair Gives Smooth Silky Touch & Instant Shine And Sof...,Warehouse C,49,36,2025-02-04 03:23:00,13
28031,ORD_28032,27800,OnePlus 80 cm (32 inches) Y Series HD Ready LED Smart Android TV 32Y1 (Black),Warehouse B,42,26,2025-02-04 17:22:00,16
28032,ORD_28033,4910,NEW Superdrug Shea Butter Face Mask 10 ml,Warehouse A,51,36,2025-02-04 11:50:00,15
28033,ORD_28034,9325,Hair Removal Cream For Men - Normal Skin,Warehouse A,93,88,2025-02-04 21:41:00,5
28034,ORD_28035,27806,Maybelline Lip Crayon Hustle in Heels (Matte),Warehouse B,68,56,2025-02-04 07:20:00,12
28035,ORD_28036,5919,"Menstrual Cup - Size Large, Above 25 Years of age or after Childbirth",Warehouse A,104,98,2025-02-04 12:27:00,6
28036,ORD_28037,26386,"Ceptics 200W Car Laptop Charger/Power Inverter with Digital Display and SmartVoltage™ Technology - 12V DC to 220V AC, 9.6A...",Warehouse C,98,80,2025-02-04 19:08:00,18
28037,ORD_28038,595,Ajmal Neutron EDP Citrus Fruity Perfume 100ml for Men and Raindrops EDP Floral Chypre Perfume 50ml for Women +1 Perfume Te...,Warehouse C,29,17,2025-02-04 07:48:00,12
28038,ORD_28039,23399,TAGG Verve NEO Smartwatch 1.69’’ HD Display | 60+ Sports Modes | 10 Days Battery | 150+ Maximum Watch Face Library | Water...,Warehouse A,37,24,2025-02-04 23:55:00,13
28039,ORD_28040,12988,Carrot Farieness Facial Sheet Mask EX,Warehouse C,37,24,2025-02-04 13:21:00,13
28040,ORD_28041,28271,Orange Essential Oil,Warehouse B,80,63,2025-02-04 20:41:00,17
28041,ORD_28042,392,"Toothbrush - 360 Degree Flosstip, Medium Bristles",Warehouse A,34,21,2025-02-04 03:38:00,13
28042,ORD_28043,28332,Organic Brahmi,Warehouse C,113,95,2025-02-04 06:20:00,18
28043,ORD_28044,23444,Nutriment Vitamin C Scrub All Skin Type 250 gm,Warehouse C,110,92,2025-02-04 09:01:00,18
28044,ORD_28045,19168,Revitalift Moisturizing Day Cream SPF 23 PA++,Warehouse B,62,45,2025-02-04 04:53:00,17
28045,ORD_28046,672,Esnofil 150mg Tablet,Warehouse B,113,98,2025-02-04 14:08:00,15
28046,ORD_28047,19138,SupCares Edge to Edge Tempered Glass for Samsung Galaxy M53 and Galaxy M52 (6.7 Inch) with Easy Self Installation Kit | Black,Warehouse A,50,38,2025-02-04 04:56:00,12
28047,ORD_28048,19149,Labgest 100mg Injection,Warehouse A,47,42,2025-02-04 19:32:00,5
28048,ORD_28049,19152,Antiseptic Liquid 550 ml + Laundry Sanitizer- Fresh Linen 480 ml,Warehouse C,14,3,2025-02-04 12:51:00,11
28049,ORD_28050,36452,Cello Papersoft Ball Pens | Pack of 10 | Blue Ball Pens | Smooth Ball Pens | Long-lasting ball pens | Professional Ball pe...,Warehouse B,59,46,2025-02-04 04:59:00,13
28050,ORD_28051,13920,Reynolds 045 25CT JAR BLUE Ball Pen I Lightweight Ball Pen With Comfortable Grip for Extra Smooth Writing I School and Off...,Warehouse A,78,72,2025-02-04 14:20:00,6
28051,ORD_28052,978,Novflox 200 Tablet,Warehouse B,78,59,2025-02-04 04:48:00,19
28052,ORD_28053,5104,"Foot Pumice Paddle - Milky White, Colour May Vary",Warehouse A,80,73,2025-02-04 19:12:00,7
28053,ORD_28054,7467,Stbotanica Go Long Onion Hair Mask 200 ml,Warehouse B,51,44,2025-02-04 17:17:00,7
28054,ORD_28055,4481,Clavifast Dry Syrup,Warehouse A,22,7,2025-02-04 16:59:00,15
28055,ORD_28056,18690,"Quartet ReWritables Mini Dry-Erase Whiteboard Markers, Fine Tip, Assorted Ink Colours, Whiteboard Non-Permanent Markers wi...",Warehouse B,61,42,2025-02-04 03:04:00,19
28056,ORD_28057,7470,Erozol 200 Capsule,Warehouse A,30,13,2025-02-04 07:58:00,17
28057,ORD_28058,12751,Thionoxide 4mg Capsule,Warehouse A,96,77,2025-02-04 15:52:00,19
28058,ORD_28059,29055,Ifaze 100mg Capsule,Warehouse B,104,96,2025-02-04 12:56:00,8
28059,ORD_28060,23675,Ajmal Distraction And Magnetize For Men & Women And Shadow Him Deodorants Pack of 3 200 ml,Warehouse A,58,43,2025-02-04 05:57:00,15
28060,ORD_28061,5330,Keto 4S Cream,Warehouse B,103,89,2025-02-04 14:40:00,14
28061,ORD_28062,5328,"BLAXSTOC DC-787 Foldable Mobile Tabletop Stand Adjustable Phone Holder and iPad Stand & For Bed , Table, Office, Video Rec...",Warehouse C,68,55,2025-02-04 18:56:00,13
28062,ORD_28063,18722,"Portronics CarPower Mini Car Charger with Dual Output, Fast Charging (Type C PD 18W + QC 3.0A) Compatible with All Smartph...",Warehouse B,45,39,2025-02-04 04:42:00,6
28063,ORD_28064,12763,Total Moisture - Cocoa Glow (24 hr Nourishing Lotion),Warehouse C,73,58,2025-02-04 07:49:00,15
28064,ORD_28065,22555,Methywell Tablet,Warehouse B,59,44,2025-02-04 19:32:00,15
28065,ORD_28066,20737,The Face Shop Rice Water Bright Light Cleansing Oil 150 Ml,Warehouse B,60,52,2025-02-04 16:52:00,8
28066,ORD_28067,29163,"Fire-Boltt Ninja 3 Smartwatch Full Touch 1.69 & 60 Sports Modes with IP68, Sp02 Tracking, Over 100 Cloud based watch faces...",Warehouse A,54,39,2025-02-04 01:04:00,15
28067,ORD_28068,4478,Onsitego 1 Year Extended Warranty for Small Electric Appliances from Rs. 10001-12500 (Email Delivery - No Physical Kit),Warehouse C,66,53,2025-02-04 08:00:00,13
28068,ORD_28069,27497,Neelibringadi Oil,Warehouse B,45,27,2025-02-04 14:33:00,18
28069,ORD_28070,10301,Rabenis 20mg Tablet,Warehouse C,42,28,2025-02-04 23:37:00,14
28070,ORD_28071,35431,"Amazon Brand - Solimo Silicone, Thermoplastic Polyurethane Anti Dust Plug Mobile Cover Soft and Flexible Back Cover for On...",Warehouse C,78,68,2025-02-04 22:55:00,10
28071,ORD_28072,19826,Asdon 4mg Tablet,Warehouse A,65,46,2025-02-04 23:53:00,19
28072,ORD_28073,22837,"Disposable Face Mask - Melt Blown, 3 Ply",Warehouse B,61,50,2025-02-04 20:06:00,11
28073,ORD_28074,19810,Kabello Front Hair Extension/Invisible Cover Up Patch 6.5 X 3.5 Inches (Brown 2 Pcs),Warehouse B,59,45,2025-02-04 16:09:00,14
28074,ORD_28075,23159,"Make Up For Life Rouge Ambrance Enduring Lipstick-05, Petals Pink, 3 g",Warehouse C,80,68,2025-02-04 06:40:00,12
28075,ORD_28076,10288,"Faber-Castell Synthetic Hair Flat Assorted Paint Brush, Set of 4",Warehouse C,77,68,2025-02-04 17:36:00,9
28076,ORD_28077,8147,Cefacur 250mg Tablet,Warehouse B,73,58,2025-02-04 23:25:00,15
28077,ORD_28078,974,Plantas Age Defence & Cell Renewal Organic Face Mask 50 ml,Warehouse A,85,70,2025-02-04 23:37:00,15
28078,ORD_28079,29133,WELLA Professionals Invigo Nutri Enrich Deep Nourishing Shampoo For Dry and Damaged Hair & Professionals Invigo Balance Cl...,Warehouse A,50,36,2025-02-04 17:36:00,14
28079,ORD_28080,18645,"10WeRun Id-116 Bluetooth Smartwatch Wireless Fitness Band for Boys, Girls, Men, Women & Kids | Sports Gym Watch for All Sm...",Warehouse B,93,80,2025-02-04 20:30:00,13
28080,ORD_28081,9358,Drobus-A Tablet,Warehouse C,72,62,2025-02-04 01:48:00,10
28081,ORD_28082,10269,Essential Oil - Carrot Seed,Warehouse A,24,16,2025-02-04 18:50:00,8
28082,ORD_28083,23707,Nature's Essence Gold Creme Bleach 43g+5g Free Aloe Vera Gel 48 gm,Warehouse A,87,70,2025-02-04 12:28:00,17
28083,ORD_28084,5390,"Sounce Adjustable Air Vent Mobile Phone Holder for Car with 360° Rotational, Quick Release Button, Compatible with All Sma...",Warehouse A,105,95,2025-02-04 21:30:00,10
28084,ORD_28085,10305,"Prolet 20mm Nylon Sport Replacement Bands and Loop Compatible With (ONLY 20mm Lugs Size) Amazfit GTS 2 Mini, Amazfit Bip,A...",Warehouse B,104,95,2025-02-04 01:02:00,9
28085,ORD_28086,18213,Chymoking DP 50mg/325mg Tablet,Warehouse B,67,49,2025-02-04 22:07:00,18
28086,ORD_28087,35423,Extra Absorb Adult Pant Style Diapers - Large,Warehouse A,100,87,2025-02-04 21:16:00,13
28087,ORD_28088,18587,Phybro 100mg Capsule,Warehouse A,17,1,2025-02-04 21:09:00,16
28088,ORD_28089,22458,Rexcore Syrup,Warehouse C,34,18,2025-02-04 17:42:00,16
28089,ORD_28090,7424,Roxi Kid 50mg Tablet,Warehouse A,27,20,2025-02-04 16:28:00,7
28090,ORD_28091,22438,R-Zolam 0.25mg Tablet,Warehouse B,48,36,2025-02-04 00:48:00,12
28091,ORD_28092,199,Biogrel A 75mg/75mg Tablet,Warehouse C,29,19,2025-02-04 07:55:00,10
28092,ORD_28093,18546,TheGiftKart Flip Back Cover Case for Redmi Note 7 / Note 7 Pro/Note 7S | Leather Finish | Inbuilt Stand & Pockets | Wallet...,Warehouse A,47,41,2025-02-04 02:16:00,6
28093,ORD_28094,4343,Soulflower Pink Strawberry Skin Soap 150 gm,Warehouse B,23,4,2025-02-04 07:50:00,19
28094,ORD_28095,22864,Gemblue Biocare Oatmeal Mask 500 ml,Warehouse B,104,89,2025-02-04 22:50:00,15
28095,ORD_28096,26057,"Deputy Hd Pro Face Concealer Orange, Green, Yellow, Creamy Beige (4pcs) Concealer Natural (Multicolor, 32g) 8g Each",Warehouse A,44,25,2025-02-04 07:53:00,19
28096,ORD_28097,35272,Fujifilm Instax Mini Film Heart Sketch,Warehouse A,29,15,2025-02-04 07:20:00,14
28097,ORD_28098,4349,"Pilgrim Red Vine, Retinol & Vitamin C Under Eye Cream for dark circles for women & men| Dark circle remover cream| Dark ci...",Warehouse A,107,95,2025-02-04 13:34:00,12
28098,ORD_28099,4354,Nacrophyl Tablet,Warehouse B,82,64,2025-02-04 13:58:00,18
28099,ORD_28100,8131,Lornifen P 8mg/500mg Tablet,Warehouse C,75,59,2025-02-04 03:02:00,16
28100,ORD_28101,7422,T Mox 500mg Tablet,Warehouse A,90,73,2025-02-04 23:07:00,17
28101,ORD_28102,29304,Pure Lavender Soap,Warehouse C,53,48,2025-02-04 19:25:00,5
28102,ORD_28103,29294,"Lenovo Tab M10 FHD Plus (3rd Gen) (10.61 inch (26.94 cm), 6 GB, 128 GB, Wi-Fi), Storm Grey with Qualcomm Snapdragon Proces...",Warehouse A,50,40,2025-02-04 19:30:00,10
28103,ORD_28104,9370,"Mi Tv Remote Suitable for Mi TV 4A (32""/43"") by Trust edge",Warehouse A,44,33,2025-02-04 18:43:00,11
28104,ORD_28105,26071,Materab-DSR Capsule,Warehouse B,37,28,2025-02-04 08:06:00,9
28105,ORD_28106,9106,"Western Digital WD Green SATA 480GB, Up to 545MB/s, 2.5 Inch/7 mm, 3Y Warranty, Internal Solid State Drive (SSD) (WDS480G3...",Warehouse A,78,71,2025-02-04 06:59:00,7
28106,ORD_28107,36744,Lizoheal 100mg Dry Syrup,Warehouse A,92,79,2025-02-04 15:53:00,13
28107,ORD_28108,18572,AEIDESS Tempered Glass Compatible for Apple iPhone Xs/X (Black) Full Screen Coverage [Edge to Edge] with Easy Installation...,Warehouse B,77,69,2025-02-04 13:30:00,8
28108,ORD_28109,6103,Caspray 27.5mcg Nasal Spray,Warehouse B,42,27,2025-02-04 00:43:00,15
28109,ORD_28110,29165,"Fashion Colour Lip Liner, Waterproof, Long Lasting, 11 Pinky Pie 0.35 gm",Warehouse C,55,45,2025-02-04 22:19:00,10
28110,ORD_28111,20752,Kurtzy Professional Shading & Drawing Pencils Set - (12 Lead Pencils) Assorted Gray-Black Sketching Pencils of 12 Shades f...,Warehouse C,100,92,2025-02-04 06:32:00,8
28111,ORD_28112,29069,"Overtime iPhone Charger Cable 4 Foot (2-Pack), Apple MFi Certified USB to Lightning Cable, 4ft USB Cord for iPhone 14/13/1...",Warehouse A,73,60,2025-02-04 18:53:00,13
28112,ORD_28113,14459,"iBall WBS-650MV 2.4GHZ Wireless High-Speed 1D Barcode Scanner Reader, Grey",Warehouse C,72,61,2025-02-04 11:39:00,11
28113,ORD_28114,8142,Garnier Black Rice Pure Charcoal Black Serum Mask Face Serum Sheet Mask for Women 28 gm,Warehouse A,94,87,2025-02-04 08:25:00,7
28114,ORD_28115,20327,Ajmal Impress Concentrated Perfume Oil Citrus And Blu Homme Deodorant Aquatic Woody Fragrance 210 ml,Warehouse C,49,36,2025-02-04 03:24:00,13
28115,ORD_28116,36348,Pain Balm Extra Power,Warehouse A,46,27,2025-02-04 13:07:00,19
28116,ORD_28117,427,Triaxophin 1000mg Injection,Warehouse C,42,35,2025-02-04 17:20:00,7
28117,ORD_28118,36157,"Pacific International Class UHS-I Class I10HC 64 GB Micro SD Memory Card for Mobile, Tablet ETC.",Warehouse A,30,12,2025-02-04 11:13:00,18
28118,ORD_28119,9934,Pesilone 1% Eye Drop,Warehouse C,71,56,2025-02-04 16:50:00,15
28119,ORD_28120,13111,TP-Link UE300 USB 3.0 to RJ45 Gigabit Ethernet Network Adapter - Plug and Play,Warehouse B,98,80,2025-02-04 19:22:00,18
28120,ORD_28121,393,RESONATE RouterUPS CRU12V2A | Zero Drop | UPS for WiFi Router | Mini UPS | Up to 4 Hours PowerBackup | Battery Replacement...,Warehouse A,78,73,2025-02-04 05:40:00,5
28121,ORD_28122,26618,"truke Buds F1 Bluetooth Truly Wireless in Ear Earbuds with mic, 48H Playtime, Instant Paring, Exceptional Sound with AAC C...",Warehouse B,37,30,2025-02-04 15:49:00,7
28122,ORD_28123,19267,Cozyset Oral Drops,Warehouse A,60,54,2025-02-04 19:55:00,6
28123,ORD_28124,28209,Amozo Ultra Hybrid Camera and Drop Protection Back Case Cover for iPhone 12/12 Pro (Polycarbonate|Back Transparent - Sides...,Warehouse A,87,78,2025-02-04 08:36:00,9
28124,ORD_28125,27829,Woman - Green Body Mist,Warehouse B,61,45,2025-02-04 20:15:00,16
28125,ORD_28126,28205,Ajmal Silver Shade Evoke silver Edition Homme Raindrops Blu Deodorant Spray (Pack of 4) 200 ml,Warehouse C,89,83,2025-02-04 09:51:00,6
28126,ORD_28127,7993,amiciVision LED Lighted Tracing Board A4 Size Drawing Board with Brightness Controlled Touch Button and 1.5m USB Cable,Warehouse A,29,14,2025-02-04 16:00:00,15
28127,ORD_28128,13005,"Tribit MaxSound Plus 24W Bluetooth Wireless Speakers,Powerful Louder Sound&Exceptional XBass(Independent XBass Button),Bui...",Warehouse B,93,87,2025-02-04 14:12:00,6
28128,ORD_28129,503,"L'Oréal Paris Foundation, Super Blendable Liquid Format, SPF 16, With Glycerine, Vitamin B and E, True Match, Shade: Ivory...",Warehouse A,39,25,2025-02-04 17:30:00,14
28129,ORD_28130,418,Ventiway AM Syrup,Warehouse B,107,90,2025-02-04 08:30:00,17
28130,ORD_28131,569,Nature's Essence Glowing Gold Peel-Off Mask 65 ml,Warehouse C,15,2,2025-02-04 22:24:00,13
28131,ORD_28132,13860,Nimohit S 100mg/10mg Tablet,Warehouse B,80,66,2025-02-04 22:41:00,14
28132,ORD_28133,20500,"Orico 2.5""(6.3cm) USB 3.0 HDD Enclosure Case Cover for SATA SSD HDD | SATA SSD HDD Enclosure High Speed USB 3.0 | Tool Fre...",Warehouse A,107,93,2025-02-04 19:03:00,14
28133,ORD_28134,5066,Anti Tanning Papaya Face Wash,Warehouse B,10,1,2025-02-04 14:39:00,9
28134,ORD_28135,22738,"Cosmic Byte CB-GK-02 Corona Wired Gaming Keyboard, 7 Color RGB Backlit with Effects, Anti-Ghosting (Black)",Warehouse C,36,28,2025-02-04 04:01:00,8
28135,ORD_28136,20450,Spigen EZ Fit Tempered Glass Screen Protector Guard for iPhone 14/13/13 Pro - 2 Pack (Privacy),Warehouse C,40,33,2025-02-04 20:45:00,7
28136,ORD_28137,456,Vogyl 200 mg/500 mg Tablet,Warehouse B,43,38,2025-02-04 15:21:00,5
28137,ORD_28138,13897,"Garnier HairColor (70ml+60g) Shade 5.32, Caramel Brown+Loreal Paris Shampoo 75ml",Warehouse A,105,91,2025-02-04 06:22:00,14
28138,ORD_28139,36320,Faces Canada Hi Shine Nail Enamel Pale Rose 230 9 Ml,Warehouse C,24,8,2025-02-04 03:43:00,16
28139,ORD_28140,8001,AEIDESS Tempered Glass Screen Protector Compatible for iPhone 11 with Edge to Edge Coverage and Easy Installation kit,Warehouse C,88,80,2025-02-04 02:42:00,8
28140,ORD_28141,36322,Acer 100 cm (40 inches) P Series Full HD Android Smart LED TV AR40AR2841FDFL (Black),Warehouse B,112,96,2025-02-04 09:58:00,16
28141,ORD_28142,36326,Bookey 10 mg/10 mg Tablet,Warehouse C,36,29,2025-02-04 05:37:00,7
28142,ORD_28143,27956,Miss Rose Skin Perfector Brick Highlighter 7003 - 126N 02 13 gm,Warehouse A,50,44,2025-02-04 19:13:00,6
28143,ORD_28144,27954,NB NOIZZYBOX Retro XXL 4 Band Radio Wireless Bluetooth Speaker with Remote and Equalizer (Gold),Warehouse C,84,78,2025-02-04 13:55:00,6
28144,ORD_28145,26477,Mycloz-Lite Tablet,Warehouse A,81,73,2025-02-04 16:21:00,8
28145,ORD_28146,20559,"Wayona Nylon Braided USB Data Sync and Fast Charging 3A Short Power Bank Cable For iPhones, iPad Air, iPad mini, iPod Nano...",Warehouse C,70,53,2025-02-04 06:31:00,17
28146,ORD_28147,13689,"Redmi Note 11 Pro (Stealth Black, 8GB RAM, 128GB Storage)| 67W Turbo Charge | 120Hz Super AMOLED Display | Charger Include...",Warehouse A,34,18,2025-02-04 11:55:00,16
28147,ORD_28148,28123,Immuniply Curcumin & Vitamin C Chewable Tablets For Kids - Immunity Booster,Warehouse B,42,36,2025-02-04 05:07:00,6
28148,ORD_28149,19620,TheGiftKart Back Cover Soft Case for Samsung Galaxy S21 FE 5G | Best Camera Protection | Inbuilt Dust Plugs & Anti-Slip Gr...,Warehouse C,114,96,2025-02-04 17:11:00,18
28149,ORD_28150,29323,Dolsym SP 100mg/325mg/15mg Tablet,Warehouse A,83,77,2025-02-04 06:45:00,6
28150,ORD_28151,14044,Malt Extracts & Pepper Vanilla Body Wash,Warehouse B,48,38,2025-02-04 16:28:00,10
28151,ORD_28152,26512,Body Lotion & Moisturiser - Neroli Nights,Warehouse A,102,94,2025-02-04 12:24:00,8
28152,ORD_28153,14006,R P Zole 20mg Tablet,Warehouse C,91,74,2025-02-04 08:11:00,17
28153,ORD_28154,36180,Colina Oral Drops,Warehouse C,28,13,2025-02-04 21:24:00,15
28154,ORD_28155,28165,Daily Life Forever52 Forever Makeup Sponge Sp018 1'S,Warehouse A,19,9,2025-02-04 19:45:00,10
28155,ORD_28156,14001,"Pidilite Fevicryl Acrylic Colour, White acrylic paint, 500 ml, Art and Craft Paint, DIY Paint, Rich Pigment, Non-Craking P...",Warehouse A,54,35,2025-02-04 01:17:00,19
28156,ORD_28157,13998,Gasobet-M Oral Suspension,Warehouse C,59,43,2025-02-04 19:37:00,16
28157,ORD_28158,28163,Norbidom D 30mg/20mg Tablet SR,Warehouse B,65,53,2025-02-04 01:23:00,12
28158,ORD_28159,27841,Kumaryasava,Warehouse C,67,56,2025-02-04 09:13:00,11
28159,ORD_28160,5885,Tridec MR 250 mg/50 mg/325 mg Tablet,Warehouse C,87,73,2025-02-04 22:28:00,14
28160,ORD_28161,28146,"CHAMBOR Intense Definition Gel Eye Liner Pencil-Teal #106, Teal,",Warehouse B,68,52,2025-02-04 14:47:00,16
28161,ORD_28162,20436,Quintop 3% Cream,Warehouse B,22,3,2025-02-04 10:15:00,19
28162,ORD_28163,28118,Abimeth 16 Tablet,Warehouse C,83,65,2025-02-04 08:22:00,18
28163,ORD_28164,7649,Azathis 200mg Oral Suspension,Warehouse C,14,2,2025-02-04 20:40:00,12
28164,ORD_28165,27865,Panasonic LR44 Alkaline Coin Battery - Pack of 10,Warehouse A,30,21,2025-02-04 01:38:00,9
28165,ORD_28166,9264,Alcohol Based Hand Sanitiser With Refreshing Lemon,Warehouse B,51,45,2025-02-04 06:31:00,6
28166,ORD_28167,5148,Vega Graduated Dressing Comb (HMC - 26D) 34 gm,Warehouse C,48,38,2025-02-04 07:13:00,10
28167,ORD_28168,13046,Heart Guard Capsules,Warehouse A,94,89,2025-02-04 00:56:00,5
28168,ORD_28169,26613,Makeup Revolution Colour Play Blushed Duo Wishful 5.8 gm,Warehouse B,59,43,2025-02-04 11:31:00,16
28169,ORD_28170,19287,"Keratine Professional Sulphate free Smooth Shampoo, Serum & Mask (COMBO PACK), 500 gms",Warehouse A,108,89,2025-02-04 06:14:00,19
28170,ORD_28171,19284,AmazonBasics Braided 3A USB A to USB Type C Fast Charging Data Cable for Smartphone (Black/White -1.2 Meter),Warehouse B,54,35,2025-02-04 15:01:00,19
28171,ORD_28172,19506,"JK Easy Copier Paper | A4 Size | 70 GSM | 500 Sheets | White Paper, 1 Ream | For Laserjet & Inkjet Printer | Fast Drying |...",Warehouse C,38,28,2025-02-04 05:30:00,10
28172,ORD_28173,14039,NOZIL 5 MG TABLET,Warehouse C,108,99,2025-02-04 22:28:00,9
28173,ORD_28174,26621,Manufaktura Home Spa 100 Percent Vegetable Massage Oil with Hops Extracts,Warehouse A,22,5,2025-02-04 08:07:00,17
28174,ORD_28175,9948,Konim P 100mg/325mg Tablet,Warehouse C,60,52,2025-02-04 16:18:00,8
28175,ORD_28176,3998,LN MART Compatible with Xiaomi Mi Watch Lite Strap Sports Smart Accessory Compatible with Redmi Watch Band Bracelet Compat...,Warehouse A,31,19,2025-02-04 00:39:00,12
28176,ORD_28177,15121,Normec M Syrup,Warehouse A,56,46,2025-02-04 10:13:00,10
28177,ORD_28178,4126,Scotmont L 5mg/10mg Tablet,Warehouse B,94,87,2025-02-04 07:04:00,7
28178,ORD_28179,35070,Alvicef AZ 200mg/250mg Tablet,Warehouse B,35,24,2025-02-04 15:00:00,11
28179,ORD_28180,35031,Acelio P Tablet,Warehouse A,57,50,2025-02-04 19:24:00,7
28180,ORD_28181,29535,WENGONVILA 100 Pcs Face Skin Care Oil Blotting Absorbing Paper with Green Tea Unisex Absorbing Sheet Oily Face Blotting Ma...,Warehouse A,46,34,2025-02-04 13:50:00,12
28181,ORD_28182,29618,Cefmann CV 200mg/125mg Tablet,Warehouse B,68,53,2025-02-04 16:11:00,15
28182,ORD_28183,12601,SONATA GOLD Smart Band Wireless Sweatproof Fitness Band S6| Activity Tracker| Blood Pressure| Heart Rate Sensor| Sleep Mon...,Warehouse B,96,78,2025-02-04 00:19:00,18
28183,ORD_28184,10462,"CLAW Shoot Bluetooth Mobile Gamepad Controller for Android Phones, Tablets & Windows PC, Laptops with Button Mapping Featu...",Warehouse C,35,22,2025-02-04 09:26:00,13
28184,ORD_28185,23093,Codil D Syrup,Warehouse C,74,58,2025-02-04 01:06:00,16
28185,ORD_28186,12606,Yetacef 100 Tablet DT,Warehouse A,47,32,2025-02-04 09:40:00,15
28186,ORD_28187,35048,Generic Whirlpool AC Compatible Remote(White),Warehouse C,58,48,2025-02-04 11:24:00,10
28187,ORD_28188,23858,Caredic-P Tablet,Warehouse A,30,18,2025-02-04 05:55:00,12
28188,ORD_28189,12609,"Lenovo IdeaPad D330 Intel Celeron N4020 10.1"" (25cm) HD IPS Detachable 2-in-1 Laptop (4GB/128GB eMMC/Windows 10/1 Yr Warra...",Warehouse A,31,18,2025-02-04 18:44:00,13
28189,ORD_28190,20278,Rohtolin D Tablet,Warehouse A,31,16,2025-02-04 17:36:00,15
28190,ORD_28191,6190,Deodorant Body Spray - Passionate for Woman,Warehouse C,47,32,2025-02-04 15:21:00,15
28191,ORD_28192,4215,Segest 200 SR Tablet,Warehouse A,57,43,2025-02-04 05:56:00,14
28192,ORD_28193,1180,Zimspor AZ Dry Syrup,Warehouse A,51,45,2025-02-04 03:53:00,6
28193,ORD_28194,4220,Aclotec 200mg Tablet CR,Warehouse B,27,14,2025-02-04 17:02:00,13
28194,ORD_28195,35087,MM BRAND Fast Type-C Charger for Xiaomi Redmi Note 8 Pro / Note8 Pro Original Adapter Like Wall Charger Mobile Charger And...,Warehouse A,94,87,2025-02-04 14:02:00,7
28195,ORD_28196,14704,Pierre Cardin Paris - Studio Nails 53,Warehouse C,94,89,2025-02-04 07:04:00,5
28196,ORD_28197,4223,Kingston DataTraveler Exodia DTX/32 GB Pen Drive USB 3.2 Gen 1 (Multicolor),Warehouse A,72,54,2025-02-04 10:33:00,18
28197,ORD_28198,23854,"Oppo F21s Pro (Starlight Black, 8GB RAM, 128 Storage) with No Cost EMI/Additional Exchange Offers",Warehouse C,26,17,2025-02-04 04:20:00,9
28198,ORD_28199,5707,Gemblue Biocare Pearl Face and Body Scrub 500 ml,Warehouse A,85,69,2025-02-04 13:27:00,16
28199,ORD_28200,14691,"AirCase C26 13.3 Inch/14 Inch Messenger Laptop Bag with Shoulder Strap, Water resistant, Handle and 2 Multi Utility Compar...",Warehouse B,57,47,2025-02-04 20:20:00,10
28200,ORD_28201,14681,"Smart Watch D20 Y68 Smart Watch for Girls Boys Men Women Kids, Blacktooth 1.3"" Smart Watch LED with Daily Activity Tracke...",Warehouse C,58,47,2025-02-04 13:25:00,11
28201,ORD_28202,35134,Coxet 90mg Tablet,Warehouse A,110,95,2025-02-04 02:12:00,15
28202,ORD_28203,10381,Self Defense Pepper Spray,Warehouse B,33,15,2025-02-04 08:10:00,18
28203,ORD_28204,36809,Yevozen T 250mg/31.25mg Injection,Warehouse A,106,92,2025-02-04 19:43:00,14
28204,ORD_28205,10380,"Apple Watch SE (GPS + Cellular, 40mm) - Space Grey Aluminium Case with Midnight Sport Band - Regular",Warehouse B,97,90,2025-02-04 18:11:00,7
28205,ORD_28206,20282,"MYVN LTG TO USB for Fast Charging & Data Sync USB Cable Compatible for iPhone 5/5s/6/6S/7/7+/8/8+/10/11, iPad Air/Mini, iP...",Warehouse A,29,14,2025-02-04 03:35:00,15
28206,ORD_28207,10379,HP 680 Black Ink Cartridges Twin Pack,Warehouse B,75,70,2025-02-04 05:07:00,5
28207,ORD_28208,36808,Abcof D Syrup,Warehouse A,88,82,2025-02-04 03:08:00,6
28208,ORD_28209,22410,Lizovel Oral Suspension,Warehouse B,13,7,2025-02-04 06:33:00,6
28209,ORD_28210,20830,"Samsung Galaxy M53 5G (Emerald Brown, 8GB, 128GB Storage) | 108MP | sAmoled+ 120Hz | 16GB RAM with RAM Plus | Travel Adapt...",Warehouse A,117,99,2025-02-04 05:28:00,18
28210,ORD_28211,184,"Blue Heaven Hypergel Nailpaint - Glitter Trail, 701 11 ml",Warehouse A,99,84,2025-02-04 23:25:00,15
28211,ORD_28212,13586,Olmore AM 20mg/5mg Tablet,Warehouse B,38,24,2025-02-04 23:37:00,14
28212,ORD_28213,37061,"Jenna Sleep Eye Mask with cooling gel for Men Women, Night Sleeping Mask & Blindfold, Block Out Light, Soft Comfort Eye Sh...",Warehouse A,100,94,2025-02-04 19:29:00,6
28213,ORD_28214,37060,"Maybelline New York Instant Age Rewind Concealer, Honey 6 gm",Warehouse A,92,74,2025-02-04 20:20:00,18
28214,ORD_28215,9425,"ASUS TUF Dash F15 (2022), 15.6"" (39.62 cms) FHD 144Hz, Intel Core i5-12450H 12th Gen, 4GB GeForce RTX 3050 Graphics, Gamin...",Warehouse C,65,53,2025-02-04 17:08:00,12
28215,ORD_28216,27101,Paperkraft Expression 5 Subject| Hard  Cover Notebook | 18.2 cm x 24.3 cm | Single Line | 400 Pages,Warehouse B,99,84,2025-02-04 19:43:00,15
28216,ORD_28217,34596,Face Wash - Bio Pineapple Oil Control Foaming,Warehouse B,44,26,2025-02-04 01:23:00,18
28217,ORD_28218,25739,"RiaTech Large Size (600x300x2mm) Extended Gaming Mouse Pad with Stitched Embroidery Edge, Premium-Textured, Non-Slip Rubbe...",Warehouse B,26,18,2025-02-04 20:50:00,8
28218,ORD_28219,13438,Fexorest 180 Tablet,Warehouse C,30,17,2025-02-04 17:24:00,13
28219,ORD_28220,1449,PlantasHair Fall Control & Repair Organic Conditioner 100 ml,Warehouse B,23,18,2025-02-04 23:00:00,5
28220,ORD_28221,26922,Telmeneed-H Tablet,Warehouse B,102,97,2025-02-04 05:45:00,5
28221,ORD_28222,30176,Maryaj Pebble Style EDP Spicy Woody Perfume And Ajmal Evoke Silver Edition Him Deodorant Spicy Floral Fragrance 300 ml,Warehouse B,92,86,2025-02-04 17:48:00,6
28222,ORD_28223,7909,Rescold-JR Syrup,Warehouse B,24,15,2025-02-04 04:31:00,9
28223,ORD_28224,14897,"Gaiatop 5 Inch Clip-on Fan, Powerful Portable Fan Battery Operated 3 Speeds Desk Fan, Clip & Small Fan USB Fan with Sturdy...",Warehouse B,110,93,2025-02-04 16:25:00,17
28224,ORD_28225,25901,Teal & Terra Neem Face Wash With Basil & Aloe Vera 100 ml,Warehouse A,41,34,2025-02-04 15:58:00,7
28225,ORD_28226,14699,Oflamax OZ 200mg/500mg Tablet,Warehouse C,43,24,2025-02-04 21:08:00,19
28226,ORD_28227,20831,Pierre Cardin Paris - Porcelain Edition Compact Powder 855-Neutral Beige,Warehouse A,61,46,2025-02-04 05:49:00,15
28227,ORD_28228,29492,Ajmal Musk Rose Concentrated Floral Perfume Free From Alcohol 12ml for unisex,Warehouse A,60,55,2025-02-04 03:06:00,5
28228,ORD_28229,13600,Simavir 250mg Tablet,Warehouse C,28,13,2025-02-04 18:50:00,15
28229,ORD_28230,12623,"Forest essentials Luxury Sugar Soap Nargis 125 gms & Forest Essentials Delicate Facial Cleanser, Saffron and Neem, 50ml",Warehouse A,52,45,2025-02-04 10:51:00,7
28230,ORD_28231,27359,TP-Link Tapo 2MP 1080p Full HD Home Security Wi-Fi Smart Camera| Alexa Enabled| 2-Way Audio| Night Vision| Motion Detectio...,Warehouse A,93,79,2025-02-04 16:05:00,14
28231,ORD_28232,27367,"Samsung Galaxy M13 (Stardust Brown, 6GB, 128GB Storage) | 6000mAh Battery | Upto 12GB RAM with RAM Plus",Warehouse C,32,24,2025-02-04 16:52:00,8
28232,ORD_28233,35102,Mattlook Power Last Lip Stain Crayon Lipstick | Rich Color | Non Transfer Long Lasting Waterproof | Super Stay | Mask Proo...,Warehouse C,35,18,2025-02-04 01:29:00,17
28233,ORD_28234,4247,"Color Naturals Creme Riche Sachet, Shade 3.16, Burgundy 60 gm",Warehouse B,19,7,2025-02-04 09:08:00,12
28234,ORD_28235,35115,"Consistent 4 GB DDR3 Desktop ram,1600Mhz",Warehouse C,28,23,2025-02-04 17:16:00,5
28235,ORD_28236,18455,SupCares Edge to Edge Tempered Glass for Samsung Galaxy M51 / M62 / F62 / A71 (6.7 Inch) with Easy Self Installation Kit |...,Warehouse A,40,31,2025-02-04 10:02:00,9
28236,ORD_28237,36815,"Spigen Screen Protector for Galaxy S22 Ultra (Transparent) Edge To Edge Full Screen Coverage , Pack Of 2",Warehouse C,84,79,2025-02-04 20:29:00,5
28237,ORD_28238,36813,Propong 40 Tablet,Warehouse C,11,4,2025-02-04 02:08:00,7
28238,ORD_28239,29478,Glycix 80mg Tablet,Warehouse C,80,62,2025-02-04 23:52:00,18
28239,ORD_28240,27383,Vega Facial Band (FB - 01) 21 gm,Warehouse B,43,33,2025-02-04 02:43:00,10
28240,ORD_28241,27384,"Ash & Roh® 50Pcs Cute Animal Stickers,Vinyl Waterproof Stickers for Laptop,Bumper,Skateboard,Water Bottles,Computer,Phone,...",Warehouse A,30,17,2025-02-04 18:46:00,13
28241,ORD_28242,36791,"Sony WI-C200 Wireless Headphones with 15 Hrs Battery Life, Quick Charge, Magnetic Earbuds for Tangle Free Carrying, BT ver...",Warehouse A,53,48,2025-02-04 00:32:00,5
28242,ORD_28243,23114,KLOSS BEAUTY SECRET Magnetic Eyelashes with a Magnetic Eyeliner,Warehouse C,108,90,2025-02-04 16:01:00,18
28243,ORD_28244,27159,Cilatone 20 Tablet,Warehouse B,73,64,2025-02-04 21:16:00,9
28244,ORD_28245,9046,GUESS Dare Homme Eau de Toilette - 100 ml (For Men),Warehouse C,70,52,2025-02-04 14:48:00,18
28245,ORD_28246,14769,"Samsung Original Travel Adapter (15W, Black)",Warehouse A,57,48,2025-02-04 07:08:00,9
28246,ORD_28247,20876,Nourishing Day Cream,Warehouse C,89,82,2025-02-04 20:14:00,7
28247,ORD_28248,7356,Kangaro Paper Punch ONE Hole Punch,Warehouse C,72,61,2025-02-04 06:19:00,11
28248,ORD_28249,14770,Vega Flat Brush (E2 - FB) 120 gm,Warehouse B,41,27,2025-02-04 19:22:00,14
28249,ORD_28250,5465,Veloz Fast 20mg Tablet,Warehouse C,46,33,2025-02-04 08:23:00,13
28250,ORD_28251,29669,Modicare Schloka Purifying Neem and Gotukola Face Wash,Warehouse A,91,72,2025-02-04 05:34:00,19
28251,ORD_28252,36877,VMPS | Remote Control Compatible for Daikin Air Conditioner Split & Window Daikin AC Remote as Same,Warehouse B,14,6,2025-02-04 08:21:00,8
28252,ORD_28253,23070,"Seagate Ultra Touch 2 TB External Hard Drive Portable HDD USB-C USB 3.0 1yr Mylio Create, 4 Months Adobe CC Photography Pl...",Warehouse A,98,91,2025-02-04 14:52:00,7
28253,ORD_28254,34995,Rovflame 75mg Injection,Warehouse A,69,59,2025-02-04 16:24:00,10
28254,ORD_28255,4166,Sirona Reusable 4 Blade Razor - Aloe Boost,Warehouse B,78,60,2025-02-04 14:04:00,18
28255,ORD_28256,4153,Truthsome Anti-Hairfall Serum with Bhringaraj & Infused with Bamboo Extract - Helps Control Hair Fall & Promotes Hair Grow...,Warehouse C,101,88,2025-02-04 23:17:00,13
28256,ORD_28257,19935,Cyazi-L 250mg/250mg Tablet,Warehouse B,87,69,2025-02-04 09:25:00,18
28257,ORD_28258,19939,Lakme Forever Matte Liquid Lip Colour Nude Dream 5.6 Ml,Warehouse B,26,17,2025-02-04 13:38:00,9
28258,ORD_28259,29676,Amazon Basics Permanent Fine Point Marker Set - Black - Pack of 12,Warehouse B,32,16,2025-02-04 01:21:00,16
28259,ORD_28260,9048,"Fashion Colour Pro Hd Eyeshadow Palette 18 Shades, Shade 01 14 gm",Warehouse C,77,59,2025-02-04 22:12:00,18
28260,ORD_28261,5483,"Hoss® USB Type C Female to USB Male Adapter - USB C to USB A Connector, Works with Laptops,Chargers,and More Devices with ...",Warehouse C,17,10,2025-02-04 13:20:00,7
28261,ORD_28262,34986,Daily Life Forever52 Contour Brush Nx003 1's,Warehouse C,113,97,2025-02-04 15:47:00,16
28262,ORD_28263,18379,Vega Dressing Comb (HMBC - 119) 30 gm,Warehouse B,21,5,2025-02-04 00:24:00,16
28263,ORD_28264,10487,BlueRigger Toslink to Mini-Toslink Digital Optical S/PDIF Audio Cable (NOT a 3.5mm aux cable) with strain-relief PVC Jacke...,Warehouse C,100,93,2025-02-04 13:17:00,7
28264,ORD_28265,29708,Clindazac 150mg Capsule,Warehouse C,73,61,2025-02-04 12:13:00,12
28265,ORD_28266,4144,Ledermycin 150mg Tablet,Warehouse B,70,62,2025-02-04 13:44:00,8
28266,ORD_28267,19942,"GIOIA BAZAAR Case for MacBook, Plastic Hard Shell Case Cover Compatible with MacBook Air 13 inch (2020 2019 2018 Release) ...",Warehouse B,38,21,2025-02-04 11:22:00,17
28267,ORD_28268,9584,(Renewed) Samsung Level U2 Bluetooth Wireless In Ear Earphones With Mic Black,Warehouse C,40,26,2025-02-04 20:52:00,14
28268,ORD_28269,20879,Rejuvenating UBTAN Essential Oil - Orange 10 ml,Warehouse A,60,43,2025-02-04 19:10:00,17
28269,ORD_28270,26859,"Korea - Herbs, Fairness Facial Mask",Warehouse B,103,94,2025-02-04 02:41:00,9
28270,ORD_28271,13256,Cipic-OD 1000mg Tablet,Warehouse B,92,79,2025-02-04 22:24:00,13
28271,ORD_28272,34966,Combo - Cocoa Butter Moisturizing Lotion,Warehouse C,31,19,2025-02-04 15:54:00,12
28272,ORD_28273,154,Rose & Sandalwood Ubtan Pack for Face,Warehouse C,47,28,2025-02-04 12:49:00,19
28273,ORD_28274,27475,Quess Care Extended Warranty Plan for 2 Year for TV Between 20001 to 30000 (Email Delivery),Warehouse A,85,73,2025-02-04 07:35:00,12
28274,ORD_28275,29699,7SEVEN® Compatible Vu Smart Tv Remote Control Suitable for Original 4K Android LED Ultra HD UHD Vu Tv Remote with Non Voic...,Warehouse C,29,16,2025-02-04 00:52:00,13
28275,ORD_28276,29643,Robustrion Smart Trifold Hard Back Flip Stand Case Cover for iPad Air 3 / iPad Air 3rd Generation Cover 10.5 inch - Black,Warehouse B,62,48,2025-02-04 17:25:00,14
28276,ORD_28277,5719,Zayn & Myza Vitamin C Kaolin Face Mask 50 gm,Warehouse B,97,89,2025-02-04 15:07:00,8
28277,ORD_28278,12636,Soulflower Lemongrass Bath & Aroma Set 600 gm,Warehouse A,95,76,2025-02-04 15:19:00,19
28278,ORD_28279,18531,Ticozid T 250mg/31.25mg Injection,Warehouse A,91,83,2025-02-04 09:14:00,8
28279,ORD_28280,18533,Hair Gel Regular Hold,Warehouse C,77,59,2025-02-04 08:24:00,18
28280,ORD_28281,18535,Aloe Veda Silk & Keratin Hair Protein Cream 100 gm,Warehouse B,59,50,2025-02-04 15:56:00,9
28281,ORD_28282,14635,Amazon Brand - Solimo Portable Digital Tyre Inflator (Black),Warehouse B,99,93,2025-02-04 20:13:00,6
28282,ORD_28283,20778,Revlon Charlie Crystal Chic Perfumed Body Spray 150 Ml,Warehouse C,68,55,2025-02-04 13:38:00,13
28283,ORD_28284,12649,PILGRIM Amazonian Patuá STRENGTHENING HAIR OIL with Argan & Avocado oil | Hair oil for strong & silky hair | Lightweight H...,Warehouse B,39,21,2025-02-04 20:01:00,18
28284,ORD_28285,35189,Myglamm Magic Sharpener 6 Gm,Warehouse C,97,92,2025-02-04 05:12:00,5
28285,ORD_28286,12645,Pentasif 40mg Tablet,Warehouse C,17,12,2025-02-04 09:11:00,5
28286,ORD_28287,5709,Cornstarch Powder For Baking | Skin | Hair | Craft | Pantry | Baby Powder | Experiments | Clothes | Soups (100 Gm),Warehouse B,79,66,2025-02-04 20:14:00,13
28287,ORD_28288,6159,SeCro 3.5mm Female to 6.35mm Male Plug Stereo Audio Auxiliary Jack Converter for Charging Adapter (Golden),Warehouse C,81,67,2025-02-04 12:08:00,14
28288,ORD_28289,18483,Trinol 35mg Tablet MR,Warehouse C,52,45,2025-02-04 20:09:00,7
28289,ORD_28290,1144,Cozynim P Oral Suspension,Warehouse C,76,62,2025-02-04 13:21:00,14
28290,ORD_28291,8197,Perfume Body Spray - White,Warehouse A,72,53,2025-02-04 16:44:00,19
28291,ORD_28292,1239,"SUGAR Cosmetics - Face Fwd - Matte Corrector Stick - 02 Onward Orange (Orange Corrector Stick) - For Dark Circles, Blemish...",Warehouse A,43,35,2025-02-04 10:00:00,8
28292,ORD_28293,35164,Ferol Sachet,Warehouse A,85,71,2025-02-04 18:44:00,14
28293,ORD_28294,1131,Onsitego 2 Years Extended Warranty for Fans Up to Rs 2500 (Email Delivery),Warehouse C,14,6,2025-02-04 00:53:00,8
28294,ORD_28295,10387,Allure Makeup Blender Sponge - Drop Brown 1's,Warehouse C,61,55,2025-02-04 00:26:00,6
28295,ORD_28296,35165,"Pilot V7 Roller Ball Pen Pack of 5 (4 Blue , 1 Black )",Warehouse A,12,5,2025-02-04 18:28:00,7
28296,ORD_28297,4289,"APCSA mi Bluetooth Smartwatch Wireless Fitness Band for Boys, Girls, Men, Women & Kids | Sports Gym Watch for All Smart Ph...",Warehouse C,58,53,2025-02-04 14:02:00,5
28297,ORD_28298,10394,Ocan Mouth Paint,Warehouse B,76,60,2025-02-04 00:57:00,16
28298,ORD_28299,6153,"Pidilite Fevicryl Acrylic Colour, Acrylic Paint, Art and Craft Paint, DIY Paint, Rich Pigment, Non-Cracking Paint for Canv...",Warehouse A,94,81,2025-02-04 17:24:00,13
28299,ORD_28300,35180,"rts (2 pack) Type C USB 3.1 Female to USB Male Adapter USB Type C to USB A Charger Cable Adapter,Compatible for All Smartp...",Warehouse A,64,55,2025-02-04 12:03:00,9
28300,ORD_28301,6152,"ZEBRONICS Zeb- K35 USB Wired Keyboard with Rupee Key,Spill-Proof and Slim Design (Black)",Warehouse A,40,26,2025-02-04 17:14:00,14
28301,ORD_28302,26016,"SanDisk Ultra® microSDXC™ UHS-I Card, 512GB, 150MB/s R, 10 Y Warranty, for Smartphones",Warehouse C,58,40,2025-02-04 11:31:00,18
28302,ORD_28303,27352,"Laam Herbals Rose Water & Refined Glycerine | Steam Distilled | Pure & Natural | Skin Softner, Balance pH, Skin Toner (100...",Warehouse B,50,35,2025-02-04 08:23:00,15
28303,ORD_28304,12621,STHIRA AC Power 110-240 to DC 12 V 5A 60 W Car Auto Inverter Cigarette Lighter Adapter,Warehouse A,88,78,2025-02-04 15:47:00,10
28304,ORD_28305,20456,Wireless Apple Watch Magnetic Charging Cable iWatch Charging Cable Apple Watch Charger Magnetic Fast Charging Cable [Porta...,Warehouse B,65,53,2025-02-04 12:59:00,12
28305,ORD_28306,25905,"Fashion Colour Soft Lip Mousse, 10 Certainly Red 8 gm",Warehouse A,98,93,2025-02-04 20:46:00,5
28306,ORD_28307,13425,Skin Perfect 30+ Anti-Fine Lines Cream,Warehouse A,77,72,2025-02-04 22:34:00,5
28307,ORD_28308,20075,L.A. Colors Eyeliner Pencil - Navy 1 gm,Warehouse A,11,6,2025-02-04 01:40:00,5
28308,ORD_28309,1472,"realme C35 (Glowing Green, 4GB RAM, 64GB Storage)",Warehouse A,34,23,2025-02-04 14:49:00,11
28309,ORD_28310,14868,I AM EYECONIC Duo Chrome Pigments DRIP DRIP 2 gm,Warehouse B,101,87,2025-02-04 14:30:00,14
28310,ORD_28311,36902,Wood Blast Man Deodorant,Warehouse C,69,58,2025-02-04 08:01:00,11
28311,ORD_28312,22331,Dizisure 20mg/40mg Tablet,Warehouse C,99,80,2025-02-04 04:25:00,19
28312,ORD_28313,13269,"Mi USB 18W Dual Port Charger|Dual USB Port|Certified Qualcomm Quick Charge 3.0| Compatible for Mobile, Headphones, TWS, Ga...",Warehouse A,39,33,2025-02-04 12:46:00,6
28313,ORD_28314,26877,Triocyl Eye Drop,Warehouse C,52,42,2025-02-04 02:33:00,10
28314,ORD_28315,10527,Genpime 250mg/31.25mg Injection,Warehouse B,114,99,2025-02-04 22:09:00,15
28315,ORD_28316,20915,Zimfix 50mg Tablet DT,Warehouse C,64,55,2025-02-04 21:39:00,9
28316,ORD_28317,1284,"Hair Lep Without Multani Mitti - Solution For Greying, Dandruff & Hairfall",Warehouse A,50,32,2025-02-04 10:31:00,18
28317,ORD_28318,27212,Itraved 100mg Capsule,Warehouse C,38,21,2025-02-04 16:46:00,17
28318,ORD_28319,20945,"Samsung Galaxy M53 5G (Deep Ocean Blue, 6GB, 128GB Storage) | 108MP | sAmoled+ 120Hz | 12GB RAM with RAM Plus | Travel Ada...",Warehouse A,39,24,2025-02-04 20:05:00,15
28319,ORD_28320,29863,"Bennett Nylon Drax Laptops, Tablets Laptop Bag Sleeve Case Cover Pouch for 14 inches Laptop Apple/Dell/Lenovo/ASUS/Hp/Sams...",Warehouse C,62,47,2025-02-04 04:04:00,15
28320,ORD_28321,4055,"Soulflower Acne Free Tea Tree Cleansing Face Wash with Salicylic Acid 2%, Neem & Basil 100 ml",Warehouse B,68,54,2025-02-04 22:10:00,14
28321,ORD_28322,9018,"SENIOR WORLD Easyfone Elite with Sound Amplification - 2.3"" phone with 20+ senior citizen friendly features Dock charger/A...",Warehouse B,87,75,2025-02-04 10:53:00,12
28322,ORD_28323,1293,"QRAA Men Intense Acne Clearing Face Wash/Cleanser, 100 g",Warehouse B,59,50,2025-02-04 04:52:00,9
28323,ORD_28324,13509,"Eridanus WiFi USB Adapter for Computer, Wi-Fi Receiver 950Mbps, 2.4GHz, 802.11b/g/n USB 2.0 Wireless Mini Wi-Fi Network Ad...",Warehouse A,70,52,2025-02-04 07:04:00,18
28324,ORD_28325,4065,Colors Woman Rose Eau De Toilette,Warehouse B,20,12,2025-02-04 05:25:00,8
28325,ORD_28326,20919,"Panasonic eneloop CC17N advanced charger for AA & AAA rechargeable Batteries,input AC100‐240V 50‐60Hz,charging output AA 3...",Warehouse B,55,42,2025-02-04 01:18:00,13
28326,ORD_28327,29830,MYVN 6A 33W 55W 67W 120W Turbo and Hyper Superfast Cable Quick Charging Type C USB Cable For Mi 9 10 11 Pro 9Se CC9 Pro No...,Warehouse C,58,46,2025-02-04 22:46:00,12
28327,ORD_28328,1289,"ASUS MW203 Multi-Device Wireless Silent Mouse, 2.4GHz with USB Nano Receiver, 2400 DPI Optical Tracking, 6 Buttons, Compat...",Warehouse B,43,25,2025-02-04 16:39:00,18
28328,ORD_28329,18307,"FEDUS Cat6 Ethernet Cable, 30 Meter High Speed 550MHZ / 10 Gigabit Speed UTP LAN Cable, Network Cable Internet Cable RJ45 ...",Warehouse B,54,41,2025-02-04 11:13:00,13
28329,ORD_28330,13293,Amlosafe-AT Tablet,Warehouse B,107,96,2025-02-04 09:58:00,11
28330,ORD_28331,18310,OpenTech® Tempered Glass Screen Protector Compatible for Samsung Galaxy M31s / A51 / A52 / A52s / A52 5G Edge to Edge Cove...,Warehouse B,15,6,2025-02-04 04:15:00,9
28331,ORD_28332,23039,Oflotas 400mg Tablet,Warehouse C,108,96,2025-02-04 12:46:00,12
28332,ORD_28333,18321,Biozobid N 100mg/15mg Tablet,Warehouse A,113,95,2025-02-04 14:00:00,18
28333,ORD_28334,22915,Sun Protect Non-Oily Sunscreen SPF 50,Warehouse C,23,10,2025-02-04 06:54:00,13
28334,ORD_28335,20968,Famonite 20mg Tablet,Warehouse C,112,98,2025-02-04 12:04:00,14
28335,ORD_28336,27143,Moxway D 250mg/250mg Capsule,Warehouse B,35,20,2025-02-04 00:52:00,15
28336,ORD_28337,15056,Clitz 100mg/100mg/100mg Soft Gelatin Capsule,Warehouse C,39,24,2025-02-04 02:10:00,15
28337,ORD_28338,13522,BhringAmla Shampoo With Bhringraj & Amla For Intense Hair Treatment,Warehouse C,94,87,2025-02-04 07:20:00,7
28338,ORD_28339,14906,Pheromone Activating Deodorant Spray For Men,Warehouse B,44,33,2025-02-04 14:39:00,11
28339,ORD_28340,9490,Sports Eucalyptus Shower Gel,Warehouse C,13,3,2025-02-04 06:40:00,10
28340,ORD_28341,83,Gaba 300 Tablet,Warehouse C,54,36,2025-02-04 23:38:00,18
28341,ORD_28342,30038,Clomac MN Cream,Warehouse C,18,13,2025-02-04 05:57:00,5
28342,ORD_28343,3956,Mox CV 91.4mg Drop,Warehouse B,115,96,2025-02-04 22:21:00,19
28343,ORD_28344,3957,"For-E 400 Vitamin E Capsule for Glowing Face, Skin and Hair Nutrition (50)",Warehouse A,115,99,2025-02-04 15:15:00,16
28344,ORD_28345,7296,Rizi 5mg Tablet,Warehouse B,94,87,2025-02-04 22:02:00,7
28345,ORD_28346,8990,Nucid 20mg Capsule,Warehouse A,34,27,2025-02-04 08:52:00,7
28346,ORD_28347,1382,"Lotus Herbals NaturaBlend Botanical Compact SPF 25, Nude, 10g",Warehouse A,19,10,2025-02-04 11:42:00,9
28347,ORD_28348,37010,Azeldip 16 Tablet,Warehouse A,93,85,2025-02-04 23:49:00,8
28348,ORD_28349,23964,"Fashion Colour Nude Makeover 2 In 1 Face Powder, Shade 01 20 gm",Warehouse B,33,23,2025-02-04 22:44:00,10
28349,ORD_28350,34758,"Fashiol Women's Good Look Very Soft and Thick Cotton Face Towels (Multicolour, 10.5 x 10.5 Inch) - 6 Pieces",Warehouse C,95,86,2025-02-04 22:02:00,9
28350,ORD_28351,34786,"GIZGA essentials 14.1 inches Neoprene Protective Reversible Sleeve for laptopss, Notebook, Netbook, ChromeBook, Microsoft ...",Warehouse C,73,61,2025-02-04 13:44:00,12
28351,ORD_28352,20004,Digifix AZ 200mg/250mg Tablet,Warehouse B,73,66,2025-02-04 02:16:00,7
28352,ORD_28353,20235,Oflox Eye Ointment,Warehouse C,107,88,2025-02-04 14:55:00,19
28353,ORD_28354,18210,Wynpep D 30mg/20mg Capsule SR,Warehouse B,45,27,2025-02-04 13:43:00,18
28354,ORD_28355,8995,Evercold Plus 5mg/325mg/10mg Tablet,Warehouse A,33,27,2025-02-04 10:43:00,6
28355,ORD_28356,7310,Dazz 6mg Tablet,Warehouse C,32,25,2025-02-04 03:02:00,7
28356,ORD_28357,29763,Beauty People Pure Matte Lipstick - Pink - Divine - 406 3.8 gm,Warehouse A,78,72,2025-02-04 20:59:00,6
28357,ORD_28358,29983,Advansed Jasmine Non - Sticky Coconut Hair Oil,Warehouse B,34,28,2025-02-04 03:36:00,6
28358,ORD_28359,19995,"F Gear Talent Laptop Backpack With Rain Cover 32 Liters (Grey,Black)",Warehouse C,33,22,2025-02-04 01:11:00,11
28359,ORD_28360,22316,Rockgen O 200mg/200mg Tablet,Warehouse C,46,38,2025-02-04 04:56:00,8
28360,ORD_28361,20956,Mupiroc Ointment,Warehouse B,78,70,2025-02-04 23:16:00,8
28361,ORD_28362,23929,"Printme Silicone Protective Case Cover for OnePlus Nord Buds, Anti Fall Anti Dust, with Hook headphone Case *Case Cover on...",Warehouse A,47,41,2025-02-04 16:15:00,6
28362,ORD_28363,34938,"KECHAODA K112, Triple Sim Phone(Black), 12",Warehouse B,62,57,2025-02-04 07:52:00,5
28363,ORD_28364,5500,"Callmate C-Thru 20000mAh Transparent Power Bank, 23W Fast Charging with Type C PD (Input & Output | 2 Output Ports and 2 I...",Warehouse B,52,38,2025-02-04 02:52:00,14
28364,ORD_28365,7340,Rabiace 200mg/20mg Capsule SR,Warehouse C,34,25,2025-02-04 08:04:00,9
28365,ORD_28366,18339,"Fashion Colour Lip Crayon, Waterproof, Long Lasting, 6 Caramel 2.8 gm",Warehouse C,14,9,2025-02-04 09:27:00,5
28366,ORD_28367,27220,Myvert 8mg Tablet,Warehouse B,89,79,2025-02-04 20:37:00,10
28367,ORD_28368,27223,Wordec 50mg Injection,Warehouse B,76,68,2025-02-04 01:31:00,8
28368,ORD_28369,10516,"Tukzer Fully Foldable Tabletop Desktop Tablet Mobile Stand Holder - Angle & Height Adjustable for Desk, Cradle, Dock, Comp...",Warehouse A,78,70,2025-02-04 20:46:00,8
28369,ORD_28370,29772,Zebronics 450 W Power Supply SMPS,Warehouse B,83,75,2025-02-04 23:26:00,8
28370,ORD_28371,22205,Glimycord M 2mg/500mg Tablet,Warehouse A,21,16,2025-02-04 03:03:00,5
28371,ORD_28372,3798,Esmee 40mg Tablet,Warehouse B,13,7,2025-02-04 00:36:00,6
28372,ORD_28373,5608,Medomol 125mg Syrup,Warehouse B,11,6,2025-02-04 07:22:00,5
28373,ORD_28374,25767,Etowin MR 60mg/4mg Tablet,Warehouse C,109,91,2025-02-04 08:54:00,18
28374,ORD_28375,7231,Shampoo - Shikakai & Badam,Warehouse B,53,37,2025-02-04 16:14:00,16
28375,ORD_28376,27013,Castor Hair Oil,Warehouse B,26,13,2025-02-04 23:55:00,13
28376,ORD_28377,37119,Amclue 500 mg/125 mg Tablet,Warehouse C,16,6,2025-02-04 12:03:00,10
28377,ORD_28378,5588,Perclin Cream,Warehouse C,41,30,2025-02-04 19:00:00,11
28378,ORD_28379,21077,"Noise ColorFit Pulse Grand Smart Watch with 1.69""(4.2cm) HD Display, 60 Sports Modes, 150 Watch Faces, Fast Charge, Spo2, ...",Warehouse A,40,27,2025-02-04 13:44:00,13
28379,ORD_28380,10600,Plantas Pigmentation Defence Organic Face Wash 100 ml,Warehouse A,110,97,2025-02-04 00:32:00,13
28380,ORD_28381,25790,MILLOR Unisex Silicone Gel Heel Pad Protector Insole Cups for Heel Swelling Pain Relief Foot Care Support Cushion Shock Ab...,Warehouse B,95,80,2025-02-04 05:59:00,15
28381,ORD_28382,7278,V Xime 100mg Tablet DT,Warehouse C,91,86,2025-02-04 15:47:00,5
28382,ORD_28383,34637,Ajmal Impress And Aura & Prose EDP Pack of 3 20 ml,Warehouse A,51,46,2025-02-04 07:22:00,5
28383,ORD_28384,18147,HARRY & JAMES® 950 Mbps USB WiFi Adapter Wireless Network Receiver Dongle for Laptop Desktop Support Windows XP/7/8/10/ an...,Warehouse C,56,37,2025-02-04 06:01:00,19
28384,ORD_28385,21010,Oxdron 4mg Injection,Warehouse B,72,66,2025-02-04 09:55:00,6
28385,ORD_28386,30141,Vega The Rose Sponge (BA - 3/14) 94 gm,Warehouse A,34,29,2025-02-04 21:42:00,5
28386,ORD_28387,15083,Ajmal Khofooq Concentrated Perfume Oil Woody Oudhy And Silver Shade Homme Deodorant Citrus Woody Fragrance 218 ml,Warehouse A,40,29,2025-02-04 21:00:00,11
28387,ORD_28388,6291,"Roselle Ultra Fine Soft Eye & Lip Liner With Vitamin"" E""",Warehouse C,82,65,2025-02-04 15:43:00,17
28388,ORD_28389,8276,"MAYCREATE® 10 Sheet Butterfly Tattoo Sticker, Temporary Sticker for Face Arm, Waterproof Temporary Tattoos for Birthday Pa...",Warehouse A,54,36,2025-02-04 05:48:00,18
28389,ORD_28390,18008,Lamsonac 30mg Capsule,Warehouse A,66,58,2025-02-04 04:21:00,8
28390,ORD_28391,34665,"Fashion Colour Jersy Girl Kiss Proof No Transfer Lipstick, 5 Fuscous 2 gm",Warehouse A,73,62,2025-02-04 23:38:00,11
28391,ORD_28392,34666,Biotique Morning Nectar Moisturizer (120ml),Warehouse C,101,86,2025-02-04 08:02:00,15
28392,ORD_28393,27126,Head To Toe 3-in-1 Wash For Men - Cool Wave,Warehouse C,11,3,2025-02-04 19:28:00,8
28393,ORD_28394,37041,Marigold Mango Lip Contour Balm,Warehouse A,49,33,2025-02-04 03:55:00,16
28394,ORD_28395,22268,Femspas Oral Suspension,Warehouse B,76,65,2025-02-04 14:46:00,11
28395,ORD_28396,59,Selmox 0.5% Eye Drop,Warehouse C,46,29,2025-02-04 21:40:00,17
28396,ORD_28397,15064,Fexyclav 250mg/125mg Tablet,Warehouse B,43,29,2025-02-04 10:23:00,14
28397,ORD_28398,10625,"AGARO USB to Type C OTG Cable, On The Go Adapter USB Type C Male to USB Female Compatible with Most Type C Devices",Warehouse C,79,64,2025-02-04 00:27:00,15
28398,ORD_28399,7276,Sitopaladi Churna,Warehouse A,71,64,2025-02-04 17:59:00,7
28399,ORD_28400,15094,Nourishing Shampoo,Warehouse A,36,18,2025-02-04 19:05:00,18
28400,ORD_28401,3890,Mosawin 5mg Tablet,Warehouse A,25,10,2025-02-04 06:56:00,15
28401,ORD_28402,3857,Clinfresh Gel,Warehouse C,89,76,2025-02-04 04:04:00,13
28402,ORD_28403,15199,Zoook Rocker Thunder Bluetooth Party Speaker 20 watts with Karaoke Mic/TF/FM/Lights/USB/Party Speaker/TWS/Echo Control/Blu...,Warehouse A,95,87,2025-02-04 14:21:00,8
28403,ORD_28404,34445,Cefidan O 200mg/200mg Tablet,Warehouse B,77,69,2025-02-04 09:03:00,8
28404,ORD_28405,17973,Esoz D 40 Capsule SR,Warehouse C,33,19,2025-02-04 17:05:00,14
28405,ORD_28406,24104,Ant Esports 690 NEO VS 4GB (1*4GB) DDR3 1600 MHz CL 11-11-11-28 SO-DIMM Laptop Memory - AE4GD3S16M16C,Warehouse B,106,96,2025-02-04 21:06:00,10
28406,ORD_28407,25694,Allianztec ESP-WROOM-32 ESP32 ESP-32S Development Board 2.4GHz Dual-Mode WiFi + Bluetooth Dual Cores Microcontroller Proce...,Warehouse C,64,45,2025-02-04 20:14:00,19
28407,ORD_28408,3808,Moxlink 0.5% Eye Drop,Warehouse C,18,1,2025-02-04 03:31:00,17
28408,ORD_28409,13390,Fogg Fantastic Deo Extreme 150 Ml,Warehouse C,41,23,2025-02-04 12:56:00,18
28409,ORD_28410,8312,Agumerz CV 400mg/57mg Dry Syrup,Warehouse B,98,81,2025-02-04 12:35:00,17
28410,ORD_28411,24073,"Lenovo IdeaPad Slim 3 Intel Celeron N4020 4th Gen 15.6"" (39.62cm) HD Thin & Light Laptop (8GB/256GB SSD/Windows 11/Office ...",Warehouse B,86,80,2025-02-04 11:03:00,6
28411,ORD_28412,37090,Eyemac Eye Drop,Warehouse B,15,8,2025-02-04 20:48:00,7
28412,ORD_28413,30313,Ocron 200 Tablet,Warehouse A,10,3,2025-02-04 05:20:00,7
28413,ORD_28414,18045,Revolution Pro Supreme Matte Lip Pigment-Foresight 2.5 ml,Warehouse A,87,74,2025-02-04 09:01:00,13
28414,ORD_28415,27029,FAE Beauty SPF Juice Ultra Light Sunscreen with No White Cast and SPF 50+ PA++++ (50 gm) | Non Greasy Formula | Broad Spec...,Warehouse B,50,45,2025-02-04 12:44:00,5
28415,ORD_28416,34546,Olstan 40 Tablet,Warehouse C,74,55,2025-02-04 02:33:00,19
28416,ORD_28417,5593,Redmi 80 cm (32 inches) Android 11 Series HD Ready Smart LED TV | L32M6-RA/L32M7-RA (Black),Warehouse C,32,24,2025-02-04 04:23:00,8
28417,ORD_28418,8945,Texcef TZ 500mg/62.5mg Injection,Warehouse C,102,90,2025-02-04 17:47:00,12
28418,ORD_28419,30264,White Beauty Mineral Clay Instant Brightness Face Wash Foam,Warehouse B,41,25,2025-02-04 08:45:00,16
28419,ORD_28420,18002,Colorbar Lux Nail Lacquer Cbn350 12 Ml,Warehouse C,52,44,2025-02-04 10:39:00,8
28420,ORD_28421,1537,Ajmal Shiro EDP Citrus Spicy Perfume 90ml for Men and Carbon EDP Citrus Spicy Perfume 100ml for Men +1 Perfume Tester FREE,Warehouse C,52,44,2025-02-04 08:25:00,8
28421,ORD_28422,5611,Kofpause A Syrup,Warehouse A,27,13,2025-02-04 07:21:00,14
28422,ORD_28423,34468,"Makeup Revolution Forever Flawless Bird of Paradise Eyeshadow Palette, Purple (1180351)",Warehouse A,93,78,2025-02-04 05:44:00,15
28423,ORD_28424,1563,"JOTO Plastic, TPU Underwater Transparent Waterproof Phone Case Holder Pouch for iPhone 14 13 12 11 Pro Max XS XR X 8 7 6S,...",Warehouse B,34,15,2025-02-04 11:28:00,19
28424,ORD_28425,34426,"COSLUXE Hair Stylists Professional Styling Comb Set, Great for All Hair Types & Styles Comb set kit Multifunction Anti-Sta...",Warehouse A,16,2,2025-02-04 09:33:00,14
28425,ORD_28426,34437,Ajmal Blu & Sacrifice II & Wisal Dahab Deo & Neea EDP Pack of 4 20 ml,Warehouse B,51,35,2025-02-04 01:16:00,16
28426,ORD_28427,22954,"Tacroz Life Line Medicos 0.03% Ointment, 20g",Warehouse A,87,72,2025-02-04 05:42:00,15
28427,ORD_28428,15209,Refill Handwash - Sandal,Warehouse C,98,89,2025-02-04 12:38:00,9
28428,ORD_28429,22957,"Sery Colorflirt Nail Paint Soothing Lilac, Purple 10 ml",Warehouse B,88,77,2025-02-04 04:41:00,11
28429,ORD_28430,1550,Nicodol Plus 325 mg/37.5 mg Tablet,Warehouse B,110,99,2025-02-04 21:22:00,11
28430,ORD_28431,8151,Ticmoxy CL 500mg/125mg Tablet,Warehouse A,47,36,2025-02-04 00:04:00,11
28431,ORD_28432,14578,SToK (ST-MC01) Currency Counting Machine with UV/MG Counterfeit Notes Detection Plus External Display and 1 Year Warranty...,Warehouse A,45,31,2025-02-04 22:32:00,14
28432,ORD_28433,7444,Flormar Compact Powder 104 Caramel 11 gm,Warehouse C,63,48,2025-02-04 01:06:00,15
28433,ORD_28434,17279,Astazo-S 1.5gm Injection,Warehouse C,85,67,2025-02-04 04:54:00,18
28434,ORD_28435,2056,Stalcef T 500mg/62.5mg Injection,Warehouse B,12,2,2025-02-04 17:32:00,10
28435,ORD_28436,34383,Oflolik 200mg Tablet,Warehouse B,76,70,2025-02-04 01:40:00,6
28436,ORD_28437,17258,"DigiTek (DWM-002) Wireless Microphone & Receiver with 8-pin Connector for Noise Cancellation, Fast Charging, Suitable for ...",Warehouse A,100,91,2025-02-04 19:41:00,9
28437,ORD_28438,8594,Cardipure 12.5mg Tablet,Warehouse A,107,98,2025-02-04 11:25:00,9
28438,ORD_28439,25589,Wipeout Sanitizing Spray,Warehouse B,32,18,2025-02-04 12:34:00,14
28439,ORD_28440,31828,Bonjour Paris Premium Super Matte 9-5 Hydrating Lipstick - Pinkish 4.2 gm,Warehouse A,38,21,2025-02-04 15:14:00,17
28440,ORD_28441,32196,Precough Syrup,Warehouse C,65,59,2025-02-04 20:15:00,6
28441,ORD_28442,25032,"pTron Basspods 882 in-Ear Earbuds, Bluetooth 5.1 Wireless Headphones with Mic, 10MM Drivers, Immersive Audio, Stereo Call...",Warehouse B,33,14,2025-02-04 13:11:00,19
28442,ORD_28443,31941,Ayurvedic Activated Charcoal & Tea Tree Face Wash,Warehouse B,13,4,2025-02-04 05:17:00,9
28443,ORD_28444,8846,3-in-1 Bluetooth Selfie Sticks with Remote and Selfie Light Multifunctional Selfie Stick Tripod Stand Compatible with All ...,Warehouse A,25,14,2025-02-04 06:44:00,11
28444,ORD_28445,21506,Faces Canada Matte Nail Enamel Primrose Pink 47 9 Ml,Warehouse C,40,29,2025-02-04 08:17:00,11
28445,ORD_28446,1966,Gavicon PX Injection,Warehouse C,58,51,2025-02-04 23:18:00,7
28446,ORD_28447,31934,Vitastat AS 150 Capsule,Warehouse B,38,28,2025-02-04 21:14:00,10
28447,ORD_28448,8395,Waltigo 16mg Tablet,Warehouse A,102,83,2025-02-04 21:50:00,19
28448,ORD_28449,3228,AM2PM Sunscreen Lotion - SPF 50,Warehouse B,76,64,2025-02-04 21:47:00,12
28449,ORD_28450,11345,Gizga Essentials Professional Super Air Blower Pump for Cleaning Dust with Hi Performance Silicone Squeeze Bulb for DSLR C...,Warehouse B,93,78,2025-02-04 14:06:00,15
28450,ORD_28451,31921,Himalayan Organics 100% Pure Bhringraj Ayurvedic Therapeutic Hair Oil | Hair Re growth And Hair Fall Control - 200ml,Warehouse C,27,11,2025-02-04 08:54:00,16
28451,ORD_28452,10980,"OJOS Compatible with MacBook Air 13.6 inch Case 2022 Release A2681 M2 Chip with Liquid Retina Display & Touch ID, Protecti...",Warehouse B,92,79,2025-02-04 05:25:00,13
28452,ORD_28453,3040,Manish Malhotra Antimicrobial Facial Wipes 20'S,Warehouse A,101,83,2025-02-04 11:04:00,18
28453,ORD_28454,2227,VIEWS Set of 1 Women's Hair Clutchers Juda Bun With Artificial Synthetic Hair Extension Natural - Black,Warehouse C,63,49,2025-02-04 04:23:00,14
28454,ORD_28455,22067,Super C Amla Extract & Zinc - Fizzy Orange Flavour,Warehouse B,80,61,2025-02-04 10:10:00,19
28455,ORD_28456,11843,Tenil 50 Tablet,Warehouse B,91,77,2025-02-04 09:32:00,14
28456,ORD_28457,25388,Dreamcatcher Essential Oil,Warehouse C,109,90,2025-02-04 06:27:00,19
28457,ORD_28458,16968,"BARROT Multi-Purpose Device Cleaning Kit | Laptops, Mobiles, Camera, TV, Smartwatches, Airpods, Tablets",Warehouse B,7,2,2025-02-04 09:21:00,5
28458,ORD_28459,33677,"SanDisk Ultra microSD UHS-I Card 256GB, 120MB/s R",Warehouse A,29,12,2025-02-04 05:51:00,17
28459,ORD_28460,21273,Zanpan 40mg Tablet,Warehouse C,73,63,2025-02-04 09:34:00,10
28460,ORD_28461,31771,TheGiftKart Flip Cover Back Case for OnePlus Nord CE 2 LITE 5G | Dual-Color Leather Finish | Inbuilt Stand & Pockets | Wal...,Warehouse C,43,34,2025-02-04 20:01:00,9
28461,ORD_28462,21313,POPIO Tempered Glass Screen Protector Compatible for iPhone 14 with Case Friendly Edge to Edge Coverage and Easy Installat...,Warehouse B,58,51,2025-02-04 16:01:00,7
28462,ORD_28463,2668,Esivac Oral Solution,Warehouse C,107,91,2025-02-04 22:04:00,16
28463,ORD_28464,15591,"Gizga Essentials USB A 3.0 HUB, 4 Port Adapter, 5GBPS Fast Data Transfer, 3 USB A Ports, 1 Type C, Multi-System Compatibl...",Warehouse B,41,27,2025-02-04 13:27:00,14
28464,ORD_28465,24818,DeBelle Gel Nail Lacquer Peach Pannacotta Creamy Peach Nail Polish 8 ml,Warehouse A,99,86,2025-02-04 12:58:00,13
28465,ORD_28466,11492,"BenQ Mobiuz EX2710S 27-inch(68.58cm) 1920 X 1080 Pixels (FHD) 1080p Full HD IPS Gaming Monitor, 165Hz, 1ms, AMD Freesync P...",Warehouse A,51,43,2025-02-04 19:53:00,8
28466,ORD_28467,34386,Khadi Essentials Luxe Bath Bar - Kaya 100 gm,Warehouse C,41,30,2025-02-04 14:37:00,11
28467,ORD_28468,33538,JBL Partybox Encore Essential | Portable Bluetooth Party Speaker | 100W Monstrous Pro Sound | Dynamic Light Show | Upto 6H...,Warehouse C,92,78,2025-02-04 05:21:00,14
28468,ORD_28469,22152,Vega Cushion Brush (E20 - CB) 138 gm,Warehouse B,58,44,2025-02-04 18:35:00,14
28469,ORD_28470,3235,Vega Flat Brush (H3 - FB) 116 gm,Warehouse B,111,98,2025-02-04 04:55:00,13
28470,ORD_28471,24468,Xaflo 200mg Tablet,Warehouse C,99,82,2025-02-04 04:54:00,17
28471,ORD_28472,33355,Sun Shield Skin Whitening Saffron Face Wash - With Sandal Extract,Warehouse C,25,13,2025-02-04 19:12:00,12
28472,ORD_28473,2642,Ajmal Tempest Concentrated Perfume Oil Floral Attar And Aura Concentrated Perfume Oil Floral Fruity Attar 22 ml,Warehouse A,19,13,2025-02-04 06:09:00,6
28473,ORD_28474,17906,Spigen Glas.tR SLIM Anti-Glare Matte Tempered Glass Screen Protector Guard for Ola S1 / S1 Pro EV Scooter 7inch Display - ...,Warehouse A,71,56,2025-02-04 17:04:00,15
28474,ORD_28475,6774,Ajmal Prose EDP & Deep Earth EDT Pack of 2 350 ml,Warehouse A,20,7,2025-02-04 01:28:00,13
28475,ORD_28476,17837,WOW IMAGINE Slim Ultra Soft Rubberised Back Cover for Samsung Galaxy F13 | M13 4G | Inner Velvet Fabric Lining | Matte Sil...,Warehouse A,46,35,2025-02-04 17:02:00,11
28476,ORD_28477,10829,Plum Bodylovin' Orchid-You-Not Shower Gel 240 Ml,Warehouse A,108,94,2025-02-04 11:34:00,14
28477,ORD_28478,32266,Revlon Color N Care Permanent Hair Color Cream - Burgundy 3Rv 40 Gm,Warehouse A,78,68,2025-02-04 22:40:00,10
28478,ORD_28479,32555,St.Botanica Body Wash - Tahitian Gardenia & Vanilla 250 ml,Warehouse C,47,41,2025-02-04 02:31:00,6
28479,ORD_28480,11138,Doran-O 2mg Injection,Warehouse C,33,18,2025-02-04 11:21:00,15
28480,ORD_28481,8340,Labepure 20mg Injection,Warehouse A,21,4,2025-02-04 14:57:00,17
28481,ORD_28482,15966,Vovenec Plus 50 mg/500 mg Tablet,Warehouse C,31,14,2025-02-04 05:28:00,17
28482,ORD_28483,1599,"GM 3261 Cuba 4+1 Power Strip with Master Switch, Indicator, Safety Shutter, 3 International Sockets & 3 USB Ports 2.4A",Warehouse B,98,87,2025-02-04 02:19:00,11
28483,ORD_28484,16685,"FACES CANADA Ultime Pro Makeup Fixer, 50 ml | Long Lasting Makeup Setting Spray | Keeps Makeup Intact | Hydrates, Soothes...",Warehouse A,33,25,2025-02-04 22:48:00,8
28484,ORD_28485,8453,Troma Plus 100 mg/500 mg Tablet,Warehouse A,91,81,2025-02-04 16:57:00,10
28485,ORD_28486,17898,Pionorm-GM Tablet,Warehouse A,34,16,2025-02-04 20:55:00,18
28486,ORD_28487,10821,Spigen Lite Fit Ultra Loop Band Strap for Apple Watch Ultra (49mm) / Apple Watch Series 8/7 (45mm) / Series SE2/6/SE/5/4 (...,Warehouse C,42,33,2025-02-04 12:29:00,9
28487,ORD_28488,3688,"ELV DIRECT Lightweight Metal Body Fine Point Capacitive Stylus Pen for Touchscreen Devices, , Compatible with All Smartpho...",Warehouse C,82,68,2025-02-04 08:44:00,14
28488,ORD_28489,25541,Emifix 100mg Dry Syrup,Warehouse C,60,54,2025-02-04 16:42:00,6
28489,ORD_28490,2141,Caryzole Lotion,Warehouse B,24,6,2025-02-04 19:22:00,18
28490,ORD_28491,24957,Lemongrass Anti-Pigmentation Massage Cream,Warehouse A,88,71,2025-02-04 20:46:00,17
28491,ORD_28492,2585,Biodol SP 50mg/325mg/15mg Tablet,Warehouse C,62,48,2025-02-04 17:57:00,14
28492,ORD_28493,11518,"Pilgrim Anti Ageing Red Vine Face Pack & Mask Paste with Mulberry Extracts & Rosehip Oil for Glowing Skin, De-Tan, Dark Sp...",Warehouse A,42,30,2025-02-04 11:32:00,12
28493,ORD_28494,24306,Slovic Cell Phone Armband | Adjustable Band fits All iPhone and Android Smartphones | Waterproof & Anti-Sweat Fabric | Cha...,Warehouse B,61,47,2025-02-04 21:34:00,14
28494,ORD_28495,25069,INEFABLE Mi Band 5 and 6 Strap Original Band Strap M5/M6 - Pack of 1 - Dark Grey - (Device Not Included - Not Compatible w...,Warehouse C,21,11,2025-02-04 14:48:00,10
28495,ORD_28496,30648,Ajmal Mukhallat Al Wafa Cp 12 Ml,Warehouse A,27,18,2025-02-04 19:03:00,9
28496,ORD_28497,25330,"Sindoor powder, loose sindoor powder, red sindoor powder pack of 1 (each 70gm) combo kumkum liquid bindi(11 in 1 colour go...",Warehouse C,31,13,2025-02-04 15:55:00,18
28497,ORD_28498,17549,Flormar Matte Nail Enamel M27 Havana 11 ml,Warehouse A,81,70,2025-02-04 05:08:00,11
28498,ORD_28499,12049,"LOXXO® Microfiber Candy Case Compatible for iPhone 12/iPhone 12 Pro 6.1 inch, Shockproof Slim Back Cover Liquid Silicone C...",Warehouse B,76,68,2025-02-04 15:48:00,8
28499,ORD_28500,11792,"Manual Toothbrush Pro Health - Base, Soft",Warehouse A,8,2,2025-02-04 13:13:00,6
28500,ORD_28501,6939,Methasone Tablet,Warehouse B,74,62,2025-02-04 16:26:00,12
28501,ORD_28502,11794,Xtore Air Foldable Invisible Mobile Phone Tabletop Stand | Next Gen Design | Comfortable Viewing Angle (Black),Warehouse A,75,70,2025-02-04 12:32:00,5
28502,ORD_28503,16078,Ronifix 200 LB Tablet,Warehouse B,17,4,2025-02-04 19:02:00,13
28503,ORD_28504,2246,"Jiva Sugar Free Chyawanprash - 100% Sugar-Free Immunity Booster | 1 Kg, Black",Warehouse A,67,53,2025-02-04 09:22:00,14
28504,ORD_28505,3396,ZEBRONICS Zeb-Bang Wireless Bluetooth On The Ear Headphone with Mic and Playback time 16 hrs (Black),Warehouse A,79,71,2025-02-04 21:53:00,8
28505,ORD_28506,16108,AZ 500mg Tablet,Warehouse A,34,27,2025-02-04 03:08:00,7
28506,ORD_28507,1938,Chyavanprashad,Warehouse A,88,77,2025-02-04 17:22:00,11
28507,ORD_28508,17052,Redgear MP80 Type Gaming Mousepad (Black/Red),Warehouse A,51,46,2025-02-04 20:05:00,5
28508,ORD_28509,21476,Sensitive After Shave Lotion,Warehouse A,74,61,2025-02-04 06:44:00,13
28509,ORD_28510,17430,"Portronics Clamp Y Adjustable Air Vent Mobile Holder for Car with 360° Rotational, One Click Release Button, Compatible wi...",Warehouse C,70,61,2025-02-04 02:54:00,9
28510,ORD_28511,31750,Espzone 1.5 Injection,Warehouse B,78,66,2025-02-04 10:44:00,12
28511,ORD_28512,7061,Global Desi Dreamy Daze Eau De Parfum 50ML & Rhytmic Soul Body Mist 200ML Pack of 2 for Women Crafted by Ajmal,Warehouse B,78,71,2025-02-04 02:38:00,7
28512,ORD_28513,7073,Recef 1gm Injection,Warehouse A,51,32,2025-02-04 01:30:00,19
28513,ORD_28514,33121,House Of Makeup Nail Lacquer - Born This Way 12 ml,Warehouse B,113,99,2025-02-04 13:34:00,14
28514,ORD_28515,7071,"GUBB Makeup Essentials Combo - 3 Makeup Brushes (Powder, Fan & Blush Brush) | Beauty Blender | Eyelash Curler Rose Gold | ...",Warehouse B,29,24,2025-02-04 05:09:00,5
28515,ORD_28516,12072,"ORICO M.2 NVMe SATA SSD Enclosure Adapter Tool-Free, USB C 3.2 Gen 2 10Gbps NVME, 5Gbps NGFF SATA PCIe M-Key(B+M Key) 223...",Warehouse A,69,57,2025-02-04 19:00:00,12
28516,ORD_28517,31149,Artangle The Starry Night by Vincent Van Gogh Hardcover Plain A5 Size Premium Notebook,Warehouse A,56,48,2025-02-04 22:23:00,8
28517,ORD_28518,11051,Itraconol 200 Capsule,Warehouse C,80,73,2025-02-04 19:19:00,7
28518,ORD_28519,6653,Maryaj Pebble Style EDP Spicy Woody Perfume And Ajmal Silver Shade Homme Deodorant Citrus Woody Fragrance 300 ml,Warehouse C,56,46,2025-02-04 21:33:00,10
28519,ORD_28520,17440,Comet Busters Small Golden Crystal Bindi (BIN462),Warehouse C,60,45,2025-02-04 02:14:00,15
28520,ORD_28521,22017,Sony MDR-EX155AP in-Ear Wired Headphones with Mic (Light Blue),Warehouse B,19,14,2025-02-04 14:48:00,5
28521,ORD_28522,21854,Pyne 25mg Tablet,Warehouse A,33,24,2025-02-04 03:20:00,9
28522,ORD_28523,11309,"Samsung Galaxy M32 Prime Edition (Black, 6GB RAM, 128GB)",Warehouse C,87,80,2025-02-04 17:05:00,7
28523,ORD_28524,11818,Herbal Papaya Soap,Warehouse A,22,3,2025-02-04 21:54:00,19
28524,ORD_28525,11043,VRPRIME Universal Travel Adapter International Charger Multiple Plug Socket Converter | 4 USB + 1 Type C Output Smart Char...,Warehouse B,76,64,2025-02-04 11:27:00,12
28525,ORD_28526,15726,"Face Mask for Kids - 7-12 Years, Black, 5 x 3 Inches",Warehouse C,61,48,2025-02-04 13:42:00,13
28526,ORD_28527,24697,Premium Applicator Tampons,Warehouse B,26,8,2025-02-04 09:22:00,18
28527,ORD_28528,15595,Optimox 250mg Injection,Warehouse A,51,43,2025-02-04 10:11:00,8
28528,ORD_28529,16988,Cixar O 200mg/200mg Tablet,Warehouse C,60,51,2025-02-04 01:32:00,9
28529,ORD_28530,31900,Cellrose 90mg Tablet,Warehouse B,24,18,2025-02-04 19:37:00,6
28530,ORD_28531,25070,(Renewed) Jbl Tune 230Nc Bluetooth 5.2 Truly Wireless In Ear Earbuds With Mic Active Noise Cancellation Massive 40 Hrs Pla...,Warehouse C,105,98,2025-02-04 02:41:00,7
28531,ORD_28532,7094,Qinet 100mg Syrup,Warehouse A,91,73,2025-02-04 11:26:00,18
28532,ORD_28533,15563,Linzomind 600mg Tablet,Warehouse B,59,54,2025-02-04 09:50:00,5
28533,ORD_28534,8706,Airtel Digital TV HD Set Top Box with 1 Month Basic Pack with Recording + Free Standard Installation,Warehouse C,52,36,2025-02-04 13:24:00,16
28534,ORD_28535,11085,Albeli Plus 6mg/400mg Tablet,Warehouse B,63,52,2025-02-04 20:47:00,11
28535,ORD_28536,25302,Brustro Kneadable Art Eraser (Pack of 6),Warehouse A,70,64,2025-02-04 10:50:00,6
28536,ORD_28537,2905,Blukast LC 5mg/10mg Tablet,Warehouse C,62,43,2025-02-04 10:13:00,19
28537,ORD_28538,31726,VALZAAR H  TABLET 40MG/12.5MG,Warehouse A,16,8,2025-02-04 07:50:00,8
28538,ORD_28539,21532,Revitalift Laser X3 Transforming Eye Cream,Warehouse B,52,37,2025-02-04 10:52:00,15
28539,ORD_28540,12156,Beauty People Smart Nails - All That Jazz 3 - D Nail Polish Jazz - Me - Green - 1027 12 ml,Warehouse B,15,3,2025-02-04 22:58:00,12
28540,ORD_28541,1988,"Newly Launched Smart Watch Charging Cable, Watch Holder Magnetic 24k Gold Plated 2 pin Cable, Compatible with T55, T100, T...",Warehouse B,92,87,2025-02-04 14:55:00,5
28541,ORD_28542,24586,Nabico 500mg Tablet,Warehouse B,57,42,2025-02-04 01:25:00,15
28542,ORD_28543,6943,Lla 5mg Tablet,Warehouse A,67,49,2025-02-04 06:30:00,18
28543,ORD_28544,24388,Jamriya Natural Baby Lotion 400 ml,Warehouse A,100,88,2025-02-04 04:35:00,12
28544,ORD_28545,16940,Euroglipt M 500mg/50mg Tablet,Warehouse A,62,51,2025-02-04 04:47:00,11
28545,ORD_28546,30944,Solution Anti Blackhead/Whitehead Masksheet (Pack of 10),Warehouse C,11,1,2025-02-04 17:39:00,10
28546,ORD_28547,17567,Amaze Body Deodorant,Warehouse A,24,12,2025-02-04 23:29:00,12
28547,ORD_28548,33967,"Dot & Key Glow Elixir Radiance Enhancing Face Oil, 20ml | Face Oil for Glowing Skin | For All Skin Types",Warehouse A,31,26,2025-02-04 03:08:00,5
28548,ORD_28549,16943,Gosart 25mg Tablet,Warehouse B,101,96,2025-02-04 18:38:00,5
28549,ORD_28550,33654,Relix MISS CLAIRE Soft Matte Lip cream Shade No.58,Warehouse A,43,34,2025-02-04 04:49:00,9
28550,ORD_28551,22088,Ondiman 2mg Injection,Warehouse C,113,96,2025-02-04 05:36:00,17
28551,ORD_28552,24280,Spigen EZ Fit Tempered Glass Screen Protector Guard for Galaxy S23 Plus - 2 Pack,Warehouse C,33,28,2025-02-04 17:48:00,5
28552,ORD_28553,31251,Lakme True Wear Color Crush Nail Color Shade 43 9 Ml,Warehouse C,85,75,2025-02-04 10:09:00,10
28553,ORD_28554,31745,"Wings Phantom 500 in Ear Earphones Wireless Earbuds with LED Battery Indicator, 40ms Low Latency, Bluetooth 5.1, 30 Hours ...",Warehouse A,57,50,2025-02-04 10:25:00,7
28554,ORD_28555,8853,SHREENOVA ID116 Plus Bluetooth Fitness Smart Watch for Men Women and Kids Activity Tracker (Black),Warehouse A,42,23,2025-02-04 05:26:00,19
28555,ORD_28556,31955,Cefkia SB 500mg/250mg Injection,Warehouse C,91,72,2025-02-04 20:32:00,19
28556,ORD_28557,33215,Daily Life Forever52 Star Dust Sd0018 Sd018 2.5 gm,Warehouse A,37,29,2025-02-04 04:32:00,8
28557,ORD_28558,10764,"Cuckoo Eyelash Extension Kit,Lash Extension Practice Kit,Mannequin Head Practice Exercise Set Training Lash Extension Supp...",Warehouse B,86,78,2025-02-04 15:56:00,8
28558,ORD_28559,22009,Theolar 20mg Tablet,Warehouse B,98,85,2025-02-04 19:39:00,13
28559,ORD_28560,25521,"Samsung Galaxy A14 5G (Dark Red, 4GB, 64GB Storage) | Triple Rear Camera (50 MP Main) | Upto 8 GB RAM with RAM Plus | Trav...",Warehouse A,36,17,2025-02-04 22:11:00,19
28560,ORD_28561,16582,Kyofur 250mg Tablet,Warehouse B,97,91,2025-02-04 05:59:00,6
28561,ORD_28562,32721,Olepra D 10mg/20mg Capsule,Warehouse B,100,86,2025-02-04 19:54:00,14
28562,ORD_28563,16760,Benzamos Plus 6mg/400mg Tablet,Warehouse A,8,3,2025-02-04 17:11:00,5
28563,ORD_28564,21733,Dr.Sheth's Face Cleansing Oil - Moringa & Vitamin C 50 ml,Warehouse A,24,13,2025-02-04 04:21:00,11
28564,ORD_28565,3125,Natapime 1000mg Injection,Warehouse A,27,9,2025-02-04 04:53:00,18
28565,ORD_28566,11608,Lapcare ChillMate Adjustable Laptop Cooling Pad with Twin Fans for Efficient Cooling,Warehouse A,21,8,2025-02-04 15:33:00,13
28566,ORD_28567,8634,Belkin Essential Series 8-Socket Surge Protector Universal Socket with 6.5ft Heavy Duty Cable (Grey),Warehouse B,105,91,2025-02-04 12:39:00,14
28567,ORD_28568,24882,NAUTICA Voyage N 83 Eau de Toilette - 100 ml (For Men),Warehouse A,34,22,2025-02-04 12:47:00,12
28568,ORD_28569,30527,Organic Harvest Face Wash - 6 in 1 (Sulphate Free) 125 gm,Warehouse C,62,54,2025-02-04 06:04:00,8
28569,ORD_28570,2083,"SMX 3 - 3 Blade Shaving System, Jumbo Pack",Warehouse B,57,47,2025-02-04 03:03:00,10
28570,ORD_28571,10846,Glucoact 40mg Tablet,Warehouse C,42,24,2025-02-04 00:18:00,18
28571,ORD_28572,15912,"ZEBRONICS ZEB-BT6590RUCF Wireless Bluetooth Multimedia Speaker with Supporting SD Card, USB, AUX, FM & Remote Control. (65...",Warehouse A,85,80,2025-02-04 16:30:00,5
28572,ORD_28573,6795,PureSense Rejuvenating Grapefruit Revitalising Face Cleansing Gel 100 ml,Warehouse B,42,31,2025-02-04 21:38:00,11
28573,ORD_28574,16591,Leveteo 500 Tablet,Warehouse A,20,14,2025-02-04 14:23:00,6
28574,ORD_28575,34214,C Mark 50mg Dry Syrup,Warehouse B,94,82,2025-02-04 16:44:00,12
28575,ORD_28576,12242,Atorgard 10mg Tablet,Warehouse C,98,87,2025-02-04 13:46:00,11
28576,ORD_28577,24106,Bioprox-CA 200mg/125mg Tablet,Warehouse B,36,30,2025-02-04 15:14:00,6
28577,ORD_28578,32382,Maxeron Mps 5 mg/125 mg Tablet,Warehouse A,68,60,2025-02-04 03:49:00,8
28578,ORD_28579,34362,Rabeshine 20mg Tablet,Warehouse B,79,67,2025-02-04 02:10:00,12
28579,ORD_28580,6350,Faces Canada Ultime Pro Gel Lustre Nail Lacquer Natural Love 41 9 Ml,Warehouse B,69,63,2025-02-04 09:54:00,6
28580,ORD_28581,21411,BlueRigger High Speed HDMI to DVI Adapter Cable (3 Feet / 0.9 Meter),Warehouse C,82,76,2025-02-04 08:32:00,6
28581,ORD_28582,10851,"Titan Smart 2 Fashion Smartwatch, 1.78” AMOLED Display with Premium Metal Body, Multiple Sports Modes with 100+ Watchface...",Warehouse A,54,41,2025-02-04 08:10:00,13
28582,ORD_28583,15927,BRUSTRO Technical Pen (Set of 9) (Includes: 1 each of 0.05mm; 0.1mm; 0.2mm; 0.3mm; 0.4mm; 0.5mm; 0.6mm; 0.8mm & Brush.),Warehouse A,93,75,2025-02-04 00:46:00,18
28583,ORD_28584,15411,Mirabelle Korea Tomato Fairness Facial Sheet Mask 25 Ml,Warehouse A,104,91,2025-02-04 08:13:00,13
28584,ORD_28585,16527,Vega Crystal Glass Nail File (NFL - 02) 38 gm,Warehouse A,76,70,2025-02-04 09:03:00,6
28585,ORD_28586,2100,"MI XIAOMI Dual Driver Dynamic Bass in-Ear Wired Earphones with Mic, 10mm& 8mm for Heavy Bass & Crystal Clear Vocals, Passi...",Warehouse B,98,90,2025-02-04 08:07:00,8
28586,ORD_28587,7035,Bisomend 5 Tablet,Warehouse C,47,34,2025-02-04 12:56:00,13
28587,ORD_28588,34399,Lakme Color Crush Nailart U4 6 Ml,Warehouse B,45,36,2025-02-04 01:58:00,9
28588,ORD_28589,6610,miss claire prestige lip eye makeup remover deep cleansing moisturizing waterproof makeup remover Net Wt..100ml Made in Ko...,Warehouse B,88,74,2025-02-04 11:49:00,14
28589,ORD_28590,2489,Cefis 200mg Tablet,Warehouse B,90,74,2025-02-04 16:19:00,16
28590,ORD_28591,2490,Plum Bright Years Restorative Overnight Creme 50 ml,Warehouse B,47,30,2025-02-04 14:33:00,17
28591,ORD_28592,32259,Glimmer Nail Polish Moulin Rouge 5 ml,Warehouse A,46,38,2025-02-04 06:00:00,8
28592,ORD_28593,15867,Electrolyte M 5% Infusion,Warehouse B,97,89,2025-02-04 01:22:00,8
28593,ORD_28594,24916,DeBelle Gel Nail Lacquer French Affair Red Nail Polish 8 ml,Warehouse B,21,5,2025-02-04 04:38:00,16
28594,ORD_28595,21591,Sehpod 50mg Dry Syrup,Warehouse B,38,32,2025-02-04 04:42:00,6
28595,ORD_28596,11530,Argan Body Butter,Warehouse A,97,81,2025-02-04 20:23:00,16
28596,ORD_28597,34261,Remedies Lemongrass & Lavender Handmade Luxury Soap,Warehouse B,27,18,2025-02-04 15:22:00,9
28597,ORD_28598,32423,Aloe Veda Distil Virgin Sesame Oil 200 ml,Warehouse A,16,10,2025-02-04 11:55:00,6
28598,ORD_28599,24112,Low-Dex Eye Drops,Warehouse B,38,28,2025-02-04 23:30:00,10
28599,ORD_28600,36715,Ritecef-O 50 Dry Syrup,Warehouse A,101,89,2025-02-04 12:34:00,12
28600,ORD_28601,17766,OUXUS USB all types smartwatch charger cable for boat watch charger & boat xtend watch charger & boat storm watch charger-...,Warehouse A,84,78,2025-02-04 09:22:00,6
28601,ORD_28602,32747,Lavitra 200mg Capsule,Warehouse A,14,8,2025-02-04 20:02:00,6
28602,ORD_28603,25601,Gemblue Biocare De Tan Face Mask 500 ml,Warehouse B,78,63,2025-02-04 22:58:00,15
28603,ORD_28604,16769,Pacinova MR 325mg/250mg Tablet,Warehouse A,57,44,2025-02-04 00:19:00,13
28604,ORD_28605,30467,HP v150w 64 GB USB 2.0 Flash Drive (Blue),Warehouse A,52,39,2025-02-04 09:12:00,13
28605,ORD_28606,15947,Mucet-M Kid Tablet,Warehouse B,50,42,2025-02-04 16:57:00,8
28606,ORD_28607,21727,HM Pk Store Generic bestbackup dc024 Battery for Airtel 2300mah Airtel AMF-311WW Data Card Hotspot doongle compataible dc0...,Warehouse C,14,8,2025-02-04 18:09:00,6
28607,ORD_28608,34279,"Shankhapushpi Syrup - Memory & Concentration Booster, For All Ages",Warehouse B,86,71,2025-02-04 21:49:00,15
28608,ORD_28609,8920,Camel Artist Water Colours Set 5ml x 12 shades,Warehouse B,97,88,2025-02-04 16:30:00,9
28609,ORD_28610,34388,LAZI 100ml Scented Laptop Screen Cleaner Cleaning Liquid Spray kit for Laptop PC Computer Tablet Smart Phone Screen Digita...,Warehouse B,86,67,2025-02-04 18:42:00,19
28610,ORD_28611,15283,Bonjour Paris Silk Matte Lipstick-Light Burgundy 4.2 gm,Warehouse A,107,90,2025-02-04 12:03:00,17
28611,ORD_28612,15816,100 % COLOR CHANGING COLOR POP MOISTURISING AND HYDRATING GEL LIPSTICK,Warehouse A,72,54,2025-02-04 16:57:00,18
28612,ORD_28613,3243,Clobirex F Cream,Warehouse B,20,3,2025-02-04 18:59:00,17
28613,ORD_28614,11997,AmazonBasics Dual-Arm Full-Motion TV Mount - 81.28-cm to 165.1-cm,Warehouse B,86,77,2025-02-04 00:13:00,9
28614,ORD_28615,33565,Citiflo 500mg/2ml Injection,Warehouse A,48,34,2025-02-04 12:25:00,14
28615,ORD_28616,15341,Malospar 200mg Tablet,Warehouse B,41,25,2025-02-04 04:51:00,16
28616,ORD_28617,24158,Fragrance Body Spray - Napoleon 150 ml + Fragrance Body Spray - Royal 150 ml,Warehouse A,25,15,2025-02-04 01:37:00,10
28617,ORD_28618,3641,Sery Move On Nail Enamel Remover 30 ml,Warehouse C,49,30,2025-02-04 12:19:00,19
28618,ORD_28619,15381,"HP 150 Wired Keyboard, Quick, Comfy and Ergonomically Design, 12Fn Shortcut Keys, Plug and Play USB Connection and LED Ind...",Warehouse C,36,20,2025-02-04 18:31:00,16
28619,ORD_28620,32250,"Smart Shelter Adjustable Size Universal 100% Metal Speaker Stand Wall Mount, Speaker Holder/Bracket, Accommodate All Speak...",Warehouse A,31,19,2025-02-04 22:58:00,12
28620,ORD_28621,32750,Gluflozin 5 Tablet,Warehouse B,104,97,2025-02-04 16:13:00,7
28621,ORD_28622,32236,Kare in Adult Diapers Pants Large,Warehouse A,78,62,2025-02-04 17:36:00,16
28622,ORD_28623,15374,"truke Newly Launched BTG Beta True Wireless in Ear Earbuds with 13mm Big Speaker Drivers,38H Playtime,Fast Charging,True G...",Warehouse B,111,98,2025-02-04 10:12:00,13
28623,ORD_28624,6611,Doltrip-BR Tablet,Warehouse A,23,11,2025-02-04 06:22:00,12
28624,ORD_28625,16640,Spigen Ultra Hybrid Cover Case for Apple Watch SE2 / 6 / SE / 5/4 (40mm) - Space Crystal (Watch not Included),Warehouse C,38,22,2025-02-04 03:06:00,16
28625,ORD_28626,32338,Paperkraft Expressions Gift Pack (Roller Ball Pen + Ball Pen)|Premium Metal Body Pens|Classic & Elegant Matte Blue Finish|...,Warehouse A,48,42,2025-02-04 20:25:00,6
28626,ORD_28627,16466,"TEC TAVAKKAL Card Reader, USB 3.0 All-in-1 USB 3.0/USB C/Micro USB Card Reader - SD, Micro SD, SDHC, Micro SDHC, Micro SDX...",Warehouse B,31,13,2025-02-04 00:06:00,18
28627,ORD_28628,32553,Deo Tripack For Men - Gentleman Classic + Gentleman Urbane + Gentleman Royale,Warehouse A,14,5,2025-02-04 14:02:00,9
28628,ORD_28629,32447,Amazon Brand - Solimo Back Cover Case for Asus Zenfone Max Pro M1 | Compatible for Asus Zenfone Max Pro M1 Back Cover Case...,Warehouse B,97,88,2025-02-04 19:06:00,9
28629,ORD_28630,15953,Octamop Tablet,Warehouse C,31,12,2025-02-04 06:40:00,19
28630,ORD_28631,15305,Fluocin Opthalmic Suspension,Warehouse B,23,12,2025-02-04 09:21:00,11
28631,ORD_28632,21927,"Amazon Basics USB A to Lightning Aluminum with Nylon Braided MFi Certified Charging Cable (Grey, 1.8 meter)",Warehouse B,20,5,2025-02-04 07:08:00,15
28632,ORD_28633,31470,"Pigeon Basics Non Induction Base Nons tick Aluminium Cookware set, including Nonstick Dosa Tawa, Nonstick Kadai With Glass...",Warehouse A,42,33,2025-02-04 17:19:00,9
28633,ORD_28634,3168,"S.A.V.I 3D Temporary Tattoo Feathers Metallic Sticker, 21X15Cm, Gold, 4 G",Warehouse B,90,85,2025-02-04 05:41:00,5
28634,ORD_28635,2530,Insight Cosmetics Concealer - Warm Yellow 3.5 gm,Warehouse B,31,16,2025-02-04 13:24:00,15
28635,ORD_28636,17829,Soulflower Herbal Peptide + Hyaluronic 4% Firming Serum - Complete Age Control Concentrate 40 ml,Warehouse C,67,58,2025-02-04 15:52:00,9
28636,ORD_28637,24982,Thromed 500 Tablet,Warehouse A,33,15,2025-02-04 08:13:00,18
28637,ORD_28638,3726,boAt Bassheads 152 Masaba Edition in Ear Wired Earphones with Mic(Aztec Fusion),Warehouse C,74,58,2025-02-04 10:05:00,16
28638,ORD_28639,2725,House of Aroma Jasmin Joy Fragrance Oil 100 ml,Warehouse B,94,75,2025-02-04 06:45:00,19
28639,ORD_28640,31573,"Dr. Jain's By Purenaturals Greynil Hair Dye, 500g - Dark Black",Warehouse C,50,44,2025-02-04 11:57:00,6
28640,ORD_28641,31577,Daily Life Forever52 Press Glitter Eyshadow/Nail Art Ps020 3 Gm,Warehouse C,16,4,2025-02-04 06:37:00,12
28641,ORD_28642,32660,"FLiX (Beetel Flow 03C USB Type A to Type C Braided Charge and data Sync Cable, upto 15W(3A) super fast charging, upto 480M...",Warehouse A,53,45,2025-02-04 14:13:00,8
28642,ORD_28643,11509,"Creme - 9 To 5, Naturale, Day, SPF 20",Warehouse A,57,39,2025-02-04 16:25:00,18
28643,ORD_28644,11916,Pregabawal NT 75mg/10mg Tablet,Warehouse B,92,87,2025-02-04 01:29:00,5
28644,ORD_28645,12266,Angiotel H 40mg/12.5mg Tablet,Warehouse B,69,62,2025-02-04 23:02:00,7
28645,ORD_28646,6783,Medocold Tablet,Warehouse B,39,28,2025-02-04 17:03:00,11
28646,ORD_28647,21377,Gemblue Biocare Fruit Face Mask 500 ml,Warehouse A,58,53,2025-02-04 08:56:00,5
28647,ORD_28648,32293,Eveready 1015 Carbon Zinc AA Batteries - 20 Pieces,Warehouse A,96,79,2025-02-04 08:09:00,17
28648,ORD_28649,21152,Geecef 200mg Tablet,Warehouse A,111,93,2025-02-04 07:16:00,18
28649,ORD_28650,2093,"HOME BUY Professional Cutting Mat A3 Self-Healing 5 Layers Double Sided Durable Non-Slip PVC 18"" X 12"" Inch",Warehouse C,13,7,2025-02-04 05:21:00,6
28650,ORD_28651,2680,"Ailun Camera Lens Protector for iPhone 13 Pro 6.1"" ＆ iPhone 13 Pro Max 6.7"",Tempered Glass,9H Hardness,Ultra HD,Anti-Scrat...",Warehouse C,20,4,2025-02-04 16:18:00,16
28651,ORD_28652,2062,Saco Ultra Clear Glossy Screen Guard Protector Compatible for HP Pavilion 15-au620TX 15.6-inch Laptop - Clear,Warehouse A,73,60,2025-02-04 01:50:00,13
28652,ORD_28653,33493,"RNTR® Cosmetic Pouch, Make up Bag for Home & Travel, Toiletry Bag for Cosmetics, Brushes, Accessories Set of 3 - Wash Bag...",Warehouse B,15,1,2025-02-04 18:58:00,14
28653,ORD_28654,10843,Sirona FDA Approved Non-Applicator Tampon - Heavy Flow 12's,Warehouse B,14,9,2025-02-04 13:40:00,5
28654,ORD_28655,30454,Unsym 0.2mg Tablet,Warehouse A,81,65,2025-02-04 01:35:00,16
28655,ORD_28656,15335,Norlead-PN Tablet,Warehouse C,47,30,2025-02-04 07:29:00,17
28656,ORD_28657,16669,Jemcuf-LS Syrup,Warehouse C,71,53,2025-02-04 12:46:00,18
28657,ORD_28658,17847,Esoborn-L Capsule SR,Warehouse A,59,47,2025-02-04 14:07:00,12
28658,ORD_28659,11218,TheGiftKart Genuine Liquid Silicone Back Cover Case for iPhone 14 PRO | Soft Micro-Fibre Lining Inside | Camera Protection...,Warehouse C,19,13,2025-02-04 05:44:00,6
28659,ORD_28660,10777,Noalzy 10mg Tablet,Warehouse B,30,21,2025-02-04 12:03:00,9
28660,ORD_28661,31613,Sprega  NT Tablet,Warehouse A,18,3,2025-02-04 13:53:00,15
28661,ORD_28662,12318,Uncle Tony Shaving Razor - Black,Warehouse A,72,60,2025-02-04 08:05:00,12
28662,ORD_28663,3121,Glynix M 2mg/500mg Tablet,Warehouse B,107,94,2025-02-04 23:28:00,13
28663,ORD_28664,15875,Plum E-Luminence The Bright Mix Face Serum 30 ml,Warehouse A,114,95,2025-02-04 00:22:00,19
28664,ORD_28665,32234,TRICINEX-PZ 150MG/750MG/225MG TABLET,Warehouse B,99,82,2025-02-04 20:30:00,17
28665,ORD_28666,15801,Amkette 4 Port Superspeed USB Hub 3.0 for PC/Laptops with Charging Function and 0.8 Meter Built-in Cable (Black),Warehouse A,33,20,2025-02-04 06:14:00,13
28666,ORD_28667,11535,Cefclik LB 200mg Tablet,Warehouse A,50,35,2025-02-04 21:55:00,15
28667,ORD_28668,16655,Excela Anti Acne Moisturizer for oily and Acne prone skin Available on 50gm for Daily use for Acne prone and Drynessface s...,Warehouse C,94,75,2025-02-04 10:35:00,19
28668,ORD_28669,11128,"GO SHOPS USB-C Female to Lightning 30W Cable Adapter, Type-C to 8 Pin Male PD Fast Charging Converter Data Sync Connector ...",Warehouse C,48,37,2025-02-04 02:59:00,11
28669,ORD_28670,15380,Doubledicestore Tempered Glass Screen Protector Compatible for redmi Note 7/Note 7 pro with Edge to Edge 11D and Easy Inst...,Warehouse B,60,50,2025-02-04 15:25:00,10
28670,ORD_28671,2509,Amazon Brand - Solimo Back Cover for Samsung Galaxy S20 FE (Silicone | Transparent),Warehouse C,57,41,2025-02-04 14:27:00,16
28671,ORD_28672,15822,Gum Care+ Tooth Brush With Bamboo Salt - Soft,Warehouse B,77,59,2025-02-04 23:01:00,18
28672,ORD_28673,11631,ZEBRONICS Zeb-Duke Wireless Bluetooth Over The Ear Headphone with Mic - (Green),Warehouse A,114,98,2025-02-04 20:56:00,16
28673,ORD_28674,15884,M.G.R.J® Portable Carrying Case Cover for Marshall Emberton/Marshall Emberton II Bluetooth Portable Speaker (Hard|EVA|Black),Warehouse C,67,59,2025-02-04 20:18:00,8
28674,ORD_28675,17826,"Sery Stay On Matte Liquid Lipstick Autumn Wind, Brown (LSO - 07) 5 ml",Warehouse C,61,44,2025-02-04 20:34:00,17
28675,ORD_28676,25553,Cephola 250mg Capsule,Warehouse C,64,47,2025-02-04 18:05:00,17
28676,ORD_28677,32287,Betaone R 50mg/5mg Tablet,Warehouse B,98,87,2025-02-04 02:18:00,11
28677,ORD_28678,8338,Organic Harvest Vitamin-A Face Sheet Mask 20 gm,Warehouse B,55,50,2025-02-04 15:57:00,5
28678,ORD_28679,21938,Black Diamond Shampoo & Body Wash 250 ml,Warehouse C,85,77,2025-02-04 22:22:00,8
28679,ORD_28680,15850,Gravinate OD 10 mg/10 mg Tablet,Warehouse B,23,15,2025-02-04 10:55:00,8
28680,ORD_28681,8776,Peptica Tablet,Warehouse C,81,73,2025-02-04 13:24:00,8
28681,ORD_28682,32628,Flormar Waterproof Lipliner 242 Deep Bordeaux 1.14 gm,Warehouse C,40,27,2025-02-04 17:30:00,13
28682,ORD_28683,6930,GREENWORTH® Pure & Natural Rose Water/Skin Toner Mist Spray - 200ml - Steam Distilled - Gulab Jal - Alcohol & Chemical Free,Warehouse B,75,58,2025-02-04 00:12:00,17
28683,ORD_28684,11133,Bombay Shaving Company Hair Removal Razor for Women (Pack of 3) | Safe and Hygienic | Experience Close and Irritation-Free...,Warehouse A,54,39,2025-02-04 20:08:00,15
28684,ORD_28685,17023,Ondem Injection,Warehouse C,97,91,2025-02-04 15:56:00,6
28685,ORD_28686,13731,Adpep N Tablet,Warehouse C,52,42,2025-02-04 20:26:00,10
28686,ORD_28687,35684,Handwash - Strawberry,Warehouse B,19,12,2025-02-04 23:17:00,7
28687,ORD_28688,23207,"AmazonBasics Laptop Sleeve Case Cover Pouch for 13-Inch(33.02 Cm), 13.3-Inch (33.78 Cm) Laptop for Men & Women | Slim Prof...",Warehouse C,37,19,2025-02-04 23:17:00,18
28688,ORD_28689,6051,Viocip 500mg Tablet,Warehouse B,20,1,2025-02-04 19:52:00,19
28689,ORD_28690,9680,"WeCool Moonwalk M2 ENC Earbuds with 48 Hours Playtime, Rich Music Experience, 4 Mic ENC for best Handsfree Calling Experie...",Warehouse B,75,69,2025-02-04 14:34:00,6
28690,ORD_28691,6049,Crucial RAM 16GB DDR4 3200 MHz CL22 Laptop Memory CT16G4SFRA32A,Warehouse B,45,35,2025-02-04 01:38:00,10
28691,ORD_28692,14325,Itrozec 100mg Capsule,Warehouse B,65,59,2025-02-04 00:43:00,6
28692,ORD_28693,7967,iFFALCON 80 cm (32 inches) HD Ready LED TV 32E32 (Black),Warehouse A,78,60,2025-02-04 04:49:00,18
28693,ORD_28694,36571,"Face Mask GP95+ - Blue, Small",Warehouse C,41,31,2025-02-04 14:54:00,10
28694,ORD_28695,28814,Love Earth Lip Tint & Cheek Tint Multipot Combo (Coral & Raspberry Pink) with Richness of Jojoba Oil and Vitamin E for Lip...,Warehouse A,26,9,2025-02-04 23:56:00,17
28695,ORD_28696,7968,Combo - Alta(Big) /Deluxe Sindoor/Liquid Sindoor(M)/Powder (Paradise),Warehouse A,21,10,2025-02-04 16:04:00,11
28696,ORD_28697,4617,Instant Pain Relief,Warehouse B,103,97,2025-02-04 21:50:00,6
28697,ORD_28698,26725,"Lava Yuva 2 Pro (Glass Green, 4GB RAM, 64GB Storage)| 2.3 Ghz Octa Core Helio G37| 13 MP AI Triple Camera |Fingerprint Sen...",Warehouse B,89,79,2025-02-04 23:23:00,10
28698,ORD_28699,4620,"Enchanteur Alluring Perfumed Deo Spray for Women, 150ml",Warehouse B,101,87,2025-02-04 01:54:00,14
28699,ORD_28700,35657,boAt Bassheads 105 Wired in Ear Earphones with Mic (Blue),Warehouse B,85,67,2025-02-04 13:02:00,18
28700,ORD_28701,10193,"Ceptics USA to India Converter Plug, World (USA, China) Australia UK to India Plug Converter - Type D Plug Adapter - Canad...",Warehouse B,75,57,2025-02-04 18:00:00,18
28701,ORD_28702,36617,"(Renewed) Nothing Phone (1) (Black, 128 GB) (8 GB RAM)",Warehouse A,19,8,2025-02-04 20:59:00,11
28702,ORD_28703,28918,Ajmal Blu & Sacrifice II Him Deo & Yearn EDP Pack of 3 20 ml,Warehouse A,81,66,2025-02-04 15:56:00,15
28703,ORD_28704,13190,Sistazan 90mg/48mg/100mg Tablet,Warehouse C,19,12,2025-02-04 12:52:00,7
28704,ORD_28705,259,Sivanna Colors Moon & Star Mini Palette - HF6040 03 03 gm,Warehouse B,41,26,2025-02-04 20:35:00,15
28705,ORD_28706,28994,Uflox 400mg Tablet,Warehouse C,32,26,2025-02-04 05:10:00,6
28706,ORD_28707,19751,Biomox Kid 125mg Tablet,Warehouse A,13,6,2025-02-04 04:58:00,7
28707,ORD_28708,14415,"HP Smart Tank 525 All-in-one Colour Printer (Upto 6000 Black and 6000 Colour Pages Included in The Box). - Print, Scan & C...",Warehouse B,13,1,2025-02-04 12:18:00,12
28708,ORD_28709,20717,Iba Advanced Activs Youth Preserve Vitamin C Face Wash l No Parabens & Sulfates l High Foam l For Glowing Skin,Warehouse C,95,78,2025-02-04 12:10:00,17
28709,ORD_28710,28971,Allure Blending Brush (eye Brush C-19 ) 1's,Warehouse C,37,30,2025-02-04 08:09:00,7
28710,ORD_28711,9664,TheGiftKart Back Cover Case for Samsung Galaxy S21 FE 5G Back Cover Case | Soft Silicon Rubberised Matte Cover | Protectiv...,Warehouse B,38,31,2025-02-04 08:17:00,7
28711,ORD_28712,35604,"Lava X3(‎Luster Blue, 3GB RAM, 32GB Storage) | 8MP Dual Camera | Fingerprint Sensor | Android 12 Go Edition | 6.5 inch HD+...",Warehouse B,30,19,2025-02-04 15:04:00,11
28712,ORD_28713,5314,Robustrion Hybrid Flip Stand Case Cover for iPad Air 5th Generation Cover/iPad Air 4th Generation iPad Air 5th Generation ...,Warehouse C,69,52,2025-02-04 13:14:00,17
28713,ORD_28714,10212,"winPlus Adjustable Laptop Cooling Pad with 6 Fans, RGB Lights, Phone Holder and Dual USB Ports for Laptop Upto 17 Inch",Warehouse A,75,62,2025-02-04 15:03:00,13
28714,ORD_28715,23640,Chambor Silver Shadow - Ivoire Rr1-101 16 gm,Warehouse A,83,68,2025-02-04 17:32:00,15
28715,ORD_28716,36584,Amazon Basics Hi-Speed 4 Port Ultra Slim USB 2.0 Hub for Laptops and Computers (Black),Warehouse B,18,13,2025-02-04 13:57:00,5
28716,ORD_28717,18795,Caxin 0.25mg Tablet,Warehouse B,82,74,2025-02-04 09:56:00,8
28717,ORD_28718,7157,Vega Cuticle Scissor (CS - 01) 17 gm,Warehouse A,95,90,2025-02-04 12:03:00,5
28718,ORD_28719,11872,Vomipen 2mg Injection,Warehouse B,33,20,2025-02-04 11:47:00,13
28719,ORD_28720,11111,Chyawanprash For Kids & Adults - Ayurvedic Immunity Booster,Warehouse B,91,83,2025-02-04 02:48:00,8
28720,ORD_28721,21431,Faber-Castell Erasable Crayon Tin Set - Pack of 12 (Assorted) + 2 FREE Gold and Silver,Warehouse C,73,57,2025-02-04 00:51:00,16
28721,ORD_28722,33255,Adzolam 0.25mg Tablet,Warehouse C,109,93,2025-02-04 18:54:00,16
28722,ORD_28723,24566,Gabaroot NT 100mg/10mg Tablet,Warehouse A,47,30,2025-02-04 09:37:00,17
28723,ORD_28724,21550,Flormar Extreme Matte Lipstick 009 Skin Tone 4 gm,Warehouse C,54,47,2025-02-04 13:36:00,7
28724,ORD_28725,25295,Clotrinec B Lotion,Warehouse C,106,96,2025-02-04 09:38:00,10
28725,ORD_28726,25458,Spigen Ultra Hybrid Magfit Back Cover Case Compatible with MagSafe Designed for iPhone 14 Pro (TPU + Poly Carbonate | Deep...,Warehouse A,30,23,2025-02-04 20:43:00,7
28726,ORD_28727,21190,Espresso Body Scrub - With Coffee & Walnut Shell Powder,Warehouse A,39,24,2025-02-04 16:22:00,15
28727,ORD_28728,24223,Ant Esports VS450L 450 Watt Non-Modular Continuous Power Gaming Power Supply/PSU for PC,Warehouse B,25,15,2025-02-04 08:33:00,10
28728,ORD_28729,24224,Sirona Face Serum - Anti-Acne 30 ml,Warehouse A,62,50,2025-02-04 18:56:00,12
28729,ORD_28730,7151,Patchouli Man Deodorant,Warehouse A,41,23,2025-02-04 19:05:00,18
28730,ORD_28731,16014,Pantofirst D 30mg/40mg Tablet SR,Warehouse A,32,25,2025-02-04 03:19:00,7
28731,ORD_28732,8862,"Oppo Enco Air 2 Bluetooth Truly Wireless in Ear Earbuds with Mic, Fast Charging & Up to 24Hrs Battery - Blue",Warehouse B,63,56,2025-02-04 13:33:00,7
28732,ORD_28733,16888,Femzone 1000mg/500mg Injection,Warehouse C,106,91,2025-02-04 01:44:00,15
28733,ORD_28734,2862,Rozidal 4mg Tablet,Warehouse B,13,5,2025-02-04 08:24:00,8
28734,ORD_28735,9145,Qudraforce Plus Ear Drop,Warehouse A,80,69,2025-02-04 01:36:00,11
28735,ORD_28736,3528,CARE CASE ® Headphones Shock Proof Pouch for Boat Airdopes 141/148 with LED Light Indicator Protective Soft Silicone Case ...,Warehouse A,60,43,2025-02-04 08:31:00,17
28736,ORD_28737,7147,Hydrating & Exfoliating Walnut Apricot Scrub,Warehouse A,40,26,2025-02-04 18:42:00,14
28737,ORD_28738,25444,Lan Flu Tablet,Warehouse C,18,13,2025-02-04 06:48:00,5
28738,ORD_28739,1764,Biolage Advanced Repairinside Shampoo,Warehouse B,40,28,2025-02-04 08:45:00,12
28739,ORD_28740,32020,"(Renewed) Nokia 105 Single SIM, Keypad Mobile Phone with Wireless FM Radio | Charcoal",Warehouse C,79,73,2025-02-04 19:00:00,6
28740,ORD_28741,3297,adidas SPT Bb Fz Long Sleeve,Warehouse B,18,5,2025-02-04 10:27:00,13
28741,ORD_28742,11391,Apsara Absolute Extra Dark Pencils - Pack of 10,Warehouse C,58,50,2025-02-04 15:58:00,8
28742,ORD_28743,12032,"cosluxe Natrul cushion, Mushroom Head Air Cushion CC Cream, BB Cream, Concealer Lasting Nude Makeup Moisturizing Oil Contr...",Warehouse C,63,44,2025-02-04 07:55:00,19
28743,ORD_28744,8363,Biosoft Charcoal Cream Wax Refill Roll On Wax 100 ml,Warehouse C,93,85,2025-02-04 05:27:00,8
28744,ORD_28745,11746,GadgetBite External Printed Hard Drive Disk Enclosure Portable Carrying Case Cover Pouch Casing for 2.5-Inch Hard Drive (G...,Warehouse B,67,48,2025-02-04 04:58:00,19
28745,ORD_28746,24692,HP USB Wireless Spill Resistance Keyboard and Mouse Set with 10m Working Range 2.4G Wireless Technology / 3 Years Warranty...,Warehouse B,89,80,2025-02-04 03:23:00,9
28746,ORD_28747,5626,Flormar Dewy Lip Glaze 11 Chic Burgundy 4.5 ml,Warehouse A,68,61,2025-02-04 23:54:00,7
28747,ORD_28748,29012,Paintol AP Tablet,Warehouse A,68,53,2025-02-04 09:53:00,15
28748,ORD_28749,14384,Jolyon 15mg Tablet MD,Warehouse A,88,78,2025-02-04 08:14:00,10
28749,ORD_28750,18758,"The Man Company Face on Point Facial Kit with Vitamin C Serum, Charcoal Face Wash & Face Scrub, daily Moisturizing Cream |...",Warehouse B,42,37,2025-02-04 08:28:00,5
28750,ORD_28751,26754,Avinim Plus Suspension,Warehouse B,49,34,2025-02-04 15:58:00,15
28751,ORD_28752,6043,Vermikey Plus Oral Suspension,Warehouse B,15,6,2025-02-04 09:35:00,9
28752,ORD_28753,18848,Raminace 2.5mg Tablet,Warehouse A,104,93,2025-02-04 15:56:00,11
28753,ORD_28754,9707,Generic Home Theater Remote Control compactable for Sony anu156 Model tv,Warehouse B,99,81,2025-02-04 15:38:00,18
28754,ORD_28755,27662,Cumbak Tablet,Warehouse A,48,43,2025-02-04 06:58:00,5
28755,ORD_28756,28762,"PLIXIO Plastic Desktop Mobile Phone Tabletop Stand, Mobile Holder Adjustable & Foldable Mobile Stand for Mobile Phone and ...",Warehouse B,50,42,2025-02-04 03:15:00,8
28756,ORD_28757,4655,"LIDBOX Foldable Wooden Mini Laptop Table for Bed, Study Table with Drawer, Tablet/Mobile Holder for Kids & Adults (DOREMON)",Warehouse C,31,24,2025-02-04 03:23:00,7
28757,ORD_28758,26221,Nextcam P 8mg/500mg Tablet,Warehouse A,105,86,2025-02-04 07:21:00,19
28758,ORD_28759,28752,Moelissa MS-LT02 RJ45 and RJ11 Network Cable Tester,Warehouse B,72,67,2025-02-04 06:31:00,5
28759,ORD_28760,19658,EYETEX PALLAVI BINDI P2 MAROON PACK OF 15,Warehouse A,74,66,2025-02-04 03:13:00,8
28760,ORD_28761,23584,Sery Colorflirt Nail Paint Tricky Purple 10 ml,Warehouse A,92,80,2025-02-04 16:56:00,12
28761,ORD_28762,823,Chronac 200mg Tablet SR,Warehouse C,105,95,2025-02-04 12:31:00,10
28762,ORD_28763,20666,Radkuf P Syrup,Warehouse A,59,49,2025-02-04 04:23:00,10
28763,ORD_28764,22788,JUSTEC Premium Keyboard Cover Protector for New HP Pavilion 15-eh 15-eg 15-er Series Laptop - Clear,Warehouse B,91,83,2025-02-04 01:11:00,8
28764,ORD_28765,5254,"Face Mask - Pro Tech 95, 6 layered, Large, MK18003",Warehouse B,56,41,2025-02-04 03:50:00,15
28765,ORD_28766,12767,Cenopran 80mg Tablet SR,Warehouse A,116,97,2025-02-04 02:42:00,19
28766,ORD_28767,18763,Glimmer Nail Polish Dark Maroon 5 ml,Warehouse B,60,48,2025-02-04 20:23:00,12
28767,ORD_28768,35851,Herbal Day Cream,Warehouse A,44,37,2025-02-04 02:51:00,7
28768,ORD_28769,19760,Arcekay 100mg Tablet,Warehouse C,7,2,2025-02-04 03:19:00,5
28769,ORD_28770,5734,V-Guard VG 50 Voltage Stabilizer for Refrigerator (Grey),Warehouse A,41,23,2025-02-04 01:52:00,18
28770,ORD_28771,12690,"HP K500F Backlit Membrane Wired Gaming Keyboard with Mixed Color Lighting, Metal Panel with Logo Lighting, 26 Anti-Ghostin...",Warehouse C,26,10,2025-02-04 13:31:00,16
28771,ORD_28772,1039,OpenTech® Tempered Glass Screen Protector Compatible for OnePlus Nord Edge to Edge Coverage with Easy Installation kit,Warehouse C,22,7,2025-02-04 08:28:00,15
28772,ORD_28773,29230,"Colorbar Glow With Love Highlighter, Prismatic Romance",Warehouse B,76,70,2025-02-04 19:23:00,6
28773,ORD_28774,18595,Flormar Deluxe Cashmere Lipstick Stylo DC21 Natural Beige 3 gm,Warehouse A,46,28,2025-02-04 07:05:00,18
28774,ORD_28775,20313,Irusu Monster vr Headset with in Built Touch Button for vr Supported mobiles(New Model) (Black),Warehouse B,51,42,2025-02-04 17:51:00,9
28775,ORD_28776,10315,Vivocet 5mg Tablet,Warehouse A,97,79,2025-02-04 03:39:00,18
28776,ORD_28777,13882,Bimox CV 500mg/125mg Tablet,Warehouse C,33,23,2025-02-04 09:41:00,10
28777,ORD_28778,23745,Onion Shampoo For Hair Growth & Hair Fall Control - Onion Oil & Plant Keratin,Warehouse C,26,12,2025-02-04 04:15:00,14
28778,ORD_28779,35718,Levofem 250mg Tablet,Warehouse A,41,27,2025-02-04 12:48:00,14
28779,ORD_28780,28789,Apple AirPods (3rd Generation) with Lightning Charging Case ​​​​​​​,Warehouse C,11,1,2025-02-04 06:37:00,10
28780,ORD_28781,13169,LIRAMARK Shockproof Protective Silicone 360° Cover Case with Buckle Designed for JBL Tune 230NC TWS (Black),Warehouse C,13,5,2025-02-04 11:32:00,8
28781,ORD_28782,22805,Beauty People Sheer Color Lipstick - 605 3.8 gm,Warehouse B,88,74,2025-02-04 05:07:00,14
28782,ORD_28783,268,Robustrion Smart Trifold Hard Back Flip Stand Case for Samsung Tab A 10.1 Back Cover T510/T515 10.1 inch 2019 - Black,Warehouse A,71,52,2025-02-04 23:42:00,19
28783,ORD_28784,18774,"Redmi Watch 2 Lite - Multi-System Standalone GPS, 3.94 cm Large HD Edge Display, Continuous SpO2, Stress & Sleep Monitorin...",Warehouse B,82,68,2025-02-04 06:33:00,14
28784,ORD_28785,13735,DavaIndia Azathioprine 50mg Tablet,Warehouse A,60,52,2025-02-04 08:23:00,8
28785,ORD_28786,13738,"Face Mask With Anti Viral Coating - 2 Ply, Cotton, Medium",Warehouse B,37,28,2025-02-04 21:26:00,9
28786,ORD_28787,838,"TIED RIBBONS Pack of 20 - Organza Pouches Return Gift Bags Potlis for Wedding Party (13 cm X 18 cm, Assorted Color)",Warehouse C,53,41,2025-02-04 04:44:00,12
28787,ORD_28788,4685,"Saregama Carvaan Premium- Portable Music Player with 5000 Preloaded Songs, FM/BT/AUX (Oakwood Brown)",Warehouse A,64,51,2025-02-04 03:01:00,13
28788,ORD_28789,35753,Ros Rest 10mg Tablet,Warehouse C,12,2,2025-02-04 07:54:00,10
28789,ORD_28790,7548,Omigas Capsule,Warehouse C,10,2,2025-02-04 02:50:00,8
28790,ORD_28791,14270,Retinol Advanced Anti-Aging Face Mask,Warehouse A,29,22,2025-02-04 15:58:00,7
28791,ORD_28792,803,Euroest 0.25mg Tablet,Warehouse A,82,70,2025-02-04 08:30:00,12
28792,ORD_28793,12856,"TP-Link Powered USB Hub with 7 Data Smart Charging USB 3.0 Ports, Compatible with Windows, Mac OS X and Linux Systems, 5V/...",Warehouse B,77,62,2025-02-04 14:41:00,15
28793,ORD_28794,14266,"Fashion Colour Non - Transfer Matt Waterproof Lipstick, 42 Conch Shell 2.6 gm",Warehouse C,110,97,2025-02-04 10:36:00,13
28794,ORD_28795,28694,"AVTY Beauty 2+1 Pcs Makeup Sponges with Makeup Foundation Brush, Professional Foundation Beauty Sponge and Makeup Brush fo...",Warehouse A,53,39,2025-02-04 23:20:00,14
28795,ORD_28796,28682,"Cigar Deodorant for Unisex, 200 Milliliters",Warehouse B,45,38,2025-02-04 11:21:00,7
28796,ORD_28797,12868,Vizep 10mg Tablet,Warehouse A,45,34,2025-02-04 06:07:00,11
28797,ORD_28798,26696,"ROYAL NEEDS ; YOUR HIGHNESS Undiluted Therapeutic Grade Tea Tree Essential Oil for Skin, Hair and Acne Care (15ml)",Warehouse A,20,13,2025-02-04 05:17:00,7
28798,ORD_28799,6017,Crucial Basics 4GB DDR4 1.2v 2666Mhz CL19 SODIMM RAM Memory Module for Laptops and Notebooks,Warehouse B,72,62,2025-02-04 19:41:00,10
28799,ORD_28800,18921,Meyaar Leather Case Cover Only Compatible with Boat Airdopes 141 & Boat Airdopes 148 (Earbuds Not Included) (Leather Yellow),Warehouse A,29,10,2025-02-04 13:31:00,19
28800,ORD_28801,35806,Saltol Plus Kid Syrup,Warehouse B,99,80,2025-02-04 12:06:00,19
28801,ORD_28802,26691,Opulus Eye Drop,Warehouse A,40,22,2025-02-04 08:46:00,18
28802,ORD_28803,27680,Tacsant 0.5mg Capsule,Warehouse A,63,44,2025-02-04 17:43:00,19
28803,ORD_28804,13762,Ayurvedic Tea Tree Hair Repair Serum,Warehouse A,76,71,2025-02-04 01:58:00,5
28804,ORD_28805,14243,Almond Shampoo - Hair Growth & Hairfall Control,Warehouse C,74,58,2025-02-04 10:18:00,16
28805,ORD_28806,12884,Duradol DP 10mg/325mg/37.5mg Tablet,Warehouse A,73,65,2025-02-04 17:12:00,8
28806,ORD_28807,35750,Revlon Nearly Naked Makeup - Fresh Beige 30 Ml,Warehouse B,18,11,2025-02-04 12:06:00,7
28807,ORD_28808,4658,Daily Life Forever52 Star Dust Eyeshadow Glitter Sd007 2.5 gm,Warehouse A,47,32,2025-02-04 10:04:00,15
28808,ORD_28809,22593,"Arata Natural Hair Care Essentials With Cleansing Shampoo(75 Ml), Conditioner(75 Ml), Hair Gel(50 Ml) & Hair Cream(50 Ml) 250 ml",Warehouse C,63,57,2025-02-04 17:28:00,6
28809,ORD_28810,9709,Wet N Wild Makeup Brush - Small Eyeshadow Brush 1's,Warehouse C,86,74,2025-02-04 07:45:00,12
28810,ORD_28811,32046,Lyzal-M Tablet,Warehouse C,106,87,2025-02-04 16:44:00,19
28811,ORD_28812,27468,Alencuf DX Syrup,Warehouse A,16,3,2025-02-04 03:44:00,13
28812,ORD_28813,8510,Myglamm Iridescent Brightening Eye Cream 15 Ml,Warehouse A,102,93,2025-02-04 17:13:00,9
28813,ORD_28814,31684,Deodorant & Complexation Soap - Original,Warehouse A,26,13,2025-02-04 04:50:00,13
28814,ORD_28815,1694,Fogg Master Oak 150 Ml,Warehouse B,102,94,2025-02-04 16:32:00,8
28815,ORD_28816,30919,Jtus-GT Syrup,Warehouse B,108,92,2025-02-04 00:40:00,16
28816,ORD_28817,12208,"Gonegal Makeup Sponge Set Beauty Sponges Blender Set with Egg Case, Soft Sponge For Liquid Foundation,Creams and Powders,L...",Warehouse B,65,51,2025-02-04 01:13:00,14
28817,ORD_28818,24211,Sivanna Colors Natural Megic Color Blush - 02 8.5 gm,Warehouse C,77,65,2025-02-04 19:43:00,12
28818,ORD_28819,6863,Tata Sky Universal Set Top Box Remote Compatible,Warehouse A,71,61,2025-02-04 13:38:00,10
28819,ORD_28820,24399,Boujee Beauty 3 Pcs Small Eye Makeup Brush Set for Precise Eyeshadow Blending and Cut Crease,Warehouse A,52,41,2025-02-04 17:15:00,11
28820,ORD_28821,6721,Nimudec Plus Tablet,Warehouse A,42,28,2025-02-04 15:59:00,14
28821,ORD_28822,30777,Daily Skincare Essentials Box,Warehouse B,26,21,2025-02-04 12:47:00,5
28822,ORD_28823,21187,Vertijab 16mg Tablet,Warehouse A,29,19,2025-02-04 15:37:00,10
28823,ORD_28824,33270,REDTECH Newly Launched FireBolt 360 SpO2 Smart Watch Charger 2 Pin USB Fast Charger Magnetic Charging Cable Adapter (Smart...,Warehouse A,106,89,2025-02-04 13:56:00,17
28824,ORD_28825,24214,Magnamont L Tablet,Warehouse C,74,60,2025-02-04 15:47:00,14
28825,ORD_28826,17354,XX Revolution press shadow palette xxtravagant 1.2 gm,Warehouse C,101,87,2025-02-04 16:54:00,14
28826,ORD_28827,10888,Cotbolt Silicone Case Cover Compatible for Samsung BN59-01312A QLED 8K 4K Smart TV Remote Shockproof Protective Remote Cov...,Warehouse C,60,53,2025-02-04 03:36:00,7
28827,ORD_28828,11728,Argan Oil - Body Butter,Warehouse C,68,50,2025-02-04 18:09:00,18
28828,ORD_28829,24755,Vega Tulip Grooming Comb Medium (DC - 1279) 27 gm,Warehouse B,80,68,2025-02-04 19:58:00,12
28829,ORD_28830,32114,VeleSolv 4-Tier Metal Mesh A4 Size Files Rack File Desk Organizer with Slidable Compartments - Black,Warehouse C,55,49,2025-02-04 20:49:00,6
28830,ORD_28831,2006,Lip Balm - Fruity Fusion,Warehouse A,78,71,2025-02-04 12:35:00,7
28831,ORD_28832,32078,Natural Glow Skin Radiance 1 Facial Kit,Warehouse B,104,95,2025-02-04 05:39:00,9
28832,ORD_28833,3280,Amozo Ultra Hybrid Camera and Drop Protection Back Cover Case for iPhone 13 Pro (TPU + Polycarbonate | Crystal Transparent),Warehouse C,13,7,2025-02-04 03:33:00,6
28833,ORD_28834,6868,Pierre Cardin Paris - Iconic Palette Eyeshadow Stiletto,Warehouse A,68,61,2025-02-04 08:20:00,7
28834,ORD_28835,25163,Anti-Pollution Creme,Warehouse C,56,38,2025-02-04 02:13:00,18
28835,ORD_28836,3557,"Face Wash - Lavender & Tea Tree Oil, Anti-Acne",Warehouse C,45,26,2025-02-04 23:03:00,19
28836,ORD_28837,34116,Cipden 500mg Tablet,Warehouse C,49,40,2025-02-04 03:20:00,9
28837,ORD_28838,11403,I-Caris Tablet,Warehouse A,95,88,2025-02-04 09:13:00,7
28838,ORD_28839,21188,"Lava Blaze 5G (Glass Blue, 4GB RAM, UFS 2.2 128GB Storage) | 5G Ready | 50MP AI Triple Camera | Upto 7GB Expandable RAM | ...",Warehouse C,79,69,2025-02-04 16:16:00,10
28839,ORD_28840,10896,Magnacet 5mg Tablet,Warehouse A,90,76,2025-02-04 15:34:00,14
28840,ORD_28841,2848,"Zebronics Zeb-Warrior 2.0 Multimedia Speaker With Aux Connectivity,USB Powered And Volume Control",Warehouse C,49,36,2025-02-04 01:15:00,13
28841,ORD_28842,10897,"Redmi A1 (Black, 2GB RAM, 32GB Storage) | Segment Best AI Dual Cam | 5000mAh Battery | Leather Texture Design | Android 12",Warehouse A,105,91,2025-02-04 23:42:00,14
28842,ORD_28843,3281,Nutriment Papaya Mask All Skin Type 300 gm,Warehouse A,61,51,2025-02-04 22:51:00,10
28843,ORD_28844,16870,Quitsun 50mg Tablet,Warehouse C,96,79,2025-02-04 01:22:00,17
28844,ORD_28845,16924,Bathing Bar - Ice Cube,Warehouse C,104,98,2025-02-04 02:32:00,6
28845,ORD_28846,31266,Bella Voste 4-In-1 Makeup Stick Green (23) 5.5 Gm,Warehouse B,101,86,2025-02-04 19:37:00,15
28846,ORD_28847,3017,Platinum Facial Kit,Warehouse C,23,10,2025-02-04 08:24:00,13
28847,ORD_28848,31114,Tigatel 4mg Tablet,Warehouse A,57,45,2025-02-04 14:21:00,12
28848,ORD_28849,17486,Wayona Usb Type C To Usb Nylon Braided Quick Charger Fast Charging Short Cable For Smartphone (Samsung Galaxy S21/S20/S10/...,Warehouse C,42,27,2025-02-04 15:42:00,15
28849,ORD_28850,3028,"Qizlar Extended Gaming Mouse Pad (800mm x 300mm x 3mm) Extra Large Gaming Mouse Mat for Gamer, Waterproof Office Desktop M...",Warehouse C,89,81,2025-02-04 18:46:00,8
28850,ORD_28851,6496,"Luxor CD/DVD/OHP Marker - Pack of 10, Black Colour",Warehouse B,40,30,2025-02-04 02:09:00,10
28851,ORD_28852,17070,"Mizi 40W USB C Wall Charger - Dual Port Fast Charger, PD 3.0 USB-C Power Delivery Adapter for iPhone 14 Series/iPhone 13 S...",Warehouse C,73,61,2025-02-04 13:51:00,12
28852,ORD_28853,31046,Wandiz-LC Tablet,Warehouse C,112,95,2025-02-04 18:23:00,17
28853,ORD_28854,2959,Amazon Brand - Solimo Back Cover for Apple iPhone 11 Pro (Silicone_Transparent),Warehouse C,64,49,2025-02-04 22:55:00,15
28854,ORD_28855,16999,Telcros H Tablet,Warehouse A,52,34,2025-02-04 21:08:00,18
28855,ORD_28856,11000,"Lenovo Tab M10 FHD 3rd Gen (10.1 inch (25.65 cm), 4 GB, 64 GB, Wi-Fi), Storm Grey",Warehouse B,51,35,2025-02-04 02:07:00,16
28856,ORD_28857,22052,Metomend-XL 50 Tablet,Warehouse A,86,70,2025-02-04 03:32:00,16
28857,ORD_28858,31061,Moxi LP Eye Drop,Warehouse A,42,27,2025-02-04 18:33:00,15
28858,ORD_28859,33185,Spigen Lite Fit Band Strap Compatible with Apple Watch Series 7 (45mm) | 6 | 5 | 4 (44mm) | 3 | 2 | 1 (42mm),Warehouse B,115,96,2025-02-04 08:42:00,19
28859,ORD_28860,33840,R Levo 500mg Tablet,Warehouse A,44,34,2025-02-04 10:29:00,10
28860,ORD_28861,11321,Lentard 40IU/ml Injection,Warehouse C,84,73,2025-02-04 13:06:00,11
28861,ORD_28862,33827,Revolution Pro Lipstick Collection Noir 16 gm,Warehouse C,97,88,2025-02-04 00:34:00,9
28862,ORD_28863,31083,"Deodorant Roll On - Deep Impact Freshness, 48 h Anti Perspirant Freshness",Warehouse A,89,77,2025-02-04 21:23:00,12
28863,ORD_28864,8812,Acenip 100 mg/325 mg Tablet,Warehouse A,25,11,2025-02-04 14:55:00,14
28864,ORD_28865,22032,"Fashion Colour Terra Cotta Blusher, Shade 08 8 gm",Warehouse C,40,32,2025-02-04 06:44:00,8
28865,ORD_28866,33178,AEIDESS Tempered Glass Screen Protector Compatible For Oneplus 7T with Edge to Edge Coverage and Easy Installation Kit,Warehouse A,108,96,2025-02-04 17:38:00,12
28866,ORD_28867,22031,The Woman's Company Panty Liners - Regular 30's,Warehouse B,73,67,2025-02-04 19:23:00,6
28867,ORD_28868,33090,SONIA Background Stand Kit 9 ft (274 cm) x 9 ft (274 cm) Photography Support System Kit Portable Foldable with Carry Bag,Warehouse C,31,18,2025-02-04 09:50:00,13
28868,ORD_28869,15691,Anupan D 10mg/40mg Tablet,Warehouse A,83,70,2025-02-04 18:33:00,13
28869,ORD_28870,6503,Street Wear Lip2Last Matte Liquid Lipstick - Chillax Pink 5 ml,Warehouse B,28,9,2025-02-04 23:55:00,19
28870,ORD_28871,31102,Glimmer Nail Polish Cabaret 5 ml,Warehouse B,113,97,2025-02-04 03:56:00,16
28871,ORD_28872,16077,Bio-Cell Firming Face Mask,Warehouse A,18,9,2025-02-04 04:18:00,9
28872,ORD_28873,17009,Monast FX 10mg/120mg Tablet,Warehouse A,62,43,2025-02-04 18:11:00,19
28873,ORD_28874,33805,Mitycip T 250mg/300mg Tablet,Warehouse C,18,10,2025-02-04 17:30:00,8
28874,ORD_28875,2285,Global Desi DremyD EDP & CosmiD Mist Pack of 2 250 ml,Warehouse C,115,97,2025-02-04 00:58:00,18
28875,ORD_28876,33263,Ajmal Impress Concentrated Perfume Oil Citrus Attar And Aurum Concentrated Perfume Oil Fruity Floral Attar 20 ml,Warehouse A,18,1,2025-02-04 21:49:00,17
28876,ORD_28877,33853,Mehandi Cone 12 Piece Mehendi Cone For Hand Designing,Warehouse C,54,37,2025-02-04 20:13:00,17
28877,ORD_28878,30904,Deptune 5mg Tablet,Warehouse C,31,17,2025-02-04 19:03:00,14
28878,ORD_28879,30889,OSAKA HR06 3000mAh AA Ni-Mh Rechargeable Batteries 8 Pieces with OSK-C903W Battery Charger Set,Warehouse B,50,37,2025-02-04 18:25:00,13
28879,ORD_28880,12174,Famecia Stainless Steel Makeup Mixing Blending Palette with Spatula,Warehouse A,84,72,2025-02-04 02:55:00,12
28880,ORD_28881,21540,LOVERIGHT Professional Makeup Combo Waterproof Long Lasting Black Kajal Matte Finish With 4 Shade Mini Red Edition Liquid ...,Warehouse A,78,65,2025-02-04 14:03:00,13
28881,ORD_28882,30893,"Fashion Colour Non - Transfer Matt Waterproof Lipstick, 32 Auburn 2.6 gm",Warehouse B,84,73,2025-02-04 18:44:00,11
28882,ORD_28883,25014,Minimalist Azeclair Face Serum 30 ml,Warehouse A,118,99,2025-02-04 10:23:00,19
28883,ORD_28884,2879,"The Canvas Arts Temporary Tattoo, Waterproof Hot & Sexy Tattoo for Mens & Women 19X9 cm TBX-9010 (Flowers Tattoo)",Warehouse B,91,77,2025-02-04 17:16:00,14
28884,ORD_28885,31713,Yves Rocher Sebo Pure Vegetal Sos Spot Eraser 10 ml,Warehouse A,40,23,2025-02-04 07:36:00,17
28885,ORD_28886,16234,"Lava A3 Power (Aqua Blue),Military Grade Certified, Jumbo Battery with 10 Days Backup, Dedicated Music Buttons, Keypad Mob...",Warehouse B,91,75,2025-02-04 09:05:00,16
28886,ORD_28887,7127,Vertiract 16mg Tablet,Warehouse B,101,83,2025-02-04 15:47:00,18
28887,ORD_28888,24584,SPAZY CASE Back Cover for Xiaomi Redmi Note 8 Pro (TPU | Black | Classic),Warehouse C,92,76,2025-02-04 05:57:00,16
28888,ORD_28889,12177,Forest Herbs 100% Natural Organic Indigo Leaf Powder for Hair Colour - 100Gms Pack of 2,Warehouse B,68,52,2025-02-04 05:12:00,16
28889,ORD_28890,22099,Accutaz AS 1000mg/125mg Injection,Warehouse C,100,85,2025-02-04 07:18:00,15
28890,ORD_28891,7125,OpenTech Transparent Tempered Glass for Galaxy F41 / M21 / M31 / M30s / M30 / A30 / A50 / A50s with Easy Installation Kit.,Warehouse B,36,24,2025-02-04 20:47:00,12
28891,ORD_28892,32942,"SWAPKART 5-in-1 Cleaning Soft Brush Keyboard Cleaner, Multi-Function Computer Tools Kit Corner Gap Duster Key-Cap Puller f...",Warehouse C,59,44,2025-02-04 23:31:00,15
28892,ORD_28893,17593,Cancyp T Syrup,Warehouse B,86,71,2025-02-04 21:55:00,15
28893,ORD_28894,17136,realme Buds Wireless in-Ear Bluetooth Earphones with mic (Blue),Warehouse B,93,80,2025-02-04 09:55:00,13
28894,ORD_28895,17380,Tropicon Plus Eye Drop,Warehouse B,112,98,2025-02-04 01:48:00,14
28895,ORD_28896,6887,Whitening Sensitive Women Deodorant For 48h Protection,Warehouse A,89,72,2025-02-04 12:49:00,17
28896,ORD_28897,6702,"ZEBRONICS Zeb-Companion 500 2.4GHz Wireless Keyboard and Mouse Set, USB Nano Receiver, Chiclet Keys, Ultra Silent, Power O...",Warehouse B,105,99,2025-02-04 04:27:00,6
28897,ORD_28898,11370,"The Beauty Co. Chocolate Coffee Body Scrub, 100 gm",Warehouse B,36,29,2025-02-04 10:32:00,7
28898,ORD_28899,31990,Veloz 10mg Tablet,Warehouse C,63,58,2025-02-04 04:01:00,5
28899,ORD_28900,3491,Adenther 150mg Injection,Warehouse C,36,19,2025-02-04 19:36:00,17
28900,ORD_28901,16212,"Crossvolt USB Type C Super Vooc Flash Charging Cable for All Type C Phones, Smartphone, Realme Devices",Warehouse C,113,98,2025-02-04 14:20:00,15
28901,ORD_28902,1994,Glista M 2mg/500mg Tablet,Warehouse B,107,94,2025-02-04 13:32:00,13
28902,ORD_28903,10878,SUNISA BB and CC Cream Foundation With Mushroom Head Air Cushion 20g and 1 Green Tea Stick Mask - (Pack of 2),Warehouse A,90,85,2025-02-04 19:21:00,5
28903,ORD_28904,33240,"Bodylicious Deodorant Spray - Blush, For Women",Warehouse A,51,34,2025-02-04 13:34:00,17
28904,ORD_28905,30881,Newly Launched SpinBot Ranger HX300 Wireless Bluetooth Over the Ear Headphones with up to 50ms Low latency and Flip Boom M...,Warehouse A,42,32,2025-02-04 02:53:00,10
28905,ORD_28906,22020,CEDO Case iQOO Z6 Lite (5G) Case Back Cover Shockproof Bumper Crystal Clear | 360 Degree Protection TPU+PC | Camera Protec...,Warehouse C,36,21,2025-02-04 12:40:00,15
28906,ORD_28907,11888,Mancode Lip Scrub 20 gm,Warehouse A,71,53,2025-02-04 20:18:00,18
28907,ORD_28908,16361,Jatyadi Oil,Warehouse B,66,58,2025-02-04 11:15:00,8
28908,ORD_28909,21572,"FAE Beauty Modern Matte Lipsticks + Gloss Bundle - Sizzling and Awkward | Cherry Red and Rose Brown | Matte, Long lasting,...",Warehouse C,72,60,2025-02-04 02:55:00,12
28909,ORD_28910,1745,Fashion Colour Vitamin C Face Scrub 130 gm,Warehouse B,83,68,2025-02-04 14:51:00,15
28910,ORD_28911,30730,"Blue Yeti USB Microphone for Recording, Streaming, Gaming, Podcasting on PC and Mac, Condenser Mic for Laptop or Computer ...",Warehouse C,112,93,2025-02-04 15:57:00,19
28911,ORD_28912,32189,Moxiruth 250mg Tablet DT,Warehouse B,26,11,2025-02-04 02:43:00,15
28912,ORD_28913,2787,Berina Hair Protein Conditioner Repair & Restrore 400 ml,Warehouse A,61,53,2025-02-04 13:56:00,8
28913,ORD_28914,2449,Dicloroy 75mg Injection,Warehouse C,63,57,2025-02-04 15:36:00,6
28914,ORD_28915,10861,Shine & Glow Face Sheet Mask,Warehouse B,100,90,2025-02-04 15:14:00,10
28915,ORD_28916,33288,Impride 2mg Tablet,Warehouse B,23,18,2025-02-04 09:18:00,5
28916,ORD_28917,2170,Flumed M Cream,Warehouse C,15,8,2025-02-04 03:53:00,7
28917,ORD_28918,1699,Otoset-MD Oral Solution,Warehouse B,56,37,2025-02-04 12:09:00,19
28918,ORD_28919,2446,Forthcef 1000mg Injection,Warehouse B,16,11,2025-02-04 15:33:00,5
28919,ORD_28920,16372,TheGiftKart Ultra-Hybrid Crystal Clear Back Case Cover for Samsung Galaxy S23 Ultra 5G | Shockproof Design | Camera Protec...,Warehouse B,87,69,2025-02-04 15:11:00,18
28920,ORD_28921,33578,Doxime OF 200mg/200mg Tablet,Warehouse C,71,55,2025-02-04 21:54:00,16
28921,ORD_28922,31644,Chambor Extreme Matte Long Wear Lip Colour - Blooming Rose 14 2.8 gm,Warehouse A,22,15,2025-02-04 21:34:00,7
28922,ORD_28923,15788,Nicka K RADIANT LIQUID SHADOW- SUMMER SOLSTICE 5 gm,Warehouse C,22,16,2025-02-04 17:20:00,6
28923,ORD_28924,7168,Spigen Tempered Glass Screen Protector [GlasTR Slim] Designed for MacBook Pro 13 inch (M1 / 2017-2021) / MacBook Air 13 in...,Warehouse B,94,84,2025-02-04 13:37:00,10
28924,ORD_28925,2810,Quess Care Total Protection Plan for 1 Year Protection for Mobile - Price Between 15001 to 20000 (Email Delivery),Warehouse A,99,91,2025-02-04 22:27:00,8
28925,ORD_28926,16355,Olmin 40-CH Tablet,Warehouse C,38,33,2025-02-04 00:30:00,5
28926,ORD_28927,32840,Cipoxel 250mg Tablet,Warehouse C,60,42,2025-02-04 14:58:00,18
28927,ORD_28928,33593,"Blue Heaven Hypergel Nailpaint - Bronze Stardust, 705 11 ml",Warehouse B,115,99,2025-02-04 15:21:00,16
28928,ORD_28929,3098,Tiny Deal Moisturizing And Hydrating Lip Gloss Tint For Dry And Chapped Lips In Cute Heart-Shaped Packaging- Multicolour M...,Warehouse B,80,65,2025-02-04 19:14:00,15
28929,ORD_28930,2811,HP USB 3.2 Light Golden Flash Drive 64GB x779W,Warehouse C,55,41,2025-02-04 02:24:00,14
28930,ORD_28931,11709,Maped Metal Open Compass - 9 Pcs Set - (Colors May Vary),Warehouse A,110,94,2025-02-04 22:15:00,16
28931,ORD_28932,21182,Fexogod 180mg Tablet,Warehouse C,56,50,2025-02-04 11:58:00,6
28932,ORD_28933,34171,ADS Pro Ultra Smooth Soft Matte Me Liquid Lip Gloss (415-Peach Red + 408-Rose) -By Glavon®,Warehouse C,103,94,2025-02-04 19:11:00,9
28933,ORD_28934,24191,Philips Audio SHE1505 Wired in Ear Earphones with Mic (Black),Warehouse A,105,98,2025-02-04 19:37:00,7
28934,ORD_28935,16258,STRIFF Adjustable Laptop Stand Patented Riser Ventilated Portable Foldable Compatible with MacBook Notebook Tablet Tray De...,Warehouse C,88,72,2025-02-04 13:55:00,16
28935,ORD_28936,16839,Pedicure File,Warehouse C,111,98,2025-02-04 19:21:00,13
28936,ORD_28937,3387,Lotus Professional PhytoRx Whitening & Brightening Skin Care Combo | Day Cream 50g | Night Cream 50g | Free Face Wash 80g...,Warehouse B,91,73,2025-02-03 02:19:00,18
28937,ORD_28938,10265,Power 10 Formula Gf Effector,Warehouse B,84,67,2025-02-03 05:37:00,17
28938,ORD_28939,18693,Olmecros AM Tablet,Warehouse B,70,56,2025-02-03 20:44:00,14
28939,ORD_28940,25366,"Sounce Desktop Mobile Phone Tabletop Stand, Mobile Holder, Adjustable & Foldable Mobile Tabletop Stand, Aluminum Stand Hol...",Warehouse C,103,88,2025-02-03 06:19:00,15
28940,ORD_28941,25379,Rinapax 50mg Tablet,Warehouse C,102,85,2025-02-03 00:48:00,17
28941,ORD_28942,17424,"Motorola a50 (Dark Blue) - Dual Sim Keypad Mobile with Expandable Memory Upto 32GB, Rear Camera, 1750 mAh Big Battery, 6 I...",Warehouse C,74,67,2025-02-03 11:50:00,7
28942,ORD_28943,3219,Ginger Mango Body Wash Soap,Warehouse C,98,93,2025-02-03 23:41:00,5
28943,ORD_28944,28975,Beard Oil - Cedarwood,Warehouse A,98,85,2025-02-03 14:01:00,13
28944,ORD_28945,10313,OpenTech® Tempered Glass Screen Protector Compatible for OnePlus 7T Edge to Edge Coverage with Easy Installation kit,Warehouse B,80,66,2025-02-03 23:17:00,14
28945,ORD_28946,17557,"Sitishield D95 Mask – Small, Black",Warehouse C,25,13,2025-02-03 20:51:00,12
28946,ORD_28947,29074,"Deva Vati - Daily Detox, 500 mg",Warehouse C,58,44,2025-02-03 00:39:00,14
28947,ORD_28948,31192,"SWAPKART Portable Flexible Adjustable Eye Protection USB LED Desk Light Table Lamp for Reading, Working on PC, Laptop, Pow...",Warehouse B,115,99,2025-02-03 10:01:00,16
28948,ORD_28949,4584,"70mai A800S True 4K Dual Channel Car Dash Camera, 2160P Front & 1080P Rear, Built-in GPS Logger, IMX415 Sensor, ADAS, F1....",Warehouse A,64,49,2025-02-03 19:18:00,15
28949,ORD_28950,18644,Bekker Oral Suspension,Warehouse A,17,9,2025-02-03 12:03:00,8
28950,ORD_28951,10271,"Wings Phantom 250 Gaming TWS Earbuds, with 40ms Low Latency, Bluetooth 5.2, 13mm Drivers, AAC Codec Support Earphones(Black)",Warehouse C,73,65,2025-02-03 20:09:00,8
28951,ORD_28952,18686,Ajmal 2 Distraction & 2 Persuade Deo & Aretha EDP Pack of 3 20 ml,Warehouse B,24,13,2025-02-03 08:36:00,11
28952,ORD_28953,31074,Colors Queen Fit For U Matte Compact Powder,Warehouse A,26,9,2025-02-03 20:16:00,17
28953,ORD_28954,10998,Opec 40mg Tablet,Warehouse B,98,92,2025-02-03 14:40:00,6
28954,ORD_28955,29138,Levotica-M Tablet,Warehouse B,21,14,2025-02-03 10:47:00,7
28955,ORD_28956,29083,Cardivas CR 20 Tablet,Warehouse A,29,16,2025-02-03 04:27:00,13
28956,ORD_28957,31068,"Fashion Colour Vitamin C Foundation / White Perfect Foundation, Shade 01 40 gm",Warehouse B,103,96,2025-02-03 02:24:00,7
28957,ORD_28958,4443,"Tresemme Keratin Smooth Anti-Frizz Hair Serum 50ml with Argan Oil, for 2X Smoother Hair and Long Lasting Frizz control upt...",Warehouse A,40,35,2025-02-03 20:18:00,5
28958,ORD_28959,29134,Nails On Board Handmade Press On Gel Nails- Holographic Aqua Blue X Small 50 gm,Warehouse C,47,35,2025-02-03 21:12:00,12
28959,ORD_28960,3427,IRONFIX® (Pack of 4) Cable Protector Data Cable Saver Charging Cord Protective Cable Cover (4pc),Warehouse B,85,79,2025-02-03 18:43:00,6
28960,ORD_28961,18699,"Azafran Non-toxic Plant-based Pencil Crayons(15 Colours), Clinically tested to be Baby Safe, Hypoallergenic, Food Grade Co...",Warehouse C,19,14,2025-02-03 23:59:00,5
28961,ORD_28962,17559,Megaphage Forte Injection,Warehouse B,84,75,2025-02-03 20:19:00,9
28962,ORD_28963,20749,Mother Sparsh Stretch Mark Massage Oil 100 ml,Warehouse A,51,43,2025-02-03 05:00:00,8
28963,ORD_28964,29015,Spigen Essential Sand Blast Back Cover Case Compatible for Samsung Galaxy M53 5G (TPU | Matte Black),Warehouse C,88,79,2025-02-03 00:09:00,9
28964,ORD_28965,25385,Bronkonil Expectorant,Warehouse B,96,77,2025-02-03 12:07:00,19
28965,ORD_28966,4589,Kufdoz Baby Suspension,Warehouse C,80,70,2025-02-03 10:51:00,10
28966,ORD_28967,10324,I AM EYECONIC Duo Chrome Pigments BAE WATCHING 2 gm,Warehouse C,97,81,2025-02-03 11:52:00,16
28967,ORD_28968,25331,Moxitak KT Eye Drop,Warehouse C,41,28,2025-02-03 09:06:00,13
28968,ORD_28969,8813,Kufrest Syrup,Warehouse A,23,9,2025-02-03 12:52:00,14
28969,ORD_28970,20711,"ZEBRONICS Zeb-Thunder Wireless Bluetooth Over The Ear Headphone, FM, mSD, 9 hrs Playback with Mic (Blue)",Warehouse A,98,89,2025-02-03 03:53:00,9
28970,ORD_28971,18782,Nutriment Ubtan Scrub All Skin Type 250 gm,Warehouse C,49,38,2025-02-03 22:49:00,11
28971,ORD_28972,4387,ENVIE® (ECR20+AA2800 4PL) Charger for AA & AAA Rechargeable Batteries,Warehouse A,59,41,2025-02-03 17:18:00,18
28972,ORD_28973,29229,Activated Charcoal Facescrub,Warehouse A,58,50,2025-02-03 14:44:00,8
28973,ORD_28974,10206,Ateros 5mg Tablet,Warehouse C,16,6,2025-02-03 17:19:00,10
28974,ORD_28975,18777,Neodrox 500mg Tablet,Warehouse B,85,73,2025-02-03 09:36:00,12
28975,ORD_28976,4392,Telca Silicon Case Cover Compatible with Noise vs104 Only (NOT for vs104 PRO),Warehouse B,50,41,2025-02-03 08:08:00,9
28976,ORD_28977,29228,Cream Hair Colour - Natural Black,Warehouse A,20,5,2025-02-03 09:48:00,15
28977,ORD_28978,30978,Chemist At Play Lip Sleeping Mask For Dry Lips | Intense Hydration & Soft Lips | Overnight Hydrating Lip Mask for Cracked ...,Warehouse B,30,12,2025-02-03 01:25:00,18
28978,ORD_28979,3462,"(Renewed) MI Smart Band 4 , Black",Warehouse C,93,78,2025-02-03 10:05:00,15
28979,ORD_28980,30983,DJI OSMO Mobile SE Intelligent Gimbal 3-Axis Phone Gimbal Portable and Foldable Android and iPhone Gimbal with ShotGuides ...,Warehouse A,45,40,2025-02-03 18:38:00,5
28980,ORD_28981,10975,Wocipflo 500mg Tablet,Warehouse A,45,37,2025-02-03 04:47:00,8
28981,ORD_28982,17563,"Biotique Natural Makeup Magicare All Day Liquid Foundation (Sand, 30ml, Natural Finish)",Warehouse B,105,88,2025-02-03 05:16:00,17
28982,ORD_28983,17451,"Samsung Galaxy A23 Blue, 6GB RAM, 128GB Storage with No Cost EMI/Additional Exchange Offers",Warehouse B,43,38,2025-02-03 06:10:00,5
28983,ORD_28984,25401,Gear Watch Charger Compatible with Samsung smartwatch S2/S3/S4 - Replacement Frontier Charging Dock Galaxy Sport Smart Wat...,Warehouse C,28,19,2025-02-03 18:26:00,9
28984,ORD_28985,6060,Ceftos 1000mg Injection,Warehouse B,100,83,2025-02-03 21:57:00,17
28985,ORD_28986,3341,HP GT52 Ink Bottle (Magenta),Warehouse A,21,2,2025-02-03 09:28:00,19
28986,ORD_28987,4606,"Lenovo L-Series 68.58 cm (27 inch) FHD IPS Ultraslim Monitor |16.7 Mn Colors, 75Hz, 4ms, AMD FreeSync, HDMI, TUV Eye Comfo...",Warehouse B,66,51,2025-02-03 22:25:00,15
28987,ORD_28988,3331,Rose Sheet Mask,Warehouse B,113,97,2025-02-03 04:03:00,16
28988,ORD_28989,17414,Wipeout Germ Killing Body Lotion,Warehouse A,20,14,2025-02-03 19:38:00,6
28989,ORD_28990,10961,Medimade Repair & Revive Conditioner With Apple Cider Vinegar (Pack of 2) 1's,Warehouse C,106,90,2025-02-03 17:56:00,16
28990,ORD_28991,31217,Dxcof AX Syrup,Warehouse B,45,36,2025-02-03 23:08:00,9
28991,ORD_28992,4598,TheGiftKart Ultra-Hybrid Crystal Clear Back Cover Case for iPhone 14 | Slim Fit Shockproof Design | Camera Protection Bump...,Warehouse C,63,54,2025-02-03 03:23:00,9
28992,ORD_28993,4597,Amozo Frameless Back Case Cover for iPhone 13 Pro (Black | Polycarbonate),Warehouse C,74,61,2025-02-03 02:56:00,13
28993,ORD_28994,3388,"ProElite Deer Flip case Cover for Samsung Galaxy Tab A 10.1"" T510/T515 (Wine Red)",Warehouse B,35,21,2025-02-03 06:54:00,14
28994,ORD_28995,18829,mCaffeine Coffee Lip Polishing Kit 24 gm,Warehouse B,61,45,2025-02-03 03:31:00,16
28995,ORD_28996,4531,"SOOPII Desktop Grade-A Quality Mobile Phone + Tablet Tabletop Stand, Mobile Holder, Adjustable & Foldable, Aluminum Stand ...",Warehouse C,48,36,2025-02-03 03:21:00,12
28996,ORD_28997,6454,"SH.HUDA Professional Beauty Super Smooth Ultra Matte Wateproof Cigarette Lipstick Set of 4, Best Gift for Your Loved Ones",Warehouse A,74,67,2025-02-03 06:21:00,7
28997,ORD_28998,31401,Pikkme Tempered Glass Screen Protector for Redmi 10A / 9A / 9i / Redmi 9 / 9c / Redmi 9 Activ/Redmi 9A Sport/Redmi 9i Spor...,Warehouse B,81,62,2025-02-03 17:40:00,19
28998,ORD_28999,18974,Elstum 250mg Tablet,Warehouse A,16,8,2025-02-03 08:27:00,8
28999,ORD_29000,17312,"AGARO Adjustable Camera Tripod Stand with Mobile Phones Clip & Camera Holder, Supports Up to 3 Kgs, 66 inches (167 cm) Tall",Warehouse B,114,99,2025-02-03 05:01:00,15
29000,ORD_29001,17632,Glyciphage-G 2 Forte Tablet PR,Warehouse B,67,56,2025-02-03 12:32:00,11
29001,ORD_29002,8777,Greeko Man Beard Cream 50 ml,Warehouse C,85,75,2025-02-03 16:43:00,10
29002,ORD_29003,25255,Rolosol Tablet,Warehouse B,29,15,2025-02-03 11:19:00,14
29003,ORD_29004,17631,Ajmal Yearn EDP & Distraction Deodorant Pack of 2 300 ml,Warehouse C,40,30,2025-02-03 18:00:00,10
29004,ORD_29005,30858,Fluderm 0.025% Cream,Warehouse A,53,47,2025-02-03 09:12:00,6
29005,ORD_29006,28585,Psypro 25mg Tablet CR,Warehouse B,98,90,2025-02-03 02:59:00,8
29006,ORD_29007,28614,"Fire-Boltt Ring Pro Bluetooth Calling, 1.75” 320 * 385px High Res, IP68 & SpO2 Monitoring, Pin Code Locking Functionality...",Warehouse B,78,73,2025-02-03 18:51:00,5
29007,ORD_29008,20620,"Etzin Video Capture Cards 4k, HDMI Video Capture Card USB 2.0 HD 1080P Capture Adapter Directly to Computer for Gaming, St...",Warehouse A,90,79,2025-02-03 00:32:00,11
29008,ORD_29009,28983,Stbotanica Sandalwood Amber Body Wash With Shea & Vitamin E 250 ml,Warehouse C,20,9,2025-02-03 04:17:00,11
29009,ORD_29010,31415,"V-Guard VND400 Voltage Stabilizer for 1.5 Ton AC (150V-285V), Grey",Warehouse C,80,67,2025-02-03 04:34:00,13
29010,ORD_29011,6455,Axikool 400mg/5ml/20mg/5ml Suspension,Warehouse A,46,37,2025-02-03 20:11:00,9
29011,ORD_29012,25264,Spigen Rugged Armor Cover Case for Apple Watch Series Series 8/7 (45mm) | Series SE2/6/SE/5/4 (44mm) - Black (Watch not In...,Warehouse C,69,50,2025-02-03 21:59:00,19
29012,ORD_29013,17349,Caftrocare-T Injection,Warehouse A,48,35,2025-02-03 06:32:00,13
29013,ORD_29014,21366,Distaclor 500mg Capsule,Warehouse B,77,67,2025-02-03 14:42:00,10
29014,ORD_29015,31261,Dell MS116 USB Optical Mouse (Black),Warehouse B,94,78,2025-02-03 11:19:00,16
29015,ORD_29016,4353,SEAHELTON Crystal Hair Remover for Women and Men Upgraded Nano-crystalline Dots Technology Crystal Hair Eraser for Women P...,Warehouse C,18,3,2025-02-03 16:21:00,15
29016,ORD_29017,21345,Rosugra 10mg Tablet,Warehouse A,69,63,2025-02-03 21:10:00,6
29017,ORD_29018,18854,Ooz Tablet,Warehouse B,90,80,2025-02-03 09:55:00,10
29018,ORD_29019,6584,Ketotas 200 Tablet,Warehouse C,90,85,2025-02-03 02:53:00,5
29019,ORD_29020,18850,"ikis - Screen Cleaner Kit 100 ml for LED and LCD TV, Computer Monitor, Laptop, and iPad Screens - Pack of 2",Warehouse B,44,32,2025-02-03 14:43:00,12
29020,ORD_29021,10345,Qmol-MF Forte Oral Suspension,Warehouse B,23,15,2025-02-03 07:13:00,8
29021,ORD_29022,30894,"Spigen Essential Sand Blast Back Cover Case Compatible For OnePlus Nord CE 2 5G (TPU, Matte Black)",Warehouse A,90,83,2025-02-03 12:33:00,7
29022,ORD_29023,9180,Tram Syrup,Warehouse A,99,85,2025-02-03 17:04:00,14
29023,ORD_29024,26102,BROADICLOX 250MG/250MG INJECTION,Warehouse B,83,66,2025-02-03 19:07:00,17
29024,ORD_29025,18603,Something4u 50 pcs Wet and Dry Cleaning Wipes for Camera Lens LCD LED Screen Mobile Phone Tablet Laptop Handset Smart Watc...,Warehouse A,71,56,2025-02-03 06:51:00,15
29025,ORD_29026,28998,Ajmal Impress Concentrated Perfume Oil Citrus Attar And Asher Concentrated Perfume Oil Oriental Attar 22 ml,Warehouse B,96,87,2025-02-03 02:24:00,9
29026,ORD_29027,30991,"Mouthwash - Plax, Peppermint Fresh",Warehouse C,84,79,2025-02-03 02:41:00,5
29027,ORD_29028,18726,"Pentel Mechanical Pencil Lead, Ain Stein, 0.5mm, 4B (C275-4B)",Warehouse C,25,6,2025-02-03 00:23:00,19
29028,ORD_29029,29144,Sony Extra Bass MDR-XB450AP On-Ear Wired Headphones with Mic (Black),Warehouse A,95,82,2025-02-03 10:19:00,13
29029,ORD_29030,31002,Rabmac 20mg Injection,Warehouse A,94,82,2025-02-03 10:37:00,12
29030,ORD_29031,26115,"Lenovo V15 Intel Celeron N4020 15.6"" (39.62 cm) HD 220 nits Antiglare Thin and Light Laptop (4GB RAM/256GB SSD/DOS/Iron Gr...",Warehouse C,61,50,2025-02-03 23:09:00,11
29031,ORD_29032,29028,Dolodart 120mg/5ml Suspension,Warehouse A,74,60,2025-02-03 18:45:00,14
29032,ORD_29033,6080,Soulflower Charcoal Cleansing Micellar Water 120 ml,Warehouse C,43,25,2025-02-03 08:02:00,18
29033,ORD_29034,17479,Camlin Kokuyo Student Water Color Cakes - 12 Shades,Warehouse B,95,87,2025-02-03 18:02:00,8
29034,ORD_29035,29044,Ajmal Amber Magic EDP Spicy Aromatic Perfume 100ml for Men and Shiro EDP Citrus Spicy Perfume 90ml for Men + 1 Perfume Tes...,Warehouse B,56,38,2025-02-03 11:33:00,18
29035,ORD_29036,26081,Pepciril O Suspension,Warehouse B,81,71,2025-02-03 00:18:00,10
29036,ORD_29037,17571,"HUDACRUSH BEAUTY Professional Color Sensational Liquid Lipstick Combo Pack, Set of 4 Mini Lipsticks Forever Matte Finish L...",Warehouse B,97,82,2025-02-03 08:15:00,15
29037,ORD_29038,4715,Saiflox OZ 200mg/500mg Tablet,Warehouse A,35,30,2025-02-03 17:41:00,5
29038,ORD_29039,31394,Charmer Princesses Touch Screen Permanent Makeup Machine PMU machine Tattoo Machine for lip,Warehouse A,67,54,2025-02-03 04:18:00,13
29039,ORD_29040,10930,Rimoquin 500mg Tablet,Warehouse A,53,42,2025-02-03 05:03:00,11
29040,ORD_29041,28621,Curetrax SS 250mg/125mg Injection,Warehouse C,48,42,2025-02-03 06:39:00,6
29041,ORD_29042,28623,Meg Slim Ras,Warehouse A,18,2,2025-02-03 10:53:00,16
29042,ORD_29043,29342,Dulopin 20mg Tablet,Warehouse A,51,36,2025-02-03 16:45:00,15
29043,ORD_29044,31378,S Clav 500mg/125mg Tablet,Warehouse A,52,39,2025-02-03 23:28:00,13
29044,ORD_29045,6575,Omevik-D Capsule,Warehouse C,11,2,2025-02-03 15:32:00,9
29045,ORD_29046,21372,Febuvolk 80mg Tablet,Warehouse A,71,62,2025-02-03 13:53:00,9
29046,ORD_29047,25425,Myglamm Wandurlust Sand Matt Nail Paint Angel Cake 11 Ml,Warehouse B,95,77,2025-02-03 11:39:00,18
29047,ORD_29048,3257,Ecomycin 1gm Injection,Warehouse C,61,49,2025-02-03 08:43:00,12
29048,ORD_29049,26284,Chymoquick 100000AU Tablet,Warehouse C,90,71,2025-02-03 10:21:00,19
29049,ORD_29050,28643,Koser Forte 10mg Tablet,Warehouse B,62,56,2025-02-03 13:33:00,6
29050,ORD_29051,31342,"Loofah/Sponge Scrubber/Body Bath  - Hangable, Dual Side, Brown, BH-063 BRN",Warehouse A,61,55,2025-02-03 05:07:00,6
29051,ORD_29052,3014,Avdec SP 50mg/325mg/10mg Tablet,Warehouse B,86,78,2025-02-03 04:27:00,8
29052,ORD_29053,3213,"Fashion Colour Soft Lip Mousse, 2 Solar Coral 8 gm",Warehouse A,22,14,2025-02-03 01:52:00,8
29053,ORD_29054,28218,Rosave-Gold 10mg Capsule,Warehouse C,30,18,2025-02-03 22:55:00,12
29054,ORD_29055,20586,Viroxit 5% Cream,Warehouse B,29,15,2025-02-03 07:52:00,14
29055,ORD_29056,28431,Epson EcoTank L3250 A4 Wi-Fi All-in-One Ink Tank Printer Ink,Warehouse A,70,56,2025-02-03 22:44:00,14
29056,ORD_29057,8767,Lulicool 1% Cream,Warehouse B,68,61,2025-02-03 02:33:00,7
29057,ORD_29058,4827,"Blue Heaven Line & Design Sketch Eyeliner & Soft Kajal, Blue Matte Finish",Warehouse C,34,24,2025-02-03 08:55:00,10
29058,ORD_29059,25214,"boAt Stone 260 4W Bluetooth Speaker with Upto 9 Hours Playback, IPX5 and Carabiner(Psyche)",Warehouse A,53,47,2025-02-03 07:41:00,6
29059,ORD_29060,28474,"Zebronics ZEB-JUKE BAR 3500 Wireless Bluetooth Single Soundbar With Supporting Wall Mount, USB, AUX, Coaxial IN, HDMI ARC...",Warehouse B,15,5,2025-02-03 05:19:00,10
29060,ORD_29061,25218,Vector,Warehouse B,70,51,2025-02-03 04:10:00,19
29061,ORD_29062,20596,"OnePlus Nord 2T 5G (Jade Fog, 8GB RAM, 128GB Storage)",Warehouse C,82,75,2025-02-03 03:58:00,7
29062,ORD_29063,10028,Sparquick 200mg Tablet,Warehouse C,31,15,2025-02-03 05:10:00,16
29063,ORD_29064,17670,Zerodol-P Tablet,Warehouse C,40,28,2025-02-03 13:40:00,12
29064,ORD_29065,18493,Rosucot Gold 75mg/10mg/75mg Tablet,Warehouse A,63,47,2025-02-03 23:48:00,16
29065,ORD_29066,26367,Stbotanica Vitamin C Spf 50 Sunblock Face And Body Mist Sunscreen Spray Uva/Uvb Pa+++ 120 ml,Warehouse B,29,20,2025-02-03 12:16:00,9
29066,ORD_29067,4301,Ritra 200mg Capsule,Warehouse B,20,5,2025-02-03 18:46:00,15
29067,ORD_29068,20441,Insta Glow Herbal Bleach - Salon Series,Warehouse B,60,45,2025-02-03 20:01:00,15
29068,ORD_29069,20853,Ondeliv 8mg Tablet MD,Warehouse C,63,54,2025-02-03 06:21:00,9
29069,ORD_29070,9036,AmazonBasics Wristband Strap for Fitbit Versa & Versa 2 Watch (Pack 3),Warehouse C,12,1,2025-02-03 21:33:00,11
29070,ORD_29071,20506,Myglamm Wandurlust Matt Chrome Nail Paint Bali 11 Ml,Warehouse B,77,61,2025-02-03 16:13:00,16
29071,ORD_29072,25532,Spigen TPU + PC Ultra Hybrid Back Cover Compatible for Samsung Galaxy A73 5G (Crystal Clear),Warehouse A,50,35,2025-02-03 15:19:00,15
29072,ORD_29073,5067,e-INFINITY 4 Volt 500ma .5a Sealed Lead Acid Type Battery Pack of 2 pcs for Mosquito Racket Zapper Battery Replacement,Warehouse C,36,31,2025-02-03 13:22:00,5
29073,ORD_29074,29674,CP PLUS 4G Sim Card Router | Supports Wi-fi 2.4G | MIMO Enabled | 300Mbps Speed | Supports WPS - Ready to use Plug and Pla...,Warehouse B,91,82,2025-02-03 17:24:00,9
29074,ORD_29075,8734,Valicet M Syrup,Warehouse C,61,42,2025-02-03 10:18:00,19
29075,ORD_29076,9049,"Classmate Long Notebook - 140 Pages, Single Line, 297Mm X 210Mm (Pack Of 12)",Warehouse A,60,52,2025-02-03 06:12:00,8
29076,ORD_29077,29664,"S.A.V.I Neon Temporary Tattoos, UV Tattoos For Men Women, Body Face Art, Feather, Eagal, Animal, Snake, Whale Tattoos Flas...",Warehouse C,19,3,2025-02-03 03:32:00,16
29077,ORD_29078,8895,Oorja Tablet 500 mg,Warehouse B,91,72,2025-02-03 10:16:00,19
29078,ORD_29079,26553,"(Renewed) Lenovo ThinkCentre M700 Desktop Mini PC (Intel Core i3 6th Gen, 8 GB DDR4 RAM, 256 GB SSD, WiFi, Windows 11, MS ...",Warehouse C,23,18,2025-02-03 20:58:00,5
29079,ORD_29080,28028,Pikkme Samsung Galaxy M12 / A12 / F12 Back Cover Soft Matte Liquid Silicone TPU | Camera Protection | Shockproof Slim Back...,Warehouse B,91,80,2025-02-03 06:14:00,11
29080,ORD_29081,28387,"iBELL CP808 8 Channel SMPS for CCTV Output 150-285 V, Power Supply Adapter for up to 8 CCTV Cameras (Pack of 1)",Warehouse A,57,51,2025-02-03 00:48:00,6
29081,ORD_29082,31538,"Willyard Makeup Beauty Kajal & 3in1 Eyeline,Mascara, Eyebrow Pencil & Waterproof Liquid-Eye Liner 36H (5 Items in the set)",Warehouse C,54,46,2025-02-03 06:07:00,8
29082,ORD_29083,20587,Danson 2mg Oral Drops,Warehouse A,38,31,2025-02-03 21:06:00,7
29083,ORD_29084,3188,"Amazon Basics Wireless Bluetooth Multi-Device Keyboard for Windows, Apple iOS Android Or Chrome, Compact Space-Saving Desi...",Warehouse B,74,62,2025-02-03 03:09:00,12
29084,ORD_29085,28250,Like An Ocean Breeze On A Warm Summer Day Room Fragrance Spray,Warehouse A,91,76,2025-02-03 09:41:00,15
29085,ORD_29086,11090,Crysendo Headphone Cushion Compatible with Plantronics C-320M/ C3220 /C325M /T110 | 5MM Thick Replacement Foam Sponge Ear ...,Warehouse A,101,83,2025-02-03 02:02:00,18
29086,ORD_29087,25482,"Gizga Essentials Laptop Bag Sleeve Case Cover Pouch for 13.3 Inch Laptop for Men & Women, Padded Laptop Compartment, Free ...",Warehouse C,85,72,2025-02-03 12:27:00,13
29087,ORD_29088,8880,Classic Shaving Foam - Tea Tree Oil Vitamin E Aloe Vera 52,Warehouse A,109,90,2025-02-03 02:30:00,19
29088,ORD_29089,30767,Maryaj M White For Her EDP Floral Fruity Perfume And Ajmal Aurum Femme Deodorant Fruity Floral Fragrance 290 ml,Warehouse B,85,73,2025-02-03 06:51:00,12
29089,ORD_29090,21185,Gentle Handwash - Fresh Sweet Lime Peel & Tulsi,Warehouse B,28,11,2025-02-03 03:45:00,17
29090,ORD_29091,4858,Ajmal Aurum Femme & Sacredlove Deo & Neea EDP Pack of 3 20 ml,Warehouse C,17,5,2025-02-03 10:51:00,12
29091,ORD_29092,5946,Parker Classic Stainless Steel GT Ball Pen,Warehouse C,92,84,2025-02-03 07:00:00,8
29092,ORD_29093,28206,M7 Slim Cover for-iPhone 7 Plus - Shockproof Soft Silicone Anti Dust Plug Back Cover/Case for Girls & Boys | Black,Warehouse B,54,42,2025-02-03 16:51:00,12
29093,ORD_29094,18471,TheGiftKart Best Camera Protection Back Cover Case for Google Pixel 6A | Ultra Clear Soft Case | Inbuilt Dust Plugs & Ant...,Warehouse C,49,36,2025-02-03 10:19:00,13
29094,ORD_29095,3543,Asracef 125mg Injection,Warehouse B,77,62,2025-02-03 23:34:00,15
29095,ORD_29096,3542,"(Renewed) Dell Vostro 4th Gen Intel Core i3 HD Business Laptop (8 GB RAM/256 GB SSD/14"" (35.6 cm)/Windows 10/MS Office/WiF...",Warehouse B,94,81,2025-02-03 22:33:00,13
29096,ORD_29097,17263,Amazon Brand - Solimo Back Cover Case for Mi Redmi Note 5 Pro | Compatible for Mi Redmi Note 5 Pro Back Cover Case | 360 D...,Warehouse B,63,45,2025-02-03 09:41:00,18
29097,ORD_29098,11163,ADISA 35L Large Laptop Backpack Office Bag College Travel Back Pack with rain Cover (Grey),Warehouse C,33,25,2025-02-03 00:18:00,8
29098,ORD_29099,26349,Finate 200mg Tablet,Warehouse A,83,66,2025-02-03 16:15:00,17
29099,ORD_29100,31463,Plum Chamomile & White Tea Dew Day Cream 45 Gm,Warehouse A,80,73,2025-02-03 23:11:00,7
29100,ORD_29101,28496,OJOS Keyboard Cover Compatible with MacBook Air 13.6 inch M2 A2681 2022 & MacBook Pro 14/16 inch M1 Pro/Max A2779 A2442 A2...,Warehouse C,104,89,2025-02-03 09:43:00,15
29101,ORD_29102,25228,Cetros Plus 5mg/325mg/10mg Tablet,Warehouse C,52,46,2025-02-03 04:42:00,6
29102,ORD_29103,26343,mCaffeine Naked Detox Dirt Removal Green Tea Face Wash 100 ml,Warehouse C,93,87,2025-02-03 18:10:00,6
29103,ORD_29104,29392,SKZ 2% Cream,Warehouse C,110,93,2025-02-03 06:19:00,17
29104,ORD_29105,4311,AKOTI 8 Piece Wall Mounted Storage Box Remote Storage Organizer Case for Air Conditioner TV Mobile Phone Plug Holder Stand...,Warehouse A,94,80,2025-02-03 17:57:00,14
29105,ORD_29106,17278,Coriminic LS Syrup,Warehouse A,46,34,2025-02-03 06:46:00,12
29106,ORD_29107,29374,Deodorant - Storm,Warehouse A,101,83,2025-02-03 13:19:00,18
29107,ORD_29108,26032,Medisone 1000mg/500mg Injection,Warehouse C,7,1,2025-02-03 10:12:00,6
29108,ORD_29109,17635,Nulet 20mg Tablet,Warehouse B,98,87,2025-02-03 04:40:00,11
29109,ORD_29110,11154,Duteron 0.5mg Capsule,Warehouse B,36,29,2025-02-03 13:23:00,7
29110,ORD_29111,3529,"Razer DeathAdder V2 Wired Gaming Mouse | 8 Programmable Buttons | 20,000 DPI Optical Sensor - Chroma RGB Lighting - Classi...",Warehouse A,30,13,2025-02-03 12:23:00,17
29111,ORD_29112,28477,Keto Dusting Powder,Warehouse C,110,96,2025-02-03 06:19:00,14
29112,ORD_29113,21382,Clear Etanol Disinfectant Hand Sanitiser Gel,Warehouse B,29,11,2025-02-03 13:15:00,18
29113,ORD_29114,18395,French Lavender Essential Oil,Warehouse B,31,19,2025-02-03 17:11:00,12
29114,ORD_29115,20863,Vildix-M 50/1000 Tablet SR,Warehouse C,62,54,2025-02-03 17:58:00,8
29115,ORD_29116,28038,Rabiwok 20mg Tablet,Warehouse A,92,83,2025-02-03 03:34:00,9
29116,ORD_29117,30729,Cefzen 125mg Syrup,Warehouse B,53,40,2025-02-03 16:08:00,13
29117,ORD_29118,31702,SERY Move on Nail Polish Remover wipes 1's,Warehouse A,21,3,2025-02-03 12:56:00,18
29118,ORD_29119,9255,Vogliboz M 500 mg/0.3 mg Tablet,Warehouse C,93,76,2025-02-03 02:57:00,17
29119,ORD_29120,25499,Fujifilm Instax Square 10 Exposures Instant Film (White),Warehouse C,52,35,2025-02-03 15:09:00,17
29120,ORD_29121,26498,Urief Tablet,Warehouse A,28,15,2025-02-03 05:02:00,13
29121,ORD_29122,19286,Soap Strips - Sandal,Warehouse C,26,17,2025-02-03 12:11:00,9
29122,ORD_29123,17729,Truly Essential Essential Oil - Patchouli 15 ml,Warehouse C,6,1,2025-02-03 14:48:00,5
29123,ORD_29124,28196,Anti Aging Hydrating Night Cream,Warehouse B,93,76,2025-02-03 13:58:00,17
29124,ORD_29125,28197,Ralocium 60mg Tablet,Warehouse B,75,59,2025-02-03 07:55:00,16
29125,ORD_29126,9906,Prasmol SP 100mg/325mg/10mg Tablet,Warehouse A,96,90,2025-02-03 21:29:00,6
29126,ORD_29127,17121,MP NT 75mg/10mg/1500mcg Tablet SR,Warehouse C,23,17,2025-02-03 15:00:00,6
29127,ORD_29128,31740,Parker Quink Flow Ball Pen Refill (Black),Warehouse C,84,73,2025-02-03 03:21:00,11
29128,ORD_29129,28111,"The Canvas Arts Temporary Tattoo Waterproof For Men & Women Wrist, Arm, Hand Tattoo T-143 (Showard Tattoo) Size 60mm X105mm",Warehouse C,64,46,2025-02-03 18:36:00,18
29129,ORD_29130,28057,Aceprone S 100mg/325mg/15mg Tablet,Warehouse B,92,79,2025-02-03 13:56:00,13
29130,ORD_29131,17069,Nitron Icepac Action,Warehouse C,20,6,2025-02-03 20:44:00,14
29131,ORD_29132,10838,"Dyazo Office Protective Laptop Sleeve | Case Cover with Handle for All 15 Inch to 15 .6"" Laptops, Notebooks (Blue)",Warehouse B,40,21,2025-02-03 19:37:00,19
29132,ORD_29133,20517,Simxen 4 Pcs Dummy CCTV Dome Camera with Blinking Red LED Light for Home Or Office Security Camera,Warehouse C,21,4,2025-02-03 19:52:00,17
29133,ORD_29134,29621,Amazon Brand - Solimo Back Cover Case for Samsung M31 / Samsung M31 Prime | Compatible for Samsung M31 / Samsung M31 Prime...,Warehouse B,31,17,2025-02-03 09:48:00,14
29134,ORD_29135,17077,Maryaj Grey Stone EDP Aromatic Woody Perfume For Me And Ajmal Sacrifice II For Him Deodorant Fruity Aromatic Fragrance 300 ml,Warehouse C,70,54,2025-02-03 14:48:00,16
29135,ORD_29136,4195,"iphone (2 PACK )USB C USB 3.1 Type C Female to USB Male Adapter Connector Converter Works with Laptops,Chargers Compatible...",Warehouse C,58,50,2025-02-03 01:50:00,8
29136,ORD_29137,28152,Itrq 200mg Capsule,Warehouse B,109,97,2025-02-03 19:10:00,12
29137,ORD_29138,31760,Oncraves 3D Back Camera Lens Protector For OnePlus 11R 5G Full Coverage 360 Degree Protection Tempered Glass Bubble-Free A...,Warehouse A,28,21,2025-02-03 18:44:00,7
29138,ORD_29139,30681,"INDUS VALLEY Hypo Allergic Aqua Colour 100% Botanical Hair Colour, 30ml + 200g - Dark Brown (Pack of 1)",Warehouse B,59,51,2025-02-03 21:48:00,8
29139,ORD_29140,29590,Clindoz-M 25 Tablet ER,Warehouse C,72,58,2025-02-03 22:46:00,14
29140,ORD_29141,28150,Xereb-DSR Capsule,Warehouse B,47,30,2025-02-03 17:59:00,17
29141,ORD_29142,17754,Itrafez 100mg Tablet,Warehouse A,33,18,2025-02-03 14:26:00,15
29142,ORD_29143,17088,Alock 200mg Tablet SR,Warehouse C,43,26,2025-02-03 22:06:00,17
29143,ORD_29144,25519,Insupride M1 Forte Tablet,Warehouse A,69,57,2025-02-03 12:59:00,12
29144,ORD_29145,25935,"boAt Aavante Bar 1750 2.1 Channel Bluetooth Soundbar with 120W RMS Signature Sound, Wireless Subwoofer, Multi-Compatibilit...",Warehouse C,32,22,2025-02-03 23:19:00,10
29145,ORD_29146,26516,ZOUK Women Messenger Bag Beige,Warehouse B,30,21,2025-02-03 20:19:00,9
29146,ORD_29147,3016,TopFinder® Waterproof Liquid Foundation For Face Makeup | SPF 15 | Highlighter | Corrector | Dry Skin Treatment | HD Water...,Warehouse A,24,18,2025-02-03 11:50:00,6
29147,ORD_29148,11249,Todaz N Tablet,Warehouse B,40,26,2025-02-03 04:18:00,14
29148,ORD_29149,28045,Nervlaz 500mcg Injection,Warehouse A,54,35,2025-02-03 23:57:00,19
29149,ORD_29150,5078,Clozema gm Cream,Warehouse A,91,72,2025-02-03 16:08:00,19
29150,ORD_29151,17772,Hygienic Hand Sanitiser Liquid,Warehouse A,60,50,2025-02-03 13:24:00,10
29151,ORD_29152,5110,Asnac TH 100mg/4mg Tablet,Warehouse B,49,37,2025-02-03 21:35:00,12
29152,ORD_29153,30632,"Seagate Expansion 500 GB External SSD up to 1000 MB/s – USB-C and USB 3.0 for PC, Laptop and Mac, 3 yr Data Recovery Servi...",Warehouse B,60,52,2025-02-03 01:04:00,8
29153,ORD_29154,29701,"Samsung Galaxy A14 5G (Light Green, 6GB, 128GB Storage) | Triple Rear Camera (50 MP Main) | Upto 12 GB RAM with RAM Plus |...",Warehouse A,109,94,2025-02-03 00:59:00,15
29154,ORD_29155,27925,Sensual Amber Handmade Luxury Soap,Warehouse C,29,10,2025-02-03 04:38:00,19
29155,ORD_29156,18372,Saco Silicone Skin Keyboard Cover Compatible for 2019 and 2018 HP Pavilion 15-cs0053cl 15.6 inch Laptop - Black,Warehouse A,75,56,2025-02-03 02:45:00,19
29156,ORD_29157,17786,Sri Sri Tattva Pavanahara Vati 500 mg Tablet 60's,Warehouse A,66,60,2025-02-03 14:38:00,6
29157,ORD_29158,5839,Dazmont-L Tablet,Warehouse C,20,8,2025-02-03 11:36:00,12
29158,ORD_29159,18373,"Fashion Colour Terra Cotta Blusher, Shade 02 8 gm",Warehouse C,104,94,2025-02-03 16:11:00,10
29159,ORD_29160,25911,Waydif P 50mg/325mg Tablet,Warehouse C,107,90,2025-02-03 23:46:00,17
29160,ORD_29161,27950,Pic 500mg Tablet,Warehouse B,95,76,2025-02-03 04:10:00,19
29161,ORD_29162,26584,Canpex Lotion,Warehouse A,17,8,2025-02-03 12:07:00,9
29162,ORD_29163,5092,Acne Clear Face Wash,Warehouse B,95,83,2025-02-03 21:16:00,12
29163,ORD_29164,4154,Spasmak Y 20 mg/500 mg Tablet,Warehouse C,49,34,2025-02-03 17:37:00,15
29164,ORD_29165,31845,Urilosin F 0.4 mg/5 mg Capsule,Warehouse A,113,96,2025-02-03 17:29:00,17
29165,ORD_29166,2984,Enter USB Game pad with Vibration E-GPV,Warehouse A,45,29,2025-02-03 16:52:00,16
29166,ORD_29167,31840,Azo 250mg Tablet,Warehouse A,28,23,2025-02-03 03:52:00,5
29167,ORD_29168,28047,Comet Busters Fancy White Diamond Dot Bindi For Women (BIN203),Warehouse A,70,64,2025-02-03 07:15:00,6
29168,ORD_29169,20508,"Stainless Steel Callus Shaver Pedicure Dead Hard Skin Remover Heel Razor Cutter With Skin (10 blades) Rub For Foot Care, R...",Warehouse B,66,49,2025-02-03 09:12:00,17
29169,ORD_29170,17770,Ringke Fusion-X Compatible For iPhone 14 Case Cover Transparent Hard Back Soft Flexible TPU Bumper Scratch Resistant Shock...,Warehouse C,101,93,2025-02-03 10:08:00,8
29170,ORD_29171,30717,Cello Colour Bombs Coloured Ink Gel Pens | Pack of 10 | 10 Vivid Ink Colours | Coloured Gel Pens | Gel Pen for Students| I...,Warehouse C,89,71,2025-02-03 10:09:00,18
29171,ORD_29172,31717,Etorip-MR Tablet,Warehouse C,73,61,2025-02-03 20:34:00,12
29172,ORD_29173,3066,Amicosh 100mg Injection,Warehouse A,22,8,2025-02-03 20:39:00,14
29173,ORD_29174,19312,Bella Voste Gel-Shine Nail Paint Shade 323 10 Ml,Warehouse C,73,68,2025-02-03 20:09:00,5
29174,ORD_29175,20687,SanDisk ® Ultra Curve USB 3.2 64GB 100MB/s R Navy Blue,Warehouse B,55,43,2025-02-03 03:21:00,12
29175,ORD_29176,27026,"L.A Girl Luminous Glow Illuminating Cream Liquid Highlighter - Moonlight, Brown, Blends Smoothly, Healthy glow (30ml)",Warehouse C,35,30,2025-02-03 10:08:00,5
29176,ORD_29177,29306,Giobact Injection,Warehouse B,70,52,2025-02-03 11:10:00,18
29177,ORD_29178,2937,OCTRIX 65w Warp Charger for OnePlus 65 Watt Warp Charging with C to C Cable | Fast Warp/Dash Charger for OnePlus 10/10 Pr...,Warehouse C,20,5,2025-02-03 23:16:00,15
29178,ORD_29179,32391,GC Individual Flat Shaped Eyelash Extensions Semi Permanent Lashes Black 12mm,Warehouse B,54,38,2025-02-03 11:03:00,16
29179,ORD_29180,6290,UNI-BALL UNSGP153SBL3 Signo Gel Pen Set - Pack of 3 (Blue),Warehouse B,108,97,2025-02-03 21:32:00,11
29180,ORD_29181,27163,Acigo-P Tablet,Warehouse C,54,40,2025-02-03 10:40:00,14
29181,ORD_29182,5521,Original Germ Protection Liquid Handwash,Warehouse A,84,71,2025-02-03 03:16:00,13
29182,ORD_29183,18046,Levipra 250mg Tablet,Warehouse C,61,43,2025-02-03 04:39:00,18
29183,ORD_29184,27177,Smoltif 50mg/325mg Tablet,Warehouse B,46,35,2025-02-03 11:49:00,11
29184,ORD_29185,8974,Zety ES 0.5mg/10mg Tablet,Warehouse B,107,98,2025-02-03 18:42:00,9
29185,ORD_29186,2681,Nimax 100mg Tablet,Warehouse B,41,23,2025-02-03 21:03:00,18
29186,ORD_29187,16674,Ajmal Shadow Homme Sacred Love Deodorant Spray (Pack of 2) 200 ml,Warehouse B,70,58,2025-02-03 02:24:00,12
29187,ORD_29188,30116,HEALTHY PANDA Chatpata Sattu Drink / Sattoo Drink/Natural Weight loss drink (400 gms) 100 X 4 Energy Drink,Warehouse C,73,65,2025-02-03 13:18:00,8
29188,ORD_29189,18167,Stampo CV 200mg/125mg Tablet,Warehouse B,32,18,2025-02-03 01:45:00,14
29189,ORD_29190,27559,Risk Taker Deodorant Body Spray For Men,Warehouse C,60,42,2025-02-03 00:16:00,18
29190,ORD_29191,11446,Gillette Wilkinson Sword Double Edge Razor Blades (Pack Of 2),Warehouse C,58,53,2025-02-03 19:06:00,5
29191,ORD_29192,25376,Qutin 100mg Tablet,Warehouse C,115,96,2025-02-03 16:15:00,19
29192,ORD_29193,10783,Omeo-DSR Capsule,Warehouse C,60,53,2025-02-03 12:26:00,7
29193,ORD_29194,17383,Sheetal Oil,Warehouse A,40,31,2025-02-03 08:44:00,9
29194,ORD_29195,8915,Fujifilm Instax Mini 9 Instant Camera (Lime Green),Warehouse A,20,4,2025-02-03 18:43:00,16
29195,ORD_29196,3712,"SHOW BEAUTY eyeliner waterproof, longlasting,Intensely Pigmented Liquid, Sweat Proof, Moisture Resistant, matte finish eye...",Warehouse A,105,87,2025-02-03 02:03:00,18
29196,ORD_29197,17881,Pentopra 40mg Tablet,Warehouse B,92,86,2025-02-03 22:02:00,6
29197,ORD_29198,32005,Bringha Hair Cleanser,Warehouse B,102,86,2025-02-03 03:21:00,16
29198,ORD_29199,16958,Salhexin Syrup,Warehouse C,56,39,2025-02-03 19:07:00,17
29199,ORD_29200,16910,Wergomet 0.2mg Injection,Warehouse B,50,31,2025-02-03 22:40:00,19
29200,ORD_29201,29806,Cpdx 100mg Tablet,Warehouse A,71,53,2025-02-03 01:00:00,18
29201,ORD_29202,18314,Nebipil-H Tablet,Warehouse C,30,20,2025-02-03 18:13:00,10
29202,ORD_29203,10800,Flormar Nail Enamel 400 Bright White 11 ml,Warehouse C,43,25,2025-02-03 19:12:00,18
29203,ORD_29204,16904,Lcmk 5mg/10mg Tablet,Warehouse A,67,52,2025-02-03 03:27:00,15
29204,ORD_29205,9694,3D Temporary Tattoo Sticker Beautiful Black Color Bold English Alphabets Letters Popular Design Size 19x9 CM - 2PCS.,Warehouse B,94,89,2025-02-03 16:48:00,5
29205,ORD_29206,2890,Optra 200mg Tablet,Warehouse A,31,25,2025-02-03 03:07:00,6
29206,ORD_29207,8918,Camlin Kokuyo Artist 40ml Acrylic Color Shade - 12 Shades (Multicolor),Warehouse A,40,32,2025-02-03 18:37:00,8
29207,ORD_29208,27624,"MATRIX Opti Long Professional 200ml Shampoo + 98g conditioner |For healthy, long hair with nourished lengths and split end...",Warehouse A,43,33,2025-02-03 12:39:00,10
29208,ORD_29209,32398,"Sanitary Pads - Extra Large Plus, Ultra Clean",Warehouse C,100,94,2025-02-03 08:49:00,6
29209,ORD_29210,5663,"Portronics My Buddy K Foldable Height Adjustable Metal Frame Laptop Stand, Ergonomic, OverHeating Protection for Laptops, ...",Warehouse B,70,60,2025-02-03 23:25:00,10
29210,ORD_29211,20014,"FLiX (Beetel) USB to iPhone Lightning Textured Pattern Data Sync & 2A Fast Charging Cable, Made in India, 480Mbps Data Syn...",Warehouse C,105,86,2025-02-03 23:16:00,19
29211,ORD_29212,5665,"Note Italy Gel Look Nail Enamel 14, Red, 9ml",Warehouse B,31,21,2025-02-03 09:59:00,10
29212,ORD_29213,24897,HP V165W 16GB USB Flash Drive,Warehouse C,55,43,2025-02-03 12:09:00,12
29213,ORD_29214,21631,TheGiftKart Shockproof Crystal Clear Back Cover Case for Samsung Galaxy A53 5G | 360 Degree Protection | Protective Design...,Warehouse A,97,86,2025-02-03 15:45:00,11
29214,ORD_29215,9463,Nature Republic Collagen BB Cream #1 Light Beige (SPF25 PA++),Warehouse B,85,75,2025-02-03 06:38:00,10
29215,ORD_29216,6791,ZEBRONICS Zeb-Duke Bluetooth Wireless Over Ear Headphone with Mic (Blue),Warehouse A,72,60,2025-02-03 15:04:00,12
29216,ORD_29217,2639,Kurtzy Watercolor Paint Set - (12 colors x 12 ml) Multicolour Non-Toxic Paint Tubes with Mixing Palette & 4 Brushes for Ar...,Warehouse C,24,19,2025-02-03 10:01:00,5
29217,ORD_29218,30246,Charmacy Milano Gradient Shadows Palatte 01 7.2 gm,Warehouse C,112,93,2025-02-03 14:29:00,19
29218,ORD_29219,5642,Olmibid CT 40mg/12.5mg Tablet,Warehouse C,42,30,2025-02-03 00:49:00,12
29219,ORD_29220,2662,"Quantum Laptop Cooling Pad with Noiseless Fan, 4-Level Metal Rod Adjustable tilt Laptop Stand, USB Powered with Blue LED, ...",Warehouse B,70,59,2025-02-03 04:15:00,11
29220,ORD_29221,30144,Mcaffeine Naked & Raw Latte Coffee Leave-in Hair Cream 50 ml,Warehouse A,72,57,2025-02-03 01:58:00,15
29221,ORD_29222,30139,Olgest 200mg Tablet SR,Warehouse B,70,63,2025-02-03 14:35:00,7
29222,ORD_29223,5531,Dealfreez Silicone TV Remote Cover for LG TV Remote AN-MR19BA AN-MR600 MR20 Magic Remote Case with Remote Loop (B-Black),Warehouse C,35,25,2025-02-03 18:42:00,10
29223,ORD_29224,21608,"TheGiftKart Back Cover Case for Samsung Galaxy F62 (Polycarbonate, TPU | Transparent | Black Bumper)",Warehouse C,69,63,2025-02-03 07:31:00,6
29224,ORD_29225,5510,Atoritic 40mg Tablet,Warehouse B,51,44,2025-02-03 01:52:00,7
29225,ORD_29226,27200,CEDO Redmi Note 11 Pro / 11 Pro + Plus (5G) Case Back Cover Shockproof Bumper Crystal Clear | 360 Degree Protection TPU+PC...,Warehouse C,18,5,2025-02-03 00:51:00,13
29226,ORD_29227,9527,TLC Soft Gel Hair Colour - Natural Black,Warehouse B,84,73,2025-02-03 07:43:00,11
29227,ORD_29228,30320,Cilnikem 10 Tablet,Warehouse A,88,75,2025-02-03 12:42:00,13
29228,ORD_29229,32335,OpenTech® Silicone Protection Bumper Case Cover for Samsung Galaxy Watch 4 (44mm) Full Coverage (Black),Warehouse B,108,94,2025-02-03 17:34:00,14
29229,ORD_29230,7876,Nicka K RADIANT LIQUID SHADOW- OCHROID TITAN 5 gm,Warehouse B,81,67,2025-02-03 17:39:00,14
29230,ORD_29231,32327,C14 Thermal Paste 13.6 W/m*K - (2.0 Gram) Subzero Overclocking ™ Stage-1 Kit,Warehouse A,45,32,2025-02-03 06:37:00,13
29231,ORD_29232,24943,Retoz-Neo 60 Tablet,Warehouse C,105,97,2025-02-03 19:31:00,8
29232,ORD_29233,32317,Tecri-D 10mg/20mg Tablet,Warehouse A,52,34,2025-02-03 11:38:00,18
29233,ORD_29234,21607,Mecef 100mg Tablet,Warehouse A,30,19,2025-02-03 14:57:00,11
29234,ORD_29235,30334,Supertol 150 Tablet,Warehouse C,73,56,2025-02-03 08:00:00,17
29235,ORD_29236,32296,"Motorola Tab (11inch, 4GB, 64GB, WiFi+LTE Calling), Modernist Teal with Mediatek Helio G90T Processor, Quadcore Speakers w...",Warehouse B,18,7,2025-02-03 09:52:00,11
29236,ORD_29237,19946,The Skin Story Keratin Shampoo 200 ml,Warehouse A,24,18,2025-02-03 05:01:00,6
29237,ORD_29238,6282,"Juarez JRZ100 Guitar Wall Hanger/Mount With Fittings/Accessories, Black",Warehouse C,105,99,2025-02-03 18:32:00,6
29238,ORD_29239,5512,"realme narzo 50A (Oxygen Green , 4GB RAM + 128 GB Storage) Helio G85 Processor | 6000 mAh Battery",Warehouse A,41,24,2025-02-03 15:53:00,17
29239,ORD_29240,10687,"Nivea Nourishing Lotion Body Milk, 200ml (Pack of 3), Dry Skin",Warehouse C,96,86,2025-02-03 14:36:00,10
29240,ORD_29241,16959,After Shave Spray - Musk For Men,Warehouse A,97,84,2025-02-03 05:26:00,13
29241,ORD_29242,16901,Akmin 500mg Injection,Warehouse C,60,55,2025-02-03 04:57:00,5
29242,ORD_29243,29831,Airtel DTH HD Set Top Box | 1 Month Entertainment Pack | Recording Feature | Free Installation,Warehouse C,66,50,2025-02-03 04:27:00,16
29243,ORD_29244,4118,Bonjour Paris Just Matte Lip Crayon - Watermelon Red 3.2 gm,Warehouse A,97,85,2025-02-03 17:38:00,12
29244,ORD_29245,11346,Gabagain NP Tablet,Warehouse C,85,70,2025-02-03 00:36:00,15
29245,ORD_29246,32026,Dethro Oral Suspension,Warehouse B,108,99,2025-02-03 18:44:00,9
29246,ORD_29247,27903,Vocid Capsule,Warehouse C,25,16,2025-02-03 11:37:00,9
29247,ORD_29248,17828,Levotum OZ Oral Suspension,Warehouse C,69,57,2025-02-03 03:58:00,12
29248,ORD_29249,20960,"(Renewed) Sony WI-C200 Wireless in-Ear Headset/Headphones with mic for Phone Call, Black (WIC200/B)",Warehouse B,27,12,2025-02-03 03:12:00,15
29249,ORD_29250,27832,Felisec 40 Tablet,Warehouse A,14,8,2025-02-03 05:23:00,6
29250,ORD_29251,29875,G Met 1mg/500mg Tablet,Warehouse B,99,86,2025-02-03 15:20:00,13
29251,ORD_29252,20889,Seracer-DP Tablet,Warehouse B,87,72,2025-02-03 17:45:00,15
29252,ORD_29253,5307,Zevacef 50mg Dry Syrup,Warehouse C,63,56,2025-02-03 10:48:00,7
29253,ORD_29254,9672,Wet N Wild Max Fanatic Mascara - Black Cat 8 ml,Warehouse C,89,77,2025-02-03 23:35:00,12
29254,ORD_29255,29893,"MAKE UP FOR LIFE 12 Hr Liquid Lip Gloss-118, Pink Peach, 5 g",Warehouse B,10,1,2025-02-03 22:58:00,9
29255,ORD_29256,5146,Glybetic MP 2mg/500mg/15mg Tablet,Warehouse B,21,16,2025-02-03 11:34:00,5
29256,ORD_29257,26739,Letroheal 2.5mg Tablet,Warehouse C,104,87,2025-02-03 03:59:00,17
29257,ORD_29258,3723,Timofex 180mg Tablet,Warehouse B,13,5,2025-02-03 08:01:00,8
29258,ORD_29259,18364,D-Tan Scrub For Men,Warehouse B,101,88,2025-02-03 00:32:00,13
29259,ORD_29260,9808,Brispod 100mg Tablet,Warehouse C,89,70,2025-02-03 03:08:00,19
29260,ORD_29261,27877,Anihist P Syrup,Warehouse A,42,26,2025-02-03 08:03:00,16
29261,ORD_29262,29913,FriendZon 9H Nano Tempered Glass Screen Protector Compatible with Royal Enfield Meteor 350 / Scram 411 / Hunter 350 (Pack ...,Warehouse B,32,13,2025-02-03 22:39:00,19
29262,ORD_29263,9676,NOYMI Silicone 2 in 1 Universal Car Mobile Holder Car Phone Holder with Refillable Aromatic Tablet Perfect for Dashboard A...,Warehouse C,23,18,2025-02-03 14:57:00,5
29263,ORD_29264,20347,Cefera O 200mg/200mg Tablet,Warehouse C,32,23,2025-02-03 07:02:00,9
29264,ORD_29265,3727,YELLOWFIN Fully Waterproof Handlebar Mobile Phone Mount Holder with 360° Rotation for Motorcycle | Bike | Scooter | Bicycl...,Warehouse A,108,94,2025-02-03 03:15:00,14
29265,ORD_29266,11412,SWAPKART 3.5 mm Headphone Jack Lightning Adapter Connector Only Supported Music Control Audio Adapter for iPhone 6 6s 7 8 ...,Warehouse C,18,2,2025-02-03 11:52:00,16
29266,ORD_29267,20425,Brimonist Eye Drop,Warehouse B,40,25,2025-02-03 00:02:00,15
29267,ORD_29268,27571,Pilot Ink Cartridges -Black(Pack of 6),Warehouse C,68,51,2025-02-03 22:47:00,17
29268,ORD_29269,6361,Flu-4-XN Tablet,Warehouse A,75,63,2025-02-03 20:40:00,12
29269,ORD_29270,5299,"iQOO Z6 5G by vivo (Dynamo Black, 4GB RAM, 128GB Storage) | Snapdragon 695-6nm Processor | 120Hz FHD+ Display | 5000mAh Ba...",Warehouse A,9,3,2025-02-03 02:27:00,6
29270,ORD_29271,25484,Hawk Proaudio SXFG010 Gold Series XLR Male to Female With Cable Tie for Speaker - 3 Meter (Black),Warehouse A,97,86,2025-02-03 16:49:00,11
29271,ORD_29272,20368,"Fashion Colour Jersy Girl Artist Makeup Collection Eyeshadow Palette, Shade 01 14 gm",Warehouse B,56,40,2025-02-03 12:55:00,16
29272,ORD_29273,16917,Apdrops KT 0.4 Eye Drops BAK Free,Warehouse C,63,44,2025-02-03 21:49:00,19
29273,ORD_29274,21140,Vega Round Brush (H3 - RB) 97 gm,Warehouse B,80,73,2025-02-03 05:09:00,7
29274,ORD_29275,25028,"Nokia 105 Plus Dual SIM, Keypad Mobile Phone with Wireless FM Radio, Memory Card Slot and MP3 Player | Red",Warehouse C,76,67,2025-02-03 19:23:00,9
29275,ORD_29276,27783,"SYSKA PW-0301 Power Wheel - Extension Board, Grey and White, 1500 watt, 240V, 4m Wire",Warehouse A,54,49,2025-02-03 08:09:00,5
29276,ORD_29277,16971,"BenQ GW2780T 27 inch (68cm) 1920 X 1080 Pixels IPS Full HD Ultra-Slim Bezel Monitor- Height Adjustment, Eye Care, Anti-Gla...",Warehouse A,62,47,2025-02-03 11:22:00,15
29277,ORD_29278,11337,POPIO Tempered Glass Compatible for Samsung Galaxy M30 / M30s / A30 / A30s / A50 / A50s (Transparent) Full Screen Coverage...,Warehouse A,10,2,2025-02-03 13:24:00,8
29278,ORD_29279,19703,LUTICA (SUN) Lotion,Warehouse A,53,39,2025-02-03 13:15:00,14
29279,ORD_29280,30575,Megamet PG 2mg/500mg/15mg Tablet SR,Warehouse C,76,63,2025-02-03 19:20:00,13
29280,ORD_29281,29801,"truke BTG Alpha True Gaming in Ear Earbuds with 40ms Low Latency Gaming Mode, 7 RGB LEDs, Instant Pairing, AAC Codec, Upto...",Warehouse B,28,22,2025-02-03 17:27:00,6
29281,ORD_29282,19651,"Nokia G11 Android 12 Smartphone, Dual SIM, 3-Day Battery Life, 4GB RAM + 64GB Storage, 50MP Dual AI Camera | Lake Blue",Warehouse C,51,46,2025-02-03 00:01:00,5
29282,ORD_29283,19512,Infoglim 2mg Tablet,Warehouse C,32,24,2025-02-03 10:24:00,8
29283,ORD_29284,19561,HUDA GIRL BEAUTY Fit Me BB and CC Cream Foundation With Air Cushion,Warehouse B,58,50,2025-02-03 00:19:00,8
29284,ORD_29285,9731,Ajmal Aurum Carbon Deodorant Spray (Pack of 4) 200 ml,Warehouse A,107,95,2025-02-03 01:16:00,12
29285,ORD_29286,10799,Logipan-DSR Capsule,Warehouse A,36,28,2025-02-03 20:55:00,8
29286,ORD_29287,27712,Eteolam 0.25mg Tablet,Warehouse C,71,64,2025-02-03 04:12:00,7
29287,ORD_29288,19616,"LG Ultrawide 29Wl500, 29 Inch (73 Cm) 21:9 Wfhd LCD 2560 X 1080 Pixels IPS Display - HDR 10, AMD Freesync, Srgb 99%, Slim ...",Warehouse C,20,2,2025-02-03 04:10:00,18
29288,ORD_29289,25054,Done 10mg/20mg Capsule,Warehouse A,75,67,2025-02-03 22:07:00,8
29289,ORD_29290,30552,Iterno 200mg Capsule,Warehouse A,94,85,2025-02-03 21:19:00,9
29290,ORD_29291,26675,Line Art Tattoo Needle And Disposable Tip Combo 7RL & 7RT,Warehouse B,71,59,2025-02-03 02:27:00,12
29291,ORD_29292,2906,Heazith 250mg Tablet,Warehouse C,82,76,2025-02-03 22:44:00,6
29292,ORD_29293,27742,Pilmox 500mg Capsule,Warehouse B,74,62,2025-02-03 17:40:00,12
29293,ORD_29294,2903,Tomoxetin 10mg Capsule,Warehouse B,74,62,2025-02-03 14:54:00,12
29294,ORD_29295,17854,"Natural Chrysanthemum Body Lotion With Shea Butter, Vitamin E & Olive Oil",Warehouse A,88,69,2025-02-03 13:12:00,19
29295,ORD_29296,11357,Lakme Absolute Mattereal Mousse Concealer 02 Natural 9 Gm,Warehouse C,42,30,2025-02-03 17:34:00,12
29296,ORD_29297,8700,"CLASSY HUDA PROFESSIONAL MAKEUP BRUSHES SETS [SET OF 10], EYESHADOW, FACE POWDER, EYELINER, EYELASHES, LIP PALETTE, FOUNDA...",Warehouse B,27,12,2025-02-03 06:47:00,15
29297,ORD_29298,16954,Nnt 25mg Injection,Warehouse A,17,2,2025-02-03 19:24:00,15
29298,ORD_29299,5787,Escytop 10mg Tablet,Warehouse C,36,20,2025-02-03 19:32:00,16
29299,ORD_29300,16957,Wesflox OZ 200mg/500mg Tablet,Warehouse C,70,60,2025-02-03 12:30:00,10
29300,ORD_29301,30190,"Fashion Colour Baked Blusher, Shade 06 8 gm",Warehouse C,98,90,2025-02-03 01:15:00,8
29301,ORD_29302,27025,Pierre Cardin Paris - Porcelain Edition Blush On 165-Peach,Warehouse B,19,3,2025-02-03 02:35:00,16
29302,ORD_29303,10635,"Blushinsta Selfie Stick, Extendable Selfie Stick with Wireless Remote and Tripod Stand, Portable, Lightweight, Compatible ...",Warehouse B,100,95,2025-02-03 14:31:00,5
29303,ORD_29304,11470,Exam 200mg Tablet ER,Warehouse A,94,83,2025-02-03 23:09:00,11
29304,ORD_29305,24970,"ZORBES® Fashion Hard Protective Cover for Samsung Galaxy Buds Pro(2021),Galaxy Buds 2,Galaxy Buds Live (2020),Shockproof f...",Warehouse A,57,45,2025-02-03 06:50:00,12
29305,ORD_29306,24972,"Upix® AC Remote No. 129, Compatible for Whirlpool 3D Auto AC Remote Control (Exactly Same Remote Will Only Work)",Warehouse B,49,41,2025-02-03 14:02:00,8
29306,ORD_29307,6262,Action Avatar Deodorant & Body Spray Perfume For Men,Warehouse C,40,28,2025-02-03 17:34:00,12
29307,ORD_29308,20280,Pure Herbs - Skin Kasturi Turmeric,Warehouse A,47,39,2025-02-03 06:17:00,8
29308,ORD_29309,6261,Natural Intimate Wipes,Warehouse A,69,62,2025-02-03 12:44:00,7
29309,ORD_29310,2768,Risdil Plus Tablet,Warehouse A,98,93,2025-02-03 08:04:00,5
29310,ORD_29311,27405,I AM EYECONIC Duo Chrome Pigments MOOD 2 gm,Warehouse C,60,48,2025-02-03 12:15:00,12
29311,ORD_29312,5411,So Soft Wet Wipes - Lemon Flavour,Warehouse C,34,23,2025-02-03 04:50:00,11
29312,ORD_29313,8674,Tough Lee Silicone Back Cover for Mi 11 Lite/Xiaomi 11 Lite NE 5G (Transparent),Warehouse B,45,39,2025-02-03 04:26:00,6
29313,ORD_29314,3773,Cinof OZ 200mg/500mg Tablet,Warehouse A,41,36,2025-02-03 20:42:00,5
29314,ORD_29315,19850,"Fashion Colour Kiss Lip No Transfer Lipstick, 81 Coral 2.6 gm",Warehouse A,97,88,2025-02-03 08:07:00,9
29315,ORD_29316,2755,Amlofab 5mg Tablet,Warehouse B,18,1,2025-02-03 05:16:00,17
29316,ORD_29317,30012,Kumkumadi Face Serum,Warehouse C,53,36,2025-02-03 12:45:00,17
29317,ORD_29318,27432,Dsorolin Tablet,Warehouse C,91,75,2025-02-03 15:30:00,16
29318,ORD_29319,30389,Adzo-AP Kid Oral Suspension,Warehouse A,34,19,2025-02-03 11:16:00,15
29319,ORD_29320,8932,mobistyle Luxury Electroplating Case Individual Camera Protection for Each Lens Back Cover Case for iPhone 14 Pro Cover (E...,Warehouse B,31,14,2025-02-03 14:26:00,17
29320,ORD_29321,6757,Bactiderm Cream,Warehouse C,100,94,2025-02-03 00:49:00,6
29321,ORD_29322,19916,I AM EYECONIC BIODEGRADABLE GLITTER CHOCOLATE 4 gm,Warehouse B,35,30,2025-02-03 21:19:00,5
29322,ORD_29323,27340,Cefponet 100mg Tablet,Warehouse B,47,42,2025-02-03 16:18:00,5
29323,ORD_29324,2743,"Samsung Galaxy M33 5G (Mystique Green, 8GB, 128GB Storage) | 6000mAh Battery | Upto 16GB RAM with RAM Plus | Travel Adapte...",Warehouse A,78,60,2025-02-03 09:24:00,18
29324,ORD_29325,17995,Cyhet Syrup,Warehouse C,88,75,2025-02-03 21:42:00,13
29325,ORD_29326,19911,D-Link R04 N300 Eagle PRO AI Advance Parental Control Router with Voice Control Assistant (Alexa & Goggle Assistant) - Wi-...,Warehouse B,95,84,2025-02-03 06:43:00,11
29326,ORD_29327,25816,"RENEE Addict Liquid Lip Tint, Water & Smudge-proof, non-transfer Long Lasting Matte Finish, Enriched With Vitamin E, Vega...",Warehouse C,63,58,2025-02-03 15:45:00,5
29327,ORD_29328,5445,Elmox 250mg Tablet DT,Warehouse B,21,8,2025-02-03 19:37:00,13
29328,ORD_29329,3970,Epson EcoTank L4260 A4 Wi-Fi Duplex All-in-One Ink Tank Printer,Warehouse B,68,57,2025-02-03 02:39:00,11
29329,ORD_29330,18207,Karmelitus 2mg Tablet,Warehouse C,106,99,2025-02-03 15:15:00,7
29330,ORD_29331,2751,Necse Aq 75mg Injection,Warehouse C,14,7,2025-02-03 10:24:00,7
29331,ORD_29332,30396,Coldy Syrup,Warehouse A,90,82,2025-02-03 08:48:00,8
29332,ORD_29333,26851,Uniball Air Micro 188M (Set Of 4 Blue Pens),Warehouse C,65,51,2025-02-03 11:29:00,14
29333,ORD_29334,30010,HP 240 Bluetooth Wireless Mouse with 3 Buttons/1600 DPI Red Optical Tracking/Sleek and Ambidextrous/Compatible to Windows ...,Warehouse A,30,14,2025-02-03 16:45:00,16
29334,ORD_29335,10166,"POCO X4 Pro 5G (Laser Black, 6GB RAM 128GB Storage)",Warehouse C,19,7,2025-02-03 14:49:00,12
29335,ORD_29336,17384,Bath & Body Works Trimap Wallflowers Fragrance PlugOS,Warehouse A,111,92,2025-02-03 12:52:00,19
29336,ORD_29337,28812,Shaving Foam,Warehouse B,78,70,2025-02-03 06:00:00,8
29337,ORD_29338,9155,Dolfy 10mg/10mg/2.5mg Tablet,Warehouse B,35,17,2025-02-03 03:36:00,18
29338,ORD_29339,17375,"Sery Stay On Matte Liquid Lipstick Forever Nude, Brown (LSO - 05) 5 ml",Warehouse C,94,83,2025-02-03 03:44:00,11
29339,ORD_29340,26061,Nexipod 100mg Tablet,Warehouse C,101,82,2025-02-03 06:41:00,19
29340,ORD_29341,3503,Liotel 40mg Tablet,Warehouse C,32,25,2025-02-03 14:19:00,7
29341,ORD_29342,31295,hynix HMT351S6BFR8C 4GB DDR3 PC3-10600 1333MHz Non-ECC Unbuffered CL9 1.5V Dual Rank,Warehouse C,71,65,2025-02-03 06:24:00,6
29342,ORD_29343,6024,Crf 1000mg/500mg Injection,Warehouse C,103,87,2025-02-03 21:13:00,16
29343,ORD_29344,25294,Oflavid Syrup,Warehouse C,90,78,2025-02-03 15:30:00,12
29344,ORD_29345,18892,Glycosar 500mg Injection,Warehouse B,12,7,2025-02-03 16:23:00,5
29345,ORD_29346,10134,Oflozen D Eye Drop,Warehouse A,27,22,2025-02-03 18:28:00,5
29346,ORD_29347,25424,NPM-Nerve Tablet SR,Warehouse A,33,23,2025-02-03 09:56:00,10
29347,ORD_29348,3279,"Maybelline New York Super Stay Matte Ink Liquid Lipstick, 220 Ambitious 5 Gm",Warehouse A,45,33,2025-02-03 07:00:00,12
29348,ORD_29349,25418,Sensiclav 125 mg/31.25 mg Syrup,Warehouse C,17,7,2025-02-03 23:50:00,10
29349,ORD_29350,18884,ONSITEGO 1 Year Extended Warranty for Small Appliances (Rs.5001-10000) (Email Delivery - No Physical Kit) for B2B,Warehouse B,83,65,2025-02-03 18:30:00,18
29350,ORD_29351,18869,IFITech IFIADPTCAM 1080p USB Charger Type Hidden Camera | Home security spy camera | Support Maximum 256 Gb Memory Cards |...,Warehouse B,80,70,2025-02-03 09:31:00,10
29351,ORD_29352,17360,Itch Fit 1% Cream,Warehouse A,74,66,2025-02-03 00:57:00,8
29352,ORD_29353,20771,Revol D 10mg/20mg Capsule,Warehouse B,80,73,2025-02-03 03:13:00,7
29353,ORD_29354,28716,REDTECH USB C to Lightning Adapter Apple Lightning to Type C Adapter for iPhone iPad Support Charger+Data Sync Adapter Com...,Warehouse C,67,62,2025-02-03 07:00:00,5
29354,ORD_29355,18873,Carbova 50mg Injection,Warehouse A,21,7,2025-02-03 02:29:00,14
29355,ORD_29356,17597,Revlon One-Stroke Defining Eyeliner Kajal - Blooming Blue 1.2 Gm,Warehouse B,84,66,2025-02-03 01:52:00,18
29356,ORD_29357,21353,Sakura Pigma Micron Pens,Warehouse A,78,59,2025-02-03 04:46:00,19
29357,ORD_29358,10500,Revlon Colorstay Full Cover Foundation - Buff 30 ml,Warehouse C,22,7,2025-02-03 16:18:00,15
29358,ORD_29359,6644,Eddzaar 40 Tablet,Warehouse B,63,51,2025-02-03 22:43:00,12
29359,ORD_29360,6389,"LUNAGARIYA®, Protective Case for Airtel Xstream settop Box Remote Remote Control Pouch Cover Holder PU Leather Cover Holde...",Warehouse C,76,58,2025-02-03 23:57:00,18
29360,ORD_29361,9588,Trd Contin 50mg Injection,Warehouse B,59,53,2025-02-03 20:15:00,6
29361,ORD_29362,29979,"JBL C100SI Wired In Ear Headphones with Mic, JBL Pure Bass Sound, One Button Multi-function Remote, Premium Metallic Finis...",Warehouse A,52,43,2025-02-03 09:42:00,9
29362,ORD_29363,27020,Alzolam 1mg Tablet,Warehouse C,109,94,2025-02-03 04:22:00,15
29363,ORD_29364,27469,"(Renewed) OnePlus 5T (Midnight Black, 128GB)",Warehouse B,76,59,2025-02-03 07:12:00,17
29364,ORD_29365,32157,Altrox KID 50mg Tablet,Warehouse C,90,72,2025-02-03 16:34:00,18
29365,ORD_29366,19832,The Moms Co. Baby Water Wipes (Pack of 3) 1's,Warehouse A,36,27,2025-02-03 14:07:00,9
29366,ORD_29367,27495,"Tukzer Case Cover for Samsung Galaxy Tab A7 Lite 8.7"" (2021) - Ultra Slim Lightweight Hard Back Trifold Smart Stand Flip F...",Warehouse A,85,76,2025-02-03 10:52:00,9
29367,ORD_29368,18003,Depsival 10mg Tablet,Warehouse C,49,32,2025-02-03 12:04:00,17
29368,ORD_29369,3806,FLiX (Beetel) 3in1 (Type C|Micro|Iphone Lightening) Textured Pattern 3A Fast Charging Cable with QC & PD Support for Type ...,Warehouse A,48,39,2025-02-03 06:26:00,9
29369,ORD_29370,30170,Domicon 150mg Tablet,Warehouse C,11,1,2025-02-03 03:44:00,10
29370,ORD_29371,10631,Robustrion Marble Series Trifold Back Flip Case Cover with Pencil Holder for Apple iPad Cover 10.2 inch iPad 9th Generatio...,Warehouse C,68,59,2025-02-03 04:11:00,9
29371,ORD_29372,5574,Aciana 150mg Injection,Warehouse C,97,86,2025-02-03 14:36:00,11
29372,ORD_29373,20204,"ZEBRONICS Zeb-100HB 4 Ports USB Hub for Laptop, PC Computers, Plug & Play, Backward Compatible - Black",Warehouse C,34,26,2025-02-03 20:37:00,8
29373,ORD_29374,18058,Daily Defence Instant Fairness Cream,Warehouse C,73,66,2025-02-03 15:18:00,7
29374,ORD_29375,27091,Lash Paradise Mascara - Waterproof,Warehouse B,61,55,2025-02-03 05:44:00,6
29375,ORD_29376,21620,"Lenovo Tab M10 Fhd Plus (2Nd Gen) (10.3 Inch, 4Gb, 128 Gb, Wi-Fi + LTE, Volte Calling, Platinum Grey) with Earphone, Kids ...",Warehouse B,88,76,2025-02-03 17:02:00,12
29376,ORD_29377,27100,"Traditional Pure Goat Milk Melt And Pour Soap Base, 1 Kg",Warehouse B,77,59,2025-02-03 01:13:00,18
29377,ORD_29378,5562,Face Cream - Complexion Care,Warehouse C,25,8,2025-02-03 17:30:00,17
29378,ORD_29379,30268,Prolet Classic Bumper Case Cover for Samsung Galaxy Watch 4 44mm TPU Plated Full Screen Protector (Black),Warehouse C,9,3,2025-02-03 14:56:00,6
29379,ORD_29380,5558,Gastowel 40 Tablet,Warehouse C,23,17,2025-02-03 20:24:00,6
29380,ORD_29381,20214,Nantis 50 Injection,Warehouse B,46,34,2025-02-03 21:35:00,12
29381,ORD_29382,20051,Nadix 1% Cream,Warehouse B,49,35,2025-02-03 15:44:00,14
29382,ORD_29383,30157,Non-Sticky Hair Oil - Walnut & Almond,Warehouse B,57,45,2025-02-03 15:06:00,12
29383,ORD_29384,10630,House Of Makeup Pout Potion Liquid Matte Lipstick - Drama Queen,Warehouse A,79,74,2025-02-03 05:47:00,5
29384,ORD_29385,18054,Lenmol-S Tablet,Warehouse B,61,51,2025-02-03 02:35:00,10
29385,ORD_29386,20196,Mood On 0.5mg/10mg Tablet,Warehouse A,40,30,2025-02-03 04:36:00,10
29386,ORD_29387,6790,Bacomik 500mg Injection,Warehouse C,85,67,2025-02-03 19:35:00,18
29387,ORD_29388,2715,Lambre TTO Cream Gel Spot Reducer 15ml,Warehouse A,90,78,2025-02-03 16:11:00,12
29388,ORD_29389,5643,Titan Ladies Neo - Ii Analog Black Dial Women's Watch NM2481SL07/NN2481SL07/NP2481SL07,Warehouse C,78,66,2025-02-03 10:48:00,12
29389,ORD_29390,18109,Sirona Natural Therapeutic Body Wash 200 ml,Warehouse A,87,74,2025-02-03 22:32:00,13
29390,ORD_29391,18090,Panpol-DSR Capsule,Warehouse A,24,12,2025-02-03 08:03:00,12
29391,ORD_29392,16594,Biosoft Roll On Wax Heater (White),Warehouse B,22,9,2025-02-03 14:41:00,13
29392,ORD_29393,16834,Atoran CV 10mg/75mg Tablet,Warehouse B,93,76,2025-02-03 19:12:00,17
29393,ORD_29394,20316,DAHSHA Pocket Sized Stitched PU Leather Credit Card Holder Visiting Business Card Case Wallet with Magnetic Shut for Men &...,Warehouse A,99,86,2025-02-03 23:52:00,13
29394,ORD_29395,10736,Lamosyn 50 Tablet,Warehouse B,71,61,2025-02-03 07:53:00,10
29395,ORD_29396,26787,Welminic-P Syrup Gluten Free,Warehouse A,48,36,2025-02-03 22:53:00,12
29396,ORD_29397,27569,"OJOS Ultra Thin Keyboard Protector Cover Compatible for M1 Pro/M1 Max Chip MacBook Pro 14""/16"" M2 M1 A2779 A2442 A2780 A24...",Warehouse A,86,71,2025-02-03 03:58:00,15
29397,ORD_29398,10573,Cufrox-L Syrup,Warehouse B,8,2,2025-02-03 16:19:00,6
29398,ORD_29399,9638,Pikkme Vivo Y12 / Y15 / Y17 / U10 Back Cover Soft Matte Liquid Silicone TPU | Camera Protection | Shockproof Slim Back Cas...,Warehouse A,42,35,2025-02-03 14:57:00,7
29399,ORD_29400,21561,"JK Copier Paper - A4, 500 Sheets, 75 GSM, Ream 3",Warehouse A,63,46,2025-02-03 16:06:00,17
29400,ORD_29401,32135,Eyetex Dazller Nail Glitter - DMA6 (Eclipse) 12 ml,Warehouse B,74,58,2025-02-03 18:46:00,16
29401,ORD_29402,18227,Rygab 450mg Tablet ER,Warehouse C,58,50,2025-02-03 12:37:00,8
29402,ORD_29403,32123,Ebee MDF Brown Laptop Table with Drawer,Warehouse A,49,37,2025-02-03 19:07:00,12
29403,ORD_29404,30480,Havana WTB-005 Sustain Pedal,Warehouse A,49,31,2025-02-03 04:56:00,18
29404,ORD_29405,30486,Nokia 105 Dual SIM (Black),Warehouse C,100,91,2025-02-03 23:39:00,9
29405,ORD_29406,9357,D-Alert Tablet,Warehouse C,67,55,2025-02-03 23:55:00,12
29406,ORD_29407,11419,Convistat 40mg Tablet,Warehouse B,44,34,2025-02-03 08:58:00,10
29407,ORD_29408,8999,"NISHTECH (1.5 Meter 4K Ultra HD HDMI Male to Male Cable (Black) -Compatible with Laptop, PC, Projector & TV & All HDMI sup...",Warehouse C,42,37,2025-02-03 00:01:00,5
29408,ORD_29409,18239,LA French Dream Girl Perfume For Women 85 ml,Warehouse B,7,2,2025-02-03 22:27:00,5
29409,ORD_29410,32101,L'Oreal Paris True Match Super Blendable Liquid Foundation Rose Vanilla 2R2C2K 30 Gm,Warehouse A,88,69,2025-02-03 00:41:00,19
29410,ORD_29411,26758,Uribact 500mg Tablet,Warehouse A,67,60,2025-02-03 17:37:00,7
29411,ORD_29412,19761,Gatifect 400mg Tablet,Warehouse C,98,91,2025-02-03 15:34:00,7
29412,ORD_29413,19755,Comet Busters Traditional Maroon Moon Bindis (BIN1250),Warehouse C,95,78,2025-02-03 05:58:00,17
29413,ORD_29414,32143,talotech Neckband Earphones Wireless Bluetooth Headphone 100Hrs Playtime Wireless In Ear Headset with Display Hi-Fi Stereo...,Warehouse A,64,46,2025-02-03 19:26:00,18
29414,ORD_29415,30451,XX Revolution press shadow palette xxecutive 1.2 gm,Warehouse A,70,52,2025-02-03 03:33:00,18
29415,ORD_29416,4007,Fusiderm Ointment,Warehouse A,50,38,2025-02-03 11:05:00,12
29416,ORD_29417,29957,TenDC Tablet,Warehouse C,39,25,2025-02-03 02:05:00,14
29417,ORD_29418,4008,Kivoflox UTI 200mg/200mg Tablet,Warehouse A,32,24,2025-02-03 01:48:00,8
29418,ORD_29419,27443,CEDO Case Realme C30 / Realme Narzo 50i Prime Case Back Cover Shockproof Bumper Crystal Clear | 360 Degree Protection TPU+...,Warehouse A,67,48,2025-02-03 14:26:00,19
29419,ORD_29420,29964,Gemblue Biocare Tomato Mask 500 ml,Warehouse B,40,21,2025-02-03 15:17:00,19
29420,ORD_29421,21575,"Fashion Colour Hi Tech Face Powder, Shade 03 10 gm",Warehouse B,93,85,2025-02-03 22:47:00,8
29421,ORD_29422,27460,Spigen Liquid Air Back Cover Case Compatible for Google Pixel 7 (TPU | Matte Black),Warehouse A,97,91,2025-02-03 13:55:00,6
29422,ORD_29423,27464,Lenovo IdeaPad Slim 3 Intel Core i5 11th Gen 15.6 inches (39.62cm) FHD Thin & Light Business Laptop (8GB/512GB SSD/Windows...,Warehouse C,79,65,2025-02-03 14:35:00,14
29423,ORD_29424,24989,"Lip Balm, Blackberry Shine, 24h Moisture With Natural Oils, Ruby Red Shine & Berry Aroma",Warehouse A,85,76,2025-02-03 04:04:00,9
29424,ORD_29425,18217,"SD CASS®Car Phone Holder Mount, Mobile Phone Holder for Car 360 Degree Rotation Dashboard Clip Mount Car Phone Stand Car D...",Warehouse C,108,95,2025-02-03 09:35:00,13
29425,ORD_29426,31640,Sunscreen Lotion With Fairness - Spf 50 Pa+++,Warehouse A,30,11,2025-02-03 23:56:00,19
29426,ORD_29427,15797,Makeup Revolution Balayage Brow Brown,Warehouse A,85,80,2025-02-03 13:51:00,5
29427,ORD_29428,26438,Rosuprime A 10mg/75mg Capsule,Warehouse A,35,25,2025-02-03 11:06:00,10
29428,ORD_29429,34941,Eradin 400mg Tablet,Warehouse C,103,86,2025-02-03 20:58:00,17
29429,ORD_29430,12138,Dell Original Inspiron 13 14 15 Laptop Charger 65W Slim Pin Ac Power Adapter(La65Ns2-01/0G6J41/Mgjn9) for Inspiron 5000 70...,Warehouse A,89,79,2025-02-03 02:51:00,10
29430,ORD_29431,14736,Mcaffeine Naked & Raw Coffee Scalp Tonic 100 ml,Warehouse B,67,58,2025-02-03 15:49:00,9
29431,ORD_29432,12614,"Honor MagicBook 15, AMD Ryzen 5 5500U 15.6-inch (39.62 cm) FHD IPS Anti-Glare Thin and Light Laptop (8GB/256GB PCIe SSD/Wi...",Warehouse B,81,76,2025-02-03 14:51:00,5
29432,ORD_29433,8212,Linifex 180 Tablet,Warehouse C,85,80,2025-02-03 07:17:00,5
29433,ORD_29434,1812,"Mini 2.4Ghz Wireless Touchpad Keyboard with 360 Degree Flip, USB Drive Port Rechargeable Lithium-Ion Battery Ergonomically...",Warehouse A,15,10,2025-02-03 20:14:00,5
29434,ORD_29435,7112,Pentel Energel - 0.7mm - Roller Gel Pen Set - Pack of 6 Pens - (3 BLUE + 3 BLACK),Warehouse B,40,33,2025-02-03 02:44:00,7
29435,ORD_29436,33947,"Redgear A-10 Wired Gaming Mouse with RGB LED, Lightweight and Durable Design, DPI Upto 2400, Compatible with Windows and MAC.",Warehouse C,43,31,2025-02-03 22:12:00,12
29436,ORD_29437,8392,Stealodeal Headset Headphone Carrying Case Earpads Storage Bag Headphone Pouch Portable Anti-Pressure (EVA-Black),Warehouse A,84,72,2025-02-03 19:39:00,12
29437,ORD_29438,12142,House of Beauty Fish Oil 10 ml,Warehouse C,26,18,2025-02-03 06:25:00,8
29438,ORD_29439,35009,Clonapik 0.25mg Tablet,Warehouse A,89,72,2025-02-03 11:42:00,17
29439,ORD_29440,22357,Sparol 200mg Tablet,Warehouse B,67,55,2025-02-03 15:22:00,12
29440,ORD_29441,15501,"Time Office Replacement Cable For Mantra Mfs100 Fingerprint Scanner (Usb, Black)",Warehouse C,89,81,2025-02-03 23:25:00,8
29441,ORD_29442,23880,Fixcott-LB Tablet DT,Warehouse C,109,97,2025-02-03 13:51:00,12
29442,ORD_29443,1740,Jovees Face Scrub - Jojoba & Neem 100 gm,Warehouse C,81,76,2025-02-03 11:40:00,5
29443,ORD_29444,23913,Cefikay 50mg Dry Syrup,Warehouse C,33,16,2025-02-03 10:04:00,17
29444,ORD_29445,15309,Genegesic-SP Tablet,Warehouse A,45,37,2025-02-03 17:10:00,8
29445,ORD_29446,34946,Fermanil SP Tablet,Warehouse B,27,15,2025-02-03 09:00:00,12
29446,ORD_29447,24218,Averreb D 30mg/20mg Capsule SR,Warehouse A,89,70,2025-02-03 00:34:00,19
29447,ORD_29448,14858,Coloncid 40mg Tablet,Warehouse C,97,87,2025-02-03 01:02:00,10
29448,ORD_29449,7158,"realme narzo 50 (Speed Blue, 6GB RAM+128GB Storage) Helio G96 Processor | 50MP AI Triple Camera | 120Hz Ultra Smooth Display",Warehouse C,32,15,2025-02-03 03:01:00,17
29449,ORD_29450,12195,Wiclenz Hygiene Bed Bath Wet Wipes For Face Men Women Cleansing & Refreshing Pack Of 60 Wipes (10 Wipes × 6 packs),Warehouse B,93,82,2025-02-03 21:38:00,11
29450,ORD_29451,22345,Devesan 100mg Tablet ER,Warehouse C,109,95,2025-02-03 22:57:00,14
29451,ORD_29452,32496,Luxor Gel One Ball Pen Blue (20's Box),Warehouse B,50,45,2025-02-03 18:02:00,5
29452,ORD_29453,15483,Instant Hair Refresh Dry Shampoo Plus - With A Hint Of Colour Beautiful Brunette,Warehouse C,105,86,2025-02-03 22:09:00,19
29453,ORD_29454,7152,Fresh Start Oil Clear Blueberry Face Wash,Warehouse C,41,29,2025-02-03 22:29:00,12
29454,ORD_29455,23899,Zalat 5mg Tablet,Warehouse C,28,23,2025-02-03 16:41:00,5
29455,ORD_29456,7359,Ajmal Silver Shade EDP Citrus Woody Perfume And Evoke Silver Edition Him Deodorant Spicy Floral Fragrance 300 ml,Warehouse B,97,85,2025-02-03 11:33:00,12
29456,ORD_29457,8361,Mefendic D 10mg/250mg Tablet,Warehouse A,102,96,2025-02-03 11:56:00,6
29457,ORD_29458,7144,Tyma-L Tablet,Warehouse A,52,44,2025-02-03 23:00:00,8
29458,ORD_29459,1198,Alrzin 5mg Tablet,Warehouse C,30,15,2025-02-03 07:39:00,15
29459,ORD_29460,12597,"Tizum External Hard Drive Case for 2.5-Inch Hard Drive - Double Padded, HDD Case (Azure Blue)",Warehouse A,22,17,2025-02-03 13:36:00,5
29460,ORD_29461,23866,"Parker Ultra Fine Navigator Roller Ball Refill, Black (9000012123)",Warehouse A,77,66,2025-02-03 16:42:00,11
29461,ORD_29462,2564,Retron Tablet MD,Warehouse B,84,78,2025-02-03 13:12:00,6
29462,ORD_29463,13690,Vildacoast 50 Tablet,Warehouse B,112,94,2025-02-03 00:40:00,18
29463,ORD_29464,21792,Gestcure 100mg Soft Gelatin Capsule,Warehouse B,115,99,2025-02-03 21:22:00,16
29464,ORD_29465,7912,Solibs 5mg/2.5mg Tablet,Warehouse A,27,19,2025-02-03 18:11:00,8
29465,ORD_29466,36535,"Skypearll AC to DC Converter, 110V-240V Mains to DC 12V Car Auto Inverter Cigarette Lighter Adapter (5A) 60W",Warehouse A,79,72,2025-02-03 21:50:00,7
29466,ORD_29467,16180,Cartilamine Forte Tablet,Warehouse C,95,78,2025-02-03 22:32:00,17
29467,ORD_29468,13821,Aceplas P 100mg/500mg Tablet,Warehouse A,77,61,2025-02-03 11:10:00,16
29468,ORD_29469,7845,"Mattlook Single Stroke Super Glide Eyeliner Kohl Kajal 24 Hours Water Proof|Smudge Proof, Jet Black (1.3gm)",Warehouse A,22,16,2025-02-03 13:43:00,6
29469,ORD_29470,8557,"Fire-Boltt Beast Pro Bluetooth Calling 1.69” with Voice Assistance, Local Music, Voice Recorder, Spo2 Monitoring, Heart Ra...",Warehouse C,92,86,2025-02-03 09:54:00,6
29470,ORD_29471,36622,Cefixbet CV 200mg/125mg Tablet,Warehouse A,48,34,2025-02-03 21:36:00,14
29471,ORD_29472,386,Medimade Activated Charcoal Face Scrub (Pack of 2) 1's,Warehouse B,48,42,2025-02-03 17:37:00,6
29472,ORD_29473,32983,Letslim-M Tablet SR,Warehouse B,92,73,2025-02-03 02:15:00,19
29473,ORD_29474,36415,Cefopac 1gm Injection,Warehouse C,28,14,2025-02-03 05:38:00,14
29474,ORD_29475,390,"Fashion Colour Non - Transfer Matt Waterproof Lipstick, 28 Bella Pink 2.6 gm",Warehouse C,70,51,2025-02-03 00:08:00,19
29475,ORD_29476,36684,Ajmal Prose EDP & Magnetize Deodorant Pack of 2 300 ml,Warehouse B,39,27,2025-02-03 02:55:00,12
29476,ORD_29477,13709,Panbrite Plus Capsule SR,Warehouse C,23,5,2025-02-03 18:07:00,18
29477,ORD_29478,11692,HOME BUY Compact 10x25 Mini Binoculars Telescope for long distance - Black,Warehouse B,82,75,2025-02-03 17:58:00,7
29478,ORD_29479,11690,"SKINN BY TITAN Verge Perfume for Men, 100 ml",Warehouse B,28,17,2025-02-03 08:32:00,11
29479,ORD_29480,237,Advance Tear Eye Drop,Warehouse C,26,14,2025-02-03 17:56:00,12
29480,ORD_29481,11650,Montilix L Dry Syrup,Warehouse C,13,1,2025-02-03 17:22:00,12
29481,ORD_29482,7225,"Fashion Colour Kiss Lip No Transfer Lipstick, 66 Date Red 2.6 gm",Warehouse C,36,26,2025-02-03 07:59:00,10
29482,ORD_29483,437,Gemblue Biocare Dead Sea Face and Body Gel 500 ml,Warehouse B,63,56,2025-02-03 18:30:00,7
29483,ORD_29484,1196,Z Clox 250 mg Injection,Warehouse A,116,97,2025-02-03 18:56:00,19
29484,ORD_29485,1211,Zaxim 50mg Syrup,Warehouse A,74,59,2025-02-03 19:20:00,15
29485,ORD_29486,35017,Epsom Salt,Warehouse C,102,87,2025-02-03 08:44:00,15
29486,ORD_29487,7135,Innisfree Jeju Cherry Blossom Skin- Toner,Warehouse A,61,44,2025-02-03 07:29:00,17
29487,ORD_29488,35020,Deflocin 200 Tablet,Warehouse C,53,45,2025-02-03 17:28:00,8
29488,ORD_29489,22103,Flormar Nail Enamel 228 Bordeaux Red 11 ml,Warehouse A,24,6,2025-02-03 20:24:00,18
29489,ORD_29490,35118,Newquin 0.5% Eye Drop,Warehouse B,86,69,2025-02-03 02:02:00,17
29490,ORD_29491,1268,Gluc Aid Eye Drop,Warehouse B,69,56,2025-02-03 13:05:00,13
29491,ORD_29492,12653,Makeup Revolution Colour Play Express Eyeshadow Palette 5.2 gm,Warehouse C,22,11,2025-02-03 00:06:00,11
29492,ORD_29493,1107,Beauty People Pure Matte Lipstick - Red - Me - 506 3.8 gm,Warehouse A,90,83,2025-02-03 04:59:00,7
29493,ORD_29494,14638,"TEQTA 7 in 2 USB C Thunderbolt 3.0 Hub for 13 15 and 16 MacBook Pro 2016-2021 & New MacBook Air 2018-2021, New M1 MacBook...",Warehouse C,63,53,2025-02-03 12:31:00,10
29494,ORD_29495,22046,"Organic Harvest Kumkumadi Radiance Facial Kit for Skin, Best for Dull, Tired & Rough Skin, Infused with Saffron Extract, I...",Warehouse B,107,96,2025-02-03 07:35:00,11
29495,ORD_29496,1876,Reequil BHA & Peptide Salicylic Acid Serum For Acne 25 ml,Warehouse A,30,12,2025-02-03 16:16:00,18
29496,ORD_29497,8409,Tooth Brush - Kid 3-6 Years,Warehouse A,57,38,2025-02-03 05:38:00,19
29497,ORD_29498,15619,"(Renewed) JBL Tune 215BT in-Ear Wireless Bluetooth Headphones with Mic, 16 Hours Playtime, Deep Bass, Quick Charge, Multi-...",Warehouse B,33,21,2025-02-03 13:51:00,12
29498,ORD_29499,34905,Cetzil-A Tablet,Warehouse C,19,1,2025-02-03 16:40:00,18
29499,ORD_29500,24648,Regenor 5mg Tablet,Warehouse A,16,8,2025-02-03 12:51:00,8
29500,ORD_29501,12394,"TECHSHIELD® Tempered Glass Screen Protector For Samsung Galaxy Tab S8/S7 11 inch (2022/2020) (SM-T870/SM-T875,SM-X700/SM-X...",Warehouse A,74,60,2025-02-03 12:00:00,14
29501,ORD_29502,34357,Acelast 100mg Capsule,Warehouse B,101,84,2025-02-03 01:39:00,17
29502,ORD_29503,22223,Moxycare CV Oral Drops,Warehouse A,13,5,2025-02-03 05:04:00,8
29503,ORD_29504,22229,"Fashion Colour Lip Crayon, Waterproof, Long Lasting, 5 Warm Red 2.8 gm",Warehouse A,82,69,2025-02-03 21:35:00,13
29504,ORD_29505,22174,Revolution Pro Supreme Pigment Gel Eyeliner-Silver 1.2 gm,Warehouse A,27,11,2025-02-03 05:40:00,16
29505,ORD_29506,8292,Spigen Rugged Armor Back Cover Case for iPhone 12 and iPhone 12 Pro (TPU | Matte Black),Warehouse C,49,39,2025-02-03 23:09:00,10
29506,ORD_29507,34351,Way Off 200 Tablet,Warehouse C,104,96,2025-02-03 04:03:00,8
29507,ORD_29508,22164,"Blue Heaven Combo Soft Kajal (Black & Green), Matte Finish (Set of 2)",Warehouse B,85,71,2025-02-03 23:21:00,14
29508,ORD_29509,34581,VARS ; LONDON Color Changing Aloe Vera Moisture Temperature Changed Color Natural Long Lasting Nourish Protect Lip Balm fo...,Warehouse A,35,18,2025-02-03 20:42:00,17
29509,ORD_29510,34622,IBS Ultra Seris 8 Smart Watch Men Two Watch NFC Door Unlock Smartwatch Bluetooth Call Wireless Charge Fitness Bracelet (Ul...,Warehouse B,73,57,2025-02-03 16:33:00,16
29510,ORD_29511,12397,Nmsd Tablet,Warehouse B,65,46,2025-02-03 23:59:00,19
29511,ORD_29512,15118,Riszes Plus 3 mg/2 mg Tablet,Warehouse C,64,54,2025-02-03 17:10:00,10
29512,ORD_29513,34345,Handwash - Skin Care,Warehouse A,94,80,2025-02-03 04:46:00,14
29513,ORD_29514,7206,"Shot Body Spray- Absolute Series, Game",Warehouse C,41,33,2025-02-03 21:44:00,8
29514,ORD_29515,34595,"Acko 1 Year Extended Warranty for Appliances from Rs 30,000 to Rs 40,000 (Email Delivery)",Warehouse A,68,52,2025-02-03 22:11:00,16
29515,ORD_29516,34608,Zitran 200 Capsule,Warehouse A,53,37,2025-02-03 09:57:00,16
29516,ORD_29517,34561,realme 360 Deg 1080p Full HD WiFi Smart Security Camera (White) | Alexa Enabled | 2-Way Audio | Night Vision | Motion Trac...,Warehouse A,31,26,2025-02-03 22:41:00,5
29517,ORD_29518,22416,Starkuff LS Syrup,Warehouse B,113,99,2025-02-03 01:22:00,14
29518,ORD_29519,1870,Fujifilm Instax Mini Single Pack 10 Sheets Instant Film for Fuji Instant Cameras,Warehouse A,71,54,2025-02-03 06:23:00,17
29519,ORD_29520,23766,"HP 500 Bluetooth Wireless Over Ear Headphones with Bluetooth 5.0,2X Speed, 4X Connectivity, with Mic,Water-Resistant Desig...",Warehouse C,98,87,2025-02-03 01:47:00,11
29520,ORD_29521,1114,"TGK Leather Flip Stand Case Cover for Nokia Tab T20 10.36 inch Tablet with Pencil Holder, Black",Warehouse C,100,82,2025-02-03 08:14:00,18
29521,ORD_29522,12105,"PRAUSH (Formerly Plume) Silk Blur Moisturising & Hydrating Primer With Hyaluronic Acid And Avocado Extracts, 50 Gm, Pink",Warehouse A,43,34,2025-02-03 22:01:00,9
29522,ORD_29523,35293,Beauty People Matte Lucious Liquid Lip Colorberrylicious - L21 ,Warehouse A,78,60,2025-02-03 16:07:00,18
29523,ORD_29524,24339,UNIGEN 20W USB Type-C PD Wall Charger Fast Charging Adapter for iPhone 14/13/13 Pro Max/13 mini/12/12 Mini/12 Pro/12 Pro M...,Warehouse C,69,63,2025-02-03 17:41:00,6
29524,ORD_29525,7077,Clovate SL Lotion,Warehouse C,21,11,2025-02-03 04:49:00,10
29525,ORD_29526,1908,Glimibrit 3mg Tablet,Warehouse A,107,89,2025-02-03 12:41:00,18
29526,ORD_29527,12680,Ajmal Avid & Blu Deo & Neea EDP Of Pack of 3 20 ml,Warehouse C,45,39,2025-02-03 03:24:00,6
29527,ORD_29528,1921,Losawell AM 50mg/5mg Tablet,Warehouse B,29,20,2025-02-03 02:41:00,9
29528,ORD_29529,15671,Seflx O 200mg/200mg Tablet,Warehouse A,99,82,2025-02-03 15:16:00,17
29529,ORD_29530,12625,Rasnerandadi Kwath,Warehouse B,80,72,2025-02-03 14:16:00,8
29530,ORD_29531,33738,Chandraprabha Bati - For Urinary Tract Related Issues,Warehouse B,96,82,2025-02-03 14:43:00,14
29531,ORD_29532,22479,Typod 100mg Tablet,Warehouse B,29,24,2025-02-03 08:23:00,5
29532,ORD_29533,15672,Cefemed 1gm Injection,Warehouse B,13,2,2025-02-03 15:36:00,11
29533,ORD_29534,23746,Levofit 500mg Tablet,Warehouse C,115,96,2025-02-03 09:33:00,19
29534,ORD_29535,22491,Sensitive Everyday Protection Anticavity Toothpaste.,Warehouse B,25,10,2025-02-03 06:07:00,15
29535,ORD_29536,35388,"(Renewed) HP Chromebook C640 10th Gen Intel Core i5 Thin & Light FHD Laptop (8 GB DDR4 RAM/64 GB eMMC SSD/14"" (35.6 cm) FH...",Warehouse B,30,13,2025-02-03 08:32:00,17
29536,ORD_29537,7063,Apple Watch SE (2nd Gen) GPS 40mm Midnight Aluminium Case with Midnight Sport Band - Regular,Warehouse A,68,58,2025-02-03 14:41:00,10
29537,ORD_29538,14618,Spigen Tough Armor Back Cover Case Compatible with OnePlus 11 (TPU + Poly Carbonate | Black),Warehouse A,99,91,2025-02-03 02:11:00,8
29538,ORD_29539,22437,CROSSVOLT 5V/4A Micro USB Vooc Super Fast Data Sync Charging Cable Compatible for Oppo F9 F9 Pro Oppo F11 Pro and All Oppo...,Warehouse B,99,88,2025-02-03 15:17:00,11
29539,ORD_29540,1094,FEDUS Cat6 Heavy Duty Outdoor Cable 20M 65 Feet Weatherproof/UV Resistant 1000mbps Ethernet Cable Suitable for Direct Buri...,Warehouse B,20,1,2025-02-03 03:12:00,19
29540,ORD_29541,1835,Ucyp Syrup,Warehouse A,94,75,2025-02-03 20:32:00,19
29541,ORD_29542,22405,Zinq Five Fan Cooling Pad and Laptop Stand with Dual Height Adjustment and Dual USB Port Extension (Black),Warehouse B,30,16,2025-02-03 06:52:00,14
29542,ORD_29543,33896,Berina Hair Treatment Spa 1000 gm,Warehouse B,60,50,2025-02-03 08:22:00,10
29543,ORD_29544,14643,LG 139 cm (55 inches) 4K Ultra HD Smart LED TV 55UQ7500PSF (Ceramic Black),Warehouse B,63,58,2025-02-03 17:15:00,5
29544,ORD_29545,33851,Pikkme Samsung Galaxy M13 4G Flip Case Leather Finish | Inside TPU with Card Pockets | Wallet Stand and Shock Proof | Magn...,Warehouse B,92,78,2025-02-03 04:38:00,14
29545,ORD_29546,33845,Consistent - 4GB DDR3 RAM 1600MHz Desktop Memory | | Long-DIMM (UDIMM) | DT PC3-1600| PC3-12800 | for Standard & Gaming De...,Warehouse C,89,79,2025-02-03 18:07:00,10
29546,ORD_29547,32796,Netgear WiFi Range Extender EX6110 - Extend your Internet Wi-Fi up to 1200 sq ft & 20 Devices with AC1200 Dual Band Wirele...,Warehouse B,57,50,2025-02-03 03:06:00,7
29547,ORD_29548,13760,Olalyf 10 Tablet MD,Warehouse A,61,53,2025-02-03 03:01:00,8
29548,ORD_29549,13185,Trizilev-M Tablet,Warehouse A,86,81,2025-02-03 08:30:00,5
29549,ORD_29550,13620,"SENS NUTON 1 with 1.7 IPS Display, Orbiter, 5ATM & 150+ Watch Faces & Free Additional Strap (Matte Black)",Warehouse C,13,3,2025-02-03 02:14:00,10
29550,ORD_29551,13504,"Parker Frontier Chrome Trim Fountain Pen with Free Card Holder, Gold Nib (Matte Black)",Warehouse B,69,51,2025-02-03 14:25:00,18
29551,ORD_29552,16429,Rice Water Brightening Scrub,Warehouse C,111,93,2025-02-03 10:19:00,18
29552,ORD_29553,13359,"Original Super Fast Charging 18W Adapter for iQOO Z6 5G, iQOO Z6 Lite 5G, iQOO Z6 Lite, iQOO U5e 5G, iQOO Z8 5G, iQOO U5x ...",Warehouse C,102,97,2025-02-03 22:48:00,5
29553,ORD_29554,2478,Strauss Bike Mobile Holder - Adjustable 360° Rotation Bicycle Phone Mount | Bike Accessories | Bike Phone Holder (Black),Warehouse B,102,88,2025-02-03 02:36:00,14
29554,ORD_29555,11667,"Face Mask - Ultra-Light Contoured Fit, Small, Black",Warehouse C,60,41,2025-02-03 11:51:00,19
29555,ORD_29556,36358,Sertagold 2% Cream,Warehouse A,21,7,2025-02-03 02:18:00,14
29556,ORD_29557,36378,"JEF Business Card Holder, Debit/Credit/Bussiness/Visiting Name Id Card Holder Book Cash Organizer File - 480 Pocket. (Black)",Warehouse B,29,12,2025-02-03 08:59:00,17
29557,ORD_29558,16143,"Zebronics ZEB-90HB USB Hub, 4 Ports, Pocket Sized, Plug & Play, for Laptop & Computers",Warehouse B,84,72,2025-02-03 16:46:00,12
29558,ORD_29559,22964,"Parker Classic Matte Black GT Ball Pen, Golden color, 1 Count (Pack of 1) (9000013841)",Warehouse A,28,17,2025-02-03 00:10:00,11
29559,ORD_29560,32911,HP 32GB Class 10 MicroSD Memory Card (U1 TF Card 32GB),Warehouse B,64,49,2025-02-03 10:05:00,15
29560,ORD_29561,32765,Bare Escentuals BarePro Performance Wear Liquid Foundation Silk 14,Warehouse B,100,91,2025-02-03 23:32:00,9
29561,ORD_29562,32666,"Paco Rabanne Invictus Eau de Toilette For Men, 50ml, Clear",Warehouse B,27,18,2025-02-03 21:02:00,9
29562,ORD_29563,2308,"Automatic Cut Off Timer Socket Plug, for Protect Your Any Rechargeable(Ex:- Mobile, Laptop) Devices from Over Charge (Up t...",Warehouse C,88,76,2025-02-03 20:19:00,12
29563,ORD_29564,6912,Faces Canada Ultime Pro Hd Intense Matte Lips + Primer Wild Orchid 21 1.4 Gm,Warehouse B,84,72,2025-02-03 00:11:00,12
29564,ORD_29565,36380,Lipofix EX Tablet,Warehouse A,39,28,2025-02-03 00:12:00,11
29565,ORD_29566,7686,AILKIN Samsung Charger Original 25W C-Type Super Fast Charger Adapter with Cable Set Charger for Galaxy S22/S21+/S21 Ultr...,Warehouse B,106,90,2025-02-03 11:42:00,16
29566,ORD_29567,16384,"CEDO 25W Dual Port (USB A + USB C) 25W PD + 18W QC Quick Charge Wall Charger Travel Adapter for Samsung M33,M53,F23, Flip...",Warehouse B,48,29,2025-02-03 03:49:00,19
29567,ORD_29568,22858,Crucial RAM 4GB DDR4 2666 MHz CL19 Laptop Memory CT4G4SFS8266,Warehouse A,71,60,2025-02-03 05:05:00,11
29568,ORD_29569,13406,"TP-Link TL-WR841N RJ-45 300Mbps Wireless Single_Band N Cable, 4 Fast LAN Ports, Easy Setup, WPS Button, Supports Parent Co...",Warehouse C,56,42,2025-02-03 07:52:00,14
29569,ORD_29570,13395,"Ajmal 1 Silver Shade Homme, 1 Wisal, 1 Magnetize And 1 Persuade Deodorants Pack of 4 200 ml",Warehouse A,89,77,2025-02-03 07:57:00,12
29570,ORD_29571,21655,TheGiftKart Tough Armor Back Cover Case for Samsung Galaxy A50s / A50 / A30s | Tough Armor Bumper | Ring Holder & Kickstan...,Warehouse A,78,65,2025-02-03 00:12:00,13
29571,ORD_29572,8539,"boAt Aavante Bar 1200D Soundbar with Dolby Audio, 100W RMS Signature Sound, 2.1 Channel with Wired Subwoofer, Entertainmen...",Warehouse C,25,9,2025-02-03 22:13:00,16
29572,ORD_29573,32531,"ZEBRONICS ZEB-K04 Mini Multimedia USB Wired Keyboard with 96 UV Coated Keys, Slim & Compact, for PC/Mac",Warehouse B,53,47,2025-02-03 01:28:00,6
29573,ORD_29574,16583,"Egate K9 Pro-Max Android 9.0 Projector for Home 4k, Full HD 1080p Native 630 ANSI 6600 Lumens LED, 4D Digital Keystone wit...",Warehouse A,80,68,2025-02-03 16:56:00,12
29574,ORD_29575,7931,Amazon Brand - Solimo Back Cover Case for Realme 6 | Compatible for Realme 6 Back Cover Case | 360 Degree Protection | Sof...,Warehouse A,67,51,2025-02-03 11:15:00,16
29575,ORD_29576,189,Cemox Kid 125mg Tablet,Warehouse A,91,77,2025-02-03 19:58:00,14
29576,ORD_29577,16561,Zebronics-Zeb Dazzle Wireless Optical Mouse with Nano Receiver (Black),Warehouse B,97,84,2025-02-03 23:39:00,13
29577,ORD_29578,32781,Comet Busters Long Maroon Tilak Bindi for Women With Stone (13mm) (BIN1443),Warehouse B,101,83,2025-02-03 04:41:00,18
29578,ORD_29579,32674,Dofcid 40mg Tablet,Warehouse B,94,75,2025-02-03 21:49:00,19
29579,ORD_29580,16272,"Beetel B17 Corded Landline Phone, Ringer Volume Control, LED for Ring Indication, Wall/Desk Mountable,Elegant Design,Clear...",Warehouse B,90,83,2025-02-03 16:35:00,7
29580,ORD_29581,22875,Esmipro 40 Tablet,Warehouse C,27,13,2025-02-03 20:04:00,14
29581,ORD_29582,23295,Opel 100mg Tablet,Warehouse B,80,69,2025-02-03 05:18:00,11
29582,ORD_29583,36349,Razehil 20mg Tablet,Warehouse B,63,53,2025-02-03 12:10:00,10
29583,ORD_29584,37093,Vega Hot Pink Luxury Sponge (BA - 3/21) 75 gm,Warehouse A,50,44,2025-02-03 17:15:00,6
29584,ORD_29585,36716,"L'Occitane Anti-Aging Immortelle Reset Triphase Essence, 50Ml | Healthy-Looking Complexion | Silicon Free",Warehouse B,71,62,2025-02-03 04:37:00,9
29585,ORD_29586,16476,MANCODE Aloe Vera Gel 100 GM,Warehouse A,67,61,2025-02-03 07:20:00,6
29586,ORD_29587,33034,Passion Indulge CARRIER OIL-ARGAN 10 ml,Warehouse C,104,87,2025-02-03 08:15:00,17
29587,ORD_29588,37132,Tolgress 2mg Capsule,Warehouse A,18,1,2025-02-03 12:16:00,17
29588,ORD_29589,21676,Carzex 5” Inch Rear View LCD TFT Car Dashboard Screen with Moving Lines Night Vision Parking Assist Rear View Camera Combo...,Warehouse B,73,61,2025-02-03 16:18:00,12
29589,ORD_29590,13546,Quantum QHM495LM 6 Light Webcam For Laptop/Desktop (Black),Warehouse B,28,22,2025-02-03 17:40:00,6
29590,ORD_29591,36403,Defence Theory Sweat & Odour Control Lotion For Men,Warehouse B,80,72,2025-02-03 15:05:00,8
29591,ORD_29592,24680,Mometis-HT Cream,Warehouse B,44,32,2025-02-03 14:56:00,12
29592,ORD_29593,13744,Crat 6mg Tablet,Warehouse B,66,55,2025-02-03 12:24:00,11
29593,ORD_29594,13502,Oil - Gingelly,Warehouse C,108,97,2025-02-03 19:57:00,11
29594,ORD_29595,21771,KREVIA Binocular for Long Distance | Professional Adults Telescopic Durbin for Bird Watching Trekking Sports | Zoom-12x40...,Warehouse B,54,41,2025-02-03 19:01:00,13
29595,ORD_29596,22902,Mouth Freshener - Elachi,Warehouse A,97,87,2025-02-03 00:18:00,10
29596,ORD_29597,11651,Zonex SP 50mg/325mg/10mg Tablet,Warehouse A,100,93,2025-02-03 21:21:00,7
29597,ORD_29598,21712,Mont-LC Kid Tablet DT,Warehouse B,63,44,2025-02-03 23:23:00,19
29598,ORD_29599,13420,Face Scrub - Strawberry Extract,Warehouse B,72,63,2025-02-03 16:24:00,9
29599,ORD_29600,37087,Biklin 100mg Injection,Warehouse A,46,31,2025-02-03 22:30:00,15
29600,ORD_29601,36583,Etabolin 50mg Injection,Warehouse C,74,68,2025-02-03 03:57:00,6
29601,ORD_29602,6902,"Amazon Basics Laptop Stand, Height-Adjustable, Foldable, Portable, Ventilated, Fits Up to 15.6-Inch Laptops (Aluminium All...",Warehouse C,84,73,2025-02-03 23:41:00,11
29602,ORD_29603,36529,SIRF TUM 7 FITME POWDER Pore-less Oil Control Compact Powder To Absorbs- All Day Matte Finish Face Makeup-Fit Me Matte-Por...,Warehouse C,71,57,2025-02-03 01:53:00,14
29603,ORD_29604,36900,Levoway-OZ Tablet,Warehouse C,87,69,2025-02-03 10:41:00,18
29604,ORD_29605,36885,Pierre Cardin Paris - Porcelain Edition Rouge Lipstick 243-Blood Red,Warehouse C,61,45,2025-02-03 17:00:00,16
29605,ORD_29606,2447,ZENTOR 250 MG TABLET,Warehouse C,91,76,2025-02-03 11:57:00,15
29606,ORD_29607,13779,Ant Esports KM500 Pro Backlit Gaming Keyboard and Mouse Set,Warehouse C,70,57,2025-02-03 03:48:00,13
29607,ORD_29608,36638,"Amazon Basics 16-Gauge Speaker Wire - 50 Feet, Transparent",Warehouse C,76,71,2025-02-03 17:29:00,5
29608,ORD_29609,16317,"Costar Bluetooth Wireless in Ear Earphones, 120 Hrs Playtime,Type-C Fast Charging,Dual Equalizer,Bass Driver,Silicone Neck...",Warehouse B,109,99,2025-02-03 05:08:00,10
29609,ORD_29610,36853,"ProElite Smart Flip Case Cover for Apple iPad 10.2"" 9th Gen (2021) / 8th Gen / 7th Gen with Stylus Pen, Rose Gold",Warehouse C,51,39,2025-02-03 01:39:00,12
29610,ORD_29611,7918,"Natural Clay Pack - Wild Turmeric, Saffron & Vetivert",Warehouse C,33,19,2025-02-03 15:33:00,14
29611,ORD_29612,2552,Ciprolet OZ 750mg Tablet,Warehouse A,33,22,2025-02-03 20:14:00,11
29612,ORD_29613,32957,"HP v236w 16GB USB 2.0 Pen Drive, Multi",Warehouse C,114,95,2025-02-03 09:05:00,19
29613,ORD_29614,36631,"SanDisk Ultra Dual Drive Go USB3.0 Type C Pendrive for Mobile (Black, 32 GB, 5Y - SDDDC3-032G-I35)",Warehouse A,112,93,2025-02-03 14:57:00,19
29614,ORD_29615,6823,"CableCreation 7-in-1 USB C Hub Multiport Adapter, USB Type C to 4K@60Hz HDMI, 1000M Ethernet, 2 USB 3.0 Ports, 100W PD and...",Warehouse A,42,25,2025-02-03 11:10:00,17
29615,ORD_29616,257,"DOODLE Set of 12 Blank Notecards with Envelopes (3 Inches x 4.25 Inches) Greeting Cards, Thank You Card (Floral Fuse)",Warehouse C,82,69,2025-02-03 02:34:00,13
29616,ORD_29617,7838,Eludril Perio Mouth Wash,Warehouse B,74,55,2025-02-03 08:20:00,19
29617,ORD_29618,32960,JBL Live Pro 2 True Wireless in Ear Earbuds ANC Earbuds | Upto 40Hrs Playtime | Adjust EQ for Extra Bass | 6 Mics for Crys...,Warehouse C,33,14,2025-02-03 17:07:00,19
29618,ORD_29619,16319,Anmol Gold Pure Coconut Oil,Warehouse B,56,40,2025-02-03 13:46:00,16
29619,ORD_29620,36480,Spigen AlignMaster Tempered Glass Screen Protector Guard for Pixel 6a - 2 Pack,Warehouse C,43,29,2025-02-03 04:00:00,14
29620,ORD_29621,11770,Tulixone 500mg Injection,Warehouse B,14,2,2025-02-03 07:44:00,12
29621,ORD_29622,36410,Rabogest L 75mg/20mg Capsule,Warehouse A,93,84,2025-02-03 20:37:00,9
29622,ORD_29623,55,Gemblue Biocare Orange Peel Off Mask 500 ml,Warehouse B,44,30,2025-02-03 15:12:00,14
29623,ORD_29624,13150,Efospar 200mg Tablet,Warehouse C,36,24,2025-02-03 07:29:00,12
29624,ORD_29625,32922,Telrith 40 Tablet,Warehouse B,56,45,2025-02-03 11:38:00,11
29625,ORD_29626,36605,Biobet 16mg Tablet,Warehouse A,87,80,2025-02-03 06:27:00,7
29626,ORD_29627,33003,"pTron Bassbuds Tango ENC Bluetooth Truly Wireless in Ear Earbuds with mic, Movie Mode, 40Hrs Total Playtime, BT 5.1, Deep ...",Warehouse C,85,79,2025-02-03 17:35:00,6
29627,ORD_29628,16274,"Fashion Colour Non - Transfer Matt Waterproof Lipstick, 30 Soft Red 2.6 gm",Warehouse C,24,16,2025-02-03 18:25:00,8
29628,ORD_29629,24686,Pride 10mg Tablet,Warehouse A,24,8,2025-02-03 11:08:00,16
29629,ORD_29630,336,Pantazol 40mg Injection,Warehouse B,88,78,2025-02-03 06:35:00,10
29630,ORD_29631,32579,Crucial RAM 8GB DDR4 3200MHz CL22 (or 2933MHz or 2666MHz) Laptop Memory CT8G4SFRA32A,Warehouse C,70,65,2025-02-03 13:01:00,5
29631,ORD_29632,21682,Panwatch D 30mg/40mg Capsule SR,Warehouse C,112,95,2025-02-03 09:58:00,17
29632,ORD_29633,7916,Thanjai Natural Arappu Powder/Albizia Amara 500g (Jar) Traditional Hair wash & Hair conditioner 100% Natural,Warehouse B,86,74,2025-02-03 19:30:00,12
29633,ORD_29634,16163,Moxrite CV 500mg/125mg Tablet,Warehouse A,105,97,2025-02-03 06:55:00,8
29634,ORD_29635,22926,Nimuwin P 100mg/500mg Tablet,Warehouse A,79,74,2025-02-03 07:42:00,5
29635,ORD_29636,13253,"Samsung Galaxy Watch4 LTE (4.4 cm, Black, Compatible with Android only)",Warehouse A,45,26,2025-02-03 19:59:00,19
29636,ORD_29637,23041,Gladvert 25mg Tablet,Warehouse C,18,1,2025-02-03 17:29:00,17
29637,ORD_29638,16500,"SupCares Edge to Edge Tempered Glass for iQOO Z6 Lite 5G, iQOO Z3 5G and iQOO Z6 5G (6.58 Inch) with Easy Self Installatio...",Warehouse A,95,88,2025-02-03 23:12:00,7
29638,ORD_29639,36736,Pro-Clinical 150 Charcoal Battery Powered Toothbrush,Warehouse C,70,64,2025-02-03 20:35:00,6
29639,ORD_29640,2595,"ZEBRONICS Zeb-Evolve BTv5.0, Voice Assistant, Rapid Charge, Dual Pairing, Call Function, Magnetic Earpiece Bluetooth Wirel...",Warehouse C,68,59,2025-02-03 07:36:00,9
29640,ORD_29641,261,Kryptofix 200mg Tablet DT,Warehouse B,94,82,2025-02-03 23:46:00,12
29641,ORD_29642,16373,"TAGG Rogue 500GT Gaming True Wireless in Ear Earbuds | 42ms Ultra Low Latency | 9 Pulse Lighting Modes, 4 Mics ENC | Type-...",Warehouse A,105,90,2025-02-03 22:24:00,15
29642,ORD_29643,36474,Ampoxid 250 mg/250 mg Capsule,Warehouse A,16,9,2025-02-03 18:54:00,7
29643,ORD_29644,16216,TANG Drink Powder Energy Drink,Warehouse B,46,27,2025-02-03 05:05:00,19
29644,ORD_29645,11617,Acidrox 250mg Tablet,Warehouse C,32,24,2025-02-03 09:00:00,8
29645,ORD_29646,363,Larfen 50mg Tablet,Warehouse A,95,76,2025-02-03 17:22:00,19
29646,ORD_29647,6882,Fluchy 150mg Tablet,Warehouse C,35,20,2025-02-03 14:06:00,15
29647,ORD_29648,81,SmiloShine Teeth Whitening Charcoal Gel Strips 7's,Warehouse B,46,36,2025-02-03 01:57:00,10
29648,ORD_29649,36648,Gamune 300mg Capsule,Warehouse B,25,16,2025-02-03 09:15:00,9
29649,ORD_29650,21763,Embeta 25mg Tablet ER,Warehouse A,71,53,2025-02-03 19:58:00,18
29650,ORD_29651,13314,"Fashion Colour Colour Correction Makeup Base Single Packing, S26 3.5 gm",Warehouse B,99,82,2025-02-03 11:12:00,17
29651,ORD_29652,11605,Aceplee-TH Tablet,Warehouse A,25,18,2025-02-03 08:38:00,7
29652,ORD_29653,37058,"Camel Artist Acrylic Color Box - 9ml Tubes, 12 Shades",Warehouse A,37,19,2025-02-03 02:27:00,18
29653,ORD_29654,36446,Aloevera Gel,Warehouse C,41,28,2025-02-03 19:39:00,13
29654,ORD_29655,37018,Truly Essential Mosquito Armour Gel 100 gm,Warehouse C,73,58,2025-02-03 17:14:00,15
29655,ORD_29656,37023,"AJO Smart Watch New Generation Bluetooth Smart Fitness Band Watch with Heart Rate Activity Tracker Waterproof Body, Calori...",Warehouse A,15,6,2025-02-03 11:47:00,9
29656,ORD_29657,13127,Dppin 1000mg Injection,Warehouse A,38,26,2025-02-03 09:33:00,12
29657,ORD_29658,13809,Mactuss-DX Syrup Sugar Free,Warehouse C,107,88,2025-02-03 21:02:00,19
29658,ORD_29659,13125,Ajmal Yearn EDP & Vibrant Ether EDT Pack of 2 350 ml,Warehouse C,26,20,2025-02-03 22:05:00,6
29659,ORD_29660,36935,Zoxaid Tablet,Warehouse C,93,86,2025-02-03 01:20:00,7
29660,ORD_29661,11722,Spigen Liquid Air Back Cover Case for Samsung Galaxy Note 9 (TPU | Matte Black),Warehouse A,75,69,2025-02-03 17:09:00,6
29661,ORD_29662,2553,Mexicold Tablet,Warehouse B,59,54,2025-02-03 00:23:00,5
29662,ORD_29663,7986,Instant Hair Refresh Dry Shampoo - Clean & Classic Original,Warehouse C,103,92,2025-02-03 17:10:00,11
29663,ORD_29664,36988,Zooclav 625 Tablet,Warehouse A,38,27,2025-02-03 21:50:00,11
29664,ORD_29665,355,Mavro Case Cover Compatible with Bose QuietComfort Earbuds 2 (Earbuds Not Included) (Black),Warehouse C,59,54,2025-02-03 19:24:00,5
29665,ORD_29666,13482,Poly by Plantronics - Blackwire 3220 Wired On Ear Headphones with Mic (Black),Warehouse C,45,26,2025-02-03 12:35:00,19
29666,ORD_29667,15136,Vitamin C Foaming Brightening Face Wash - With Vitamin C & Natural Extracts,Warehouse B,37,18,2025-02-03 08:13:00,19
29667,ORD_29668,13180,Remove Multi Action Hair And Blackheads Removing Hard Wax 80 ml,Warehouse B,38,25,2025-02-03 16:25:00,13
29668,ORD_29669,34544,"COOLCOLD USB Mic, Mic for PC, Microphone for PC, Noise Cancelling USB Microphone, Recording Mic for Laptop Desktop Mac, Pl...",Warehouse B,15,8,2025-02-03 19:18:00,7
29669,ORD_29670,1963,boAt Bassheads 102 in Ear Wired Earphones with Mic(Fiery Red),Warehouse A,15,9,2025-02-03 06:50:00,6
29670,ORD_29671,887,"TP-LINK TL-WN821N 300 MBPS WiFi WI-FI Wireless N USB Adapter, MIMO, WPS Button, Supports Windows 11/10/8.1/8/7/XP, Mac OS ...",Warehouse C,78,67,2025-02-03 14:44:00,11
29671,ORD_29672,12762,Tripoxy D Tablet,Warehouse B,74,57,2025-02-03 06:52:00,17
29672,ORD_29673,944,Eyetex Pallavi Sindoor Liquid - Bright Red 1's,Warehouse C,89,82,2025-02-03 18:01:00,7
29673,ORD_29674,23670,Neemli Naturals Glycolic & Apple Cider vinegar Exfoliating Toner 100 ml,Warehouse A,19,1,2025-02-03 09:06:00,18
29674,ORD_29675,7476,"Powder - Prickly Heat, Icy Cool",Warehouse C,24,8,2025-02-03 11:22:00,16
29675,ORD_29676,21980,Acevid-P 100mg/325mg Tablet,Warehouse C,87,74,2025-02-03 15:28:00,13
29676,ORD_29677,23721,"Sunisa Fit Me Foundation Waterproof Original 2 in 1 Air Cushion CC and BB Cream Foundation (Ivory, 20g) (Sunisa + 4 Liquid...",Warehouse B,102,85,2025-02-03 19:23:00,17
29677,ORD_29678,12724,Telmiduce 20mg Tablet,Warehouse C,114,95,2025-02-03 00:54:00,19
29678,ORD_29679,15693,"OnePlus 11 5G (Eternal Green, 8GB RAM, 128GB Storage)",Warehouse A,45,35,2025-02-03 21:13:00,10
29679,ORD_29680,33685,Z Mox FA 250mg Tablet,Warehouse C,19,5,2025-02-03 12:01:00,14
29680,ORD_29681,33682,House of Beauty Vitamin C Complex 60's,Warehouse C,66,55,2025-02-03 05:44:00,11
29681,ORD_29682,35473,Myglamm Sanitizing Wipes (Pack Of 5) 25 Gm,Warehouse A,94,83,2025-02-03 13:56:00,11
29682,ORD_29683,35489,"Powder Brush, (EV-20) 1 gm",Warehouse B,92,83,2025-02-03 06:44:00,9
29683,ORD_29684,563,Canon EF50MM F/1.8 STM Lens for Canon DSLR Cameras,Warehouse A,105,91,2025-02-03 19:11:00,14
29684,ORD_29685,7052,Kodiros 5mg Tablet,Warehouse A,66,58,2025-02-03 09:33:00,8
29685,ORD_29686,14462,TheGiftKart Flip Cover Back Case for OnePlus Nord CE 2 LITE 5G | Genuine Leather Finish | Designer Button | Inbuilt Pocket...,Warehouse C,85,68,2025-02-03 04:09:00,17
29686,ORD_29687,23691,"LG 242 L 3 Star Smart Inverter Frost-Free Double Door Refrigerator (GL-I292RPZX, Shiny Steel, Door Cooling+, Gross Volume-...",Warehouse A,91,74,2025-02-03 07:53:00,17
29687,ORD_29688,8129,Superdrug Tropical Cocktail Peel Mask 10 ml,Warehouse A,108,92,2025-02-03 15:33:00,16
29688,ORD_29689,1979,Ajmal 3 Nightingale & 1 Magnetize Deodorant Pack of 4 Deodorant 200 ml,Warehouse B,31,18,2025-02-03 20:36:00,13
29689,ORD_29690,15739,mCaffeine Non-sticky Latte Coffee Moisturizer with Shea Butter & Ceramide 50 ml,Warehouse C,46,30,2025-02-03 22:34:00,16
29690,ORD_29691,35545,VEIKK S640 V2 Graphic Drawing Tablet Pen Tablet 6 x 4 inch Drawing Tablet with Battery -Free Passive Pen (8192 Levels Pres...,Warehouse B,11,2,2025-02-03 07:44:00,9
29691,ORD_29692,33590,Nocolic Oral Drops,Warehouse C,78,70,2025-02-03 02:52:00,8
29692,ORD_29693,33584,Ajmal Colaba Mukhallat Concentrated Perfume Oil Floral Oriental And Blu Homme Deodorant Aquatic Woody Fragrance 214 ml,Warehouse C,66,58,2025-02-03 17:08:00,8
29693,ORD_29694,35662,Swizip 2000mg/250mg Injection,Warehouse B,48,30,2025-02-03 05:46:00,18
29694,ORD_29695,7536,SONATA Gold Series Hidden Voice Recorder |Sg2 Audio Bug Device | Spy Voice Recorder Product Microphone | Built-in Recharge...,Warehouse C,57,51,2025-02-03 11:59:00,6
29695,ORD_29696,7019,"Insight Non Transfer Lip Color, Matte Finish, 4ml (01 Joyfull)",Warehouse A,95,76,2025-02-03 05:58:00,19
29696,ORD_29697,23589,Beauty Glazed Matte Power Lip Color Matte Liquid Lipstick Waterproof liquid Matte Lipstick 3.5 G Ultra Matte Liquid Lipsti...,Warehouse A,18,6,2025-02-03 07:28:00,12
29697,ORD_29698,826,Flormar OMLashes Extra Volume Mascara 12 ml,Warehouse B,30,15,2025-02-03 14:32:00,15
29698,ORD_29699,35625,Iconic Grand Mascara Black (by Ori Flame),Warehouse C,33,14,2025-02-03 00:39:00,19
29699,ORD_29700,35624,Blaupunkt BTW100 Truly Wireless Bluetooth in Ear Earbuds with ENC CRISPR TECH I HD Sound I 80ms Low Latency I 40H Playtime...,Warehouse B,48,40,2025-02-03 08:06:00,8
29700,ORD_29701,35619,3-In-1 Face Wash,Warehouse A,82,76,2025-02-03 22:54:00,6
29701,ORD_29702,23641,Itaspor SB Forte 100mg Capsule,Warehouse C,65,60,2025-02-03 15:59:00,5
29702,ORD_29703,16030,"Spiky Kids' Affordable Smartwatch with Camera, 2G Calling, Location Track, Games - Perfect for Girls and Boys - Pack of 1...",Warehouse C,67,62,2025-02-03 07:02:00,5
29703,ORD_29704,562,Omerex 20mg Capsule,Warehouse A,56,47,2025-02-03 03:29:00,9
29704,ORD_29705,36161,Thyramax 50mcg Tablet,Warehouse C,17,12,2025-02-03 07:49:00,5
29705,ORD_29706,36168,"Logitech C922 Pro Stream Webcam, HD 1080p/30fps or HD 720p/60fps, Digital, Hyperfast Streaming, Stereo Audio, HD Light Cor...",Warehouse B,101,91,2025-02-03 07:56:00,10
29706,ORD_29707,36177,Gaacef O 200mg/200mg Tablet,Warehouse B,15,4,2025-02-03 06:47:00,11
29707,ORD_29708,36196,"JK Copier Paper - A4, 75 GSM, 1 Ream, 500 Sheets",Warehouse A,69,51,2025-02-03 00:29:00,18
29708,ORD_29709,13980,Instant Brightness Cream 2X Sun Protection,Warehouse A,33,16,2025-02-03 14:43:00,17
29709,ORD_29710,13979,Dapy-M 500 Tablet SR,Warehouse B,10,1,2025-02-03 10:13:00,9
29710,ORD_29711,33187,"Portronics SoundDrum POR-821 Wireless Bluetooth 4.2 Stereo Speaker with FM, USB Music (Grey)",Warehouse C,46,27,2025-02-03 10:18:00,19
29711,ORD_29712,22728,Trimetaday V 2 Tablet SR,Warehouse A,88,76,2025-02-03 03:33:00,12
29712,ORD_29713,515,Combicef 500mg/500mg Injection,Warehouse A,51,40,2025-02-03 04:08:00,11
29713,ORD_29714,11836,"KHADI NATURAL Ayurvedic Sandalwood Massage Oil, Paraben and Mineral Oil Free, 210ml",Warehouse C,104,90,2025-02-03 03:44:00,14
29714,ORD_29715,23380,Septriaxone Injection,Warehouse B,9,1,2025-02-03 09:07:00,8
29715,ORD_29716,23513,ADISA Large Laptop Backpack Office Bag College Travel Back Pack with USB (Navy),Warehouse C,48,29,2025-02-03 20:02:00,19
29716,ORD_29717,14194,"Sounce Earphone Case Cover Compatible with OnePlus Nord Buds CE, Soft Silicone Skin Case Cover Shock-Absorbing Protective ...",Warehouse B,66,51,2025-02-03 18:16:00,15
29717,ORD_29718,15769,Hair Conditioner - Colour Protection,Warehouse B,75,62,2025-02-03 15:43:00,13
29718,ORD_29719,35582,Vostop 4mg Tablet,Warehouse A,74,60,2025-02-03 17:18:00,14
29719,ORD_29720,14430,"Fashion Colour Face Highlighter Bronzer And Illumintor, Shade 05 7.5 gm",Warehouse B,40,28,2025-02-03 19:03:00,12
29720,ORD_29721,35587,Laxpo Syrup,Warehouse B,93,81,2025-02-03 17:35:00,12
29721,ORD_29722,926,Nirflox 200mg Tablet,Warehouse B,89,75,2025-02-03 04:52:00,14
29722,ORD_29723,14428,MI 360 Home Security Wireless Camera 2K Pro with Bluetooth Gateway BLE 4.2 l Dual Band Wi-fi Connection l 3 Million HD 129...,Warehouse B,21,11,2025-02-03 19:06:00,10
29723,ORD_29724,920,Lavender & Calendula Healing Intense Moisturizer,Warehouse C,72,58,2025-02-03 09:09:00,14
29724,ORD_29725,15758,AKG K52 Wired Over Ear Headphones Without Mic (Black),Warehouse C,102,97,2025-02-03 21:53:00,5
29725,ORD_29726,7043,DELORTA 5 MG TABLET,Warehouse A,23,17,2025-02-03 11:25:00,6
29726,ORD_29727,23648,Shine Protect Hair Styling Gel,Warehouse C,88,74,2025-02-03 09:58:00,14
29727,ORD_29728,8108,Asticin 250mg Injection,Warehouse C,36,18,2025-02-03 23:24:00,18
29728,ORD_29729,2004,TheGiftKart OnePlus Nord CE 2 LITE 5G Back Case Cover | Tough Armor Bumper | Ring Holder & Kickstand in-Built | 360 Degree...,Warehouse C,112,94,2025-02-03 18:46:00,18
29729,ORD_29730,14286,"Dyazo 3-Port USB Data Hub High Speed Splitter Plug / Box / Adapter Expansion , Small, Compact, Universal Data Transfer, Wi...",Warehouse C,40,32,2025-02-03 14:54:00,8
29730,ORD_29731,8459,Atrovarace 20mg Tablet,Warehouse B,66,53,2025-02-03 06:56:00,13
29731,ORD_29732,12842,Pack of 6 Maroon Color Bindi size 2.5mm (Heart shape box) Forehead Multicolor Bindis for Girls & Women,Warehouse C,74,65,2025-02-03 14:30:00,9
29732,ORD_29733,30095,"Forest Essentials Kashmiri Saffron and Neem Delicate Facial Cleanser, 200ml & Forest essentials Luscious Lip Balm Narangi ...",Warehouse C,103,95,2025-02-03 14:43:00,8
29733,ORD_29734,28381,AGARO USB Type A Female 3.0 to Micro OTG with Nylon Braided Cable,Warehouse C,57,47,2025-02-03 12:21:00,10
29734,ORD_29735,28307,Police Passion + To Be Women Deodorant Spray - For Women 400 ml,Warehouse A,42,28,2025-02-03 09:54:00,14
29735,ORD_29736,18446,Streetwear Nail Enamel (Matte) - Just Red 8 Ml,Warehouse C,49,35,2025-02-03 13:44:00,14
29736,ORD_29737,31593,Sporcin 200mg Tablet,Warehouse C,54,40,2025-02-03 05:17:00,14
29737,ORD_29738,25477,Titanic MR Tablet,Warehouse C,28,18,2025-02-03 21:37:00,10
29738,ORD_29739,4884,Itvil 50mg Tablet,Warehouse B,68,49,2025-02-03 20:26:00,19
29739,ORD_29740,3571,Spigen Ultra Hybrid Back Cover Case for iPhone 12 Mini (TPU + Poly Carbonate | Matte Black),Warehouse A,40,31,2025-02-03 00:58:00,9
29740,ORD_29741,9233,"ESR Air Armor Case, Compatible with 13 Case, Military-Grade Drop Protection, Shock-Absorbing Air-Guard Corners, Yellowing ...",Warehouse B,85,69,2025-02-03 06:00:00,16
29741,ORD_29742,8764,Glimtin M Forte 1mg/1000mg Tablet,Warehouse C,67,61,2025-02-03 19:38:00,6
29742,ORD_29743,31566,"SanDisk 256 GB USB 3.0 iXpand Flash Drive Luxe for iPhone, iPad Pro, MAC Devices, Type-C Android Phone & Other Devices (SD...",Warehouse C,63,57,2025-02-03 09:24:00,6
29743,ORD_29744,17214,UltraProlink UM1050U Power Qube Surge Protector & Spike Guard | White | 175J Extension Board | 4 Universal Sockets 2500W |...,Warehouse B,29,10,2025-02-03 11:37:00,19
29744,ORD_29745,4878,Deferataj 125mg Tablet DT,Warehouse B,72,60,2025-02-03 04:32:00,12
29745,ORD_29746,20843,Gudcef-CV Dry Syrup,Warehouse C,78,69,2025-02-03 18:03:00,9
29746,ORD_29747,25475,Natural Vita Rich Face Wash,Warehouse B,117,99,2025-02-03 02:32:00,18
29747,ORD_29748,26405,"Tizum Earphone Carrying Case - Multi Purpose Pocket Storage with Carabinr Hook, Travel Organizer for Earphones, Pen Drive...",Warehouse C,76,64,2025-02-03 06:18:00,12
29748,ORD_29749,11195,"Redmi K50i 5G (Quick Silver, 8GB RAM, 256GB Storage) | Flagship Mediatek Dimensity 8100 Processor | 144Hz Liquid FFS Display",Warehouse B,88,78,2025-02-03 23:43:00,10
29749,ORD_29750,25992,Men - After Shave Lotion Speedster,Warehouse A,108,99,2025-02-03 03:45:00,9
29750,ORD_29751,29490,Original Body Mist - For Man,Warehouse B,37,30,2025-02-03 19:05:00,7
29751,ORD_29752,20852,Recharge Game Face Bodyspray,Warehouse A,54,48,2025-02-03 15:50:00,6
29752,ORD_29753,31600,Wet N Wild Color Icon Eyeshadow Quad- House Of Thorns 4.8 gm,Warehouse B,75,64,2025-02-03 09:01:00,11
29753,ORD_29754,9947,"Ceptics India to USA Converter Plug, USA, Japan, Philippines, Canada Travel Plug Adapter - Type B Universal Travel Adapter...",Warehouse C,101,90,2025-02-03 17:25:00,11
29754,ORD_29755,28222,"Techmount� Replacement Silicone Band Straps Compatible with Xiaomi MI Band 3 & 4 (Xiaomi MI Band 3 & 4, Black/Grey/Navy-Bl...",Warehouse A,17,12,2025-02-03 04:33:00,5
29755,ORD_29756,31675,Lenphor I Craze Eye Liner Greenicious Green 1.7 Ml,Warehouse B,77,68,2025-02-03 02:20:00,9
29756,ORD_29757,17173,"realme C33 (Aqua Blue, 4GB RAM, 64GB Storage)",Warehouse A,35,16,2025-02-03 03:12:00,19
29757,ORD_29758,3103,Pure&Safe Instant Hand Sanitizer,Warehouse A,68,54,2025-02-03 14:04:00,14
29758,ORD_29759,19242,Ayurvedic Shampoo - Anti-Dandruff,Warehouse B,11,1,2025-02-03 12:45:00,10
29759,ORD_29760,8319,Duotax 500 mg/250 mg Injection,Warehouse B,19,9,2025-02-03 10:09:00,10
29760,ORD_29761,31396,Crysendo Headphone Cushion Compatible with JBL Infinity Glide 500 & 700 Ear Cushion Pads | Replacement Ear Pad Covers | Pr...,Warehouse B,87,80,2025-02-03 20:56:00,7
29761,ORD_29762,2616,Nicka K NINE COLOR Eyeshadow PALETTE - UNDER THE SEA 11.7 gm,Warehouse C,63,48,2025-02-03 01:47:00,15
29762,ORD_29763,14262,Prolet Cute Silicone 3D Cartoon Pattern Kitty Cover for Airpods Pro Headphones (Pink Kitty),Warehouse B,19,14,2025-02-03 11:52:00,5
29763,ORD_29764,8450,AmazonBasics Cleaning Kit for DSLR Cameras and Sensitive Electronics (Cleaning Solution Not Included),Warehouse A,54,45,2025-02-03 15:57:00,9
29764,ORD_29765,11959,"Lava Blaze 5G (Glass Green, 6GB RAM, UFS 2.2 128GB Storage) | 5G Ready | 50MP AI Triple Camera | Upto 9GB Expandable RAM |...",Warehouse C,113,98,2025-02-03 13:01:00,15
29765,ORD_29766,35811,"ZEBRONICS Zeb-Juke BAR 9500WS PRO Dolby 5.1 soundbar with Wireless Satellites, Dolby Audio, 525 Watts Output Power, 16.5cm...",Warehouse C,50,42,2025-02-03 13:24:00,8
29766,ORD_29767,1566,"Cosmic Byte Orcus RGB Honeycomb Gaming USB Mouse with Software, Ultra Lightweight 74Grams, Braided Cable (Black)",Warehouse C,74,56,2025-02-03 00:28:00,18
29767,ORD_29768,7556,Etadol 120 Tablet,Warehouse A,85,69,2025-02-03 05:03:00,16
29768,ORD_29769,15886,Spigen Rugged Armor Back Cover Case for iPhone 13 (TPU | Matte Black),Warehouse B,68,49,2025-02-03 18:19:00,19
29769,ORD_29770,2097,MENOGIA MF  TABLET 500 MG/250 MG,Warehouse C,43,33,2025-02-03 03:35:00,10
29770,ORD_29771,762,Stencold Tablet,Warehouse C,94,77,2025-02-03 18:01:00,17
29771,ORD_29772,757,"IVANA'S Henna Stencil Temporary Tattoo Temples Sheets- Set of 8, Black, M (RTATTO-01)",Warehouse A,99,86,2025-02-03 17:27:00,13
29772,ORD_29773,35866,Essential Souls Facewash - Strawberry Splash 200 ml,Warehouse C,48,41,2025-02-03 07:41:00,7
29773,ORD_29774,14227,Panasonic KX-TS400SXW,Warehouse C,104,92,2025-02-03 14:41:00,12
29774,ORD_29775,22602,Abhsant 600Pcs Eyelid Tape Portable Breathable Natural Invisible Single Sided Tool Natural Strips Stickers Instant Eye Lif...,Warehouse A,115,98,2025-02-03 16:14:00,17
29775,ORD_29776,35716,Sirona Feminine Pain Relief Patches (Pack of 2 x 5's ),Warehouse B,72,56,2025-02-03 09:29:00,16
29776,ORD_29777,22574,"Fashion Colour Kiss Lip No Transfer Lipstick, 23 Reddish Violet 2.6 gm",Warehouse A,59,49,2025-02-03 00:12:00,10
29777,ORD_29778,33527,Insight Cosmetics HD Conceal - Golden Russet 8 gm,Warehouse B,98,84,2025-02-03 10:08:00,14
29778,ORD_29779,864,Mesacol CR 2gm Granules,Warehouse A,69,52,2025-02-03 23:05:00,17
29779,ORD_29780,35686,"Charcoal Clean Black Gel Toothpaste - Bamboo Charcoal & Mint, Saver Pack",Warehouse B,10,5,2025-02-03 07:21:00,5
29780,ORD_29781,24415,Charcoal Bath Soap,Warehouse B,48,36,2025-02-03 01:12:00,12
29781,ORD_29782,8100,Ajmal 2 Magnetize Deo & Yearn EDP Pack of 3 20 ml,Warehouse B,88,74,2025-02-03 16:32:00,14
29782,ORD_29783,23610,Mucocil LS Syrup,Warehouse C,83,78,2025-02-03 12:39:00,5
29783,ORD_29784,24428,Foxtale Vit-A-Lity 0.15% Encapsulated Retinol Night Serum for Fighting the Signs of Ageing Reduces Fine Lines And Wrinkle...,Warehouse B,17,6,2025-02-03 00:22:00,11
29784,ORD_29785,22577,"Scarters Mouse Pad Vol. I for Work from Home/Office | Vegan Leather | Anti-Skid, Anti-Slip, Reversible use, Dual Color | S...",Warehouse B,90,78,2025-02-03 05:07:00,12
29785,ORD_29786,35701,Casecandy® - (Pack 2 Compatible Screen Protector Guard For Apple Watch Series 7 45MM Screen Size | HD Screen Guard For App...,Warehouse C,33,21,2025-02-03 23:25:00,12
29786,ORD_29787,7527,Essential Souls Face Wash - Tulip 100 ml,Warehouse B,79,73,2025-02-03 23:37:00,6
29787,ORD_29788,15823,Onsitego 1 Year Extended Warranty for Juicer Mixer Grinders Up to Rs 5000 (Email Deliver),Warehouse A,84,70,2025-02-03 13:49:00,14
29788,ORD_29789,35710,Etotan 25mg Tablet,Warehouse C,36,31,2025-02-03 19:12:00,5
29789,ORD_29790,839,Le Bonheur Seaweed Gel Sunscreen SPF 25 | For Skin Fairness - Glowing | Sun Protection With Moisturization | Matt Effect |...,Warehouse C,61,49,2025-02-03 00:15:00,12
29790,ORD_29791,11990,LEUKODERMA POWDER FOR WHITE SKIN PATCHES - AYURVEDIC TREATMENT FOR VITILIGO ..,Warehouse C,103,92,2025-02-03 08:11:00,11
29791,ORD_29792,2048,Zumix CV 200mg/125mg Tablet,Warehouse B,63,47,2025-02-03 22:42:00,16
29792,ORD_29793,24587,Mirabelle Korea Melt Blown Filter 3 Ply Mask 5' s,Warehouse C,60,45,2025-02-03 17:30:00,15
29793,ORD_29794,17167,Lotril VG 100mg Pessaries,Warehouse B,95,79,2025-02-03 12:24:00,16
29794,ORD_29795,33224,Elegance 4 Blade - Razor & Cartridge Pack,Warehouse B,8,3,2025-02-03 04:13:00,5
29795,ORD_29796,23923,Omen Trio 40/12.5 Tablet,Warehouse A,29,13,2025-02-03 02:43:00,16
29796,ORD_29797,34894,"JBL Cinema SB120, Dolby Digital Soundbar with Built-in Subwoofer for Deep Bass, 2.0 Channel Home Theatre with Remote, HDMI...",Warehouse B,36,31,2025-02-03 14:06:00,5
29797,ORD_29798,15452,"vivo Y22 (Starlit Blue, 4GB RAM, 64GB Storage) with No Cost EMI/Additional Exchange Offers",Warehouse A,106,88,2025-02-03 08:19:00,18
29798,ORD_29799,15453,St.Botanica Professional Facial Serum - C 20 ml,Warehouse C,56,41,2025-02-03 18:12:00,15
29799,ORD_29800,12204,Eclin 500 mg/500 mg Injection,Warehouse B,52,37,2025-02-03 23:33:00,15
29800,ORD_29801,34139,Theolate 250mg/250mg Tablet,Warehouse C,31,22,2025-02-03 01:37:00,9
29801,ORD_29802,34246,Doubledicestore Tempered Glass Screen Protector Compatible for samsung galaxy m13 4G with Edge to Edge Coverage and Easy I...,Warehouse A,87,79,2025-02-03 23:43:00,8
29802,ORD_29803,34779,ELEPHANTBOAT®Metal Telescope Spotting Scope Camera Mobile Phone Mount Holder Bracket Clip,Warehouse A,57,51,2025-02-03 18:07:00,6
29803,ORD_29804,7309,"BY4U Laptop Tabletop Stand for Desk, Portable Stand, Adjustable Height, Foldable, Non-Slip Aluminum MacBook Computer Stan...",Warehouse A,94,78,2025-02-03 20:22:00,16
29804,ORD_29805,34772,Azusa T 8/40 Tablet,Warehouse C,60,46,2025-02-03 20:56:00,14
29805,ORD_29806,1421,Glimmer Premium Nail Enamel Red Apple 10 ml,Warehouse A,109,93,2025-02-03 07:37:00,16
29806,ORD_29807,15081,Ifsc 500mg Injection,Warehouse C,73,55,2025-02-03 00:58:00,18
29807,ORD_29808,24147,G2K Injection,Warehouse A,51,43,2025-02-03 13:03:00,8
29808,ORD_29809,1648,Leezkest 600mg Tablet,Warehouse B,13,1,2025-02-03 07:17:00,12
29809,ORD_29810,22271,Sery Colorflirt Nail Paint Charcoal Black 10 ml,Warehouse C,104,88,2025-02-03 07:14:00,16
29810,ORD_29811,22280,Miss Claire Single Eyeshadow 0504 2 Gm,Warehouse C,79,72,2025-02-03 12:16:00,7
29811,ORD_29812,34702,Zoxamol Tablet,Warehouse A,88,79,2025-02-03 06:27:00,9
29812,ORD_29813,34294,Clop-GM Neo Cream,Warehouse A,63,55,2025-02-03 10:13:00,8
29813,ORD_29814,22290,Pantavoiz 40mg Tablet,Warehouse C,100,88,2025-02-03 16:07:00,12
29814,ORD_29815,15023,"Burt'S Bees Lip Balm, Crème Finish, 0.15Oz - Rose",Warehouse A,53,37,2025-02-03 00:25:00,16
29815,ORD_29816,23967,Metbrolin 100mg Capsule,Warehouse A,18,8,2025-02-03 03:16:00,10
29816,ORD_29817,1658,20pcs Demon Slayer Anime Merch Sticker Pack from animo India Perfect for Laptop Computer Car Water Bottle Travel Case Guit...,Warehouse B,16,2,2025-02-03 23:54:00,14
29817,ORD_29818,15014,"Cat Care Compatible with Airpods Pro GEN-2 (2022) Pouch Case Cover, Soft Silicone Cartoon Character Cover with Key-Chain, ...",Warehouse B,22,3,2025-02-03 20:45:00,19
29818,ORD_29819,14996,Feroxa-OZ Tablet,Warehouse B,48,32,2025-02-03 22:51:00,16
29819,ORD_29820,34265,"Portronics Car Power 12 Car Charger with 17W Total Output, Triple USB Port, 3.4A Compatible with Most Cars(Black)",Warehouse B,76,64,2025-02-03 23:21:00,12
29820,ORD_29821,24167,Lakme Forever Matte Liquid Lip Colour Red Carpet 5.6 Ml,Warehouse C,92,83,2025-02-03 10:22:00,9
29821,ORD_29822,23963,Weltron T 250mg/31.25mg Injection,Warehouse C,106,92,2025-02-03 07:12:00,14
29822,ORD_29823,1937,Dark Side Perfume For Men,Warehouse B,89,76,2025-02-03 03:54:00,13
29823,ORD_29824,24372,Junkyard Vinyl Anime Stickers for Laptop Gadgets Kids (Pack of 100),Warehouse A,77,72,2025-02-03 05:19:00,5
29824,ORD_29825,14517,"L'amant - Eau De Toilette, For Her",Warehouse A,28,18,2025-02-03 13:10:00,10
29825,ORD_29826,34166,OpenTech® Tempered Glass Screen Protector Compatible for Samsung Galaxy S21 5G with Edge to Edge Coverage and Easy Install...,Warehouse B,91,83,2025-02-03 18:59:00,8
29826,ORD_29827,34850,"Soft Light Moisturiser For Face, Hand & Body - Non-Sticky Cream With Vitamin E & Jojoba Oil",Warehouse A,26,15,2025-02-03 22:39:00,11
29827,ORD_29828,23434,"Samsung Original Type C to C Cable - 3.28 Feet (1 Meter), Black",Warehouse C,77,69,2025-02-03 10:28:00,8
29828,ORD_29829,7280,Amipox 25 mg/10 mg Tablet,Warehouse B,78,72,2025-02-03 20:40:00,6
29829,ORD_29830,1573,Alaspan AM Tablet,Warehouse A,77,59,2025-02-03 04:14:00,18
29830,ORD_29831,572,"Kids Anticavity Toothpaste - 6+ Years, Bubble Fruit Flavour, Batman",Warehouse B,109,95,2025-02-03 11:43:00,14
29831,ORD_29832,12341,Syncwire Charger Compatible with OnePlus Nord 10 / 9R / 9 Pro / 8/8 Pro / 7T / 7T Pro / 7/7 Pro / 6 / 6T / 5T / 5 / 3T / 3...,Warehouse A,67,55,2025-02-03 21:19:00,12
29832,ORD_29833,15251,"VEGA Powder Makeup Brush, (EV-20) - Wooden",Warehouse A,95,90,2025-02-03 17:21:00,5
29833,ORD_29834,1542,GUBB Pumice Stone For Feet Dead Skin Removal|Pedicure Tool With Rubber Grip - Removes dirt & dead cells | Great exfoliatio...,Warehouse B,103,86,2025-02-03 20:27:00,17
29834,ORD_29835,12351,Bronk X Syrup,Warehouse A,55,44,2025-02-03 14:00:00,11
29835,ORD_29836,34469,Perfume Body Spray - Enchanted Voilet For Women,Warehouse A,94,77,2025-02-03 14:46:00,17
29836,ORD_29837,34479,Choice Long Sanitary Pads,Warehouse B,71,62,2025-02-03 08:00:00,9
29837,ORD_29838,1534,KYOSEI Advanced Tempered Glass Compatible with Google Pixel 7 with Military-Grade Anti-Explosion Edge-to-Edge Coverage Scr...,Warehouse B,58,44,2025-02-03 19:40:00,14
29838,ORD_29839,1527,Vanizolol-A 5mg/50mg Tablet,Warehouse B,82,67,2025-02-03 12:41:00,15
29839,ORD_29840,12370,"Artistix Talon Anti Theft Design Laptop Backpack, With USB Charging Port (46 Cm, 25L,Black)",Warehouse B,83,72,2025-02-03 23:14:00,11
29840,ORD_29841,15154,Panasonic KX-TG3711SX Cordless Phone Silver,Warehouse B,101,95,2025-02-03 23:14:00,6
29841,ORD_29842,1502,Rosemary Shampoo,Warehouse B,89,78,2025-02-03 23:16:00,11
29842,ORD_29843,8302,Shea Butter Moisturizing Bath Soap With Coconut Husk & Honey - For Soft Skin,Warehouse A,98,82,2025-02-03 23:01:00,16
29843,ORD_29844,15144,"Chambor Luminous Blush, Candy Rose No.01, 6 g",Warehouse B,103,98,2025-02-03 11:50:00,5
29844,ORD_29845,12415,Lukzer 1 Pair Body Scrubber Bath Gloves Spa Massage Body Cleaner Wash Mitts Dead Skin Cleansing Scrub Nylon Exfoliating Sh...,Warehouse B,43,35,2025-02-03 12:06:00,8
29845,ORD_29846,34625,SanDisk® Ultra Curve USB 3.2 128GB 100MB/s R Green,Warehouse C,73,68,2025-02-03 11:50:00,5
29846,ORD_29847,1278,AmazonBasics Car Charger with 36W Fast Charging for Cellular Phones | Dual Port -Type C and USB Output | Micro USB Cable I...,Warehouse B,98,86,2025-02-03 15:27:00,12
29847,ORD_29848,15434,Flormar Nail Enamel 454 Army Glam 11 ml,Warehouse C,54,36,2025-02-03 14:29:00,18
29848,ORD_29849,34232,"L'Oreal Paris Infallible 24H Fresh Wear Foundation, 220 Sand 30 Gm",Warehouse A,66,49,2025-02-03 08:45:00,17
29849,ORD_29850,22300,Faces Canada Ultime Pro Intense Gel Kajal Black M 1.2 Gm,Warehouse A,84,77,2025-02-03 13:47:00,7
29850,ORD_29851,1339,Parker Ultra Fine Navigator Roller Ball Refill Blue,Warehouse C,53,44,2025-02-03 22:08:00,9
29851,ORD_29852,14935,Vishal 3 Sizes Water Brush Pen for Watercolor Calligraphy Drawing Tool Marker,Warehouse A,96,81,2025-02-03 08:48:00,15
29852,ORD_29853,22310,Miraz 15 Tablet,Warehouse A,77,72,2025-02-03 00:14:00,5
29853,ORD_29854,8242,Doubledicestore Tempered Glass Screen Protector Compatible for oneplus nord with Edge to Edge Coverage and Easy Installati...,Warehouse A,56,50,2025-02-03 09:56:00,6
29854,ORD_29855,22144,"HOMAVA Dummy Fake Wired Security CCTV Dome Camera with Flashing Red LED Light,11.5 X 11.5 X 7.2 cm, Black",Warehouse A,56,51,2025-02-03 19:04:00,5
29855,ORD_29856,23933,Revlon Nail Enamel - Knock Out 8 Ml,Warehouse B,15,8,2025-02-03 12:21:00,7
29856,ORD_29857,14076,"boAt Type C A325 Tangle-free, Sturdy Type C Cable with 3A Rapid Charging & 480mbps Data Transmission(Black)",Warehouse C,58,44,2025-02-03 09:55:00,14
29857,ORD_29858,12349,Amvasc 2.5mg Tablet,Warehouse C,62,50,2025-02-03 03:32:00,12
29858,ORD_29859,8045,"JBL C115 True Wireless in Ear Earbuds with Mic, Jumbo 21 Hours Playtime with Quick Charge, True Bass, Dual Connect, Blueto...",Warehouse C,32,24,2025-02-03 10:58:00,8
29859,ORD_29860,22647,"Duracell Specialty 2032 Lithium Coin Battery 3V, Pack of 2 (DL2032/CR2032) Designed for use in keyfobs, Scales, wearables ...",Warehouse C,98,89,2025-02-03 11:01:00,9
29860,ORD_29861,36011,Kodak 106 cm (42 inches) Full HD Certified Android Smart LED TV 42FHDX7XPRO (Black),Warehouse B,42,26,2025-02-03 22:13:00,16
29861,ORD_29862,36012,Dex-CPM 6mg Tablet SR,Warehouse B,101,92,2025-02-03 10:39:00,9
29862,ORD_29863,14123,Ambrozen-S Syrup,Warehouse B,74,56,2025-02-03 20:44:00,18
29863,ORD_29864,36016,Lenphor Aqualicious Hydrating Primer 30 Ml,Warehouse B,23,14,2025-02-03 06:28:00,9
29864,ORD_29865,8513,Dot & Key Green Screen Skin Detox Smoothie SPF 20 Day Cream 60 ml,Warehouse C,48,37,2025-02-03 07:14:00,11
29865,ORD_29866,33229,Nomad - Deodorant Body Spray,Warehouse A,64,45,2025-02-03 10:08:00,19
29866,ORD_29867,22498,Gasja 40mg Tablet,Warehouse A,97,87,2025-02-03 10:42:00,10
29867,ORD_29868,13921,Universal Remote Control for All Sony TV for All LCD LED and Bravia TVs Remote,Warehouse C,67,51,2025-02-03 16:21:00,16
29868,ORD_29869,24635,"Face Moisturiser With 5 Essential Oils, Non-Sticky Formula For Skin Repair",Warehouse A,37,26,2025-02-03 02:52:00,11
29869,ORD_29870,487,Realbest-SP Tablet,Warehouse C,97,92,2025-02-03 08:10:00,5
29870,ORD_29871,16083,Zolnap 10mg Tablet,Warehouse B,41,33,2025-02-03 06:13:00,8
29871,ORD_29872,21855,"ZEBRONICS ZEB-LPC88A Laser Toner Printer Cartridge for HP Laser Jet P1007/P1008/P1106/P1108, Pro M1136/M1213nf/M1216, Pro ...",Warehouse C,65,49,2025-02-03 01:15:00,16
29872,ORD_29873,24639,Lcmika 100mg Injection,Warehouse A,23,18,2025-02-03 21:37:00,5
29873,ORD_29874,481,Cefitek S 250mg/125mg Injection,Warehouse C,29,15,2025-02-03 00:34:00,14
29874,ORD_29875,475,MARVIK Soft Silicone Ultra Slim Protection Case Cover for Smartwatches Compatible with Samsung Galaxy Watch Active 4 (44m...,Warehouse C,60,48,2025-02-03 22:36:00,12
29875,ORD_29876,16104,TheGiftKart Back Cover For Xiaomi Redmi Note 10 Pro/ Note 10 Pro Max ( Poly Carbonate|Black ),Warehouse B,28,16,2025-02-03 23:52:00,12
29876,ORD_29877,36149,"'L'Occitane Shea Chestnut Body Cream, Holiday Collection, Nourish & Soften Skin 3.4 Oz",Warehouse B,79,70,2025-02-03 22:16:00,9
29877,ORD_29878,22737,"Fashion Colour Super Smooth Translucent Powder, Shade 02 15 gm",Warehouse A,18,10,2025-02-03 08:16:00,8
29878,ORD_29879,13910,MECHIP Bluetooth Smart Fitness Band for Unisex D18 Activity Tracker Sport Watch for Connect All Smart Phones (Free Size) (...,Warehouse A,89,76,2025-02-03 14:05:00,13
29879,ORD_29880,13909,Zedoxy 200 Tablet,Warehouse B,106,98,2025-02-03 03:48:00,8
29880,ORD_29881,2240,Maryaj Ramona EDP Citrus Floral Perfume And Ajmal Raindrops Femme Deodorant Floral Chypre Fragrance 300 ml,Warehouse B,30,21,2025-02-03 07:26:00,9
29881,ORD_29882,23332,"Golden Wolf Laptop Bag Business Anti-theft Backpack with Lock, Water Resistant College School Laptop Backpack with Rain Co...",Warehouse C,12,3,2025-02-03 10:53:00,9
29882,ORD_29883,33098,Flupara 500 Tablet,Warehouse A,60,43,2025-02-03 11:16:00,17
29883,ORD_29884,36299,Espentral-DSR Capsule,Warehouse C,73,54,2025-02-03 23:38:00,19
29884,ORD_29885,13079,Epaal® 22mm Universal Silicone Strap with Dots Texture for Samsung Watch 3 45mm / Samsung Gear S3 Classic/Frontier/Huawei ...,Warehouse A,47,33,2025-02-03 23:29:00,14
29885,ORD_29886,13085,"boAt Airdopes 172 True Wireless in Ear Earbuds with ENx™ Tech, Beast Mode, 35H Playtime, 11mm Drivers, ASAP™ Charge, IPX4,...",Warehouse C,30,14,2025-02-03 18:39:00,16
29886,ORD_29887,33175,Faces Canada Weightless Creme Finish Lipstick Amber 14 4 Gm,Warehouse B,79,64,2025-02-03 20:55:00,15
29887,ORD_29888,36258,Amigold 50 Tablet,Warehouse C,90,80,2025-02-03 22:48:00,10
29888,ORD_29889,33164,Steel 100mg Tablet,Warehouse B,49,43,2025-02-03 09:59:00,6
29889,ORD_29890,14154,Skyshop® Solar External TPMS Car Tyre Pressure Monitoring System with 4 Tires Sensors Bar/PSI & Temperature Display (Exter...,Warehouse A,101,86,2025-02-03 17:36:00,15
29890,ORD_29891,24638,Venticet LC 5mg/10mg Tablet,Warehouse A,54,40,2025-02-03 10:37:00,14
29891,ORD_29892,21912,OpenTech® Tempered Glass Screen Protector Compatible for iQOO 7 5G / iQOO 7 Legend 5G / iQOO 9 SE 5G with Edge to Edge Cov...,Warehouse C,86,69,2025-02-03 17:06:00,17
29892,ORD_29893,36103,Rutobro-D Tablet,Warehouse B,54,40,2025-02-03 15:48:00,14
29893,ORD_29894,7615,Out 400mg Tablet,Warehouse B,30,11,2025-02-03 02:13:00,19
29894,ORD_29895,35975,"Garnier Skin Naturals, Pure Active Neem Face Wash 50 gm",Warehouse B,61,56,2025-02-03 22:18:00,5
29895,ORD_29896,36068,Krona 2mg/500mg/15mg Tablet,Warehouse C,15,9,2025-02-03 05:14:00,6
29896,ORD_29897,12969,"Face Wash by Cetaphil,Gentle Foaming Cleanser for All Skin Types - 236 ml| Foaming Face Wash with Vitamin E, B5| Dermatolo...",Warehouse B,71,52,2025-02-03 02:49:00,19
29897,ORD_29898,14078,Gear Classic 20L Faux Leather Water Resistant Anti Theft Laptop Bag/Backpack for Men/Women-Tan,Warehouse B,38,31,2025-02-03 14:42:00,7
29898,ORD_29899,8508,Ajmal Yearn EDP & Magnetize Deodorant Pack of 2 300 ml,Warehouse B,36,17,2025-02-03 21:28:00,19
29899,ORD_29900,12992,Deborah Milano Perfect Smokey Eye Palette - 02 Rose 5 gm,Warehouse C,109,99,2025-02-03 15:48:00,10
29900,ORD_29901,8041,Flormar Supershine Lipstick 521 Absolute Fuchsia 3.9 gm,Warehouse C,54,42,2025-02-03 00:51:00,12
29901,ORD_29902,14071,Phlebosol QPS Solution,Warehouse C,21,9,2025-02-03 17:09:00,12
29902,ORD_29903,608,Crysendo Headphone Cushion Compatible with Senheiser HD 350 BT / 4.40 BT/HD 4.50 BT/HD 4.50 BTNC / 458 BT Earpads | Protei...,Warehouse A,10,4,2025-02-03 01:23:00,6
29903,ORD_29904,23413,Pierre Cardin Paris - Porcelain Edition Rouge Lipstick 236-Soft Beige,Warehouse A,81,75,2025-02-03 06:06:00,6
29904,ORD_29905,606,Ourfix AZ 200mg/250mg Tablet,Warehouse A,41,29,2025-02-03 00:07:00,12
29905,ORD_29906,36100,Sebastian Professional Volupt Volumising Shampoo for Hair Volume Boosting | 250 ml | Softening Hair Cleanser for Fine Hair...,Warehouse A,44,38,2025-02-03 01:46:00,6
29906,ORD_29907,36102,B-Oze Cream,Warehouse A,85,79,2025-02-03 02:04:00,6
29907,ORD_29908,6969,"Natural Moisturising Lotion, Enriched with Echinacea & Aloevera",Warehouse A,12,4,2025-02-03 06:12:00,8
29908,ORD_29909,8491,Menospan MF 500mg/250mg Tablet,Warehouse C,73,60,2025-02-03 03:48:00,13
29909,ORD_29910,6995,House of Beauty Derma Roller 1.00mm 1's,Warehouse A,92,83,2025-02-03 22:59:00,9
29910,ORD_29911,648,POPIO Edge To Edge Full Screen Coverage Tempered Glass Screen Protector for Fossil Carlyle/Julianna GEN 5 Digital Smartwat...,Warehouse B,53,44,2025-02-03 09:15:00,9
29911,ORD_29912,23480,Wycin 250mg Injection,Warehouse A,90,74,2025-02-03 07:04:00,16
29912,ORD_29913,35954,rts 2023 Dual USB Travel Adapter Worldwide All in One International Universal Power Travel Adaptor Wall Charger AC Power P...,Warehouse C,28,18,2025-02-03 21:53:00,10
29913,ORD_29914,15940,Skin Refreshing & Energising Anti Pollution Gel Scrub - With Coconut & Coffee,Warehouse A,92,79,2025-02-03 12:55:00,13
29914,ORD_29915,24488,Lerinex A 5mg/60mg Tablet,Warehouse C,105,98,2025-02-03 08:16:00,7
29915,ORD_29916,33375,Novogesic P Tablet,Warehouse A,24,5,2025-02-03 23:40:00,19
29916,ORD_29917,33276,EEshmox DX 250mg/250mg Capsule,Warehouse B,43,36,2025-02-03 15:23:00,7
29917,ORD_29918,2121,"IFB 20 Litre Solo Microwave Oven (20PM-MEC2B, Mechanical Knob,Black)",Warehouse A,57,41,2025-02-03 23:06:00,16
29918,ORD_29919,23506,StBotanica Body Shimmer Oil 30 ml,Warehouse C,15,1,2025-02-03 08:57:00,14
29919,ORD_29920,33296,Kofrituss-AT Syrup Sugar Free,Warehouse A,13,2,2025-02-03 12:29:00,11
29920,ORD_29921,7582,TheGiftKart Dual-Color Leather Finish Samsung Galaxy M21 2021 Edition / M21 / M30s Flip Back Cover | Inbuilt Stand & Pocke...,Warehouse C,63,44,2025-02-03 08:23:00,19
29921,ORD_29922,14113,"Orico 2.5 inch (6.35cm) SSD Sata Hard Disk External Portable Case Cover USB3.0, 2139U3-CR (Transparent)",Warehouse A,32,15,2025-02-03 06:47:00,17
29922,ORD_29923,17321,Restacid Tablet,Warehouse C,44,31,2025-02-02 00:10:00,13
29923,ORD_29924,16787,Styling Shampoo For Men - Cooling & Style,Warehouse C,109,99,2025-02-02 15:02:00,10
29924,ORD_29925,22149,F Gear 22 Ltrs Burner Art Lthr Brown Laptop Backpack (3343),Warehouse B,94,85,2025-02-02 12:38:00,9
29925,ORD_29926,21448,House of Quirk Printed 3 Cms Cosmetic Pouch (Standard_COSPAY_WHI_LLAMA_WHITE LLAMA),Warehouse A,76,71,2025-02-02 17:53:00,5
29926,ORD_29927,12244,NEMOZOLE 200MG SUSPENSION,Warehouse C,10,4,2025-02-02 00:21:00,6
29927,ORD_29928,3048,"Duracell USB C To Lightning Apple Certified (Mfi) Braided Sync & Charge Cable For Iphone, Ipad And Ipod. Fast Charging Lig...",Warehouse C,27,16,2025-02-02 06:33:00,11
29928,ORD_29929,15849,COI Note Pad/Memo Book with Sticky Notes & Clip Holder with Pen for Gifting,Warehouse C,100,94,2025-02-02 02:31:00,6
29929,ORD_29930,21871,"Amazinghind Leatherette Material Professional File Folders for Certificates, Files and folders for documents, Document Fol...",Warehouse A,81,74,2025-02-02 23:24:00,7
29930,ORD_29931,2778,Tata Sky Universal Remote Compatible for SD/HD,Warehouse A,39,31,2025-02-02 19:33:00,8
29931,ORD_29932,11677,"truke Buds BTG 1 Bluetooth Truly Wireless Gaming in Ear Earbuds with (ENC) & Quad MEMS Mic for Clear Calls, 13mm Titanium ...",Warehouse C,20,13,2025-02-02 17:17:00,7
29932,ORD_29933,15393,Lakme Absolute White Intense Liquid Concealer Rose Fair 5.4 Ml,Warehouse B,60,52,2025-02-02 01:43:00,8
29933,ORD_29934,16790,Bonepower 50mg/750mg/250mg Tablet,Warehouse C,51,40,2025-02-02 16:45:00,11
29934,ORD_29935,25156,Solgesic 325mg/10mg Tablet,Warehouse C,51,44,2025-02-02 11:38:00,7
29935,ORD_29936,17746,Rabrem Tablet,Warehouse C,83,69,2025-02-02 22:03:00,14
29936,ORD_29937,24215,"M-Audio M-Track Duo – USB Audio Interface for Recording, Streaming and Podcasting with Dual XLR, Line & DI Inputs, plus a ...",Warehouse B,95,82,2025-02-02 18:21:00,13
29937,ORD_29938,6419,L.A. Colors Drama Lash Mascara Black 13 ml,Warehouse C,49,37,2025-02-02 07:12:00,12
29938,ORD_29939,32798,"Maybelline New York Sensational Liquid Matte Lipstick 11, Made Easy 7 gm",Warehouse B,68,61,2025-02-02 06:57:00,7
29939,ORD_29940,21567,"Burney® Premium Eyelash Curler with 2 Eyelashes And Glue, Parlor Accessories Combo (Gift Pack For Girls)",Warehouse C,80,66,2025-02-02 12:58:00,14
29940,ORD_29941,25155,Lakme Absolute Matte Ultimate Lip Color With Argan Oil Royal Rust 3.4 Gm,Warehouse C,38,19,2025-02-02 10:42:00,19
29941,ORD_29942,1736,Lakme Forever Matte Liquid Lip Colour Nude Myth 5.6 Ml,Warehouse B,31,24,2025-02-02 06:59:00,7
29942,ORD_29943,24992,Ajmal Majmua And Jannatul Firdaus & Yearn EDP Pack of 3 20 ml,Warehouse C,51,42,2025-02-02 08:09:00,9
29943,ORD_29944,25527,Fancyku Kpop BTS Bangtan Boys Casual Backpack Daypack Laptop Bag School Bag Bookbag Shoulder Bag with USB Charging Port(Bl...,Warehouse A,56,44,2025-02-02 02:46:00,12
29944,ORD_29945,1734,Orange Soap,Warehouse C,54,49,2025-02-02 03:44:00,5
29945,ORD_29946,3562,Eurosartan Trio 20mg/10mg/12.5mg Tablet,Warehouse B,26,15,2025-02-02 17:43:00,11
29946,ORD_29947,15470,The Moms Co. Diaper Rash Cream 25 gm,Warehouse A,39,23,2025-02-02 09:31:00,16
29947,ORD_29948,34129,"Spy Mission HD Small Security Camera Series-1 Hidden Recording Device for Indoor and Outdoor, Portable Mini Pen Camera Vid...",Warehouse B,34,28,2025-02-02 17:00:00,6
29948,ORD_29949,25270,"All new Echo Show 8 (2nd Gen, 2021 release)- Smart speaker with 8"" HD screen, stereo sound & hands-free entertainment with...",Warehouse A,81,65,2025-02-02 18:07:00,16
29949,ORD_29950,30779,It Eg 200mg Capsule,Warehouse C,50,34,2025-02-02 10:46:00,16
29950,ORD_29951,2011,Sitaglize-M 50/1000 Tablet,Warehouse A,58,43,2025-02-02 13:52:00,15
29951,ORD_29952,34242,Propysalic  Ointment,Warehouse B,38,28,2025-02-02 16:36:00,10
29952,ORD_29953,6715,Winble Back Cover For Redmi Note 10 Pro Max/ Redmi note 10 pro ( Silicone|Black ),Warehouse C,102,96,2025-02-02 04:41:00,6
29953,ORD_29954,3494,Paro CR Forte Tablet,Warehouse A,31,16,2025-02-02 11:33:00,15
29954,ORD_29955,8371,Paxum 10mg Injection,Warehouse B,25,12,2025-02-02 20:31:00,13
29955,ORD_29956,21225,Telekuff DX Syrup,Warehouse B,69,57,2025-02-02 16:53:00,12
29956,ORD_29957,6870,STABILO Swing Cool Highlighter Pen Pastel - Pack of 4 (Assorted Colours),Warehouse C,24,17,2025-02-02 03:07:00,7
29957,ORD_29958,15518,OpenTech® Tempered Glass Screen Protector Compatible for OnePlus 6T / OnePlus 7 Edge to Edge Coverage with Easy Installati...,Warehouse A,97,87,2025-02-02 06:35:00,10
29958,ORD_29959,3007,"QZ USB Hub 3.1 for Desktop PC high Speed, USB 3.1 Gen 1, 4 Ports, 1 Meter Cable, Black",Warehouse A,108,90,2025-02-02 18:11:00,18
29959,ORD_29960,6869,Oflatoon OZ Tablet,Warehouse B,19,11,2025-02-02 11:18:00,8
29960,ORD_29961,33592,Badam Pak - For Vitality & Stamina,Warehouse A,97,87,2025-02-02 04:00:00,10
29961,ORD_29962,11294,Flormar HD Invisible Cover Foundation 90 Golden Neutral 30 ml,Warehouse C,66,50,2025-02-02 08:36:00,16
29962,ORD_29963,31800,Cilnipres TC 40mg/10mg/12.5mg Tablet,Warehouse C,108,92,2025-02-02 15:27:00,16
29963,ORD_29964,30892,Asern-P Tablet,Warehouse A,109,93,2025-02-02 21:19:00,16
29964,ORD_29965,24784,OpenTech® Tempered Glass Screen Protector Compatible for iPhone XR / 11 (Transparent) Full Screen Coverage (Except Edges) ...,Warehouse B,22,16,2025-02-02 20:35:00,6
29965,ORD_29966,31351,Ampra 40mg Injection,Warehouse A,46,30,2025-02-02 16:33:00,16
29966,ORD_29967,3559,"The Body Shop Vegan Body Yogurt Mango , 200 Ml",Warehouse C,38,30,2025-02-02 00:36:00,8
29967,ORD_29968,15396,"Fashion Colour Oil Free Sunscreen Foundation, 40g",Warehouse C,39,22,2025-02-02 07:12:00,17
29968,ORD_29969,21948,Street Wear Lip2Last Matte Liquid Lipstick - Go Go Rose 5 ml,Warehouse A,41,24,2025-02-02 10:21:00,17
29969,ORD_29970,30731,Robustrion Pack of 1 Anti-Scratch & Smudge Proof Premium Tempered Glass Screen Protector for Samsung Tab A7 Lite 8.7 inch ...,Warehouse C,70,54,2025-02-02 13:06:00,16
29970,ORD_29971,2454,Gold Creme Bleach,Warehouse C,24,18,2025-02-02 08:48:00,6
29971,ORD_29972,1691,"Neutrogena Oil Free Acne Wash For Acne Prone Skin With Salicylic Acid, 175ml",Warehouse C,82,69,2025-02-02 13:10:00,13
29972,ORD_29973,17753,Savo F 10mg/160mg Tablet,Warehouse A,29,20,2025-02-02 13:57:00,9
29973,ORD_29974,25520,Mikka 500mg Injection,Warehouse A,48,30,2025-02-02 21:20:00,18
29974,ORD_29975,15408,"Fashion Colour Non - Transfer Matt Waterproof Lipstick, 8 Pink 2.6 gm",Warehouse B,72,67,2025-02-02 19:27:00,5
29975,ORD_29976,3623,Lovax 300 Tablet,Warehouse C,115,96,2025-02-02 02:46:00,19
29976,ORD_29977,24173,Slim Soft Toothbrush - Soft Bristles,Warehouse A,50,44,2025-02-02 02:55:00,6
29977,ORD_29978,16791,Itramat 200mg Capsule,Warehouse B,75,57,2025-02-02 03:47:00,18
29978,ORD_29979,17085,"Fashion Colour Proffessional Makeup Kit, FC2322B - 02 92.1 gm",Warehouse A,25,7,2025-02-02 05:40:00,18
29979,ORD_29980,31418,CALAILIS 7 Pairs 6D Faux Mink Lashes Faux Wispy Dramatic Long False Eyelashes Fluffy Extension Luxurious Fake Eyelashes Ma...,Warehouse B,33,27,2025-02-02 01:10:00,6
29980,ORD_29981,31094,"Belkin USB-A to Micro USB Charging Cable for Android Phones and Tablets (3.3 Feet/1 Meter, Black)",Warehouse A,98,81,2025-02-02 20:25:00,17
29981,ORD_29982,16061,Act Esosafe D Capsule PR,Warehouse A,33,28,2025-02-02 00:55:00,5
29982,ORD_29983,16370,Hypan 40mg Injection,Warehouse B,54,38,2025-02-02 03:33:00,16
29983,ORD_29984,1881,Helicoset Injection,Warehouse B,53,45,2025-02-02 08:48:00,8
29984,ORD_29985,33091,Klojet 2mg Tablet MD,Warehouse A,67,56,2025-02-02 10:16:00,11
29985,ORD_29986,17494,"realme Buds Wireless 2 Neo Bluetooth in Ear Earphones with Mic, Fast Charging & Up to 17Hrs Playtime (Blue)",Warehouse B,94,79,2025-02-02 22:17:00,15
29986,ORD_29987,12112,Medimade Anti Aging Fuji Matcha Green Tea Clay Face Mask (Pack of 2) 1's,Warehouse B,52,47,2025-02-02 01:18:00,5
29987,ORD_29988,2332,"Super Poligrip Original, 2.4 Ounce Package",Warehouse C,92,80,2025-02-02 13:23:00,12
29988,ORD_29989,15700,Itrament 100 Capsule,Warehouse B,47,39,2025-02-02 09:10:00,8
29989,ORD_29990,33698,Xoftad S 500mg/250mg Injection,Warehouse B,46,41,2025-02-02 11:33:00,5
29990,ORD_29991,31073,Vasograin Tablet,Warehouse C,84,65,2025-02-02 23:19:00,19
29991,ORD_29992,17432,Epson 003 65 ml for EcoTank L1110/L3100/L3101/L3110/L3115/L3116/L3150/L3151/L3152/L3156/L5190 Black Ink Bottle,Warehouse B,89,79,2025-02-02 12:53:00,10
29992,ORD_29993,8718,Indulgeo Essentials Vitamin C Glow Essence 20 ml,Warehouse C,25,16,2025-02-02 08:40:00,9
29993,ORD_29994,15646,PEFKO PSS56 19MM Replacement Soft Silicone Sporty Straps / Bands Compatible for Boat Storm Smart Watch & Watches with 19mm...,Warehouse A,34,27,2025-02-02 04:28:00,7
29994,ORD_29995,2298,Parker Jotter Standard CT Ball Pen (Black),Warehouse B,80,72,2025-02-02 15:59:00,8
29995,ORD_29996,12088,Gram SPN 1000mg/500mg Injection,Warehouse A,66,60,2025-02-02 23:35:00,6
29996,ORD_29997,31148,Fluroide Eye Drop,Warehouse A,58,46,2025-02-02 00:49:00,12
29997,ORD_29998,33072,Iscozole 20mg Capsule,Warehouse C,20,6,2025-02-02 16:22:00,14
29998,ORD_29999,33069,Moxicare LP Eye Drop,Warehouse A,8,1,2025-02-02 23:39:00,7
29999,ORD_30000,24347,Vega Bleach Brush (BB - 01) 18 gm,Warehouse B,93,77,2025-02-02 10:28:00,16
30000,ORD_30001,3375,LACASA 100 MG TABLET,Warehouse C,96,85,2025-02-02 22:07:00,11
30001,ORD_30002,31887,Clonext Cream,Warehouse B,74,55,2025-02-02 16:28:00,19
30002,ORD_30003,8825,"The Body Shop Vitamin E Moisture Cream, 100ml",Warehouse C,84,76,2025-02-02 04:57:00,8
30003,ORD_30004,12092,Trazograf 76% Injection,Warehouse B,100,95,2025-02-02 15:40:00,5
30004,ORD_30005,33772,"Noise ColorFit Pro 3 Assist Smart Watch with Alexa Built-in, 24*7 Spo2 Monitoring, 1.55"" HD TruView Display, Stress, Slee...",Warehouse C,98,84,2025-02-02 10:39:00,14
30005,ORD_30006,33774,Khaas Bath Soap - Honey-Aloe-Turmeric,Warehouse A,30,22,2025-02-02 16:27:00,8
30006,ORD_30007,1926,"Buds & Berries Moisturising Shea Butter and Argan Oil Body Wash for Soft, Smooth and Clear Skin | No Soap, No Paraben, No ...",Warehouse B,94,75,2025-02-02 06:38:00,19
30007,ORD_30008,31134,Etotroy MR 60mg/4mg Tablet,Warehouse C,36,29,2025-02-02 11:39:00,7
30008,ORD_30009,33052,"Wings Phantom 760 Wireless Earphones, Earbuds with Low Latency 40 ms, Sync App Support, Gaming Designed case with LED Ligh...",Warehouse C,110,96,2025-02-02 16:32:00,14
30009,ORD_30010,24752,Cetsu 10mg Tablet,Warehouse C,52,40,2025-02-02 09:06:00,12
30010,ORD_30011,17006,Sucradac O Syrup,Warehouse B,74,67,2025-02-02 05:59:00,7
30011,ORD_30012,12094,Varnceft SB 1000mg/500mg Injection,Warehouse A,32,14,2025-02-02 19:26:00,18
30012,ORD_30013,2969,mCaffeine Coffee Lip Kit For Chapped & Pigmented Lips 34 gm,Warehouse C,39,25,2025-02-02 21:35:00,14
30013,ORD_30014,31091,Playboy Play It Sexy Woman Deodorant Spray 150 ml,Warehouse B,19,6,2025-02-02 03:23:00,13
30014,ORD_30015,33024,SupCares Edge to Edge Anti Glare Matte Tempered Glass for iPhone 11 and iPhone XR (6.1 Inch) with Easy Self Installation K...,Warehouse C,81,75,2025-02-02 11:26:00,6
30015,ORD_30016,33690,Meftrax 500mg/250mg Tablet,Warehouse C,101,89,2025-02-02 22:52:00,12
30016,ORD_30017,15459,"Maybelline Hyper Glossy Liquid Liner, Black, Glossy Finish 3g",Warehouse C,29,17,2025-02-02 20:19:00,12
30017,ORD_30018,30769,"Sounce 36W 3-Ports Car Charger Adapter, 1 Type C with Power Delivery (PD), 1 USB Port Qualcomm (QC) 3.0 & 1 USB Port Charg...",Warehouse B,92,78,2025-02-02 03:07:00,14
30018,ORD_30019,6429,Oxypar F Tablet,Warehouse B,104,95,2025-02-02 21:34:00,9
30019,ORD_30020,11442,Hisense 108 cm (43 inches) Bezelless Series 4K Ultra HD Smart LED Google TV 43A6H (Black),Warehouse A,103,90,2025-02-02 11:16:00,13
30020,ORD_30021,11140,Tixi LB 50mg Dry Syrup,Warehouse B,61,43,2025-02-02 00:20:00,18
30021,ORD_30022,32181,"Tuarso 8K HDMI 2.1 Cable 48Gbps,1.5 Meter High-Speed Braided HDMI Cable(8K@60HZ,4K@120HZ,2K@240HZ) HDMI 2.1 Cable Compatib...",Warehouse B,26,18,2025-02-02 08:29:00,8
30022,ORD_30023,15443,"MyGlamm POPxo Makeup Homegirls Liquid Lipstick kit-Cheerleader, Ride or Die, BFF 4L-1.5g x 3",Warehouse B,88,83,2025-02-02 18:02:00,5
30023,ORD_30024,16046,"Mother Sparsh Rose & Beetroot Face Wash for Dull, Dry & Uneven Skin | With Papaya Extract For Healthy Moist Skin | Soap Fr...",Warehouse C,21,9,2025-02-02 21:06:00,12
30024,ORD_30025,16376,Vega Hot Pink Nail File (NF - 01) 16 gm,Warehouse A,26,9,2025-02-02 14:30:00,17
30025,ORD_30026,11296,Rozegrel 10mg Tablet,Warehouse A,102,90,2025-02-02 23:12:00,12
30026,ORD_30027,15547,Cefipel-Plus LB Tablet,Warehouse C,103,86,2025-02-02 16:18:00,17
30027,ORD_30028,16777,Ajmal Aurum & Wisal & Wisal Dhahab & Sacred Love Deo & Aretha EDP Pack of 5 20 ml,Warehouse A,15,2,2025-02-02 12:54:00,13
30028,ORD_30029,6681,Allure Pencil Brush - (231) 1's,Warehouse C,71,60,2025-02-02 22:49:00,11
30029,ORD_30030,33721,Endomal L 80 mg/480 mg Tablet DT,Warehouse B,47,29,2025-02-02 01:23:00,18
30030,ORD_30031,3355,NOTE TOTAL LOOK BROW KIT 03 4.8 gm,Warehouse B,74,58,2025-02-02 03:03:00,16
30031,ORD_30032,33798,HP USB 3.1 Flash Drive 64GB X760L,Warehouse C,94,85,2025-02-02 23:24:00,9
30032,ORD_30033,17477,"Fashion Colour Kiss Lip No Transfer Lipstick, 74 Poppy Red 2.6 gm",Warehouse B,42,23,2025-02-02 20:46:00,19
30033,ORD_30034,22025,"Apple USB-C to Lightning Cable -2m (For iPhone, iPad, AirPods or iPod with Lightning connector)",Warehouse B,16,1,2025-02-02 18:49:00,15
30034,ORD_30035,33041,"DUCARE Synthetic Bristles Makeup Brushes - Black , Pack of 27 , DRM-DF2725",Warehouse A,12,6,2025-02-02 08:18:00,6
30035,ORD_30036,33727,Soap - Neem & Turmeric,Warehouse A,104,88,2025-02-02 08:24:00,16
30036,ORD_30037,12106,Spasran 10mg/150mg Tablet,Warehouse A,76,70,2025-02-02 17:30:00,6
30037,ORD_30038,33803,"PiBOX India, Dual Bay USB 3.0 to SATA I, II, III Hard Drive Docking Station Upto 12TB for 2.5 or 3.5in HDD, SSD with Hard ...",Warehouse B,87,69,2025-02-02 23:08:00,18
30038,ORD_30039,11801,Anxitreat 0.25mg Tablet MD,Warehouse A,41,29,2025-02-02 13:22:00,12
30039,ORD_30040,11017,"Acko 1 Year Extended Warranty for Tablets Between INR 10,001-20,000 (Email Delivery)",Warehouse A,104,87,2025-02-02 14:13:00,17
30040,ORD_30041,31107,Excellence Creme Hair Color (72ml + 100g) + Color Protect Shampoo 175 ml,Warehouse C,17,10,2025-02-02 02:13:00,7
30041,ORD_30042,11350,"NIVIA Spikester (Encounter) 494 Polypropylene Volleyball, Size - 4 (Multicolour)",Warehouse C,103,92,2025-02-02 07:59:00,11
30042,ORD_30043,31938,Soap - Activated Charcoal,Warehouse A,84,67,2025-02-02 20:16:00,17
30043,ORD_30044,16859,Hazcob 1500mcg Injection,Warehouse B,45,28,2025-02-02 03:49:00,17
30044,ORD_30045,19200,Kcet-M Tablet,Warehouse C,67,54,2025-02-02 00:50:00,13
30045,ORD_30046,17352,"Artis AR-60W-MG1 60 Watts Laptop Adapter/Charger compatible with MB Pro 13”/MB Unibody (16.5V, 3.65A) (L-Tip Connector)",Warehouse A,52,33,2025-02-02 03:58:00,19
30046,ORD_30047,19069,Muchek LS Syrup,Warehouse A,81,63,2025-02-02 21:27:00,18
30047,ORD_30048,4915,"iQOO Neo 6 5G (Maverick Orange, 12GB RAM, 256GB Storage) | Only Snapdragon 870 in The Segment | 50% Charge in Just 12 Mins...",Warehouse B,59,52,2025-02-02 20:20:00,7
30048,ORD_30049,28284,Dexgen Syrup,Warehouse C,22,10,2025-02-02 16:23:00,12
30049,ORD_30050,26435,Sandal & Turmeric Soap - Super Saver Pack,Warehouse C,71,55,2025-02-02 00:02:00,16
30050,ORD_30051,35999,Dutora M 80mg/250mg Tablet,Warehouse B,24,9,2025-02-02 12:34:00,15
30051,ORD_30052,19121,Novadryl 25mg Capsule,Warehouse A,77,66,2025-02-02 10:41:00,11
30052,ORD_30053,35992,Levoreq-M Tablet,Warehouse B,108,94,2025-02-02 13:53:00,14
30053,ORD_30054,5965,Oslol 20 Tablet,Warehouse A,47,40,2025-02-02 13:21:00,7
30054,ORD_30055,683,St.Botanica Pure Rosehip Coldpressed & Unrefined Oil 50 ml,Warehouse C,41,28,2025-02-02 08:48:00,13
30055,ORD_30056,19096,SupCares Edge to Edge Tempered Glass for Samsung Galaxy S20 FE 5G (6.5 Inch) with Easy Self Installation Kit | Black,Warehouse A,36,26,2025-02-02 13:17:00,10
30056,ORD_30057,4804,Hair Mask With Tea Tree & Lemon Oil - Dandruff Control & Itch Treatment,Warehouse B,17,11,2025-02-02 10:49:00,6
30057,ORD_30058,9214,"ZEBRONICS Zeb- Haze 2.4GHz Wireless Mouse with up to 1200 DPI, Power Saving Mode, Nano Receiver and Plug & Play Usage - Black",Warehouse B,95,80,2025-02-02 13:16:00,15
30058,ORD_30059,697,"SanDisk 2TB Extreme Portable SSD 1050MB/s R, 1000MB/s W,Upto 2 Meter Drop Protection with IP55 Water/dust Resistance, HW E...",Warehouse A,15,3,2025-02-02 13:18:00,12
30059,ORD_30060,13039,"Vega Eye Groomer Brush, pink, 18 g",Warehouse A,78,60,2025-02-02 17:32:00,18
30060,ORD_30061,19055,Ramipril 2.5mg Capsule,Warehouse B,46,37,2025-02-02 17:36:00,9
30061,ORD_30062,7586,Revolution Pro New Neutrals Blushed Satin Matte Lipstick Plush 3.2 gm,Warehouse B,103,89,2025-02-02 21:12:00,14
30062,ORD_30063,28510,S T Dase Plus 50mg/10mg Tablet,Warehouse C,102,83,2025-02-02 16:00:00,19
30063,ORD_30064,26342,"JGD PRODUCTS Shock Proof Protective Soft Back Cover for iPhone X, iPhone Xs (Transparent) [Bumper Corners with Air Cushion...",Warehouse C,18,3,2025-02-02 12:25:00,15
30064,ORD_30065,19041,"Samvardhan 8.5 inch LCD Writing Tablet, Best Gift Electronic Drawing and Writing Board for Kids & Adults, Handwriting Pape...",Warehouse C,51,43,2025-02-02 17:31:00,8
30065,ORD_30066,26332,The Face Shop Real Nature Glowing Bride Face Masksheet (Pack Of 10),Warehouse B,34,25,2025-02-02 14:34:00,9
30066,ORD_30067,35941,"Generic(Unbranded)4-Channel Relay Control Board Module With Optocoupler, 4 Way Relay Module for Arduino",Warehouse A,48,40,2025-02-02 06:19:00,8
30067,ORD_30068,10073,Nurocef 100mg Tablet DT,Warehouse B,61,42,2025-02-02 22:06:00,19
30068,ORD_30069,35930,Battery Power Kids Toothbrush - Barbie,Warehouse B,60,50,2025-02-02 17:05:00,10
30069,ORD_30070,19130,"BEAUTE BLANC Fruit Vinegar Gel Hair Color, Natural Black Color Dye for Hair Care, Natural Ammonia Free Color Dye (500ml x 2)",Warehouse B,94,75,2025-02-02 21:46:00,19
30070,ORD_30071,36007,Melmet 1000 SR Tablet,Warehouse C,92,74,2025-02-02 04:18:00,18
30071,ORD_30072,19133,Itcon 100mg Capsule,Warehouse A,100,84,2025-02-02 22:11:00,16
30072,ORD_30073,28338,"Dyazo 4.8 Amp (2.4 & 2.4 Amp) Dual Port Fast USB Car Charger Compatible W/iPhone Xr/Xs/Max/X/8/7/Plus,Ipad Pro/Air 2/Mini,...",Warehouse C,35,20,2025-02-02 17:11:00,15
30073,ORD_30074,26460,"Fashion Colour German Eyeshadow, 02 Sparkling Yellow 1.4 gm",Warehouse A,66,49,2025-02-02 01:51:00,17
30074,ORD_30075,9901,HydraGel Indian Sunscreen SPF 50 With Aloe Vera & Raspberry For Sun Protection,Warehouse B,63,50,2025-02-02 02:02:00,13
30075,ORD_30076,4899,"Fogg Pure Lady Blooming Lilies, Eau De Parfum for Women, Floral Fragrance, 50ml",Warehouse C,43,27,2025-02-02 13:58:00,16
30076,ORD_30077,22733,KHR Pouch Compatible with Noise Buds VS104 Protective Soft Silicone 360° Full Protection Dust-Proof Shockproof Case Cover ...,Warehouse C,56,42,2025-02-02 23:35:00,14
30077,ORD_30078,19231,Rexace Tablet,Warehouse A,90,71,2025-02-02 02:09:00,19
30078,ORD_30079,15655,"GIZGA essentials iStuff365 Istuff365 2-in-1 Laptop, Mobile Tabletop Stand, 12"" To15.6 Laptops, Ergonomic Design, 8-Adjusta...",Warehouse B,97,85,2025-02-02 19:59:00,12
30079,ORD_30080,36130,Cortishort 6mg Tablet,Warehouse B,78,67,2025-02-02 01:31:00,11
30080,ORD_30081,36121,Miss Rose 2 In 1 Creamy Matte Lipstick 7102 - 001M 51 2.1 gm,Warehouse C,102,94,2025-02-02 23:56:00,8
30081,ORD_30082,22704,Omefam D 10mg/20mg Capsule,Warehouse B,38,21,2025-02-02 12:43:00,17
30082,ORD_30083,589,Cenorol 3mg Tablet,Warehouse C,31,20,2025-02-02 03:36:00,11
30083,ORD_30084,22723,Yearn Eau De Parfum Aquatic Perfume - Party Wear For Men,Warehouse A,105,90,2025-02-02 13:42:00,15
30084,ORD_30085,523,Voglimac R HD 1mg/0.3mg Tablet,Warehouse A,95,81,2025-02-02 13:44:00,14
30085,ORD_30086,28555,Apple Cider Vinegar Face Wash - Oil Control,Warehouse C,31,20,2025-02-02 11:44:00,11
30086,ORD_30087,36223,Lip Liner Set of 12 Colors Matte Professional Long Lasting Waterproof Lip Liner Pencil For All Skin,Warehouse B,30,25,2025-02-02 09:54:00,5
30087,ORD_30088,28009,"ProElite Faux Leather Smart Flip Case Cover for Apple iPad 10.2"" 9th Gen (2021) / 8th Gen / 7th Gen with Stylus Pen, Dark ...",Warehouse B,113,95,2025-02-02 13:54:00,18
30088,ORD_30089,5056,"Omeron m i Original New Series 2023 Bluetooth Wireless Smart Watch, Fitness Band for Boys, Girls, Men, Women & Kids | Spor...",Warehouse C,50,35,2025-02-02 21:04:00,15
30089,ORD_30090,9879,NOTE ULTRA BLACK EYELINER 4.5 ml,Warehouse A,74,66,2025-02-02 14:57:00,8
30090,ORD_30091,5043,Ofciron PD Eye Drop,Warehouse B,100,92,2025-02-02 17:25:00,8
30091,ORD_30092,28049,SPF 50+ Aloe Vera Cucumber Gel,Warehouse B,62,43,2025-02-02 18:44:00,19
30092,ORD_30093,20511,Enlinea Edge to Edhe Screen Protector | Screen Guard for Ola S1 Pro | OLA S1 | OLA Air (Glossy),Warehouse C,47,34,2025-02-02 14:01:00,13
30093,ORD_30094,493,Zopid 5mg Tablet,Warehouse C,37,23,2025-02-02 09:15:00,14
30094,ORD_30095,28058,Atulya Chandan Haldi Soap 125 gm,Warehouse B,36,21,2025-02-02 04:36:00,15
30095,ORD_30096,8017,Nutriment Gold Scrub All Skin Type 250 gm,Warehouse A,75,61,2025-02-02 14:14:00,14
30096,ORD_30097,5873,Magmox LP Eye Drop,Warehouse A,60,48,2025-02-02 02:31:00,12
30097,ORD_30098,28082,"ASUS TUF Gaming A15, 15.6""(39.62 cms) FHD 144Hz, AMD Ryzen 5 4600H,4GB GeForce GTX 1650 Laptop(8GB/512GB SSD/Win11/Black/...",Warehouse A,54,38,2025-02-02 21:19:00,16
30098,ORD_30099,5017,Comet Busters Basic Oval Maroon Bindis (5 mm) (BV727),Warehouse A,91,80,2025-02-02 11:57:00,11
30099,ORD_30100,28113,Founten D 0.4mg/0.5mg Tablet,Warehouse C,23,18,2025-02-02 12:22:00,5
30100,ORD_30101,13958,Onsitego 1 Year Extended Warranty for Small Household Appliances from Rs. 4001-5000 (Email Delivery - No Physical Kit),Warehouse A,73,54,2025-02-02 15:11:00,19
30101,ORD_30102,9897,Texan S 250mg/125mg Injection,Warehouse A,55,41,2025-02-02 08:13:00,14
30102,ORD_30103,28293,Beetrip-Plus 25mg/10mg Tablet,Warehouse A,26,11,2025-02-02 14:04:00,15
30103,ORD_30104,28298,Excellence Creme Hair Color(72ml+100g) 5 Light Brown+Color Protect Shampoo 175ml,Warehouse C,87,71,2025-02-02 15:36:00,16
30104,ORD_30105,25139,DEVCOMM Finger (Pack of 6 pieces) Sleeves PUBG Finger For Mobile Game Controllers Anti Sweat Breathable Professional Touch...,Warehouse B,111,96,2025-02-02 14:11:00,15
30105,ORD_30106,6641,Vega Shampoo Comb (HMBC - 406) 49 gm,Warehouse A,62,52,2025-02-02 12:04:00,10
30106,ORD_30107,17643,Moxifit-P Eye Drop,Warehouse C,112,94,2025-02-02 22:24:00,18
30107,ORD_30108,6859,Novaspas 80mg/250mg Tablet,Warehouse A,9,1,2025-02-02 12:20:00,8
30108,ORD_30109,8741,"Urban Wolf Tech Pouch: The All-in-One Waterproof Travel Organizer for Cables, Adapters, Chargers, Power Banks, SD Cards, H...",Warehouse B,18,10,2025-02-02 20:50:00,8
30109,ORD_30110,15488,"Peiroks Type C to 3.5 mm Audio Jack Connector, Headphones Jack Converter for Galaxy S8, S8 Plus, S9, S9 Plus, S10 Plus, S1...",Warehouse A,40,32,2025-02-02 17:58:00,8
30110,ORD_30111,30821,Maybelline New York Line Tattoo High Impact Liner Black 1 gm,Warehouse A,25,9,2025-02-02 23:44:00,16
30111,ORD_30112,25276,"UNEXTS Foldable Laptop Table Multipurpose with Cup Holder, Study Bed Breakfast Table Large Size and Portable/Ergonomic & R...",Warehouse B,100,85,2025-02-02 23:08:00,15
30112,ORD_30113,25466,Bio Almond Nourishing Soap 75G+Bio Berry Body Wash 200ml+Bio Apple Shampoo 200ml,Warehouse C,98,93,2025-02-02 13:08:00,5
30113,ORD_30114,8681,Gomo Tablet,Warehouse C,48,37,2025-02-02 18:04:00,11
30114,ORD_30115,12194,Exol Syrup,Warehouse A,69,53,2025-02-02 23:16:00,16
30115,ORD_30116,3025,"Stbotanica Bulgarian Rose Otto Glow Deep Hydration Facial Toner Deep Hydration No Paraben, Sls & Alcohol 150 ml",Warehouse A,15,5,2025-02-02 08:14:00,10
30116,ORD_30117,31778,DOMS Poster Colour 14 Shades,Warehouse A,30,24,2025-02-02 06:51:00,6
30117,ORD_30118,2432,Sinal Premium Heavy Duty Wall Mount Stand for 17-32 inches LCD LED TV Moving TV,Warehouse C,99,88,2025-02-02 06:22:00,11
30118,ORD_30119,6934,Queenolar 150mg Tablet,Warehouse A,19,6,2025-02-02 07:49:00,13
30119,ORD_30120,11717,Tamride 0.4mg Tablet,Warehouse A,19,1,2025-02-02 03:00:00,18
30120,ORD_30121,25283,Revmic 500mg Injection,Warehouse A,52,36,2025-02-02 14:56:00,16
30121,ORD_30122,8442,Uritor 10mg Tablet,Warehouse C,65,58,2025-02-02 05:29:00,7
30122,ORD_30123,3276,Myglamm Lit Nail Enamel - Bad Romance 7 ML,Warehouse B,51,35,2025-02-02 22:42:00,16
30123,ORD_30124,3294,Samsung 80 cm (32 Inches) Wondertainment Series HD Ready LED Smart TV UA32T4340BKXXL (Glossy Black),Warehouse C,114,97,2025-02-02 08:39:00,17
30124,ORD_30125,12030,Clavsar DS Syrup,Warehouse A,81,72,2025-02-02 02:38:00,9
30125,ORD_30126,30929,Leemark M Kid 2.5mg/4mg Tablet,Warehouse A,22,17,2025-02-02 19:59:00,5
30126,ORD_30127,33987,Caldipree Silicone Full Wrap Remote Case Compatible with LG AN-MR19BA AN-MR600 Magic Remote with Lanyard (Black),Warehouse C,106,96,2025-02-02 10:05:00,10
30127,ORD_30128,33991,"Fashion Colour Vivid Matte Lipstick, 2 Soft Purple 3.8 gm",Warehouse B,112,93,2025-02-02 13:53:00,19
30128,ORD_30129,11830,Gemblue Biocare Dead Sea Face Mask 500 ml,Warehouse B,79,69,2025-02-02 18:47:00,10
30129,ORD_30130,15538,"MI Poco M2 (Brick Red, 6GB RAM, 128GB Storage)",Warehouse C,73,54,2025-02-02 03:03:00,19
30130,ORD_30131,6652,Luliben Z XL 1% Cream,Warehouse C,69,55,2025-02-02 17:36:00,14
30131,ORD_30132,21966,Lighten Up Lip Mender,Warehouse C,30,17,2025-02-02 22:10:00,13
30132,ORD_30133,34084,Vimzip 250mg Tablet,Warehouse B,45,29,2025-02-02 09:09:00,16
30133,ORD_30134,34081,Allure Eyeshadow Brush (c-20 ) 1's,Warehouse C,90,74,2025-02-02 10:43:00,16
30134,ORD_30135,4893,"Dyazo Vegan PU Leather Mouse Pad, Extended Desk Mat for Work from Home /Office / Gaming, Reversible Anti-Slip, Design Wate...",Warehouse B,83,64,2025-02-02 08:26:00,19
30135,ORD_30136,19153,"POPIO Tempered Glass Screen Protector Compatible For OnePlus 7T with Edge to Edge Coverage and Easy Installation Kit, Pack...",Warehouse A,24,13,2025-02-02 14:14:00,11
30136,ORD_30137,28319,"ASUS Vivobook 14, Intel Core i7-1165G7 11th Gen, 14"" (35.56 cm) FHD, Thin and Laptop (16GB/512GB SSD/Intel Iris Xe Graphic...",Warehouse A,83,68,2025-02-02 15:30:00,15
30137,ORD_30138,26422,Gemblue Biocare Pearl Face Mask 500 ml,Warehouse B,108,95,2025-02-02 05:19:00,13
30138,ORD_30139,14084,Revlon Touch & Glow Advanced Fairness Face Wash 100 Gm,Warehouse B,101,90,2025-02-02 07:08:00,11
30139,ORD_30140,26420,Lakme Absolute Matte Ultimate Lip Color With Argan Oil Choco Brownie 3.4 Gm,Warehouse A,103,95,2025-02-02 21:13:00,8
30140,ORD_30141,28346,Microflox CT 500mg/600mg Tablet,Warehouse A,69,56,2025-02-02 01:05:00,13
30141,ORD_30142,36013,"Redmi 10 Power (Sporty Orange, 8GB RAM, 128GB Storage)",Warehouse B,30,16,2025-02-02 20:26:00,14
30142,ORD_30143,9982,"Fashion Colour Nude Makeover 2 In 1 Face Powder, Shade 02 20 gm",Warehouse C,58,46,2025-02-02 14:25:00,12
30143,ORD_30144,20567,All Natural Probiotics Shampoo Bar - For Normal Hair,Warehouse C,53,39,2025-02-02 08:53:00,14
30144,ORD_30145,14112,"ZXN Ultra Fast C-Type Charger for Xiaomi Redmi Note 7, Note 7S, Note 7 Pro, Note 8, 8A,Note 8 pro, Note 9 Pro Power Adapte...",Warehouse A,52,39,2025-02-02 23:41:00,13
30145,ORD_30146,9230,Anti-Aging Face Wash With Hyaluronic Acid And Vitamin C,Warehouse A,61,45,2025-02-02 04:03:00,16
30146,ORD_30147,7605,TheGiftKart Ultra-Hybrid Crystal Clear Back Cover Case for iPhone 12/12 PRO | Anti-Slip Grip Built-in | Bold Camera Protec...,Warehouse B,104,90,2025-02-02 20:58:00,14
30147,ORD_30148,14122,Zonate 1gm Injection,Warehouse A,97,88,2025-02-02 01:47:00,9
30148,ORD_30149,662,Ridazole Oral Suspension,Warehouse C,35,18,2025-02-02 21:42:00,17
30149,ORD_30150,21861,ELV Mobile Phone Mount Tabletop Holder for Phones and Tablets - Black,Warehouse A,16,2,2025-02-02 22:28:00,14
30150,ORD_30151,18108,"The Face Shop Jeju Aloe Fresh Soothing Foam Cleanser | Gel to Foam cleanser for Skin,Body and Face | Hydrating & cooling c...",Warehouse B,69,52,2025-02-02 20:56:00,17
30151,ORD_30152,9003,Body Wash - Mint & Cucumber,Warehouse B,46,33,2025-02-02 05:06:00,13
30152,ORD_30153,1822,"UGREEN USB 3.0 Sharing Switch, 2 Computers 4-Port USB Peripheral Switcher Adapter Box Selector for PC, Printer, Scanner, M...",Warehouse A,25,13,2025-02-02 02:55:00,12
30153,ORD_30154,8580,Trafna 500mg/250mg Tablet,Warehouse B,44,33,2025-02-02 14:19:00,11
30154,ORD_30155,16850,DeBelle Gel Nail Lacquer Aqua Frenzy Metallic Sky Blue Nail Polish 8 ml,Warehouse B,14,4,2025-02-02 02:58:00,10
30155,ORD_30156,32105,AmazonBasics 14-inches Laptop Sleeve (Black),Warehouse A,112,98,2025-02-02 03:56:00,14
30156,ORD_30157,25446,Diocef T 1000mg/125mg Injection,Warehouse B,51,39,2025-02-02 20:48:00,12
30157,ORD_30158,25281,Ajmal Aurum Silver Shade Wisal Deodorant Spray (Pack of 3) 200 ml,Warehouse B,104,89,2025-02-02 18:48:00,15
30158,ORD_30159,16284,"Noise Newly Launched Evolve 2 Play AMOLED Display Smart Watch with Fast Charging, Always On Displa, 50 Sports Modes, Hindi...",Warehouse B,37,26,2025-02-02 19:31:00,11
30159,ORD_30160,30829,"Eyeliner, Quick-drying, Intense Color, Matte Finish Light Weight, WaterProof, 24hrs, Long Lasting, SmudgeProof - Black",Warehouse A,70,51,2025-02-02 22:53:00,19
30160,ORD_30161,16847,Dioxx XR 500mg Tablet,Warehouse C,100,95,2025-02-02 11:05:00,5
30161,ORD_30162,17469,Flormar Fusion Power Foundation Serum 060 Soft Beige 30 ml,Warehouse A,105,90,2025-02-02 03:18:00,15
30162,ORD_30163,17225,Kandolac P 400mg/500mg Tablet,Warehouse C,12,1,2025-02-02 09:02:00,11
30163,ORD_30164,11044,Spigen Rugged Armor Back Cover Case for iPhone XR (TPU | Matte Black),Warehouse C,47,39,2025-02-02 20:31:00,8
30164,ORD_30165,11798,Cefriya SL 250mg/125mg Injection,Warehouse A,104,93,2025-02-02 06:26:00,11
30165,ORD_30166,24093,"Mars Smudge Proof Long Lasting Matte Lip Crayon - LS14-13,3.5g",Warehouse C,53,40,2025-02-02 14:44:00,13
30166,ORD_30167,25699,Zedex Cough Syrup,Warehouse A,91,72,2025-02-02 11:25:00,19
30167,ORD_30168,34506,"Sounce Mouse Pad, Ergonomic Mouse Pad with Comfortable Gel Wrist Rest Support and Lycra Cloth, Non-Slip PU Base for Easy T...",Warehouse A,31,19,2025-02-02 10:27:00,12
30168,ORD_30169,2659,"BESTOR Right Angle USB C Adapter, 40Gbps USB C Adapter, 90 Degree Type-C Male to Female Adapter, USB C Splitter Adapter Su...",Warehouse A,57,49,2025-02-02 18:57:00,8
30169,ORD_30170,30319,Conditioner With Macademia Oil,Warehouse A,94,89,2025-02-02 16:24:00,5
30170,ORD_30171,15924,Ajmal Selfie And Aura Of CP & Aretha EDP Pack of 3 20 ml,Warehouse C,20,3,2025-02-02 21:29:00,17
30171,ORD_30172,25206,Ancepod CV 200mg/125mg Tablet,Warehouse C,57,42,2025-02-02 06:21:00,15
30172,ORD_30173,21678,"Mizi [2 Pack] USB-C Metal Anti Dust Plug Cover, Protect Charging Port from Dust and Moist with Storage Box and Cable Clip ...",Warehouse C,42,34,2025-02-02 04:42:00,8
30173,ORD_30174,11194,"LXCN® Car Rearview Mirror Phone Holder 360 Degree Extendable and Retractable, Universal 360° Car Rearview Mirror Mobile Ho...",Warehouse C,67,60,2025-02-02 14:46:00,7
30174,ORD_30175,24906,Apple iPhone 14 Pro Max (128 GB) - Deep Purple,Warehouse B,48,36,2025-02-02 11:44:00,12
30175,ORD_30176,32552,Bactxim AZ 200mg/250mg Tablet,Warehouse C,74,62,2025-02-02 03:48:00,12
30176,ORD_30177,3828,Cefimed 50mg Tablet,Warehouse B,81,76,2025-02-02 14:52:00,5
30177,ORD_30178,33292,Orabest Mouth Paint,Warehouse B,17,8,2025-02-02 10:45:00,9
30178,ORD_30179,22219,"Ajmal Jannatul Firdaus Concentrated Oriental Perfume 10ml for Unisex & Ajmal Aurum Deodorant for Woman, 200 ml & Ajmal Imp...",Warehouse A,107,97,2025-02-02 12:19:00,10
30179,ORD_30180,11551,"Kasahara Vati - Cough, 250mg",Warehouse A,23,7,2025-02-02 07:00:00,16
30180,ORD_30181,32461,"DESICREW Natural & Pure Beetroot Powder For Healty Pinkish Skin & Rosy Cheeks, Glowing & Shiny Skin Face Pack 100 Gm",Warehouse A,34,16,2025-02-02 05:54:00,18
30181,ORD_30182,2587,URBANMAC Beauty 15 Colors Contour Face Cream Makeup Concealer Palette + Oval Make up Brush,Warehouse C,107,91,2025-02-02 10:08:00,16
30182,ORD_30183,15926,KABEER ART Sticky Notes 3 x 5 Inch Pad 4 Colors (400 Sheets),Warehouse C,79,66,2025-02-02 20:06:00,13
30183,ORD_30184,25715,Spinocef 500mg Injection,Warehouse A,64,46,2025-02-02 08:13:00,18
30184,ORD_30185,10679,Ranidom NF 15mg/10mg Tablet,Warehouse C,71,53,2025-02-02 05:42:00,18
30185,ORD_30186,24940,Es Gi D 30mg/40mg Capsule SR,Warehouse A,98,81,2025-02-02 18:04:00,17
30186,ORD_30187,16675,Tustross Expectorant,Warehouse C,77,64,2025-02-02 00:14:00,13
30187,ORD_30188,25344,"Wet n Wild Coverall Concealer Palette, Color Commentary, 6.5g",Warehouse B,72,53,2025-02-02 20:35:00,19
30188,ORD_30189,34308,Esmopraz D 30mg/40mg Capsule SR,Warehouse B,39,20,2025-02-02 23:40:00,19
30189,ORD_30190,31452,"Ant Esports ICE-280TGW Mid Tower Computer Case I Gaming Cabinet -White Supports ATX, Micro-ATX, Motherboard with Transpare...",Warehouse B,37,19,2025-02-02 22:16:00,18
30190,ORD_30191,24141,Dulfre 5mg Tablet,Warehouse B,47,39,2025-02-02 13:10:00,8
30191,ORD_30192,11640,"Skin Naturals - Hydra Bomb, Face Serum Sheet Mask, Blue",Warehouse B,85,72,2025-02-02 03:10:00,13
30192,ORD_30193,1619,Cardika AM 5mg/2.5mg Capsule,Warehouse C,74,66,2025-02-02 22:17:00,8
30193,ORD_30194,32559,Fullform 400 Rotacap,Warehouse A,76,69,2025-02-02 07:22:00,7
30194,ORD_30195,21894,DYMO DYM12966 Organizer Xpress Pro Light Plastic Embosser for 3/8 Tapes,Warehouse C,58,50,2025-02-02 14:16:00,8
30195,ORD_30196,11191,Pee Safe Natural Intimate Wash 105 ml,Warehouse C,81,72,2025-02-02 13:37:00,9
30196,ORD_30197,22230,"Duracell Rechargeable AA 1300mAh Batteries, 4Pcs",Warehouse B,21,9,2025-02-02 01:36:00,12
30197,ORD_30198,33366,The Moms Co. Vita Rich Face Wash 100 ml,Warehouse A,27,9,2025-02-02 04:01:00,18
30198,ORD_30199,32539,Riaspas Oral Suspension,Warehouse C,51,35,2025-02-02 19:24:00,16
30199,ORD_30200,21667,"Noise Buds VS402 in-Ear Truly Wireless Earbuds with 35H of Playtime, Low Latency, Quad Mic with ENC, Instacharge(10 min=12...",Warehouse B,113,97,2025-02-02 11:34:00,16
30200,ORD_30201,34560,"D-Link R15 AX1500 Eagle PRO AI Dual-Band Smart Router, Wi-Fi 6, 4 Gigabit Ports, 4 External Antennae, Voice Control, Paren...",Warehouse A,65,57,2025-02-02 07:29:00,8
30201,ORD_30202,31620,Clovia Gal Pal Sanitary Pads - XXL for Extra Heavy Flow - 320 mm (Pack of 20) 1's,Warehouse A,63,53,2025-02-02 01:55:00,10
30202,ORD_30203,1487,Wayona USB Type C Fast Charger Cable Fast Charging USB C Cable/Cord Compatible for Samsung Galaxy S10e S10 S9 S8 Plus S1...,Warehouse B,74,55,2025-02-02 08:54:00,19
30203,ORD_30204,11201,Mother Sparsh Ayurvedic Tummy Roll-On Liquid - Hing & Saunf Oil 40 ml,Warehouse B,94,86,2025-02-02 06:40:00,8
30204,ORD_30205,7255,Ampine 5mg Tablet,Warehouse C,36,31,2025-02-02 05:26:00,5
30205,ORD_30206,21653,Mcaffeine Micro Fiber Hair Wrap 1's,Warehouse B,48,43,2025-02-02 04:41:00,5
30206,ORD_30207,17215,Maxceft CT 500 mg/62.5 mg Injection,Warehouse C,26,19,2025-02-02 15:20:00,7
30207,ORD_30208,3151,Bio Aloevera Lotion - 30 Spf Sunscreen For Normal To Oily Skin In The Sun,Warehouse A,93,82,2025-02-02 08:52:00,11
30208,ORD_30209,17210,Budefast Oxipule,Warehouse C,104,99,2025-02-02 07:50:00,5
30209,ORD_30210,17188,TheGiftKart Transparent Crystal Clear Back Cover for Samsung Galaxy M21 / M21 2021 Edition / M30s Back Cover | Shockproof ...,Warehouse A,86,75,2025-02-02 20:17:00,11
30210,ORD_30211,17230,Taft Classic Hair Spray Extra Strong 3,Warehouse C,93,77,2025-02-02 18:46:00,16
30211,ORD_30212,21896,Amozo Tough Rugged Shockproof Cover Case Compatible with AirPods Pro 2 / AirPods Pro GEN-2 (2022) - (Polycarbonate | Black),Warehouse A,49,32,2025-02-02 13:30:00,17
30212,ORD_30213,24500,Aceplee-D Tablet,Warehouse B,78,65,2025-02-02 14:22:00,13
30213,ORD_30214,6987,"Redmi A1 (Light Green, 2GB RAM 32GB ROM) | Segment Best AI Dual Cam | 5000mAh Battery | Leather Texture Design | Android 12",Warehouse C,54,37,2025-02-02 05:57:00,17
30214,ORD_30215,18081,"ZEBRONICS Zeb-Music Bomb X Wireless 20W Portable Speaker, 4000 mAh Battery, RGB Lights, IPX7 Water Resistant, Wireless BT/...",Warehouse C,102,86,2025-02-02 14:47:00,16
30215,ORD_30216,18089,"POND'S Age Miracle Whip Cream, 35g",Warehouse A,100,94,2025-02-02 00:31:00,6
30216,ORD_30217,17194,Masterblaster Germ Protection Liquid Handwash Refill,Warehouse B,52,37,2025-02-02 05:26:00,15
30217,ORD_30218,32499,Boltove® Decoration Sky Blue Backdrop Curtain Tulle Net Transparent for Birthdays Anniversary Baby Shower Photo Shoot Wedd...,Warehouse B,49,42,2025-02-02 00:54:00,7
30218,ORD_30219,10651,The Natural Wash Hair Mask With Amla Bhringraj & Shikakai For Dry And Damaged Hair 200 Gm,Warehouse B,76,65,2025-02-02 02:17:00,11
30219,ORD_30220,30279,"AGN Tulip Perfume, 150ml - Pack of 1",Warehouse A,73,56,2025-02-02 01:28:00,17
30220,ORD_30221,30296,Acifin Plus Tablet,Warehouse C,57,41,2025-02-02 07:37:00,16
30221,ORD_30222,11577,"Portronics Toad Ergo Vertical Advanced Wireless Ergonomic Mouse 2.4Ghz, 6D Button, Wrist Support, Adjustable DPI Upto 120...",Warehouse B,44,37,2025-02-02 12:51:00,7
30222,ORD_30223,34521,Spanvast 10 Tablet,Warehouse A,36,19,2025-02-02 05:22:00,17
30223,ORD_30224,16459,"LA Girl Velvet Contour Blush Stick, Velour, 5.8g",Warehouse A,63,57,2025-02-02 14:19:00,6
30224,ORD_30225,32273,Vitamin C Skin Brightening Gel,Warehouse C,28,21,2025-02-02 23:25:00,7
30225,ORD_30226,6372,"COLORESSENCE Ipop Kajal Pencil Combo, Waterproof Smudge Proof Long Lasting Mild Roll-on Pen - Black",Warehouse B,28,10,2025-02-02 14:36:00,18
30226,ORD_30227,24472,Mediflam MR 250mg/50mg/325mg Tablet,Warehouse C,7,1,2025-02-02 18:31:00,6
30227,ORD_30228,25550,Acer Aspire 5 Gaming Laptop Intel Core i5 12th gen (12-Cores) Processor (16 GB/512 GB SSD/Windows 11 Home/4GB Graphics/NVI...,Warehouse A,36,29,2025-02-02 13:50:00,7
30228,ORD_30229,1623,"Fashion Colour Lip Liner, Waterproof, Long Lasting, 3 Toffee Bar 0.35 gm",Warehouse B,69,57,2025-02-02 21:12:00,12
30229,ORD_30230,32285,Ajmal Aura Concentrated Perfume Oil Floral Fruity Attar And Jannatul Firdaus Concentrated Perfume Oil Oriental Attar 20 ml,Warehouse C,50,40,2025-02-02 16:45:00,10
30230,ORD_30231,16718,Dutoid Capsule,Warehouse A,85,77,2025-02-02 06:05:00,8
30231,ORD_30232,21589,Beard Growth Oil Powered with Vetiver & 4 Essential Oils,Warehouse A,101,87,2025-02-02 12:16:00,14
30232,ORD_30233,31741,Loxy 250mg/250mg Capsule,Warehouse A,47,38,2025-02-02 02:22:00,9
30233,ORD_30234,16428,Rutomed Tablet,Warehouse A,61,45,2025-02-02 15:12:00,16
30234,ORD_30235,24814,Provin 200 Soft Gelatin Capsule,Warehouse B,62,47,2025-02-02 21:23:00,15
30235,ORD_30236,2079,Copris-G Expectorant,Warehouse B,48,43,2025-02-02 00:12:00,5
30236,ORD_30237,34380,"Prestige Popular Max 5 + 3 + 2 Litre Aluminium Outer Lid Pressure Cooker Combo Pack, 2 Lids, Silver, Large (11791)",Warehouse C,105,99,2025-02-02 19:40:00,6
30237,ORD_30238,15871,"ProElite Smart Flip Case Cover for Lenovo Tab M10 FHD Plus 3rd Gen 10.6 inch Translucent Back with Stylus Pen, Navy",Warehouse A,70,52,2025-02-02 09:14:00,18
30238,ORD_30239,16420,Etorgo 60mg Tablet,Warehouse C,63,58,2025-02-02 09:24:00,5
30239,ORD_30240,32308,Lotus Herbals Whiteglow Skin Whitening & Brightening Deep Moisturising Creme Spf 20 Pa+++ 60 Gm,Warehouse A,95,90,2025-02-02 19:11:00,5
30240,ORD_30241,3071,"Maybelline New York Pencil Radiant Concealer, Dark Circles and Blemish Ultra Blendable, Instant Anti Age Eraser, Caramel, 6g",Warehouse A,63,52,2025-02-02 20:11:00,11
30241,ORD_30242,11473,"Portronics Clamp M2 Adjustable Car Mobile Phone Holder Stand, 360° Rotational, Strong Suction Cup, Compatible with 4 to 6 ...",Warehouse A,34,26,2025-02-02 18:49:00,8
30242,ORD_30243,11627,Saficef O 200mg/200mg Tablet,Warehouse B,57,39,2025-02-02 15:15:00,18
30243,ORD_30244,3649,Stylist - Texture Me Texturising Spray,Warehouse C,19,14,2025-02-02 00:45:00,5
30244,ORD_30245,3077,"double sided black eyeliner water proof smudge proof stamp eyeliner,star shape 10 g (BLACK)",Warehouse C,44,27,2025-02-02 01:42:00,17
30245,ORD_30246,11876,"SECUREMENT® Plastic Tamper Proof Courier Bag/Envelope/Polybag for Packing, 60 Micron, 12 Inch x 16 Inch, White and Black, ...",Warehouse C,73,68,2025-02-02 15:13:00,5
30246,ORD_30247,34275,Forthcef 250 Injection,Warehouse C,79,65,2025-02-02 18:15:00,14
30247,ORD_30248,32288,SHOW BEAUTY Cosmetics Waterproof lipstick long lasting - Non Transfer smudge Proof- Hydrating & Moisturizing pop - Nude Na...,Warehouse B,82,77,2025-02-02 08:09:00,5
30248,ORD_30249,25237,TheGiftKart Crystal Clear Back Cover Case for Samsung Galaxy S21 FE 5G | Shockproof 360 Degree Protection | Transparent Ha...,Warehouse B,30,22,2025-02-02 01:19:00,8
30249,ORD_30250,31704,Epson EcoTank L130 Single Function InkTank Printer,Warehouse C,96,79,2025-02-02 13:24:00,17
30250,ORD_30251,17888,NOTE GEL LOOK NAIL ENAMEL 25 9 ml,Warehouse C,21,2,2025-02-02 17:08:00,19
30251,ORD_30252,32306,Goldistat EZ 10 mg/10 mg Tablet,Warehouse A,37,24,2025-02-02 16:21:00,13
30252,ORD_30253,7638,Tolfen Tablet,Warehouse C,93,84,2025-02-02 07:30:00,9
30253,ORD_30254,12263,Nicodil 5mg Tablet,Warehouse A,75,62,2025-02-02 00:47:00,13
30254,ORD_30255,7204,F Gear Blackhawk 40 Ltrs Black Laptop Backpack (3178),Warehouse C,106,92,2025-02-02 21:45:00,14
30255,ORD_30256,24959,Mefi M Oral Suspension,Warehouse A,70,51,2025-02-02 03:16:00,19
30256,ORD_30257,15866,Chigat 400mg Tablet,Warehouse A,69,58,2025-02-02 03:45:00,11
30257,ORD_30258,17143,Canon Compatible for Canon GI-790 Ink Bottle (Black),Warehouse A,20,2,2025-02-02 06:09:00,18
30258,ORD_30259,30633,Hexa Advanced Body Wash With Milk Protein,Warehouse A,32,16,2025-02-02 16:52:00,16
30259,ORD_30260,30637,G 1 Transparent A4 Size Document File | Storage Bag with Snap Button for Certificates/Legal Documents | Set of 5 | Plastic...,Warehouse C,70,55,2025-02-02 12:41:00,15
30260,ORD_30261,25537,Flormar Perfect Coverage Foundation 121 Golden Neutral 30 ml,Warehouse C,75,59,2025-02-02 04:34:00,16
30261,ORD_30262,24837,Ascodil AM Syrup,Warehouse A,100,95,2025-02-02 20:08:00,5
30262,ORD_30263,8464,Lip Lightener For Men,Warehouse B,113,99,2025-02-02 08:54:00,14
30263,ORD_30264,34301,"BlueRigger High Speed HDMI Cable with Ethernet - Supports 3D, 4K 60Hz, Audio Return - Latest Version (10 Feet / 3 Meters)",Warehouse C,22,6,2025-02-02 01:02:00,16
30264,ORD_30265,1604,Epidol 1.5mg Tablet,Warehouse C,96,77,2025-02-02 10:13:00,19
30265,ORD_30266,15323,Prazonic 2.5mg Tablet XL,Warehouse C,50,36,2025-02-02 07:01:00,14
30266,ORD_30267,32272,Ibizolid Dry Syrup,Warehouse C,17,11,2025-02-02 23:54:00,6
30267,ORD_30268,24822,Aconmox CV 500mg/125mg Tablet,Warehouse B,36,23,2025-02-02 06:40:00,13
30268,ORD_30269,3670,Amazon Brand - Solimo TPU Back Cover for OnePlus 7 Pro (Clear),Warehouse A,29,19,2025-02-02 22:59:00,10
30269,ORD_30270,1630,Sage Square Ghost Comic FACE MASK Fawkes Mask Anonymous Edition Face-Mask Perfect Fit Cosplay Holi Halloween Function Part...,Warehouse C,47,39,2025-02-02 00:57:00,8
30270,ORD_30271,32715,Wyace Plus 100mg/500mg Tablet,Warehouse A,42,34,2025-02-02 16:00:00,8
30271,ORD_30272,7202,"eller santé® Wireless Charger 3in1 Magnetic Mag-Safe Charger dock for iPhone 14, 14 Plus, 14 Pro, 14 Pro Max, iPhone 13, 1...",Warehouse C,74,63,2025-02-02 20:43:00,11
30272,ORD_30273,25563,"Zayn & Myza Pollution Defense CC With SPF 30 Compact, Natural Nude 9 gm",Warehouse B,62,49,2025-02-02 00:32:00,13
30273,ORD_30274,25551,Rosurid 5mg Tablet,Warehouse A,27,15,2025-02-02 21:50:00,12
30274,ORD_30275,16753,Glocof Syrup,Warehouse A,23,17,2025-02-02 08:38:00,6
30275,ORD_30276,16742,Mecotis 75mg Capsule,Warehouse B,37,25,2025-02-02 23:29:00,12
30276,ORD_30277,32716,Clovomox LB 500mg/125mg Tablet,Warehouse A,79,60,2025-02-02 11:47:00,19
30277,ORD_30278,1637,Red Onion Hair Growth Oil,Warehouse B,115,96,2025-02-02 08:32:00,19
30278,ORD_30279,6376,"Logitech B100 Wired USB Mouse, 3 yr Warranty, 800 DPI Optical Tracking, Ambidextrous PC/Mac/Laptop - Black",Warehouse A,77,61,2025-02-02 17:12:00,16
30279,ORD_30280,32719,Aegte Kisproof Liquid Matte Lipstick - Lusty Red 707 5 ml,Warehouse B,76,57,2025-02-02 03:43:00,19
30280,ORD_30281,31451,"DYAZO 10 Inches LED Ring Light for Camera, and Video Shooting , Makeup with 7 Feet Long Foldable and Lightweight Ring Ligh...",Warehouse C,88,79,2025-02-02 16:20:00,9
30281,ORD_30282,34321,"Lenovo Q-Series 24 Inch (60.5Cm) 1920x1080 Pixels FHD IPS Monitor | Height Adjustment, 2X3W Speakers, 75Hz, AMD FreeSync, ...",Warehouse B,58,41,2025-02-02 12:50:00,17
30282,ORD_30283,8757,"Sounce Screen Protector Compatible with Fitbit Versa 2 Case, Ultra-Thin Slim Soft TPU Protective Case All-Around Full Cove...",Warehouse B,84,66,2025-02-02 00:21:00,18
30283,ORD_30284,6363,"Fashion Colour Terra Cotta Blusher, Shade 14 8 gm",Warehouse A,91,82,2025-02-02 05:59:00,9
30284,ORD_30285,33382,Derwent Precision 0.5mm Mechanical Pencil Refill Set,Warehouse B,9,3,2025-02-02 20:36:00,6
30285,ORD_30286,31220,Kazenzo 5 in 1 Art Tip Electric Nails Decorator Salon Sharper Grinder Drill Machine Polish Manicure Pedicure Grooming Tool...,Warehouse B,25,15,2025-02-02 23:29:00,10
30286,ORD_30287,17038,"DIGITEK® 3-Axis Handheld Gimbal Stabilizer for Smartphones & Gopro with Face & Object Tracking Motion, Various Time Lapse ...",Warehouse B,99,86,2025-02-02 04:33:00,13
30287,ORD_30288,16889,Ceptics India to European Travel Adapter (Schuko) - Type E/F India to Europe - CE Certified - RoHS Compliant - White - 1 P...,Warehouse B,28,12,2025-02-02 21:48:00,16
30288,ORD_30289,1813,Forcip 250mg Tablet,Warehouse C,100,92,2025-02-02 10:15:00,8
30289,ORD_30290,30960,Gabadon M 300mg/500mcg Tablet,Warehouse A,25,6,2025-02-02 00:11:00,19
30290,ORD_30291,33964,POPIO Type C Dash Charging USB Data Cable for OnePlus Devices,Warehouse C,84,67,2025-02-02 10:07:00,17
30291,ORD_30292,24727,L'Occitane Immortelle Precious Enriched Emulsion,Warehouse B,89,78,2025-02-02 11:34:00,11
30292,ORD_30293,7100,Nulet 1.25 Tablet MD,Warehouse C,90,75,2025-02-02 03:35:00,15
30293,ORD_30294,31850,Fashion Colour Skin Brightening Face Serum 50 ml,Warehouse A,45,33,2025-02-02 20:03:00,12
30294,ORD_30295,31964,"Adult Pull-up Pants for Men - Comfort Protect Underwear, Large/Extra Large",Warehouse A,67,61,2025-02-02 23:49:00,6
30295,ORD_30296,33679,Enduro Rechargeable Battery 2-Pack (HERO10 Black/HERO9 Black),Warehouse C,39,32,2025-02-02 16:07:00,7
30296,ORD_30297,16167,Perfume - Ultra Sensual,Warehouse A,52,33,2025-02-02 19:27:00,19
30297,ORD_30298,24318,Iqoo neo 7 Camera Lens Protector Pack of 2,Warehouse B,33,19,2025-02-02 18:24:00,14
30298,ORD_30299,25372,Stenkold Tablet,Warehouse C,74,60,2025-02-02 13:27:00,14
30299,ORD_30300,21284,"MMAK Dust Guard Film Protector Ultra Thin 0.03 mm for Airpods Pro Case, Silver",Warehouse C,39,20,2025-02-02 19:46:00,19
30300,ORD_30301,30969,"Man Matters Double Dht Blocking Anti Hair Fall Shampoo For Men & Women With Saw Palmetto, Caffeine, Biotin & Argan Oil | T...",Warehouse A,75,57,2025-02-02 11:02:00,18
30301,ORD_30302,15602,Appetite Yogue Appetite Booster For Kids - Hunger Tonic,Warehouse A,75,67,2025-02-02 00:42:00,8
30302,ORD_30303,16112,Fragrant Deo Soap - Good Morning,Warehouse C,60,41,2025-02-02 20:36:00,19
30303,ORD_30304,21812,"Bambalio BPG 180-50 (Classic) Glossy Photo Paper, 180 gsm, 50 Sheets A4 Size",Warehouse A,53,40,2025-02-02 16:22:00,13
30304,ORD_30305,33097,Ibimox BD Oral Suspension,Warehouse C,38,31,2025-02-02 10:27:00,7
30305,ORD_30306,3328,Fixbase-S 1.5gm Injection,Warehouse A,25,14,2025-02-02 06:49:00,11
30306,ORD_30307,16171,PIDILITE Fevicryl Water Based Glass Colours 10 Assorted (115ml),Warehouse B,87,77,2025-02-02 11:59:00,10
30307,ORD_30308,16934,Camel Artist water colour cakes - 18 shades,Warehouse C,97,91,2025-02-02 02:06:00,6
30308,ORD_30309,32955,Eslika 10mg Tablet,Warehouse B,12,6,2025-02-02 12:03:00,6
30309,ORD_30310,31033,Erox 250mg Tablet DT,Warehouse C,16,8,2025-02-02 03:18:00,8
30310,ORD_30311,11366,Flormar BB Cream BB04 Light/Medium 35 ml,Warehouse A,38,31,2025-02-02 13:19:00,7
30311,ORD_30312,15597,Lotus Herbals Baby+ Tender Touch Baby Body Lotion 100 Ml,Warehouse C,48,39,2025-02-02 06:51:00,9
30312,ORD_30313,32976,"Garnier Hair Color (70ml+60g) Shade 5, Light Brown+Loreal Paris Shampoo 75ml",Warehouse C,68,57,2025-02-02 13:03:00,11
30313,ORD_30314,1855,Hair Fall Control Oil,Warehouse B,68,58,2025-02-02 14:31:00,10
30314,ORD_30315,8390,"Americos Chemicals Private Limited Glow in The Dark Pigment Powder (Blue, 40 g)",Warehouse C,24,9,2025-02-02 22:57:00,15
30315,ORD_30316,16091,Amlored 5mg Tablet,Warehouse A,70,58,2025-02-02 09:30:00,12
30316,ORD_30317,3439,Jelly Flower Color Changing Lipstick Temperature Change Moisturizer flower Magic Color Change Lip Gloss (BLUE FLOWER),Warehouse C,102,90,2025-02-02 16:25:00,12
30317,ORD_30318,8559,Like An Early Morning At An Indian Temple Room Fragrance Spray,Warehouse C,29,19,2025-02-02 20:49:00,10
30318,ORD_30319,25340,Antonio Banderas The Icon Eau De Toilette 100Ml With Deodorant 150Ml,Warehouse A,82,73,2025-02-02 13:19:00,9
30319,ORD_30320,11046,ADS 9to9 2x1 Primer concealer Compact Powder,Warehouse B,91,84,2025-02-02 15:05:00,7
30320,ORD_30321,33080,Realspar Professional Makeup Glitter Black (Golden),Warehouse A,52,43,2025-02-02 14:35:00,9
30321,ORD_30322,1932,Sony MDR-EX15AP EX In-Ear Wired Stereo Headphones with Mic (Black),Warehouse A,35,28,2025-02-02 00:46:00,7
30322,ORD_30323,25336,Biomal 150mg Injection,Warehouse B,68,57,2025-02-02 08:42:00,11
30323,ORD_30324,31870,"EcoBerry Tinted Face Powder For Everyday No Makeup Look, Talc Free, Hypoallergenic, Sensitive Skin 100% Pure, Organic | Na...",Warehouse C,46,27,2025-02-02 18:06:00,19
30324,ORD_30325,21478,Fexoap 120mg Tablet,Warehouse A,21,7,2025-02-02 16:39:00,14
30325,ORD_30326,11358,Ajmal Classic Oud CP & Yearn EDP Pack of 2 20 ml,Warehouse B,88,81,2025-02-02 12:51:00,7
30326,ORD_30327,21356,Parker Classic Gold Gold Trim Ball Pen,Warehouse B,24,10,2025-02-02 09:11:00,14
30327,ORD_30328,17010,NOTE ULTRA RICH COLOR EYE PENCIL 02 1.1 gm,Warehouse A,74,62,2025-02-02 19:20:00,12
30328,ORD_30329,30986,Jectocos Injection 1.5ml,Warehouse B,50,31,2025-02-02 11:47:00,19
30329,ORD_30330,31846,HUION Inspiroy H640P 6*4 inch Graphics Drawing Tablet with Battery-Free Stylus 8192 Pressure Sensitivity 6 Customized Hot ...,Warehouse B,74,58,2025-02-02 14:25:00,16
30330,ORD_30331,33906,Refluzole 20mg Tablet,Warehouse B,26,19,2025-02-02 05:55:00,7
30331,ORD_30332,32010,Anti-Pollution Face Pack,Warehouse A,66,48,2025-02-02 13:43:00,18
30332,ORD_30333,1980,Timofeh 5mg/10mg Tablet,Warehouse A,50,35,2025-02-02 18:21:00,15
30333,ORD_30334,24295,Sefmox 500mg Capsule,Warehouse A,48,41,2025-02-02 02:51:00,7
30334,ORD_30335,32007,"realme 10 Pro 5G (Hyperspace, 128 GB) (8 GB RAM)",Warehouse B,24,10,2025-02-02 05:53:00,14
30335,ORD_30336,25397,Hynix Hmt451S6Afr8A-Pb 4Gb Pc3-12800 DDR3-1600Mhz Non-Ecc Unbuffered Cl11 204-Pin Sodimm 1.35V Low Voltage Single Rank Mem...,Warehouse C,21,9,2025-02-02 20:17:00,12
30336,ORD_30337,1832,SOFLIN® Multi-Purpose Wall Mount Holder Stand for Charging Mobile Just Fit in Socket and Hang Pack of 1 (Mutlicolor),Warehouse B,116,98,2025-02-02 23:38:00,18
30337,ORD_30338,24283,SanDisk Extreme Pro SD UHS I 64GB Card for 4K Video for DSLR and Mirrorless Cameras 200MB/s Read & 90MB/s Write,Warehouse A,23,7,2025-02-02 10:51:00,16
30338,ORD_30339,33638,Maryaj M For Her EDP Fruity Floral Perfume And Ajmal Raindrops Femme Deodorant Floral Chypre Fragrance 290 ml,Warehouse B,37,20,2025-02-02 19:10:00,17
30339,ORD_30340,17017,Ugetak 500 Tablet,Warehouse A,73,66,2025-02-02 04:43:00,7
30340,ORD_30341,33125,Oflofix-M Oral Suspension,Warehouse C,72,53,2025-02-02 08:13:00,19
30341,ORD_30342,17021,"TWIREY Hair Coloring Dyeing Kit Brush with Bowl, Professional Use Dye Brush Kit for Saloon Color Mixing Bowl Set and Parlo...",Warehouse A,29,14,2025-02-02 14:50:00,15
30342,ORD_30343,17031,Blue Heaven Bling Nailpaint 807 (Smokey Night) 8 ml,Warehouse B,28,11,2025-02-02 17:49:00,17
30343,ORD_30344,11304,Telbo-AM Tablet,Warehouse C,78,66,2025-02-02 16:05:00,12
30344,ORD_30345,31257,Ziox 250mg Tablet,Warehouse B,80,67,2025-02-02 13:23:00,13
30345,ORD_30346,8725,Insight Cosmetics Non Transfer Matte Lipstick - Crucifix 4.2 gm,Warehouse B,75,57,2025-02-02 01:56:00,18
30346,ORD_30347,1968,Limaflam Tablet,Warehouse A,100,84,2025-02-02 13:23:00,16
30347,ORD_30348,32578,"Colorbar Stunning Brow Pencil Mini, Chestnut,",Warehouse A,25,13,2025-02-02 10:35:00,12
30348,ORD_30349,15230,Oflax 200mg Tablet,Warehouse A,99,85,2025-02-02 22:35:00,14
30349,ORD_30350,25641,Man - Green Eau De Toilette Deodorant,Warehouse B,59,40,2025-02-02 18:09:00,19
30350,ORD_30351,16506,Macorate 600 Tablet,Warehouse C,49,39,2025-02-02 14:34:00,10
30351,ORD_30352,21696,"Samsung Original Wireless Charger Duo Pad for Cellular Phones (15W, Black)",Warehouse C,72,57,2025-02-02 09:49:00,15
30352,ORD_30353,24117,Superdrug Vitamin C Orange Peel Jam 75 ml,Warehouse A,64,52,2025-02-02 19:35:00,12
30353,ORD_30354,24938,Spigen TPU Essential Sand Blast Back Cover Case Compatible For Samsung Galaxy M13 4G (Matte Black),Warehouse B,75,56,2025-02-02 20:36:00,19
30354,ORD_30355,2699,"Make Up Combo Kit For Girls & Women, 1Makeup Fixer, 1 Primer, 2 In 1 Concealer And Highlighter Stick, 1 High Definition Fo...",Warehouse C,28,10,2025-02-02 09:27:00,18
30355,ORD_30356,21872,"iPhone Original 20W Charger Type C Adapter for iPhone 14/ 14 Plus/ 14 Pro/ 14 Pro Max, iPhone 13/13 Pro/13 Pro Max/13 Min...",Warehouse A,31,22,2025-02-02 22:34:00,9
30356,ORD_30357,33247,"SupCares Edge to Edge Anti Glare Matte Tempered Glass for iPhone 14, iPhone 13 and iPhone 13 Pro (6.1 Inch) with Easy Self...",Warehouse A,28,21,2025-02-02 19:27:00,7
30357,ORD_30358,8602,Gold Glowing skin Face Scrub,Warehouse B,106,88,2025-02-02 00:51:00,18
30358,ORD_30359,11881,Mothercare Smart Narrow Neck Bottle - Pink 150 ml,Warehouse C,66,48,2025-02-02 01:50:00,18
30359,ORD_30360,6631,Portronics My Buddy+ Portable Foldable Laptop Table with Cooling Fan(Black),Warehouse C,35,17,2025-02-02 20:09:00,18
30360,ORD_30361,11168,MANCODE Caffeine Scrub 100 gm,Warehouse C,9,2,2025-02-02 17:26:00,7
30361,ORD_30362,10750,Surezone-SB Injection,Warehouse A,37,30,2025-02-02 20:26:00,7
30362,ORD_30363,7233,Papayablem Papaya-N-Saffron Anti-Blemish Creme,Warehouse C,59,45,2025-02-02 01:45:00,14
30363,ORD_30364,8656,Oil Free Face Moisturizer,Warehouse B,50,32,2025-02-02 09:17:00,18
30364,ORD_30365,30431,Fucid 20mg Capsule,Warehouse B,9,3,2025-02-02 20:20:00,6
30365,ORD_30366,11517,Calamine Pack - Anti-Acne,Warehouse C,68,51,2025-02-02 10:08:00,17
30366,ORD_30367,21118,Ibikof LS Plus Syrup,Warehouse B,49,37,2025-02-02 03:25:00,12
30367,ORD_30368,11240,Dava Derm Cream,Warehouse C,11,2,2025-02-02 12:35:00,9
30368,ORD_30369,2692,"Oppo Enco Air 2 Pro Bluetooth Truly Wireless in Ear Earbuds with Mic, Fast Charging & Up to 28Hrs - Grey",Warehouse C,83,76,2025-02-02 22:09:00,7
30369,ORD_30370,33265,Casio SX-100-W Portable Calculator with Foldable Design,Warehouse C,31,21,2025-02-02 10:40:00,10
30370,ORD_30371,3181,Passion Indulge CLEANSER-PEARL LIGHT 100 ml,Warehouse B,67,56,2025-02-02 09:46:00,11
30371,ORD_30372,7224,BB Fairness Cream,Warehouse C,43,38,2025-02-02 20:51:00,5
30372,ORD_30373,34425,Terflox TZ 200mg/600mg Tablet,Warehouse B,35,25,2025-02-02 11:35:00,10
30373,ORD_30374,32239,"Kreo Halo 12 Inch Selfie Ring Light with Tripod Stand | Portable, 3 Modes, Youtube Ready | Dimmable and Bright Lighting fo...",Warehouse B,84,78,2025-02-02 04:53:00,6
30374,ORD_30375,2548,Avecid OS Syrup,Warehouse C,35,19,2025-02-02 05:45:00,16
30375,ORD_30376,1533,Ajmal Musk Rose Concentrated Perfume Oil Floral Musky Alcohol-free Attar 12ml for Unisex and Maryaj Blaze Eau De Parfum Ci...,Warehouse C,51,33,2025-02-02 07:40:00,18
30376,ORD_30377,11226,"COLAB Dry Shampoo Instant Hair Refresh Without White Residue, Original 50ml | Paraben Free, Vegan & Cruelty Free Dry Shampoo",Warehouse B,44,30,2025-02-02 06:54:00,14
30377,ORD_30378,17389,Robustrion Case Cover for Xiaomi Mi Pad 5 11 inch Smart Deer Pattern Flip Stand Xiaomi Pad 5 Cover - Vine Red,Warehouse C,94,75,2025-02-02 12:40:00,19
30378,ORD_30379,25643,Oflabin 100mg Tablet DT,Warehouse C,96,82,2025-02-02 03:58:00,14
30379,ORD_30380,33893,Logitech H151 Wired On Ear Headphones With Mic (Black),Warehouse C,75,61,2025-02-02 07:38:00,14
30380,ORD_30381,32958,Glix-M Tablet,Warehouse B,118,99,2025-02-02 18:08:00,19
30381,ORD_30382,15589,Closide 100mg/4mg Tablet,Warehouse C,50,32,2025-02-02 13:04:00,18
30382,ORD_30383,6398,Oirgametril 5mg Tablet,Warehouse C,103,84,2025-02-02 17:54:00,19
30383,ORD_30384,16798,Miss Claire Charcoal Nose Strip 6'S,Warehouse C,47,30,2025-02-02 20:38:00,17
30384,ORD_30385,11860,Divon 25mg Injection,Warehouse B,52,39,2025-02-02 22:11:00,13
30385,ORD_30386,15900,"Justec 45W Replacement Charger for MacBook Air 11"" & 13"" - A1435, A1436, A1465, A1466 - T Shape",Warehouse A,89,81,2025-02-02 18:18:00,8
30386,ORD_30387,15226,Allure Angular Makeup Brush (c-21 ) 1's,Warehouse B,38,23,2025-02-02 15:11:00,15
30387,ORD_30388,11609,Dompra 10mg/20mg Tablet,Warehouse B,82,67,2025-02-02 15:51:00,15
30388,ORD_30389,3100,Color Naturals Creme Riche Ultra Hair Color - Golden Brown,Warehouse A,101,96,2025-02-02 23:57:00,5
30389,ORD_30390,24914,Adp 10 Tablet,Warehouse B,45,33,2025-02-02 21:38:00,12
30390,ORD_30391,16508,Cefrosen 1000mg Injection,Warehouse B,63,45,2025-02-02 15:27:00,18
30391,ORD_30392,32378,Quinobid 400mg Tablet,Warehouse B,38,33,2025-02-02 13:23:00,5
30392,ORD_30393,2672,"HDMI Extender,HDMI to RJ45 Network Cable Extender Converter Repeater Over cat 5e / 6 1080p up to 30m Extender for HDTV PS4...",Warehouse B,79,73,2025-02-02 12:58:00,6
30393,ORD_30394,32588,Xylocaine 5% Injection,Warehouse B,54,44,2025-02-02 07:50:00,10
30394,ORD_30395,16657,"Store2508 Model-P4 6-Way Swivel Tilt TV Wall Mount for LCD/LED TV's from 32"" to 55"" Inch",Warehouse A,96,91,2025-02-02 20:33:00,5
30395,ORD_30396,10724,"ZEBRONICS DC Black ADAM Edition Rocket 500 Bluetooth 5.0 Portable Speaker 20W RMS, TWS, 10 Hour Backup, Built-in Rechargea...",Warehouse C,78,71,2025-02-02 12:31:00,7
30396,ORD_30397,30398,Ajmal Diza EDP Fruity Floral Perfume And Blu Homme Deodorant Aquatic Woody Fragrance 300 ml,Warehouse A,37,31,2025-02-02 18:35:00,6
30397,ORD_30398,25652,Plum Grape Seed & Sea Buckthorn LightStay Day Cream - SPF 30 PA++ 60 ml,Warehouse C,19,14,2025-02-02 04:21:00,5
30398,ORD_30399,2562,Giloy Neem Juice With Tulsi,Warehouse A,23,10,2025-02-02 01:51:00,13
30399,ORD_30400,33400,Dolcet-M Kid Tablet,Warehouse A,30,12,2025-02-02 15:24:00,18
30400,ORD_30401,24480,Mefigic-P Oral Suspension,Warehouse A,66,48,2025-02-02 08:10:00,18
30401,ORD_30402,11228,Atulya Sandalwood Essential Oil 15 ml,Warehouse C,82,69,2025-02-02 03:21:00,13
30402,ORD_30403,10720,Flormar Compact Powder 090 Medium Rose 11 gm,Warehouse B,69,58,2025-02-02 22:02:00,11
30403,ORD_30404,30367,Acitreat-D Tablet,Warehouse B,58,44,2025-02-02 05:35:00,14
30404,ORD_30405,10707,Coconut Oil - Virgin,Warehouse B,107,99,2025-02-02 11:53:00,8
30405,ORD_30406,20556,"SYSKA Power Bank 10000mah | 6 Months Warranty | PL100J, 3-in-1 Led Light for Camping and Travel, Upto 40 Hours Working Per...",Warehouse C,78,70,2025-02-02 18:33:00,8
30406,ORD_30407,36174,Depten AZ 0.25mg/20mg Tablet,Warehouse A,78,64,2025-02-02 22:12:00,14
30407,ORD_30408,26473,Pacimol MF 50mg/125mg Oral Suspension,Warehouse B,107,96,2025-02-02 02:53:00,11
30408,ORD_30409,9107,Torib-MR Tablet,Warehouse C,95,90,2025-02-02 03:04:00,5
30409,ORD_30410,6274,"RIXTEC Set of 10 Natural Body Loofah for Bathing | Organic Loofah with strep | Shower Sponge for Women, Men and Kids",Warehouse B,47,32,2025-02-02 18:18:00,15
30410,ORD_30411,35296,Paridol-AC Tablet,Warehouse B,78,64,2025-02-02 19:00:00,14
30411,ORD_30412,15058,"SanDisk Extreme Pro microSD UHS I Card 128GB for 4K Video on Smartphones,Action Cams,Drones 200MB/s Read, 90MB/s Write",Warehouse C,32,14,2025-02-02 09:32:00,18
30412,ORD_30413,30079,"Zebronics ZEB-JUKE BAR 9700 PRO DOLBY ATMOS Bluetooth Home Theater Soundbar With Subwoofer Supporting 4K HDR, Wall Mount, ...",Warehouse B,73,65,2025-02-02 18:18:00,8
30413,ORD_30414,25798,"LAKMÉ Sun Expert Ultra Powder Matte SPF 40 PA+++ Compact, 7g",Warehouse A,72,58,2025-02-02 01:02:00,14
30414,ORD_30415,15025,Bourbon Spice - Hair & Beard Conditioner 250 ml,Warehouse A,15,1,2025-02-02 16:42:00,14
30415,ORD_30416,3966,Bio Bhringraj Oil 800 Ml,Warehouse A,20,8,2025-02-02 15:22:00,12
30416,ORD_30417,18200,NHT 1020 Cordless Trimmer For Men - Black,Warehouse C,102,96,2025-02-02 08:18:00,6
30417,ORD_30418,20907,Alzol 200mg Oral Suspension,Warehouse C,15,8,2025-02-02 08:09:00,7
30418,ORD_30419,6226,Eluga 10mg Tablet,Warehouse B,31,20,2025-02-02 19:34:00,11
30419,ORD_30420,30000,MK Combo of Suruchi Round Bindi (Size 2) Classy Maroon 6 Packets & 6 Packets of Diamond Bindi/Tikali/Tikli For Women/Girls...,Warehouse A,30,24,2025-02-02 12:55:00,6
30420,ORD_30421,29343,Bio Walnut - Purifying & Polishing Scrub For All Skin Types,Warehouse A,32,18,2025-02-02 01:07:00,14
30421,ORD_30422,1098,Mefella-D Tablet,Warehouse B,82,63,2025-02-02 05:13:00,19
30422,ORD_30423,8265,Gatiquin OZ 400 mg/1000 mg Kit,Warehouse B,38,27,2025-02-02 03:01:00,11
30423,ORD_30424,7337,Urbane Noir Perfume Spray,Warehouse A,59,48,2025-02-02 11:05:00,11
30424,ORD_30425,18429,Zithromin 250mg Tablet,Warehouse A,56,39,2025-02-02 20:21:00,17
30425,ORD_30426,20966,Dromitin 40mg Injection,Warehouse C,110,94,2025-02-02 14:08:00,16
30426,ORD_30427,29560,Moxonix 0.3 Tablet,Warehouse A,64,54,2025-02-02 04:56:00,10
30427,ORD_30428,18333,boAt Bassheads 220 Wired in Ear Earphones(Indi Lime),Warehouse C,86,70,2025-02-02 01:05:00,16
30428,ORD_30429,8214,"3M Command, Small Clear Wire Wall Hooks, Up to 225gms, Holds Strongly, Reusable, Adhesive hooks for wall, Multi-surface da...",Warehouse A,80,72,2025-02-02 15:55:00,8
30429,ORD_30430,22428,"MARS Trend Setting Ultra Fine Matte Loose Powder Compact (Banana+Matte translucent, 24 g)",Warehouse B,85,73,2025-02-02 06:45:00,12
30430,ORD_30431,1371,Nortrip 50mg Tablet,Warehouse B,51,33,2025-02-02 12:17:00,18
30431,ORD_30432,35250,Woman - Green Eau De Toilette Deodorant,Warehouse B,21,13,2025-02-02 18:57:00,8
30432,ORD_30433,10356,Novosiz 5mg Tablet,Warehouse B,33,19,2025-02-02 00:58:00,14
30433,ORD_30434,35263,Berina A35 Golden Green Blonde Hair Color Cream 60 gm,Warehouse B,59,40,2025-02-02 13:19:00,19
30434,ORD_30435,4341,Nokia 125 TA-1253 DS in Black,Warehouse C,52,41,2025-02-02 04:38:00,11
30435,ORD_30436,34695,Olabest 5mg Tablet,Warehouse A,96,87,2025-02-02 09:37:00,9
30436,ORD_30437,34700,Clincin V 100mg/100mg Tablet VT,Warehouse B,25,18,2025-02-02 04:54:00,7
30437,ORD_30438,6192,Ufibate S Lotion,Warehouse B,81,71,2025-02-02 00:38:00,10
30438,ORD_30439,18424,Vofex-OL Tablet,Warehouse C,41,23,2025-02-02 23:09:00,18
30439,ORD_30440,22308,"ZEBRONICS Zeb-Reaper 2.4GHz Wireless Gaming Mouse with USB Nano Receiver, 500Hz Polling Rate, 4000 DPI, 7 Buttons with Rap...",Warehouse B,36,23,2025-02-02 04:16:00,13
30440,ORD_30441,14671,"iPhone Original 20W PD Charger Compatible with i-Phone 13,12,11,X,8 Series | Pd Charger Adapter with Cable for i-Phone 13/...",Warehouse B,98,86,2025-02-02 16:29:00,12
30441,ORD_30442,29500,Instacef 200mg Tablet DT,Warehouse C,25,7,2025-02-02 08:37:00,18
30442,ORD_30443,6181,Ceftramax 500mg Injection,Warehouse C,14,8,2025-02-02 07:50:00,6
30443,ORD_30444,29437,Zymase DP 50mg/325mg/10mg Tablet,Warehouse C,77,60,2025-02-02 03:24:00,17
30444,ORD_30445,35146,Zacort 6mg Tablet,Warehouse C,43,28,2025-02-02 16:01:00,15
30445,ORD_30446,4231,Mecona Plus Injection,Warehouse A,39,25,2025-02-02 07:08:00,14
30446,ORD_30447,1327,Onmol-N Tablet,Warehouse B,70,54,2025-02-02 12:21:00,16
30447,ORD_30448,29430,Tegaser 6mg Tablet,Warehouse A,14,3,2025-02-02 22:33:00,11
30448,ORD_30449,34788,Brustro Artists Colour Pencil Set of 72 (in an Elegant tin Box),Warehouse C,60,54,2025-02-02 12:25:00,6
30449,ORD_30450,29996,Bennett™ Mystic Formal Business Briefcase Bag Crossbody Messenger College Bags For Men Women MacBook INoteBook ITablet Lap...,Warehouse A,88,77,2025-02-02 02:54:00,11
30450,ORD_30451,26080,Urbn 20W Type C PD Adapter | Dual Port Super Fast Charger | Quick Charge 3.0 & Power Delivery 3.0 | for iPhone 13/13Pro/13...,Warehouse B,64,48,2025-02-02 06:18:00,16
30451,ORD_30452,4222,Medfix LB 200mg Capsule,Warehouse B,57,48,2025-02-02 08:18:00,9
30452,ORD_30453,30022,Ajmal Selfie Concentrated Perfume Oil Woody Aromatic And Avid Homme Deodorant Aquatic Woody Fragrance 210 ml,Warehouse B,24,12,2025-02-02 17:41:00,12
30453,ORD_30454,10458,Gemblue Biocare Diamond Face and Body cream 500 ml,Warehouse B,44,25,2025-02-02 13:47:00,19
30454,ORD_30455,3962,"Nokia 105 Dual SIM, Keypad Mobile Phone with Wireless FM Radio | Charcoal",Warehouse B,102,88,2025-02-02 09:41:00,14
30455,ORD_30456,34717,MARS Artist's arsenal eyeshadow palette (EP40-01),Warehouse A,76,58,2025-02-02 15:59:00,18
30456,ORD_30457,34714,Vega Pocket Wooden Comb (HMWC - 07) 30 gm,Warehouse B,27,16,2025-02-02 23:21:00,11
30457,ORD_30458,30030,TheGiftKart Sleek Back Cover Case for Samsung Galaxy S23 Ultra 5G | Slim Fit Protective Design | Ultra Matte Finish | Came...,Warehouse A,73,55,2025-02-02 22:39:00,18
30458,ORD_30459,34847,De-Tan 3 In 1 Face Cream,Warehouse C,17,4,2025-02-02 09:17:00,13
30459,ORD_30460,34704,"Logitech M331 Silent Plus Wireless Mouse, 2.4GHz with USB Nano Receiver, 1000 DPI Optical Tracking, 3 Buttons, 24 Month Li...",Warehouse B,18,6,2025-02-02 02:45:00,12
30460,ORD_30461,20975,Miss Claire Fake It Ultimate Cover Concealer - 1,Warehouse B,29,23,2025-02-02 03:45:00,6
30461,ORD_30462,34703,"Fashion Colour Cover Up Liquid Concealer, Shade 07 11 gm",Warehouse B,47,35,2025-02-02 20:51:00,12
30462,ORD_30463,25806,Auxen D 500mg/10mg Tablet,Warehouse A,98,81,2025-02-02 02:20:00,17
30463,ORD_30464,4350,Orkay PISTA MILK SHAKE,Warehouse C,19,3,2025-02-02 05:38:00,16
30464,ORD_30465,20861,Vaadi Herbals Oil-Control Moisturiser - Tulip with Green Almond Extract 60 ml,Warehouse C,81,65,2025-02-02 01:06:00,16
30465,ORD_30466,14612,Eyetex Pallavi Sindoor Liquid - Light Maroon 1's,Warehouse C,70,53,2025-02-02 10:29:00,17
30466,ORD_30467,25932,Alpred 8mg Tablet,Warehouse A,51,38,2025-02-02 20:14:00,13
30467,ORD_30468,29564,Stbotanica Vitamin C Brightening Foaming Face Wash With Built In Brush 120 ml,Warehouse C,74,64,2025-02-02 05:42:00,10
30468,ORD_30469,7411,"Redmi SonicBass Wireless In Ear Earphones with Mic Noise Cancellation, IPX4 Splash & Sweat Proof, Multi-Point Dual Pairin...",Warehouse C,28,10,2025-02-02 01:21:00,18
30469,ORD_30470,29940,"Peiroks Type C to 3.5 mm Jack Audio Connector, Noise Cancelling Headphones Jack Converter Audio Adapter for OnePlus Nord /...",Warehouse B,64,51,2025-02-02 01:48:00,13
30470,ORD_30471,7959,"Authentic Store Plastic Crocodile Hair Clips for Women, 12 Pieces",Warehouse C,47,31,2025-02-02 03:44:00,16
30471,ORD_30472,220,Pidilite Fevicol 200 Gram Craft Glue Ultimate Adhesive for Student’s Project Work & Serious Crafters (FMR803120100000),Warehouse C,70,58,2025-02-02 00:11:00,12
30472,ORD_30473,27476,Akuflex SP 100 mg/325 mg/15 mg Tablet,Warehouse B,105,87,2025-02-02 03:09:00,18
30473,ORD_30474,9362,Aloe Veda Luxury Shower Gel - Cedarwood 300 ml,Warehouse B,43,36,2025-02-02 20:04:00,7
30474,ORD_30475,19809,Pregnisafe 10mg/10mg Tablet,Warehouse A,71,54,2025-02-02 00:15:00,17
30475,ORD_30476,27510,Medimade Pink Rose Clay Face Mask 250 gm,Warehouse C,92,79,2025-02-02 06:11:00,13
30476,ORD_30477,36694,Under Eye Gel For Men,Warehouse C,25,20,2025-02-02 20:42:00,5
30477,ORD_30478,23168,Nandika Beauty Moisturising Cold Cream 100 gm,Warehouse A,27,20,2025-02-02 05:47:00,7
30478,ORD_30479,22822,"Panty Liners Soft - Comfort Classic, Individually Packed",Warehouse A,111,95,2025-02-02 12:54:00,16
30479,ORD_30480,23172,Dexicate 500mg Tablet,Warehouse B,72,53,2025-02-02 09:27:00,19
30480,ORD_30481,27517,"GM 3060 E-Book 4 + 1 Power Strip 240 Volts with Master Switch, Indicator, Safety Shutter & 4 International sockets, Red & ...",Warehouse B,27,12,2025-02-02 13:19:00,15
30481,ORD_30482,27532,Neuroscan 800 Tablet,Warehouse B,36,20,2025-02-02 14:56:00,16
30482,ORD_30483,19803,"Vitamin C, E & Hyaluronic Acid Brightening Night Cream With Argan Oil",Warehouse A,39,24,2025-02-02 13:51:00,15
30483,ORD_30484,26773,"Ajmal 1 Wisal Dhahab, 1 Wisal, 1 Nightingale And 1 Distraction Deodorants Pack of 4 200 ml",Warehouse A,80,63,2025-02-02 23:15:00,17
30484,ORD_30485,252,Physicians Formula Shimmer Strips Extreme Shimmer Shadow & Liner - Bronze Eyes 3.4 gm,Warehouse A,71,64,2025-02-02 14:41:00,7
30485,ORD_30486,9668,"EarthenPot, Epsom Salt granule for Foot Bath Body Relax Muscle Relieves Aches Pain 1kg, 1000 gram",Warehouse C,83,77,2025-02-02 12:10:00,6
30486,ORD_30487,27545,"Casio CBC600 Carry Case, Black",Warehouse C,102,90,2025-02-02 23:54:00,12
30487,ORD_30488,13702,Kohinoor Red Bindi For Women (Size-4),Warehouse C,47,33,2025-02-02 07:43:00,14
30488,ORD_30489,9666,GUTON 25MG TABLET,Warehouse A,58,50,2025-02-02 05:54:00,8
30489,ORD_30490,27575,"Portronics Power 45 20000mAh Power Bank for Laptop/Mobile with 45W Fast Charging, Dual Input(Type C + Micro USB) & Triple ...",Warehouse C,84,77,2025-02-02 10:24:00,7
30490,ORD_30491,19636,"Lowfe Upgraded T55 / T500 Watch Cable, Watch Holder Magnetic 2 pin Cable, Watch Charging Cable, T55, T500 Charger 4mm Adap...",Warehouse C,60,44,2025-02-02 18:38:00,16
30491,ORD_30492,27706,"Bella Vita Luxury DOMINUS MAN Eau De Parfum for Men with Sandalwood, Vanilla Cedar | Strong & Long Lasting Perfume for Men...",Warehouse B,91,84,2025-02-02 12:07:00,7
30492,ORD_30493,18665,"TheGiftKart Back Cover for Redmi Note 10 Lite/Note 9 Pro/Pro Max/Poco M2 Pro (TPU, PC | Transparent)",Warehouse B,40,30,2025-02-02 12:55:00,10
30493,ORD_30494,9809,Cytox 1000mg Injection,Warehouse B,36,29,2025-02-02 04:26:00,7
30494,ORD_30495,20446,"ZEBRONICS Zeb- Haze 2.4GHz Wireless Mouse with up to 1200 DPI, Power Saving Mode, Nano Receiver and Plug & Play Usage - Blue",Warehouse C,98,81,2025-02-02 07:20:00,17
30495,ORD_30496,27908,"POPIO Tempered Glass Compatible for iPhone 14 Plus (Transparent) Edge to Edge Full Screen Coverage with Installation Kit, ...",Warehouse A,97,92,2025-02-02 05:43:00,5
30496,ORD_30497,13858,Fashionury Back Cover for Samsung Galaxy M21/ Samsung M30s (Silicone|Brown),Warehouse C,29,15,2025-02-02 14:18:00,14
30497,ORD_30498,36737,Ernie Ball Nickel Wound Electric Guitar Strings,Warehouse A,65,50,2025-02-02 22:47:00,15
30498,ORD_30499,27685,Zeodent Dental Gel,Warehouse C,110,98,2025-02-02 17:10:00,12
30499,ORD_30500,1084,Brainox 200mg Injection,Warehouse A,104,91,2025-02-02 11:06:00,13
30500,ORD_30501,19697,rts RFID Blocking Credit Card Holder Credit/Debit/ATM/Business Visiting Name Wallet ID Protector Case PU Leather Steel for...,Warehouse B,52,46,2025-02-02 17:14:00,6
30501,ORD_30502,29316,Cobafem Plus Injection,Warehouse A,61,46,2025-02-02 17:18:00,15
30502,ORD_30503,18551,Edycet 5mg Tablet,Warehouse A,103,89,2025-02-02 08:34:00,14
30503,ORD_30504,29588,Atortin 10mg Tablet,Warehouse A,94,81,2025-02-02 18:21:00,13
30504,ORD_30505,16584,Linospan 200mg Infusion,Warehouse A,12,4,2025-02-02 12:29:00,8
30505,ORD_30506,13722,"JGD PRODUCTS USB 2.0 A to 5 pin Mini USB B Cable for External HDDS/Camera/Card Readers, etc (100 CM)",Warehouse C,12,6,2025-02-02 18:21:00,6
30506,ORD_30507,36574,Madrox 125mg Tablet,Warehouse C,27,13,2025-02-02 16:54:00,14
30507,ORD_30508,5297,"Fashion Colour Satin Smooth Lip Definer, 9 Rose Bud 1.41 gm",Warehouse B,22,16,2025-02-02 19:13:00,6
30508,ORD_30509,19708,Anabel Liquid Gel,Warehouse A,112,99,2025-02-02 07:19:00,13
30509,ORD_30510,26726,Cemax Syrup,Warehouse A,27,20,2025-02-02 19:52:00,7
30510,ORD_30511,22797,"Faber-Castell Paint Brush Set - Round, Pack of 4 (Navy Blue)",Warehouse B,73,54,2025-02-02 23:47:00,19
30511,ORD_30512,13733,Snigdha Skin Whitening Night Cream,Warehouse C,30,15,2025-02-02 14:13:00,15
30512,ORD_30513,5284,"GIZGA essentials Extended Gaming Mouse Pad, Laptop Desk Mat, Computer Mouse Pad with Smooth Mouse Control, Mercerized Surf...",Warehouse B,83,75,2025-02-02 04:42:00,8
30513,ORD_30514,13714,Torcob 90mg Tablet,Warehouse A,111,92,2025-02-02 01:39:00,19
30514,ORD_30515,5282,"POPIO Flexible PET Screen Guard Protector Compatible for Apple Watch Series 4, Series 5, Series 6 (Black), Pack of 1, 44mm",Warehouse C,14,1,2025-02-02 16:58:00,13
30515,ORD_30516,27630,EASYSHOP USB Type C USB 3.1 Type C Female to USB 3.0 Male Adapter Connector Converte USB3.1 Type-c Adapter (Compatible wit...,Warehouse A,39,34,2025-02-02 11:16:00,5
30516,ORD_30517,19694,"OREI USA Travel Adapter, Japan, Philippines Canada Travel Plug, India to USA Converter Plug - 2 in 1 Type B - Perfect for ...",Warehouse A,14,3,2025-02-02 15:55:00,11
30517,ORD_30518,9698,Kazkuff LS Syrup,Warehouse B,11,6,2025-02-02 08:09:00,5
30518,ORD_30519,27647,Water Resistant SPF 60 Sun Screen Gel Creme,Warehouse C,79,69,2025-02-02 10:02:00,10
30519,ORD_30520,7973,Woman - Urban Musk Body Mist,Warehouse B,98,92,2025-02-02 17:36:00,6
30520,ORD_30521,7727,Rife Single Monitor Wall Mount Arm | VESA Wall Mount Monitor Arm | Full Motion Gas Spring Arm Fits 17 to 32 Inch Screens w...,Warehouse C,54,44,2025-02-02 04:55:00,10
30521,ORD_30522,19664,Dare Deodorant Spray - Men,Warehouse C,101,86,2025-02-02 01:22:00,15
30522,ORD_30523,5781,Interdental Brush With Ultra Soft Bristles,Warehouse C,32,23,2025-02-02 15:46:00,9
30523,ORD_30524,36513,"Shot Body Spray - Maxx, Rage",Warehouse C,106,93,2025-02-02 03:56:00,13
30524,ORD_30525,326,Sentosa 37.5mg Tablet ER,Warehouse C,21,12,2025-02-02 13:12:00,9
30525,ORD_30526,23247,"ClubBeauty Makeup Brush Set- Pink, 7 Piece",Warehouse C,63,55,2025-02-02 16:57:00,8
30526,ORD_30527,36595,FYM Permanent makeup tattoo 3R needle cartridge for eyebrow(10pc),Warehouse C,56,37,2025-02-02 12:28:00,19
30527,ORD_30528,18489,DeBelle Gel Nail Lacquer Luxe Noir Black Nail Polish 8 ml,Warehouse B,23,17,2025-02-02 13:13:00,6
30528,ORD_30529,7395,Faces Canada Longstay Liquid Matte Lipstick Sunset Coral 12 6 Ml,Warehouse C,46,36,2025-02-02 05:07:00,10
30529,ORD_30530,36362,Revlon Colorstay Brow Pencil - Soft Black 0.35 Gm,Warehouse A,86,78,2025-02-02 04:35:00,8
30530,ORD_30531,15080,Spantra Methi Seed Conditioner 300 ml,Warehouse B,33,27,2025-02-02 20:15:00,6
30531,ORD_30532,20900,Remdrox LB 500mg Capsule,Warehouse B,28,23,2025-02-02 17:57:00,5
30532,ORD_30533,29759,Sepsadone OZ Ointment,Warehouse A,54,45,2025-02-02 19:18:00,9
30533,ORD_30534,30194,"Shower Sponge - Pink & White, Colour May Vary",Warehouse B,104,94,2025-02-02 20:13:00,10
30534,ORD_30535,18631,Prednolone 5mg Tablet,Warehouse C,87,81,2025-02-02 06:39:00,6
30535,ORD_30536,14511,Winble Bumper Case for OnePlus Nord 2 5G (Silicone | Grey),Warehouse C,87,69,2025-02-02 01:19:00,18
30536,ORD_30537,24016,"Miss Claire Natural Mineral Compact Powder, 23 Brown, 7 g",Warehouse A,59,51,2025-02-02 04:26:00,8
30537,ORD_30538,18382,D-Tan Cleanser,Warehouse C,48,39,2025-02-02 02:40:00,9
30538,ORD_30539,24023,"Pain-X Body Pain Relief Gel For Muscle, Joints, Knee, Neck & Back Pain",Warehouse B,20,9,2025-02-02 23:51:00,11
30539,ORD_30540,4169,Ajmal Diza EDP Fruity Floral Perfume And Aurum Concentrated Perfume Oil Fruity Floral 110 ml,Warehouse A,29,18,2025-02-02 19:38:00,11
30540,ORD_30541,35378,CASE PLUS 3.5 mm Headphone Jack Lightning Adapter Connector Only Supported Music Control Audio Adapter for iPhone-New - 20...,Warehouse B,57,45,2025-02-02 08:07:00,12
30541,ORD_30542,29219,VITRO I AM NATURAL Aloe Jojoba shampoo (Pack Of 3) 750 ml,Warehouse C,56,44,2025-02-02 21:20:00,12
30542,ORD_30543,18580,Disogel Suspension Cardamom,Warehouse B,96,77,2025-02-02 02:43:00,19
30543,ORD_30544,1258,"TP-Link AC750 Wifi Range Extender | Up to 750Mbps | Dual Band WiFi Extender, Repeater, Wifi Signal Booster, Access Point| ...",Warehouse B,46,33,2025-02-02 23:52:00,13
30544,ORD_30545,12418,Aziviz 250 Tablet,Warehouse B,97,90,2025-02-02 15:27:00,7
30545,ORD_30546,21050,"HP M24f 23.8-Inch(60.47cm) Eye Safe Certified Full HD 1920 x 1080 Pixels IPS 3-Sided Micro-Edge LED Monitor, 75Hz, AMD Fre...",Warehouse B,19,6,2025-02-02 20:17:00,13
30546,ORD_30547,34991,Liquid Face Wash,Warehouse C,67,49,2025-02-02 23:32:00,18
30547,ORD_30548,14853,"Tecno Ace-A3 | 30 Hours Standby Time | Bluetooth Truly Wireless in Ear Earbuds BT 5.0 | Light Weight | Splash Proof, with ...",Warehouse A,73,61,2025-02-02 12:26:00,12
30548,ORD_30549,7364,Nikidac 50mg Injection,Warehouse A,63,48,2025-02-02 22:15:00,15
30549,ORD_30550,14851,"Man-In-Charge - Aqua Blue, Eau De Parfum",Warehouse A,100,84,2025-02-02 04:28:00,16
30550,ORD_30551,18612,"Sounce AirPods Pro Case, Soft Silicone Skin Case Cover Shock-Absorbing Protective Case with Keychain Compatible with AirPo...",Warehouse A,32,19,2025-02-02 05:31:00,13
30551,ORD_30552,35413,"ZEBRONICS Zeb-DUKE1 Bluetooth 5.0 Wireless Over Ear Headphones With Mic, with AUX Port, Call Function, Voice Assistant Sup...",Warehouse A,104,87,2025-02-02 06:51:00,17
30552,ORD_30553,25757,SERY Melt up Makeup Remover 100 ml,Warehouse A,84,73,2025-02-02 20:28:00,11
30553,ORD_30554,18643,Leather Shave Cream - Fresh Lime,Warehouse C,55,36,2025-02-02 07:17:00,19
30554,ORD_30555,29259,Rabifiz 20mg Tablet,Warehouse C,47,29,2025-02-02 05:33:00,18
30555,ORD_30556,20991,Quench Botanics Mama Cica Dark Spot Correcting Ampoule 30 ml,Warehouse C,25,16,2025-02-02 12:23:00,9
30556,ORD_30557,3906,Skin Purifying & Radiant Glow Brightening Scrub - With Mandarin & Green Tea,Warehouse A,73,60,2025-02-02 01:47:00,13
30557,ORD_30558,25736,Original 25W Charger Super Fast Charger for Samsung M51/M42/F23 5G/M53 5G/M52 5G/M33|Type C to C | Travelling Charger (Ada...,Warehouse A,81,73,2025-02-02 12:30:00,8
30558,ORD_30559,8030,Sivanna Colors Drawing Natural Automatic Eyebrow Natural Brown - ES8007 02 03 gm,Warehouse C,83,72,2025-02-02 21:17:00,11
30559,ORD_30560,29123,Medgim 100mg Dry Syrup,Warehouse B,56,39,2025-02-02 10:00:00,17
30560,ORD_30561,22511,Infanim 100mg Tablet,Warehouse B,45,30,2025-02-02 09:59:00,15
30561,ORD_30562,29728,Vega Hot Curl Brush (Large) (H1 - PRL) 208 gm,Warehouse B,62,45,2025-02-02 04:31:00,17
30562,ORD_30563,8291,PRO365® Indo 12MM Luxury White Laptop Table/Lapdesk 3D Design/6 Months Warranty/Tablet Stand/Cup Holder/Foldable/Round Edges,Warehouse A,95,85,2025-02-02 08:20:00,10
30563,ORD_30564,34934,Sivanna Colors In The Peach Pro Cheek - HF6038 04 10 gm,Warehouse B,91,78,2025-02-02 11:43:00,13
30564,ORD_30565,15068,Monticope Suspension,Warehouse C,66,48,2025-02-02 11:17:00,18
30565,ORD_30566,29624,Nicoline 10mg Tablet,Warehouse A,74,60,2025-02-02 14:15:00,14
30566,ORD_30567,1400,Junior Traiminic Syrup,Warehouse C,28,14,2025-02-02 06:31:00,14
30567,ORD_30568,10331,Sinam 100mg Injection,Warehouse C,47,31,2025-02-02 02:02:00,16
30568,ORD_30569,34920,Bio Pista Facepack 175 Gm,Warehouse B,103,90,2025-02-02 08:51:00,13
30569,ORD_30570,4186,Oflonova 50mg Suspension,Warehouse B,39,28,2025-02-02 12:42:00,11
30570,ORD_30571,10329,Javakusum Hair Oil,Warehouse C,71,57,2025-02-02 00:54:00,14
30571,ORD_30572,18346,Samsung EVO Plus 256GB microSDXC UHS-I U3 130MB/s Full HD & 4K UHD Memory Card with Adapter (MB-MC256KA),Warehouse A,100,85,2025-02-02 03:28:00,15
30572,ORD_30573,9125,Merisulide Plus Tablet,Warehouse C,43,38,2025-02-02 05:24:00,5
30573,ORD_30574,7342,Nosotron 8 Tablet MD,Warehouse B,66,59,2025-02-02 15:57:00,7
30574,ORD_30575,14833,mCaffeine Cellulite & Stretch Mark Reduction Duo 200 gm,Warehouse A,94,83,2025-02-02 03:39:00,11
30575,ORD_30576,12430,Enriched Coconut Hair Oil - With 7 Ayurvedic Herbs,Warehouse C,18,1,2025-02-02 00:28:00,17
30576,ORD_30577,15071,Oblivion LCD Writing Pad/Tablet 8.5 inches | Electronic Writing Scribble Board for Kids |Kids Learning Toy |for Home/Schoo...,Warehouse C,33,18,2025-02-02 22:48:00,15
30577,ORD_30578,29761,Ikonic Paddle Brush - Small Black 89 ml,Warehouse C,70,61,2025-02-02 10:27:00,9
30578,ORD_30579,34670,Clen B Cream,Warehouse C,102,84,2025-02-02 19:02:00,18
30579,ORD_30580,29768,Renor TI 400 mg/600 mg Tablet,Warehouse B,59,51,2025-02-02 09:17:00,8
30580,ORD_30581,29625,Faces Canada Belle De Luxe Nail Enamel Charlotte Nude 69 9 Ml,Warehouse A,100,94,2025-02-02 13:51:00,6
30581,ORD_30582,1414,"JK Cedar - A4, 500 Sheets, 100 GSM, 1 Ream",Warehouse C,90,76,2025-02-02 03:36:00,14
30582,ORD_30583,35026,"Uni Posca Paint Marker Pen, Medium Point, Set of 7 Natural Color (PC-5M 7C)",Warehouse B,77,63,2025-02-02 21:52:00,14
30583,ORD_30584,18365,"7 Days Bye Bye Pigmentation Blemishes Removal Cream || Anti Pigmentation Cream For Women/Men With Niacinamide, B-White & L...",Warehouse B,52,44,2025-02-02 06:37:00,8
30584,ORD_30585,26005,Arata Natural Hydrating & Non-Drying Body Wash With Coconut & Citrus Extracts 75 ml,Warehouse A,76,60,2025-02-02 02:26:00,16
30585,ORD_30586,18306,Dolsil 50mg Injection,Warehouse B,91,75,2025-02-02 10:03:00,16
30586,ORD_30587,10548,Cefvib LB 200mg Tablet,Warehouse A,68,61,2025-02-02 05:51:00,7
30587,ORD_30588,35076,Zufix 50mg Syrup,Warehouse C,17,7,2025-02-02 22:11:00,10
30588,ORD_30589,12489,"Fashion Colour Velvet Touch Face Powder, Shade 02 10 gm",Warehouse A,95,89,2025-02-02 12:32:00,6
30589,ORD_30590,22413,"Artis 61 Watts USB Type C Laptop Adapter/Charger Compatible with MB Pro 13” (20.3V,3A) 2016 Onwards. Connector: USB Type-C...",Warehouse A,14,4,2025-02-02 04:13:00,10
30590,ORD_30591,10437,"BITZAG M i Smart Watch D116 Bluetooth Smart Watch Touch Screen Bluetooth SmartWatch with Activity Tracker, Heart Rate Sens...",Warehouse C,73,54,2025-02-02 15:52:00,19
30591,ORD_30592,14640,Rdin 300mg Tablet,Warehouse A,40,22,2025-02-02 14:24:00,18
30592,ORD_30593,34884,Precious Brightening Serum+ Creme,Warehouse B,19,13,2025-02-02 21:03:00,6
30593,ORD_30594,34793,Pyzole OX Oral Suspension,Warehouse C,33,17,2025-02-02 21:48:00,16
30594,ORD_30595,29363,Bathing Soap - Mild Dew (Peach & Avocado),Warehouse A,45,39,2025-02-02 12:54:00,6
30595,ORD_30596,1102,Tritum 1.5 Injection,Warehouse C,96,89,2025-02-02 02:51:00,7
30596,ORD_30597,6254,boAt Bassheads 242 in Ear Wired Earphones with Mic(Neon Green),Warehouse A,99,89,2025-02-02 19:33:00,10
30597,ORD_30598,1125,"Fashion Colour Super Smooth Translucent Powder, Shade 04 15 gm",Warehouse B,94,88,2025-02-02 22:26:00,6
30598,ORD_30599,1119,Metglar Forte 2mg/1000mg Tablet,Warehouse C,84,68,2025-02-02 20:19:00,16
30599,ORD_30600,10391,Wellcef S 500mg/250mg Injection,Warehouse C,23,13,2025-02-02 10:11:00,10
30600,ORD_30601,29414,Neemwash Neem & Clove Ultra-Purifying Face Wash With Active Neem Slices,Warehouse B,28,12,2025-02-02 21:45:00,16
30601,ORD_30602,18486,"GLAMLER Professional Makeup Combo Nude Eyeshadow Palette, Lipstick, Makeup Brush, Black & White Kajal, Lip Balm, Blender, ...",Warehouse C,72,54,2025-02-02 09:05:00,18
30602,ORD_30603,6175,Ajmal Asher Concentrated Perfume Oil Oriental And Silver Shade Homme Deodorant Citrus Woody Fragrance 212 ml,Warehouse B,38,21,2025-02-02 01:51:00,17
30603,ORD_30604,25978,STRIFF Foldable Tablet Mobile Tabletop Stand Holder - Angle & Height Adjustable Desk Cell Phone Holder Anti-Slip Compatibl...,Warehouse B,86,78,2025-02-02 07:21:00,8
30604,ORD_30605,22376,Salziba D 30mg/20mg Capsule SR,Warehouse A,53,39,2025-02-02 08:25:00,14
30605,ORD_30606,12516,St.Botanica Clarifying Facial Serum - BHA 20 ml,Warehouse A,54,47,2025-02-02 16:33:00,7
30606,ORD_30607,35098,Predvia 16 Tablet,Warehouse A,84,75,2025-02-02 04:41:00,9
30607,ORD_30608,25839,Matee 850mg Tablet,Warehouse B,33,21,2025-02-02 23:37:00,12
30608,ORD_30609,1164,"SanDisk Ultra microSD UHS-I Card 64GB, 120MB/s R",Warehouse C,23,7,2025-02-02 13:49:00,16
30609,ORD_30610,12507,"Camel Artist's Oil Color Box - 9ml tubes, 12 Shades",Warehouse A,101,89,2025-02-02 01:49:00,12
30610,ORD_30611,20821,Pantadence 40mg Tablet,Warehouse A,52,47,2025-02-02 20:16:00,5
30611,ORD_30612,25999,"Zayn & Myza Transfer - Proof Power Matte Lipstick, Selfie Red 3.2 gm",Warehouse C,77,61,2025-02-02 09:49:00,16
30612,ORD_30613,20793,Consistent 17' inch LED Monitor 1804,Warehouse A,20,7,2025-02-02 21:04:00,13
30613,ORD_30614,20928,Lituket 10mg Tablet DT,Warehouse C,54,40,2025-02-02 14:54:00,14
30614,ORD_30615,18131,Allure Wing Liner Brush (ASB317) 1's,Warehouse B,46,31,2025-02-02 20:02:00,15
30615,ORD_30616,4395,"Nokia 110 4G with Volte HD Calls, Up to 32GB External Memory, FM Radio (Wired & Wireless Dual Mode), Games, Torch | Aqua 1...",Warehouse C,36,24,2025-02-02 17:01:00,12
30616,ORD_30617,34971,Physicians Formula The Healthy Eyeshadow - Smoky Plum 6 gm,Warehouse B,58,42,2025-02-02 05:13:00,16
30617,ORD_30618,20892,S Cef 250mg Tablet,Warehouse C,65,59,2025-02-02 23:39:00,6
30618,ORD_30619,14569,L.A. Colors Jumbo Eye Pencil - Sunglasses 3.8 gm,Warehouse A,100,91,2025-02-02 02:50:00,9
30619,ORD_30620,29743,Panza-CT Capsule ER,Warehouse A,35,16,2025-02-02 11:46:00,19
30620,ORD_30621,18141,Ajmal Impress Concentrated Perfume Oil Citrus And Wisal Deodorant Floral Musky Fragrance 210 ml,Warehouse C,50,43,2025-02-02 08:57:00,7
30621,ORD_30622,26095,Nenate 25mg Injection,Warehouse B,67,59,2025-02-02 15:52:00,8
30622,ORD_30623,25766,Revlon Colorstay Full Cover Foundation - Sand beige 30 ml,Warehouse C,19,12,2025-02-02 23:35:00,7
30623,ORD_30624,29752,"RPM Euro Games Laptop/PC Controller Wired for Windows - 7, 8, 8.1, 10 and XP, Ps3(Upgraded with XYAB Buttons)",Warehouse B,64,54,2025-02-02 08:47:00,10
30624,ORD_30625,23872,Daoryl M 1mg/500mg Tablet,Warehouse C,91,83,2025-02-02 16:27:00,8
30625,ORD_30626,10494,Jovees Oil Control Face Wash - Tea Tree 120 ml,Warehouse B,91,80,2025-02-02 18:54:00,11
30626,ORD_30627,30183,Dura 25mg Injection,Warehouse C,68,59,2025-02-02 03:27:00,9
30627,ORD_30628,14547,Dolcet Tablet,Warehouse C,76,57,2025-02-02 23:28:00,19
30628,ORD_30629,18253,Revolution Skincare Salicylic Acid Serum 30 ml,Warehouse C,86,76,2025-02-02 15:40:00,10
30629,ORD_30630,14536,Flormar Silk Matte Liquid Lipstick 009 Nasty Coral 4.5 gm,Warehouse C,44,37,2025-02-02 17:34:00,7
30630,ORD_30631,15090,Ajmal Majmua Concentrated Perfume Oil Oriental Attar And Asher Concentrated Perfume Oil Oriental Attar 22 ml,Warehouse C,60,55,2025-02-02 07:26:00,5
30631,ORD_30632,25929,"If Ramble Matte Quin Lip Color, 3 ml(1)",Warehouse C,78,62,2025-02-02 02:21:00,16
30632,ORD_30633,10430,Rostin 10mg Tablet,Warehouse B,44,36,2025-02-02 17:33:00,8
30633,ORD_30634,23772,Azux 500mg Tablet,Warehouse A,25,10,2025-02-02 21:37:00,15
30634,ORD_30635,29536,Flormar Dewy Lip Glaze 13 Pink Glory 4.5 ml,Warehouse C,75,60,2025-02-02 17:07:00,15
30635,ORD_30636,34816,Natural Protein Hair Detox Kit,Warehouse B,54,45,2025-02-02 14:55:00,9
30636,ORD_30637,12618,CEHAM 1000MG INJECTION,Warehouse C,41,23,2025-02-02 00:29:00,18
30637,ORD_30638,1336,"EGV [3 Pack] Screen Protector for Samsung Galaxy S22 5G, Tempered Glass Screen Protector, 9H Hardness Shockproof, Easy Ins...",Warehouse A,89,76,2025-02-02 20:23:00,13
30638,ORD_30639,34871,TSC TE244 Desktop Thermal Transfer Barcode Printer with USB connectivity 203 DPI Bar Code Label Printer,Warehouse A,11,6,2025-02-02 13:25:00,5
30639,ORD_30640,1122,Saipod-O 200mg/200mg Tablet,Warehouse A,29,12,2025-02-02 09:33:00,17
30640,ORD_30641,26022,Ohria Ayurveda Lodhra Vacha Face Pack | Dry Herbs Powder - 60g,Warehouse C,93,82,2025-02-02 06:09:00,11
30641,ORD_30642,19440,Allerkit Tablet,Warehouse B,81,71,2025-02-02 10:59:00,10
30642,ORD_30643,34820,"Amazon Basics 20000mAh Lithium Polymer 18W Fast Charging Power Bank | Triple Output (Type C, 2 USB) and Dual Input (Type ...",Warehouse A,96,82,2025-02-02 07:37:00,14
30643,ORD_30644,423,LINLO Tempered Glass Screen Guard Compatible for OnePlus 7 / OnePlus 6T with Edge to Edge Coverage and Easy Installation K...,Warehouse C,32,16,2025-02-02 18:53:00,16
30644,ORD_30645,12890,Awedde 10 Tablet,Warehouse A,67,54,2025-02-02 02:21:00,13
30645,ORD_30646,9154,Bathing Soap - Kesar & Milk Cream,Warehouse A,42,34,2025-02-02 08:56:00,8
30646,ORD_30647,35685,Omitop 10mg/20mg Tablet,Warehouse C,45,37,2025-02-02 07:33:00,8
30647,ORD_30648,23618,"HP Laserjet 108A Monochrome Laser Printer with USB Connectivity, Compact Design, Fast Printing",Warehouse A,95,82,2025-02-02 01:05:00,13
30648,ORD_30649,4669,Men Expert Pure & Matte Icy Effect Charcoal Black Foam 100ml/3.4oz,Warehouse C,58,50,2025-02-02 15:57:00,8
30649,ORD_30650,14264,Memopi HC Cream,Warehouse B,25,8,2025-02-02 05:06:00,17
30650,ORD_30651,26313,Blaupunkt Newly Launched SBA25 Gaming 25W Bluetooth Soundbar with 2000mAh Battery I Gaming RGB Lights I TurboVolt Charging...,Warehouse B,30,24,2025-02-02 02:06:00,6
30651,ORD_30652,18899,Chambor Silver Shadow - Rose Pale Rr2 32 gm,Warehouse A,66,61,2025-02-02 09:29:00,5
30652,ORD_30653,23530,"Fashion Colour Baked Blusher, Shade 08 8 gm",Warehouse B,87,78,2025-02-02 22:52:00,9
30653,ORD_30654,736,Amex-CV 625 Tablet,Warehouse A,101,96,2025-02-02 03:37:00,5
30654,ORD_30655,14207,"SanDisk Ultra Dual Drive Go USB Type C Pendrive for Mobile, Navy Blue, 256GB, 5Y Warranty",Warehouse C,92,78,2025-02-02 04:35:00,14
30655,ORD_30656,28594,Olzox-AM Tablet,Warehouse B,36,23,2025-02-02 03:28:00,13
30656,ORD_30657,18982,SUGAR Cosmetics Set The Tone Tinted Powder - 15 Cappuccino 15 gm,Warehouse C,42,25,2025-02-02 11:16:00,17
30657,ORD_30658,35876,Natural White - All-In-One Fairness Night Skin Cream,Warehouse A,63,53,2025-02-02 10:32:00,10
30658,ORD_30659,23543,Ajmal Desert Rose EDP Floral Oriental Perfume And Sacrifice II For Him Deodorant Fruity Aromatic Fragrance 300 ml,Warehouse C,94,84,2025-02-02 12:10:00,10
30659,ORD_30660,7523,Smartflam Tablet,Warehouse B,54,44,2025-02-02 05:36:00,10
30660,ORD_30661,14233,Gastowel-DSR Capsule,Warehouse C,73,61,2025-02-02 18:53:00,12
30661,ORD_30662,18970,Zecita Plus 5 Tablet,Warehouse C,49,32,2025-02-02 22:54:00,17
30662,ORD_30663,22630,Nerbipro P 750mcg/75mg Capsule,Warehouse B,69,52,2025-02-02 17:34:00,17
30663,ORD_30664,35848,Skin Cottage Bath + Scrub (Floral) 1000 ml,Warehouse B,84,75,2025-02-02 02:09:00,9
30664,ORD_30665,4709,Faces Canada Glam On Perfect Blush Hot Pink 02 5 g (Pink),Warehouse A,117,99,2025-02-02 01:14:00,18
30665,ORD_30666,35826,Sandalwood Aroma Massage Oil,Warehouse B,80,70,2025-02-02 02:28:00,10
30666,ORD_30667,26278,Kenozole Shampoo,Warehouse A,27,9,2025-02-02 22:49:00,18
30667,ORD_30668,4697,"Panasonic Corded Telephone, Black",Warehouse A,58,45,2025-02-02 14:39:00,13
30668,ORD_30669,4696,"Cetaphil PRO Dryness Control Day Protect Hand Cream, 50ml",Warehouse C,34,29,2025-02-02 15:00:00,5
30669,ORD_30670,6018,Fingus 250mg Tablet,Warehouse A,42,32,2025-02-02 13:49:00,10
30670,ORD_30671,9179,"Cosmic Byte GS430 Gaming wired over ear Headphone, 7 Color RGB LED and Microphone",Warehouse B,77,72,2025-02-02 04:51:00,5
30671,ORD_30672,28697,"Zebronics Zeb-Space Deck PRO Wireless Bluetooth 40W Boombox Party Portable Speaker Supporting LED Display, RGB Lights, US...",Warehouse A,69,60,2025-02-02 18:56:00,9
30672,ORD_30673,10179,"O3+ Hydrating & Soothing Face Wash with Aloe Vera and Cucumber Extracts, 50g",Warehouse B,23,6,2025-02-02 10:49:00,17
30673,ORD_30674,23606,Maryaj Tuxedo EDP Spicy Woody Perfume And Ajmal Avid Homme Deodorant Aquatic Woody Fragrance 300 ml,Warehouse C,43,37,2025-02-02 12:34:00,6
30674,ORD_30675,26191,ZEBRONICS Zeb-Bang Wireless Bluetooth Over The Ear Headphone with Mic and and Playback time 16 hrs (Blue),Warehouse A,86,69,2025-02-02 02:35:00,17
30675,ORD_30676,28699,Esjor-DSR Capsule,Warehouse B,86,69,2025-02-02 07:34:00,17
30676,ORD_30677,36862,NOTE LUMINOUS SILK COMPACT BLUSHER 04 5.5 gm,Warehouse A,91,74,2025-02-02 05:31:00,17
30677,ORD_30678,36873,Capxime-LB Tablet,Warehouse B,62,50,2025-02-02 07:32:00,12
30678,ORD_30679,9561,Rabeedon D 30mg/20mg Capsule SR,Warehouse C,25,15,2025-02-02 02:59:00,10
30679,ORD_30680,13262,"4 Pcs Carrot Facial Bath Cleansing Sponges for Aging Skin Cleaning, FLUZOV Reusable Cosmetic Face Sponge Pads, for Facial,...",Warehouse C,50,31,2025-02-02 21:35:00,19
30680,ORD_30681,142,Omex 20mg Capsule,Warehouse C,14,2,2025-02-02 11:19:00,12
30681,ORD_30682,7911,Kridol P 325 mg/37.5 mg Tablet,Warehouse C,78,65,2025-02-02 15:22:00,13
30682,ORD_30683,19941,Axocin 400mg Tablet,Warehouse C,86,78,2025-02-02 16:36:00,8
30683,ORD_30684,26871,HUMBLE® Spiral Charger Cable Protector Data Cable Saver Charging Cord Protective Cable Cover Set of 1 (4 Pieces).,Warehouse B,100,89,2025-02-02 05:32:00,11
30684,ORD_30685,36865,Nutriment Apple cider Scrub All Skin Type 250 gm,Warehouse A,21,13,2025-02-02 03:31:00,8
30685,ORD_30686,5064,Himalaya Furglow skin and Coat tonic Pack of 400 ml,Warehouse A,110,96,2025-02-02 04:39:00,14
30686,ORD_30687,9287,Riopah 1mg Tablet,Warehouse C,57,44,2025-02-02 16:46:00,13
30687,ORD_30688,36293,"DR VAKU® 20W iPhone Charger Type C Adapter for iPhone 14/14 Plus/14 Pro,13/13 Pro/13 Mini,12/12 Mini,11 Series With PD 3....",Warehouse C,109,95,2025-02-02 02:32:00,14
30688,ORD_30689,26249,Pretee 500mg Injection,Warehouse A,21,14,2025-02-02 10:28:00,7
30689,ORD_30690,23570,Kama Ayurveda Youth Restore Gift Box,Warehouse A,20,12,2025-02-02 13:34:00,8
30690,ORD_30691,8081,MyGlamm Superfoods Onion & Moringa-Hair Oil 100 ml,Warehouse C,96,77,2025-02-02 22:57:00,19
30691,ORD_30692,12839,"VOYEE V33 Gaming Bluetooth Truly Wireless in Ear Earbuds with Mic TWS 5.2 Ipx5 Water/Sweat Resistant, Deep Bass, 60 Ms Low...",Warehouse B,65,51,2025-02-02 15:04:00,14
30692,ORD_30693,35735,"SanDisk Ultra Luxe USB 3.1 Flash Drive 256GB, Upto 150MB/s, All Metal, Metallic Silver",Warehouse A,17,2,2025-02-02 20:41:00,15
30693,ORD_30694,10151,"Eye Makeup Brush Set Eye Blending Brush, Smudge Brush, Eye Foundation Brush, Eye Base Brush & Eye liner Brush",Warehouse C,84,76,2025-02-02 03:32:00,8
30694,ORD_30695,26224,ZY-Q 200 Tablet,Warehouse C,114,96,2025-02-02 10:35:00,18
30695,ORD_30696,14292,Forcan TZ 150mg/1000mg Tablet,Warehouse C,93,88,2025-02-02 04:13:00,5
30696,ORD_30697,20679,Sitaglyn M IR 50/500 Tablet,Warehouse C,51,40,2025-02-02 23:20:00,11
30697,ORD_30698,4628,"Fashion Colour Terra Cotta Blusher, Shade 11 16 gm",Warehouse C,52,38,2025-02-02 10:07:00,14
30698,ORD_30699,28790,"Samsung Galaxy M13 5G (Stardust Brown, 4GB, 64GB Storage) | 5000mAh Battery | Upto 8GB RAM with RAM Plus",Warehouse C,32,17,2025-02-02 17:03:00,15
30699,ORD_30700,20690,"Apple Lightning to USB Camera Adapter, USB 3.0 OTG Cable for iPhone/iPad to Connect Card Reader, USB Flash Drive, U Disk, ...",Warehouse C,68,61,2025-02-02 03:25:00,7
30700,ORD_30701,28865,I AM EYECONIC FINE GLITTER CHAMELEON COPPER 4 gm,Warehouse C,41,33,2025-02-02 07:06:00,8
30701,ORD_30702,868,Toriron 500mg Injection,Warehouse A,91,81,2025-02-02 03:42:00,10
30702,ORD_30703,27255,Amoit CV 1000mg/200mg Injection,Warehouse B,57,42,2025-02-02 18:22:00,15
30703,ORD_30704,12911,Night Saffron Anti Ageing & Brightening Cream With Kashmiri Saffron & Bio Retinol,Warehouse B,35,29,2025-02-02 17:30:00,6
30704,ORD_30705,26183,ADISA 15.6 inch Laptop Backpack Office Bag College Travel Back Pack 32 Ltrs (z-Black),Warehouse C,53,37,2025-02-02 11:59:00,16
30705,ORD_30706,4555,Kodak 80 cm (32 inches) HD Ready Certified Android Smart LED TV 32HDX7XPROBL (Black),Warehouse A,7,2,2025-02-02 16:11:00,5
30706,ORD_30707,28965,Olancer 5mg Tablet,Warehouse B,56,47,2025-02-02 00:11:00,9
30707,ORD_30708,35622,Robustrion Smart Trifold Translucent Back Case Cover for Apple iPad 10.2 inch 9th Gen 2021 Cover 8th Gen 2020 7th Gen 2019...,Warehouse B,24,14,2025-02-02 20:34:00,10
30708,ORD_30709,897,Not Out Condoms - With 1500+ Raised Dots,Warehouse B,81,72,2025-02-02 15:10:00,9
30709,ORD_30710,20713,Redgear Pro Wireless Series Gamepad Wireless Receiver for PC Black,Warehouse A,71,65,2025-02-02 11:15:00,6
30710,ORD_30711,14388,Biotique Bio Mud Youthful Firming & Revitalizing Face Pack 75 gm,Warehouse A,95,79,2025-02-02 21:53:00,16
30711,ORD_30712,903,The Moms Co. Natural Vitamin C Face Wash 100 ml,Warehouse C,101,91,2025-02-02 22:04:00,10
30712,ORD_30713,18754,Monolev 5mg/10mg Tablet,Warehouse A,28,19,2025-02-02 18:36:00,9
30713,ORD_30714,6067,Titan Analog Silver Dial Men's Watch-NL1584SL03/NP1584SL03,Warehouse B,112,97,2025-02-02 18:55:00,15
30714,ORD_30715,9141,Flormar Quick Dry Nail Enamel QD20 Rose Taboo 11 ml,Warehouse A,9,1,2025-02-02 03:37:00,8
30715,ORD_30716,14408,Wheat Grass Powder 100 g + Spirulina Powder 100 g,Warehouse B,46,37,2025-02-02 11:56:00,9
30716,ORD_30717,19381,Camel Camlin Kokuyo Canvas Board - 30cm x 40cm,Warehouse B,57,45,2025-02-02 23:58:00,12
30717,ORD_30718,4568,Decoript K 50mg/10mg Tablet,Warehouse B,64,54,2025-02-02 09:50:00,10
30718,ORD_30719,7646,POPIO Tempered Glass Screen Protector Compatible for OnePlus Nord CE 2 5G (Black) with Edge to Edge Coverage and Easy Inst...,Warehouse C,27,21,2025-02-02 21:35:00,6
30719,ORD_30720,13967,Lakme Lipstick Pink Splash (Matte),Warehouse A,74,59,2025-02-02 03:53:00,15
30720,ORD_30721,4987,Cold Processed Neem Henna Anti-Dandruff Hair Cleansing Bar For Shiny Hair,Warehouse A,72,58,2025-02-02 03:46:00,14
30721,ORD_30722,4984,SERY Mattish Lipstick Rosy Rose 3.5 gm,Warehouse A,104,94,2025-02-02 16:55:00,10
30722,ORD_30723,13997,Skincare Hand Wash Liquid Pump,Warehouse C,77,61,2025-02-02 06:37:00,16
30723,ORD_30724,13016,Nacrocob 2500mcg Injection,Warehouse A,48,40,2025-02-02 18:48:00,8
30724,ORD_30725,8026,"Portronics Power Plate 9 with 3 USB Ports + 8 Power Sockets Power Converter, 2500W Power Output, 2.1A USB Charging Port, 3...",Warehouse C,57,51,2025-02-02 00:14:00,6
30725,ORD_30726,19298,Benepack 4 Tablet,Warehouse A,45,27,2025-02-02 21:58:00,18
30726,ORD_30727,23390,Vd Met 500mg/50mg Tablet,Warehouse A,112,93,2025-02-02 03:40:00,19
30727,ORD_30728,22709,Professional Natural Long Lasting Paint Tattoo Eyebrow Pencil Waterproof,Warehouse B,73,60,2025-02-02 23:38:00,13
30728,ORD_30729,27929,Face Mask For Kids - Lion King,Warehouse A,49,38,2025-02-02 07:22:00,11
30729,ORD_30730,36167,Cemed LB 200mg Tablet,Warehouse C,53,37,2025-02-02 16:08:00,16
30730,ORD_30731,35650,Colorbar Full Cover Makeup Foundation Stick Fcms002 9 Gm,Warehouse A,19,13,2025-02-02 10:54:00,6
30731,ORD_30732,18781,L.A Girl Shockwave Neon Eye Liner - SCream in ( Yellow) 1.2 gm,Warehouse C,54,46,2025-02-02 21:25:00,8
30732,ORD_30733,26155,Mobile Phone Stand Wall Charger - Adapter Charging Holder Hanging Stand Bracket Support Charge Hanger Rack Shelf Cell Phon...,Warehouse B,74,55,2025-02-02 16:02:00,19
30733,ORD_30734,6084,Vero Forza Glide Pro V2 (4 Pieces) | Mobile Gaming Sleeve | VFiber 3.0 Technology,Warehouse A,106,98,2025-02-02 22:51:00,8
30734,ORD_30735,29027,House of Aroma Believe Fragrance Oil 100 ml,Warehouse B,95,79,2025-02-02 22:07:00,16
30735,ORD_30736,931,"KEBILSHOP 3.5mm Male to Female 5 Meter Stereo Aux Extension Cable Compatible with Headphone, MobilePhone, Car Stereo, Home...",Warehouse A,97,81,2025-02-02 23:34:00,16
30736,ORD_30737,22561,"Phy Aqua + Earthy Sulphate-Free Body Wash Set with lasting fragrance - Non-Drying Cleansing Formulation, No Sulphates, Par...",Warehouse C,59,50,2025-02-02 15:59:00,9
30737,ORD_30738,18724,MODFRILL Unisex Messenger Bag,Warehouse C,71,60,2025-02-02 01:37:00,11
30738,ORD_30739,29036,"DarkPyro Ice Roller For Face, Neck and Body | For Puffy Eyes, Easy to Use and Carry | Unbreakable and Reusable | Glowing a...",Warehouse A,81,69,2025-02-02 21:54:00,12
30739,ORD_30740,8122,"Fashion Colour Lip Crayon, Waterproof, Long Lasting, 12 Dark Violet 2.8 gm",Warehouse A,44,32,2025-02-02 18:23:00,12
30740,ORD_30741,29047,Vega Basic Hand Loofah (NBA - 4/1) 35 gm,Warehouse B,43,30,2025-02-02 05:56:00,13
30741,ORD_30742,945,"OTOROYS Metal CNC Bike Mount Holder Navigation 360 Degree Rotation Mirror Cradle for All Smartphones Bicycle, Motorcycle, ...",Warehouse A,47,32,2025-02-02 14:41:00,15
30742,ORD_30743,9134,Flormar Waterproof Lipliner 232 Passionate Red 1.14 gm,Warehouse A,80,62,2025-02-02 08:37:00,18
30743,ORD_30744,18717,Faces Canada Splash Nail Enamel Fushcia 131 8 Ml,Warehouse C,69,59,2025-02-02 10:05:00,10
30744,ORD_30745,18712,Etobone 120 Tablet,Warehouse B,98,85,2025-02-02 01:22:00,13
30745,ORD_30746,23686,CHAMBOR Extreme Matte Long-Wear Foundation Make up - Bronze #3046-30ml,Warehouse A,51,45,2025-02-02 16:51:00,6
30746,ORD_30747,22536,MyVobo 0.3mg Tablet,Warehouse C,101,87,2025-02-02 20:33:00,14
30747,ORD_30748,35525,Hista L Kid 2.5mg/5mg Tablet,Warehouse B,72,62,2025-02-02 17:51:00,10
30748,ORD_30749,35524,Gel Bathing Bar - Lemongrass & Jojoba,Warehouse A,38,28,2025-02-02 00:24:00,10
30749,ORD_30750,10275,Samsung F23 5G Charger Adapter C to C 20w Adaptor for Samsung Galaxy F23 Adaptive Fast Mobile Charger ( Max 25 watt - 20 w...,Warehouse C,100,87,2025-02-02 23:23:00,13
30750,ORD_30751,14467,Dyazo Aluminium Portable High Speed Micro USB to USB A Female OTG Adapter/Converter Compatible with Samsung S6 Edje S7 Edg...,Warehouse A,15,7,2025-02-02 15:39:00,8
30751,ORD_30752,4464,Zeora D 10mg/20mg Tablet,Warehouse B,16,8,2025-02-02 21:21:00,8
30752,ORD_30753,18736,"Nokia 215 4G Dual SIM 4G Phone with Long Battery Life, Multiplayer Games, Wireless FM Radio and Durable Ergonomic Design |...",Warehouse C,69,61,2025-02-02 01:34:00,8
30753,ORD_30754,10231,Rivela Tint Spf - Bottle of 50 ml Sunscreen Lotion,Warehouse A,50,40,2025-02-02 07:01:00,10
30754,ORD_30755,26163,"FLiCKA Game Of Colors Eyeshadow Palette, 18 in 1 Long Lasting Blendable Eye Makeup Palette (18gms) Shimmery, Powder and Gl...",Warehouse C,46,34,2025-02-02 10:24:00,12
30755,ORD_30756,10211,"MI REDMI 9i Sport (Carbon Black, 64 GB) (4 GB RAM)",Warehouse C,76,57,2025-02-02 02:19:00,19
30756,ORD_30757,6058,Cfd 125mg Dry Syrup,Warehouse A,80,75,2025-02-02 13:35:00,5
30757,ORD_30758,873,"Stealodeal Hard Disk Case Cover for Seagate, Toshiba, WD, Sony, Transcend, Lenovo, HP & Hitachi 2.5 HDD External Hard Disk...",Warehouse A,94,75,2025-02-02 10:37:00,19
30758,ORD_30759,4580,Affovog-M 2 Tablet SR,Warehouse A,83,75,2025-02-02 17:34:00,8
30759,ORD_30760,28895,"VIHM 7 in 1 Electronic Cleaner kit, Cleaning Kit for Monitor Keyboard Airpods MacBook iPad iPhone iPod, Screen Dust Brush ...",Warehouse B,23,18,2025-02-02 12:43:00,5
30760,ORD_30761,13547,Volabay 0.3 M Tablet SR,Warehouse C,107,89,2025-02-02 10:28:00,18
30761,ORD_30762,14347,Tsr 400mg Tablet,Warehouse B,110,91,2025-02-02 19:52:00,19
30762,ORD_30763,13820,"NYNHUDA Insta Beauty Hated with Love 63 Color Metallic, Shimmery, Matte, Glittery Finish Eye Shadow Palette Makeup Kit for...",Warehouse A,52,42,2025-02-02 01:52:00,10
30763,ORD_30764,13316,Salvatore Ferragamo Acqua Essenziale Eau De Toilette Spray 50ml,Warehouse B,21,5,2025-02-02 23:59:00,16
30764,ORD_30765,20397,Aecef S 500mg/250mg Injection,Warehouse C,116,99,2025-02-02 02:35:00,17
30765,ORD_30766,27787,"Samsung Galaxy Tab A8 26.69cm (10.5 inch) Display, RAM 4 GB, ROM 64 GB Expandable, Wi-Fi Tablet, Gray, (SM-X200NZAEINU)",Warehouse B,17,9,2025-02-02 19:11:00,8
30766,ORD_30767,27799,"SanDisk Ultra Dual Drive Go 32GB USB 3.0 Type C PenDrive for Mobile (Mint Green, 5Y)",Warehouse A,71,57,2025-02-02 02:27:00,14
30767,ORD_30768,5170,Ethacid 250mg Tablet,Warehouse A,87,72,2025-02-02 21:52:00,15
30768,ORD_30769,27833,Ciproace 250mg Tablet,Warehouse A,104,93,2025-02-02 15:33:00,11
30769,ORD_30770,9797,Radicet-LM Syrup,Warehouse B,21,10,2025-02-02 17:41:00,11
30770,ORD_30771,7782,Ajmal Distraction & Nightingale Deo & Neea EDP Pack of 3 20 ml,Warehouse B,79,69,2025-02-02 17:02:00,10
30771,ORD_30772,26806,Cello Liquiball Ball Pen - Pack of 10 (Blue),Warehouse B,39,20,2025-02-02 05:07:00,19
30772,ORD_30773,19849,"Sandhimitra Vati - Arthralgia, 500 mg",Warehouse A,21,15,2025-02-02 18:05:00,6
30773,ORD_30774,62,Cephen MF DS Syrup,Warehouse C,108,89,2025-02-02 13:53:00,19
30774,ORD_30775,5535,House Of Makeup Nail Lacquer - Acai Butter 12 ml,Warehouse A,20,4,2025-02-02 03:02:00,16
30775,ORD_30776,27157,EGOTUDE Shock Proof Hard PC Back Soft Edge Bumper Cover Case for iPhone 8 Plus / 7 Plus (Smoked Black),Warehouse C,65,54,2025-02-02 02:38:00,11
30776,ORD_30777,7894,"The Cosmetic Town Makeup Brush Set, 5pc with Makeup Blender Puff Combo (Multicolour), 6 Items in The Set",Warehouse A,33,25,2025-02-02 17:35:00,8
30777,ORD_30778,72,"Ayurjeet Hair Color Shampoo 180ml Natural Black | Beard, Moustache, Chest, Instant colour, long lasting, No Harsh Chemical...",Warehouse B,59,41,2025-02-02 09:20:00,18
30778,ORD_30779,13808,The Moms Co. Natural Age Control Essential Night Regime 75 gm,Warehouse B,43,32,2025-02-02 15:50:00,11
30779,ORD_30780,36993,"Techspark S8 Ultra Smartwatch with 2.05"" HD Display, Bluetooth Calling Multiple Sports Modes, Multiple Watch Faces, Spo2 M...",Warehouse A,100,82,2025-02-02 22:06:00,18
30780,ORD_30781,13303,Flormar Matte Nail Enamel M39 Marble 11 ml,Warehouse C,23,13,2025-02-02 21:52:00,10
30781,ORD_30782,23023,Loxin 250mg Tablet,Warehouse A,101,92,2025-02-02 03:23:00,9
30782,ORD_30783,27188,Flormar Dewy Lip Glaze 09 Vibrant Red 4.5 ml,Warehouse C,53,42,2025-02-02 02:28:00,11
30783,ORD_30784,94,Ancool  Oral Suspension Sugar Free,Warehouse C,80,68,2025-02-02 19:07:00,12
30784,ORD_30785,36948,Beauty People Liquid Illuminator 03 Pure Pearl 25 ml,Warehouse A,107,89,2025-02-02 12:56:00,18
30785,ORD_30786,7833,Netnox 10mg Injection,Warehouse A,35,22,2025-02-02 18:27:00,13
30786,ORD_30787,7900,Rixicef Plus Tablet,Warehouse C,61,48,2025-02-02 19:21:00,13
30787,ORD_30788,26893,Evamax 500mg Tablet,Warehouse B,48,43,2025-02-02 16:37:00,5
30788,ORD_30789,27205,Hello ! Tf-600 Cli Caller Id Corded Landline Phone for Intercom and Epabx Desk & Wall Mountable (Black) Made in India,Warehouse C,96,83,2025-02-02 04:14:00,13
30789,ORD_30790,23049,Unicron 5 in 1 Keyboard & Earphone Cleaner Keyboard Cleaning Brush Laptop Cleaning Kit Cleaning Pen for Airpods Cleaner So...,Warehouse C,41,22,2025-02-02 15:25:00,19
30790,ORD_30791,27765,Araiper S 250mg/125mg Injection,Warehouse C,97,80,2025-02-02 01:40:00,17
30791,ORD_30792,23270,Enkasol 1.4gm Syrup,Warehouse B,102,97,2025-02-02 07:05:00,5
30792,ORD_30793,19970,Manish Malhotra Glitter Mascara - Gilt 7 Gm,Warehouse B,31,16,2025-02-02 12:50:00,15
30793,ORD_30794,20487,Medimade Papaya Premium Soap (Pack of 3) 1's,Warehouse B,22,14,2025-02-02 03:42:00,8
30794,ORD_30795,27932,Classmate Octane Gel 25s Jar- 20 Blue Gel Pens + 5 Black Gel Pens,Warehouse B,48,33,2025-02-02 00:28:00,15
30795,ORD_30796,19439,Glimispica M 2mg/500mg Tablet,Warehouse B,105,98,2025-02-02 01:52:00,7
30796,ORD_30797,13265,Telzoe MT 40mg/50mg Tablet,Warehouse B,19,10,2025-02-02 00:27:00,9
30797,ORD_30798,19433,Adoloc 20mg Capsule,Warehouse B,103,98,2025-02-02 19:53:00,5
30798,ORD_30799,5848,Cosmic Byte Equinox Mousepad Control Edition (L) (32x27x0.3cms),Warehouse C,18,13,2025-02-02 13:43:00,5
30799,ORD_30800,27967,Biorex 25mg Tablet,Warehouse A,37,29,2025-02-02 14:50:00,8
30800,ORD_30801,27975,Xorimax 250mg Tablet,Warehouse C,98,89,2025-02-02 09:06:00,9
30801,ORD_30802,13890,Essential Oil - Basil,Warehouse C,20,11,2025-02-02 01:37:00,9
30802,ORD_30803,19394,Lina Trading Pink Air Cushion Puff Case Container Cosmetic Concealer BB CC Cream Box,Warehouse C,39,33,2025-02-02 06:05:00,6
30803,ORD_30804,23322,"Ambrane 36W Fast Car Charger with Dual Output, Qualcomm Quick Charge 3.0 Compatible with all Cars for iPhone, All Smartpho...",Warehouse A,26,20,2025-02-02 00:32:00,6
30804,ORD_30805,13891,Capiloc 500mg Tablet,Warehouse B,39,22,2025-02-02 10:34:00,17
30805,ORD_30806,20477,Ajmal Mercurial - Thunder Edt 250 Ml,Warehouse B,57,49,2025-02-02 21:35:00,8
30806,ORD_30807,27892,Insight Cosmetics Insta-Ready Illuminating Highlighter - Luminous 7.5 gm,Warehouse B,86,70,2025-02-02 21:34:00,16
30807,ORD_30808,5800,Tenovate GN Cream,Warehouse B,20,5,2025-02-02 07:53:00,15
30808,ORD_30809,5143,Histiv 8mg Tablet,Warehouse B,105,97,2025-02-02 02:21:00,8
30809,ORD_30810,13768,Azosuf 250mg Tablet,Warehouse A,75,56,2025-02-02 01:38:00,19
30810,ORD_30811,20437,Pregadd NT 75mg/10mg Tablet,Warehouse A,25,11,2025-02-02 16:58:00,14
30811,ORD_30812,23253,Eyetex Dazller Nail Glitter - DR13 (Crimson) 12 ml,Warehouse A,45,30,2025-02-02 01:38:00,15
30812,ORD_30813,36481,Aerocort Forte Rotacap,Warehouse C,55,41,2025-02-02 16:59:00,14
30813,ORD_30814,347,TNW -The Natural Wash Matte Velvet Longstay mini Liquid Lipstick - 01- Blush Nude - 1.2ml,Warehouse C,23,9,2025-02-02 10:59:00,14
30814,ORD_30815,5794,Zydox 100mg Tablet,Warehouse B,56,47,2025-02-02 16:34:00,9
30815,ORD_30816,26678,Wottagirl! Perfume Spray - Spell Bound,Warehouse C,64,46,2025-02-02 09:50:00,18
30816,ORD_30817,27753,3D Temporary Tattoo Golden And Silver Metallic Sticker Bow Flower Hearts Design Size 21x15CM - 1PC. (9-1),Warehouse A,77,63,2025-02-02 08:32:00,14
30817,ORD_30818,36453,Santoor Sandal and Turmeric Soap (Pack of 4 soaps 125g each),Warehouse B,37,29,2025-02-02 20:04:00,8
30818,ORD_30819,20393,Blaupunkt Newly Launched BTW300 BASS Buds Truly Wireless Bluetooth in Ear Earbuds I Bass Demon Tech I ENC CRISPR TECH I 40...,Warehouse C,34,19,2025-02-02 15:12:00,15
30819,ORD_30820,23265,Spigen Thin Fit Back Cover Case for Samsung Galaxy S23 Ultra (Poly Carbonate + TPU | Abyss Green),Warehouse B,36,21,2025-02-02 10:53:00,15
30820,ORD_30821,22909,"Bath Loofah - Bittersweet Orange, Colour May Vary",Warehouse A,47,41,2025-02-02 12:54:00,6
30821,ORD_30822,7810,Yofix 50mg Tablet DT,Warehouse C,102,86,2025-02-02 22:29:00,16
30822,ORD_30823,27350,Sounce Indoor Entertainment & Watching a Movie with This Cool Big Square Mobile Foldable Stand Holder (Pack of 2) (Black -...,Warehouse C,113,99,2025-02-02 02:48:00,14
30823,ORD_30824,13250,"boAt Wave Lite Smartwatch with 1.69"" HD Display, Sleek Metal Body, HR & SpO2 Level Monitor, 140+ Watch Faces, Activity Tra...",Warehouse B,60,51,2025-02-02 10:06:00,9
30824,ORD_30825,13591,Tough Lee Tempered Glass Screen Guard for Mi Redmi 9 Power / 9 Prime; Poco M2 / M3 (Transparent) Full Coverage Gorilla Pro...,Warehouse A,49,30,2025-02-02 08:10:00,19
30825,ORD_30826,168,Podowart S Paint,Warehouse C,77,68,2025-02-02 00:54:00,9
30826,ORD_30827,19902,Azomarc Plus 100 mg/500 mg Tablet,Warehouse C,21,12,2025-02-02 19:36:00,9
30827,ORD_30828,26832,Superdrug Teatree Exfoliating Cream Wash 150 ml,Warehouse B,104,88,2025-02-02 08:53:00,16
30828,ORD_30829,19897,"BlueRigger High Speed HDMI Cable with Ethernet - Supports 3D, 4K 60Hz and Audio Return - Latest Version (3 Feet / 0.9 Meter)",Warehouse A,43,27,2025-02-02 12:47:00,16
30829,ORD_30830,19888,Onipas 4mg Tablet,Warehouse C,68,50,2025-02-02 04:21:00,18
30830,ORD_30831,13612,"ARTBRIZ Brizberry Mouse Pad, Large Printed Premium Textured Waterproof Anti Skid Rubber Base for Desktop Laptop Gaming Pro...",Warehouse A,88,73,2025-02-02 02:46:00,15
30831,ORD_30832,27400,Hyaluronic Acid Moisture Eye Cream,Warehouse B,61,54,2025-02-02 01:10:00,7
30832,ORD_30833,36792,Berina A1 Black Hair Color Cream 60 gm,Warehouse C,77,66,2025-02-02 06:35:00,11
30833,ORD_30834,7800,Boujee Beauty Fluffy Highlighter Brush B319 135 gm,Warehouse C,100,90,2025-02-02 14:18:00,10
30834,ORD_30835,36789,Ajmal Carbon EDP Citrus Spicy Perfume 100ml for Men and Aurum EDP Fruity Floral Perfume 75ml for Women +1 Perfume Tester FREE,Warehouse A,72,59,2025-02-02 13:34:00,13
30835,ORD_30836,13639,"URBN 10000 mAh lithium_polymer Power Bank with 22.5 Watt Super Fast Charging, Blue",Warehouse B,68,56,2025-02-02 13:06:00,12
30836,ORD_30837,22877,Clazin M 80mg/500mg Tablet,Warehouse B,33,14,2025-02-02 17:25:00,19
30837,ORD_30838,27426,Forest Essentials Tinted Lip Serum Madhu Rasa Gulaab Jal 2.2g (Lipstick),Warehouse C,53,34,2025-02-02 00:50:00,19
30838,ORD_30839,9615,Dalium 37.5mg Tablet,Warehouse A,76,59,2025-02-02 21:59:00,17
30839,ORD_30840,23117,Nytram-SR 100 Tablet,Warehouse B,93,75,2025-02-02 04:20:00,18
30840,ORD_30841,13577,Carpigrel-A Tablet,Warehouse A,44,37,2025-02-02 00:08:00,7
30841,ORD_30842,9575,Evaflor Whisky Silver Deodorant 200 ml,Warehouse A,59,53,2025-02-02 05:57:00,6
30842,ORD_30843,9571,Wonrab 20mg Tablet,Warehouse A,70,54,2025-02-02 22:53:00,16
30843,ORD_30844,135,Noise_Pulse Go Buzz SmartWatch Charger 2 Pin USB Fast Charger Magnetic Charging Cable Adapter (Smart Watch Charger 2 pin),Warehouse B,25,9,2025-02-02 10:42:00,16
30844,ORD_30845,13531,"VOYEE Controller for PC, Wired Gamepad, Gaming Controller Compatible with PS3/PC Windows 10/8/7, with Dual Vibration Motors",Warehouse C,35,28,2025-02-02 05:53:00,7
30845,ORD_30846,36891,"realme C35 (Glowing Black, 6GB RAM, 128GB Storage)",Warehouse B,80,63,2025-02-02 12:21:00,17
30846,ORD_30847,9549,"Tecno Phantom X2 5G Stardust Grey (8GB RAM,256GB Storage) | World's 1st 4nm Dimensity 9000 5G Processor | Dual Curved AMOL...",Warehouse C,20,9,2025-02-02 02:02:00,11
30847,ORD_30848,7822,"HDMI Switch Splitter, 2 Port Bi-Directional Manual HDMI Switch 2 in 1 Out or 1 in 2 Out Splitter Supports 4K 2K 3D Full HD...",Warehouse B,91,72,2025-02-02 23:00:00,19
30848,ORD_30849,27251,Omyrol Cream,Warehouse B,101,92,2025-02-02 02:00:00,9
30849,ORD_30850,36884,Acutrax TZ 250mg/31.25mg Injection,Warehouse A,92,85,2025-02-02 15:42:00,7
30850,ORD_30851,5715,Ajmal Amber Magic EDP Spicy Aromatic Perfume 100ml for Men and Blu Femme EDP Floral Woody Perfume 50ml for Women +1 Perfum...,Warehouse B,35,21,2025-02-02 13:35:00,14
30851,ORD_30852,23059,MAC Studio Fix Fluid Foundation SPF 15 NW25,Warehouse B,92,81,2025-02-02 05:25:00,11
30852,ORD_30853,20113,"Sony HT-S20R Real 5.1ch Dolby Digital Soundbar for TV with subwoofer and Compact Rear Speakers, 5.1ch Home Theatre System...",Warehouse A,22,13,2025-02-02 07:00:00,9
30853,ORD_30854,20038,"SanDisk Ultra Dual Drive Go usb3.0 Type C Pen Drive for Mobile (Green, 128 GB, 5Y)",Warehouse B,40,32,2025-02-02 16:59:00,8
30854,ORD_30855,36762,Spasmo Corfen 20 mg/500 mg Tablet,Warehouse A,63,58,2025-02-02 13:17:00,5
30855,ORD_30856,2,Enzocare-D Tablet,Warehouse C,49,31,2025-02-02 14:45:00,18
30856,ORD_30857,26973,"Base Camp Cologne Soap - With Cedar Wood & Mint,",Warehouse A,37,29,2025-02-02 12:06:00,8
30857,ORD_30858,22950,Ozed D 10mg/20mg Capsule,Warehouse A,88,73,2025-02-02 17:28:00,15
30858,ORD_30859,5632,Faces Canada Ultime Pro Matte Lip Crayon Evening Star 40 2.8 Gm,Warehouse C,96,77,2025-02-02 14:04:00,19
30859,ORD_30860,27021,Liposoluble Wax - Dark Chocolate,Warehouse A,93,84,2025-02-02 01:50:00,9
30860,ORD_30861,26954,Cefseep Dry Syrup,Warehouse B,26,14,2025-02-02 06:23:00,12
30861,ORD_30862,13388,AVA Line Art Tattoo ECO Degradable tattoo Machine Cover,Warehouse A,41,22,2025-02-02 07:37:00,19
30862,ORD_30863,22981,Desfax 50mg Tablet ER,Warehouse B,11,2,2025-02-02 06:48:00,9
30863,ORD_30864,37103,"MaxFresh Toothpaste - Blue Gel With Menthol For Super Fresh Breath, Peppermint Ice",Warehouse C,83,77,2025-02-02 09:18:00,6
30864,ORD_30865,13408,Vogisir 0.3mg Tablet,Warehouse B,106,96,2025-02-02 21:23:00,10
30865,ORD_30866,27039,Onsitego 1 Year Extended Warranty for Small Household Appliances from Rs. 10001-12500 (Email Delivery - No Physical Kit),Warehouse C,39,21,2025-02-02 19:45:00,18
30866,ORD_30867,13328,Powerpak MS-1001 3 Leg Boom Microphone Stand (Black),Warehouse A,104,87,2025-02-02 23:05:00,17
30867,ORD_30868,20105,GUBB Multi use Oval Makeup Brush,Warehouse A,36,19,2025-02-02 13:44:00,17
30868,ORD_30869,27103,Glimgold MF 1 mg/500 mg Tablet,Warehouse A,105,90,2025-02-02 18:30:00,15
30869,ORD_30870,20261,Maxpee 0.4mg Tablet MR,Warehouse A,94,83,2025-02-02 06:42:00,11
30870,ORD_30871,19965,Faber-Castell Grip Erasable Crayon Set - Pack of 24 (Assorted),Warehouse A,103,87,2025-02-02 06:42:00,16
30871,ORD_30872,27228,Elecious Methi Seed Powder For Hair Growth - 200 g | Fenugreek Powder,Warehouse B,73,58,2025-02-02 05:56:00,15
30872,ORD_30873,27131,(Renewed) Lenovo ThinkCenter 19 Inch AIO Desktop Set(Intel i5 4thGen/ 8GB/256GB SSD/19 inchesHD Monitor+Keyboard+Mouse+Tin...,Warehouse C,15,4,2025-02-02 16:51:00,11
30873,ORD_30874,13444,"Faces Canada Magnet Eyes Kajal, Waterproof, 24hrs Long Stay, One Stroke Smooth Glide, Black 0.35g & Faces Splash Glossy Na...",Warehouse B,71,56,2025-02-02 03:39:00,15
30874,ORD_30875,22997,Rosera 20mg Tablet,Warehouse B,28,20,2025-02-02 21:56:00,8
30875,ORD_30876,7855,Adprim S Suspension,Warehouse B,26,12,2025-02-02 22:19:00,14
30876,ORD_30877,9486,"Deep Cleanse Facial Ubtan - Papaya & Red Sandalwood, For Tridosha",Warehouse C,99,86,2025-02-02 08:54:00,13
30877,ORD_30878,20194,Makeup Foundation Blend Blush Brush With Sponge Puff Combo Pack of 2,Warehouse C,27,11,2025-02-02 08:35:00,16
30878,ORD_30879,17861,Action Pro 4-Way Adjustment Base Front Chin Mount Full Face Helmet Compatible with GoPro Hero 10 9 8 7 6 5 4 3+ 3 SJCAM YI...,Warehouse B,17,3,2025-02-01 02:59:00,14
30879,ORD_30880,29923,Olmesafe H 12.5mg/40mg Tablet,Warehouse B,31,19,2025-02-01 14:13:00,12
30880,ORD_30881,18290,Flormar Dewy Lip Glaze 04 Undressed 4.5 ml,Warehouse A,84,73,2025-02-01 00:56:00,11
30881,ORD_30882,17884,Z Pred Eye Drop,Warehouse C,26,8,2025-02-01 15:22:00,18
30882,ORD_30883,1584,Monocon 50mg Dry Syrup,Warehouse B,72,58,2025-02-01 17:59:00,14
30883,ORD_30884,18308,Supreme Suhag Red Color Kumkum Round Bindi Box with 15 Flaps (D05-06mm) S5,Warehouse A,13,8,2025-02-01 07:56:00,5
30884,ORD_30885,34366,"Classmate Pulse 6 Subject Notebook - Unruled, 300 Pages, Spiral Binding, 240mm*180mm",Warehouse B,37,26,2025-02-01 10:00:00,11
30885,ORD_30886,29790,Ajmal Aurum Avid Sacrifice II Deodorant Spray (Pack of 3) 200 ml,Warehouse C,114,99,2025-02-01 08:38:00,15
30886,ORD_30887,34903,Absolute White Intense Wet & Dry Compact,Warehouse A,102,83,2025-02-01 13:15:00,19
30887,ORD_30888,29796,Beard Vitalizer,Warehouse B,97,87,2025-02-01 09:40:00,10
30888,ORD_30889,29960,"MOCA Ultra Slim Lightweight PU Leather Magnetic Smart Folio Flip Cover Case for Apple iPad Air 2/iPad A1566/A1567, 2014 La...",Warehouse B,25,16,2025-02-01 19:17:00,9
30889,ORD_30890,4097,Shwas 8 mg/2.4 mg/100 mg Capsule,Warehouse B,76,60,2025-02-01 14:30:00,16
30890,ORD_30891,1618,Glucomap Ayurvedic Medicine For Diabetes Type 2,Warehouse B,94,76,2025-02-01 17:32:00,18
30891,ORD_30892,25817,Febutop 80 Tablet,Warehouse C,83,65,2025-02-01 07:29:00,18
30892,ORD_30893,17948,Taft Looks Marathon Power Gel - Long Lasting Hold 6,Warehouse C,39,27,2025-02-01 12:59:00,12
30893,ORD_30894,17938,Hydro Replenish Refreshing Face Mist,Warehouse B,53,47,2025-02-01 13:43:00,6
30894,ORD_30895,14948,Remigan 10 mg/40 mg Drop,Warehouse B,30,22,2025-02-01 03:50:00,8
30895,ORD_30896,6253,Allerzine 10mg Tablet,Warehouse B,104,88,2025-02-01 19:05:00,16
30896,ORD_30897,30421,Silomax 4mg Capsule,Warehouse B,88,73,2025-02-01 10:43:00,15
30897,ORD_30898,25828,Spigen Ultra Hybrid Cover Case Designed for Samsung Galaxy Buds2 Pro (2022) | Galaxy Buds 2 (2021) | Galaxy Buds Pro (202...,Warehouse A,38,28,2025-02-01 18:25:00,10
30898,ORD_30899,34433,"Sounce Essentials Professional 6-in-1 Cleaning Kit for Cameras & Sensitive Electronics (Includes: Air Blower, Cotton Swab...",Warehouse B,115,96,2025-02-01 22:23:00,19
30899,ORD_30900,17956,"Lenovo Tab P11 Plus Tablet (11 inch (27.94 cm), 6 GB, 128 GB, Wi-Fi+LTE, Voice Calling), Slate Grey with 2K Display, Quad ...",Warehouse B,67,51,2025-02-01 06:16:00,16
30900,ORD_30901,17962,Redmi Note 12 5G Frosted Green 4GB RAM 128GB ROM | 1st Phone with 120Hz Super AMOLED and Snapdragon® 4 Gen 1 | 48MP AI Tri...,Warehouse C,105,97,2025-02-01 10:41:00,8
30901,ORD_30902,29992,Tasya Kakadu Plum Vit C Tan Removal Face Pack 100 gm,Warehouse A,43,26,2025-02-01 02:16:00,17
30902,ORD_30903,8928,Konaz 2% Shampoo,Warehouse C,103,86,2025-02-01 19:19:00,17
30903,ORD_30904,3980,Glamyou Multicolor Bindi Daily Use Simple Forehead Bindi For Women - Pack of 4 Boxes (Bindi Size : 1.5mm each),Warehouse B,82,65,2025-02-01 11:29:00,17
30904,ORD_30905,10586,AIV TECH Edge To Edge Tempered Glass For Google Pixel 6A with Easy Installation Kit,Warehouse A,30,21,2025-02-01 19:28:00,9
30905,ORD_30906,30558,House Of Makeup Good On You Hydra Matte Lipstick - Raisin & Shine 3.5 gm,Warehouse A,109,96,2025-02-01 18:03:00,13
30906,ORD_30907,18342,Lakme Forever Matte Liquid Lip Colour Red Revival 5.6 Ml,Warehouse A,100,84,2025-02-01 05:36:00,16
30907,ORD_30908,794,Archies Parfum 01 WOMEN DEO COMBO 400 ml,Warehouse B,68,55,2025-02-01 03:25:00,13
30908,ORD_30909,23917,Movon 500mg/50mg/325mg Tablet,Warehouse C,30,23,2025-02-01 19:01:00,7
30909,ORD_30910,18344,Agaro Blaze USB 3.0 to USB Type C OTG Adapter,Warehouse A,96,87,2025-02-01 23:29:00,9
30910,ORD_30911,1489,Fundys 75mg Tablet SR,Warehouse C,97,82,2025-02-01 19:18:00,15
30911,ORD_30912,4010,Cortlic 6mg Tablet,Warehouse B,94,89,2025-02-01 07:07:00,5
30912,ORD_30913,1488,Mecotic P 500mcg/75mg Tablet,Warehouse C,81,62,2025-02-01 23:40:00,19
30913,ORD_30914,34568,Brufen 200 Tablet,Warehouse C,94,77,2025-02-01 17:07:00,17
30914,ORD_30915,34571,Professional Herbal Almond Facial Massage Cream - Moisturise Sensitive Skin,Warehouse C,103,97,2025-02-01 05:13:00,6
30915,ORD_30916,10632,Technotech Universal All in One World Travel Adapter Surge Protector Charger Plug (TTC291),Warehouse A,45,39,2025-02-01 10:16:00,6
30916,ORD_30917,12467,Drosec 125mg Syrup,Warehouse A,18,4,2025-02-01 02:31:00,14
30917,ORD_30918,34749,Brikdol-SP Tablet,Warehouse C,63,51,2025-02-01 21:53:00,12
30918,ORD_30919,6340,Nimcox P Tablet,Warehouse C,32,20,2025-02-01 05:26:00,12
30919,ORD_30920,29846,"SupCares Edge to Edge Tempered Glass for iPhone 14, iPhone 13 and 13 Pro (6.1 Inch) with Easy Self Installation Kit | Black",Warehouse C,35,20,2025-02-01 22:24:00,15
30920,ORD_30921,7215,Redustat Plus 10mg/200mg Tablet,Warehouse C,53,43,2025-02-01 14:25:00,10
30921,ORD_30922,29856,SupCares Edge to Edge Privacy Tempered Glass for iPhone 14 Pro (6.1 Inch) with Easy Self Installation Kit | Black,Warehouse C,48,30,2025-02-01 16:37:00,18
30922,ORD_30923,4057,"Ustraa Hair Cream for Men - For Daily Use - (Set of 2) Style & nourishment - Non-sticky, Non-oily - Sulphate & Paraben FREE",Warehouse A,64,56,2025-02-01 08:46:00,8
30923,ORD_30924,12299,NOTE LUMINOUS SILK COMPACT POWDER 08 10 gm,Warehouse A,94,84,2025-02-01 15:52:00,10
30924,ORD_30925,34870,"ID-116 Smartwatch for Men's Womens Boys Girls, Bluetooth Smart Fitness Band Watch with Heart Rate Activity Tracker Step & ...",Warehouse B,52,43,2025-02-01 21:43:00,9
30925,ORD_30926,29866,"Ant Value FKBRI05 Multimedia Wireless Keyboard & Mouse Combo, Compact Light-Weight for PCs, Laptops & Smart TV (Black)",Warehouse C,60,48,2025-02-01 03:20:00,12
30926,ORD_30927,29869,"Acko 1 Year Extended Warranty for Laptops from Rs 40,000 to Rs 60,000 (E-mail delivery)",Warehouse B,103,91,2025-02-01 16:43:00,12
30927,ORD_30928,1591,"Samsung Galaxy M04 Light Green, 4GB RAM, 128GB Storage | Upto 8GB RAM with RAM Plus | MediaTek Helio P35 | 5000 mAh Battery",Warehouse C,81,69,2025-02-01 22:49:00,12
30928,ORD_30929,30507,Liv Daily Capsule,Warehouse B,92,75,2025-02-01 14:15:00,17
30929,ORD_30930,25849,Q-Mol Oral Suspension,Warehouse C,81,67,2025-02-01 12:45:00,14
30930,ORD_30931,18240,"Sanfe Intimate Lightening Serum - 50g | For Dark Underarms, Inner Thighs, Knees And Bikini Area | With Kojic Acid, Vitamin...",Warehouse B,16,6,2025-02-01 01:08:00,10
30931,ORD_30932,32495,7SEVEN® Compatible Tata Sky Remote Control Replacement of Original dth SD HD tata Play Set top Box Remote - IR Learning Un...,Warehouse B,67,59,2025-02-01 15:16:00,8
30932,ORD_30933,25593,Daily Life Forever52 Long Wear El Eyeliner & Tattoo Gt008 5 GM,Warehouse A,55,44,2025-02-01 20:16:00,11
30933,ORD_30934,6231,Blackstar Nano MAG Car Mobile Holder - Car Mount - Magnetic Mobile Holder for Car ( Smallest Magnetic Mobile Holder with S...,Warehouse B,45,26,2025-02-01 07:03:00,19
30934,ORD_30935,25586,Ajmal Ascend EDP & Deep Earth EDT Pack of 2 350 ml,Warehouse A,28,12,2025-02-01 08:36:00,16
30935,ORD_30936,17914,Flormar Silk Matte Liquid Lipstick 016 Hot Cocoa 4.5 gm,Warehouse B,61,56,2025-02-01 18:22:00,5
30936,ORD_30937,1290,Telsmarc Beta 40mg/25mg Tablet ER,Warehouse A,35,27,2025-02-01 15:47:00,8
30937,ORD_30938,15200,Doupod 200 Tablet,Warehouse B,10,4,2025-02-01 08:33:00,6
30938,ORD_30939,3268,Kynicold Syrup,Warehouse B,105,94,2025-02-01 18:11:00,11
30939,ORD_30940,1569,Thyroxinol 25 Tablet,Warehouse B,76,70,2025-02-01 13:52:00,6
30940,ORD_30941,28559,Panvic 40mg Tablet,Warehouse B,77,61,2025-02-01 11:20:00,16
30941,ORD_30942,33556,Zolpa 10 Tablet,Warehouse C,115,97,2025-02-01 00:27:00,18
30942,ORD_30943,24431,FF&D F3800X 160 W 5.1 Channel Bluetooth Home Audio Speaker & Home Theater System,Warehouse B,91,81,2025-02-01 09:14:00,10
30943,ORD_30944,31388,Azicip 500 Tablet,Warehouse A,104,90,2025-02-01 01:18:00,14
30944,ORD_30945,11136,Mother Sparsh 98% Water Based Wipes 80's,Warehouse C,13,5,2025-02-01 15:21:00,8
30945,ORD_30946,10094,L.A Girl HD PRO Face Pressed Powder Soft Honey 7 gm,Warehouse C,23,7,2025-02-01 00:00:00,16
30946,ORD_30947,4738,Avgesic-CR Tablet,Warehouse B,58,40,2025-02-01 13:26:00,18
30947,ORD_30948,4740,Empia Gel Sugar Free,Warehouse C,112,99,2025-02-01 12:22:00,13
30948,ORD_30949,5994,Uziq S 250mg/125mg Injection,Warehouse A,32,16,2025-02-01 01:37:00,16
30949,ORD_30950,25240,Worison Pocket Size Spiral Sticky Note Pad,Warehouse B,13,8,2025-02-01 08:13:00,5
30950,ORD_30951,14183,Holistic Regenerating Exfoliator,Warehouse B,45,38,2025-02-01 07:04:00,7
30951,ORD_30952,4756,Coffit-DX Syrup,Warehouse C,56,49,2025-02-01 08:50:00,7
30952,ORD_30953,31448,"Rissachi Premium Heavy Duty Wall Mount Stand for 17 to 32-inch LCD LED TV (Black, Wall Mount)",Warehouse B,28,11,2025-02-01 07:59:00,17
30953,ORD_30954,2069,Jovees Face Scrub - Papaya & Honey 100 Gm,Warehouse A,90,71,2025-02-01 23:24:00,19
30954,ORD_30955,10086,Nano Cold Tablet,Warehouse A,50,40,2025-02-01 01:35:00,10
30955,ORD_30956,756,Ajmal Selfie Concentrated Perfume Oil Woody Aromatic And Carbon Homme Deodorant Citrus Spicy Fragrance 210 ml,Warehouse A,37,25,2025-02-01 12:57:00,12
30956,ORD_30957,19009,Ceastra 100 Capsule,Warehouse C,77,61,2025-02-01 03:47:00,16
30957,ORD_30958,25246,Saranac Plus Tablet,Warehouse C,79,61,2025-02-01 06:05:00,18
30958,ORD_30959,22634,Surgicef 1000mg Injection,Warehouse C,83,71,2025-02-01 16:43:00,12
30959,ORD_30960,7016,"Pantene Advanced Hair Fall Solution Long Black Shampoo, 650 ml",Warehouse B,85,79,2025-02-01 00:29:00,6
30960,ORD_30961,15120,Faces Canada No Transfer Matte Lipstick B-Town Babe 03 3.5 Ml,Warehouse B,98,84,2025-02-01 04:59:00,14
30961,ORD_30962,4743,Suminat 50 Tablet,Warehouse B,61,49,2025-02-01 01:40:00,12
30962,ORD_30963,33507,"Mary Paxton 2PACK Microblading Eyebrow Ruler,Makeup Measure Eyebrow Guide Ruler Permanent Tools Calipers Tattoo Eyebrow Li...",Warehouse A,67,52,2025-02-01 20:23:00,15
30963,ORD_30964,33514,RED4 Liquid Lipstick Matte Finish Natural Colors Non Transfer Long stay lipsticks for Girls Womena Nude Cofee Red Maroon S...,Warehouse A,49,34,2025-02-01 21:46:00,15
30964,ORD_30965,28633,Onlord 10mg Tablet,Warehouse A,88,76,2025-02-01 13:57:00,12
30965,ORD_30966,24412,Yellow Balm,Warehouse B,23,5,2025-02-01 08:02:00,18
30966,ORD_30967,22629,Rapidsflow® Straight Colored Hair Streak/Hair Extensions For Women And Girls Real Hair For Highlighting (Set Of 4 pc) (Black),Warehouse C,68,60,2025-02-01 06:10:00,8
30967,ORD_30968,3272,Bacozid 1000mg Injection,Warehouse A,98,90,2025-02-01 16:53:00,8
30968,ORD_30969,34630,Pro Anti Dandruff Hair Cream,Warehouse B,101,94,2025-02-01 02:36:00,7
30969,ORD_30970,11139,Skin Purifying Jasmine Aroma Mask,Warehouse C,69,54,2025-02-01 19:04:00,15
30970,ORD_30971,7025,"SanDisk Cruzer Force USB Flash Drive, CZ71 16GB, USB2.0, Durable Metal Casing",Warehouse A,43,27,2025-02-01 01:38:00,16
30971,ORD_30972,15267,ONSITEGO 1 Year Extended Warranty for Audio Systems,Warehouse A,90,71,2025-02-01 09:25:00,19
30972,ORD_30973,34822,Cure Itra 200mg Capsule,Warehouse B,31,20,2025-02-01 12:15:00,11
30973,ORD_30974,8997,"Ovking Professional Makeup Combo 18 Color Nude Eyeshadow Palette, 12 Pcs Brush, Matte + Poreless Liquid Foundation, Fixer,...",Warehouse A,52,43,2025-02-01 05:39:00,9
30974,ORD_30975,12512,FitSpark New Eagle Series Action Cameras (Eagle i9 Plus),Warehouse B,105,91,2025-02-01 22:13:00,14
30975,ORD_30976,25597,RoboCraze UNO R3 SMD Board compatible with Arduino | Development Board with USB cable,Warehouse A,47,30,2025-02-01 19:13:00,17
30976,ORD_30977,8243,Sunaina Bridal Collection Red Bindi For Women & Girls (Size-1) (6MM),Warehouse B,59,51,2025-02-01 05:59:00,8
30977,ORD_30978,34401,Moxbro 250mg Capsule,Warehouse B,64,49,2025-02-01 10:10:00,15
30978,ORD_30979,14927,House Of Makeup Nail Lacquer - Maasai Red 12 ml,Warehouse C,84,77,2025-02-01 03:14:00,7
30979,ORD_30980,34412,Dexanil 5mg Tablet,Warehouse B,90,75,2025-02-01 20:56:00,15
30980,ORD_30981,34825,Bio Active Intense Night Therapy Cream,Warehouse C,38,23,2025-02-01 07:02:00,15
30981,ORD_30982,29945,Flucamag 150mg Tablet,Warehouse A,26,17,2025-02-01 22:02:00,9
30982,ORD_30983,29952,White Beauty SPF 15 PA Fairness Cream,Warehouse C,65,50,2025-02-01 07:06:00,15
30983,ORD_30984,18219,Camel Fabrica Acrylic Ultra Pearl and Metallic Colour Set - Pack of 20 (White),Warehouse C,48,42,2025-02-01 22:43:00,6
30984,ORD_30985,22193,ZOUL Type C to Type C Fast Charging Cable 65W USB C to USB C Nylon Braided Cord Compatible with Macbook Air Oneplus 9R Sam...,Warehouse A,77,70,2025-02-01 22:41:00,7
30985,ORD_30986,31272,Etidix-E 5 Tablet,Warehouse B,64,47,2025-02-01 10:13:00,17
30986,ORD_30987,25615,Diclocure S Tablet,Warehouse C,100,87,2025-02-01 22:43:00,13
30987,ORD_30988,33938,Comfabie Women's Fashion Backpack Purses Multipurpose Design Handbags and Shoulder Bag PU Leather Travel bag Vegan Leather...,Warehouse A,72,59,2025-02-01 09:34:00,13
30988,ORD_30989,14561,Greyon Liquid Lip Gloss Red 83,Warehouse B,31,14,2025-02-01 00:18:00,17
30989,ORD_30990,7109,Ziletiz 5mg Tablet,Warehouse A,87,69,2025-02-01 19:20:00,18
30990,ORD_30991,6000,Anthro 50mg Capsule,Warehouse A,66,53,2025-02-01 04:41:00,13
30991,ORD_30992,35887,Ofoxo 200mg Tablet,Warehouse B,78,59,2025-02-01 22:06:00,19
30992,ORD_30993,10097,Taft Shine Gel Wax,Warehouse A,30,23,2025-02-01 01:34:00,7
30993,ORD_30994,31419,Diseglim Forte 4mg Tablet,Warehouse A,70,61,2025-02-01 06:10:00,9
30994,ORD_30995,2052,Zedom 40 Tablet,Warehouse C,114,99,2025-02-01 08:09:00,15
30995,ORD_30996,21954,Sifix-O 200mg/200mg Tablet,Warehouse C,20,15,2025-02-01 21:35:00,5
30996,ORD_30997,3232,Novadec 25mg Injection,Warehouse B,69,62,2025-02-01 09:10:00,7
30997,ORD_30998,6002,"Vaadi Herbals Lip Balm, Strawberry And Honey, 10g (Pack Of 4)",Warehouse A,17,9,2025-02-01 23:39:00,8
30998,ORD_30999,15126,Voglizen 0.3mg Tablet,Warehouse C,50,33,2025-02-01 09:47:00,17
30999,ORD_31000,18569,Tulsi Capsules,Warehouse C,34,22,2025-02-01 07:14:00,12
31000,ORD_31001,34636,Tough Lee Tempered Glass Screen Protector Guard for Lenovo Tab M10 Plus FHD (2nd Gen) (TB-X606X / TB-X606V / TB-X606F) (1...,Warehouse C,28,21,2025-02-01 16:14:00,7
31001,ORD_31002,34503,Spigen EZ Fit Tempered Glass Screen Protector Guard for iPhone 14 Plus / 13 Pro Max - 2 Pack,Warehouse A,90,79,2025-02-01 10:59:00,11
31002,ORD_31003,30802,INDUS VALLEY Ultra Rich Replenishing Shea Butter Fruit Face Scrub - (50ml),Warehouse A,80,62,2025-02-01 08:06:00,18
31003,ORD_31004,29420,TheGiftKart Tough Armor Bumper Back Case Cover for OnePlus 11R 5G | Ring Holder & Kickstand in-Built | 360 Degree Protecti...,Warehouse B,40,24,2025-02-01 23:57:00,16
31004,ORD_31005,10901,TheGiftKart Shockproof Crystal Clear Back Cover Case for Samsung Galaxy M13 4G | 360 Degree Protection | Protective Design...,Warehouse B,65,48,2025-02-01 03:20:00,17
31005,ORD_31006,30797,AmazonBasics High-Speed Mini-HDMI (NOT MICRO USB/MICRO HDMI) to HDMI Cable - 3 Feet (Latest Standard)- NOT COMPATIBLE WITH...,Warehouse A,80,66,2025-02-01 10:52:00,14
31006,ORD_31007,14658,"Ningen Bearberry Underarm Cream I Added Calendula and Jojoba Extracts I Dermatologically Tested, Paraben Free I 100g",Warehouse B,42,30,2025-02-01 08:11:00,12
31007,ORD_31008,14664,Mi Business Casual 21L Water Resistant Laptop Backpack (Dark Grey),Warehouse B,79,64,2025-02-01 08:20:00,15
31008,ORD_31009,20803,"Cucumber Water - Cleanser & Toner, For Men & Women",Warehouse A,80,66,2025-02-01 00:26:00,14
31009,ORD_31010,30823,Semi Glim Total 2 mg Tablet SR,Warehouse A,27,12,2025-02-01 15:31:00,15
31010,ORD_31011,6142,Miss Rose Professional Make-up High Pigment Glitter Eyeshadow for Professional Makeup Shimmery Finish - Green,Warehouse A,20,6,2025-02-01 10:31:00,14
31011,ORD_31012,26054,PUMA 23 Ltrs Puma Black Laptop Backpack (7574901),Warehouse A,94,88,2025-02-01 07:36:00,6
31012,ORD_31013,30825,Cefdop CV Syrup,Warehouse C,38,28,2025-02-01 04:20:00,10
31013,ORD_31014,7139,Eau de Perfume - Imperial Patchouli For Women,Warehouse A,41,27,2025-02-01 18:57:00,14
31014,ORD_31015,29327,Arfast MR 100mg/325mg/250mg Tablet,Warehouse A,49,37,2025-02-01 20:46:00,12
31015,ORD_31016,14634,Be Bodywise 2% AHA Body Wash | Helps Exfoliates & Promotes Glowing & Radiant Skin | 250 mL,Warehouse A,68,59,2025-02-01 21:58:00,9
31016,ORD_31017,35243,"Logitech Plug and Play USB Keyboard K120, Black",Warehouse A,22,6,2025-02-01 22:51:00,16
31017,ORD_31018,6457,Amlovas-M 2.5mg/50mg Tablet,Warehouse A,54,49,2025-02-01 10:29:00,5
31018,ORD_31019,15500,Gse+tx Tablet,Warehouse B,86,71,2025-02-01 22:22:00,15
31019,ORD_31020,12180,Lavender Dew Perfumed Talc,Warehouse A,36,26,2025-02-01 03:05:00,10
31020,ORD_31021,1769,Canada - Bath N Body Milk & Honey Body Scrub,Warehouse A,70,63,2025-02-01 18:39:00,7
31021,ORD_31022,15498,Osia Osia Royal Arabian Oud 125 gm,Warehouse A,96,82,2025-02-01 16:47:00,14
31022,ORD_31023,10920,"Giovanni Organic Tea Tree Triple Treat Invigorating Shampoo with No Parabens, No Sulphates, No Mineral Oil, No Colours, No...",Warehouse A,67,59,2025-02-01 17:32:00,8
31023,ORD_31024,26033,"CZARTECH [1.2 Mt USB-C cable Compatible with i-Phone, i-Pad and More, 20W Fast Charging,Power Delivery Cable [Nylon Braide...",Warehouse A,60,45,2025-02-01 19:40:00,15
31024,ORD_31025,29366,"Parag Fragrances Sandal Attar 4 In 1 Combo (Gold Sandal, Sandal Balaji, Real Sandal & Sandal Kesar) Real, Natural & Alcoho...",Warehouse A,61,47,2025-02-01 06:39:00,14
31025,ORD_31026,1106,INEFABLE® Pubg Battleground Anti-Slip Thumb Finger Multi-Color Sleeve Slip-Proof Sweat-Proof Professional Touch Screen for...,Warehouse A,22,10,2025-02-01 06:45:00,12
31026,ORD_31027,29372,Nasowel - SC Nasal Drops,Warehouse C,85,74,2025-02-01 07:55:00,11
31027,ORD_31028,35210,"Portronics Ear 1 in-Ear Wired Earphones Crystal Clear Sound with Mic. I Metal Earbuds, TPE + Nylon Braided Wire(White)",Warehouse A,55,40,2025-02-01 22:53:00,15
31028,ORD_31029,15364,ADDMAX Extension Cord with USB Port – 10A 220V-50/60Hz [6 socket Outlet with 2 USB Port] [Fire flame proof] [USB Charging ...,Warehouse B,65,52,2025-02-01 04:12:00,13
31029,ORD_31030,29756,"Joyesa 5 in 1 Lipsticks for Women, Red & Nude Edition Pro Colors Hydrating Lips Velvety Matte Finish Shades, 7.5g, Pack of...",Warehouse A,49,44,2025-02-01 02:49:00,5
31030,ORD_31031,23915,Bio Margosa Neem Shampoo & Conditioner 180 Ml,Warehouse A,23,16,2025-02-01 13:22:00,7
31031,ORD_31032,18501,Mandarin & Cypress Luxury Shower Gel,Warehouse A,22,8,2025-02-01 20:29:00,14
31032,ORD_31033,23818,Precarise 75mg Tablet,Warehouse A,69,54,2025-02-01 22:26:00,15
31033,ORD_31034,18503,Fren 500mg Tablet,Warehouse B,90,85,2025-02-01 17:56:00,5
31034,ORD_31035,35781,Faces Canada Ultime Pro Lip Definer Maroon 06 0.35 Gm,Warehouse B,92,79,2025-02-01 17:06:00,13
31035,ORD_31036,34037,Calpol 120mg Suspension Strawberry,Warehouse A,73,63,2025-02-01 01:36:00,10
31036,ORD_31037,20766,"Cetaphil Restoraderm Body Moisturizer, Shea Butter, 295 ml",Warehouse C,48,43,2025-02-01 08:44:00,5
31037,ORD_31038,10346,Telmitan 40 Tablet,Warehouse C,49,33,2025-02-01 04:10:00,16
31038,ORD_31039,1060,"Cosmic Byte CB-GK-16 Firefly Per-Key RGB TKL Mechanical Keyboard with Swappable Outemu Blue Switch, Macros, Software (Black)",Warehouse B,36,31,2025-02-01 05:52:00,5
31039,ORD_31040,10971,Deual-L Capsule SR,Warehouse B,104,87,2025-02-01 16:50:00,17
31040,ORD_31041,23752,Baby Hair Oil - With Organic & ColdPressed Natural Oil,Warehouse A,109,94,2025-02-01 05:18:00,15
31041,ORD_31042,23756,Astrotel H 80mg/12.5mg Tablet,Warehouse C,43,24,2025-02-01 14:31:00,19
31042,ORD_31043,21257,Ajmal Aurum Avid Silvershade Deodorant Spray (Pack of 3) 200 ml,Warehouse A,68,51,2025-02-01 11:23:00,17
31043,ORD_31044,23758,"Toothpaste - Gum Care, Expert Protection",Warehouse B,69,52,2025-02-01 20:53:00,17
31044,ORD_31045,35353,"Dermafique Aqua Cloud Light Moisturising Crème, 200g for Normal, Oily, Dry and Combination Skin for Soft Hydrated Glowing ...",Warehouse C,25,8,2025-02-01 03:15:00,17
31045,ORD_31046,22464,Lavidiclo SP 50mg/325mg/15mg Tablet,Warehouse C,78,71,2025-02-01 13:52:00,7
31046,ORD_31047,29242,HP 805XL Black Original Ink Cartridge,Warehouse C,13,6,2025-02-01 13:41:00,7
31047,ORD_31048,8389,I AM EYECONIC BIODEGRADABLE GLITTER MIRROR 4 gm,Warehouse A,28,15,2025-02-01 10:06:00,13
31048,ORD_31049,8854,Texar S 1000mg/500mg Injection,Warehouse C,46,33,2025-02-01 14:28:00,13
31049,ORD_31050,8380,Brustro Folding Box 33 Well Plastic Palette 26x13 cm,Warehouse B,53,47,2025-02-01 09:05:00,6
31050,ORD_31051,21238,Cyprolac Syrup,Warehouse A,57,43,2025-02-01 02:02:00,14
31051,ORD_31052,24271,Manish Malhotra Methi Face Scrub Gel 50 Gm,Warehouse B,97,87,2025-02-01 00:21:00,10
31052,ORD_31053,29265,INOVERA (LABEL) Nylon Professional Cosmetic Makeup Kit Storage Organizer Travel Toiletry Vanity Bag with Adjustable Compar...,Warehouse C,57,42,2025-02-01 21:25:00,15
31053,ORD_31054,14630,Ifnopime 1gm Injection,Warehouse B,40,23,2025-02-01 04:17:00,17
31054,ORD_31055,1780,Ads Panstick Tender Effect Charm Non Stop Protection Concealer (25 g),Warehouse A,83,73,2025-02-01 08:39:00,10
31055,ORD_31056,22117,Relax - Lavender Handmade Bathing Bar With Natural Chunks,Warehouse A,91,80,2025-02-01 22:38:00,11
31056,ORD_31057,29387,Veltramol 325 mg/37.5 mg Tablet,Warehouse B,49,43,2025-02-01 14:38:00,6
31057,ORD_31058,18513,"Long & Black Shampoo - With Goodness Of Amla & Bhringraj, For Shiny, Black Hair",Warehouse B,98,82,2025-02-01 09:20:00,16
31058,ORD_31059,12190,"Octrix Lightning to 3.5 mm Headphone Jack Adapter for iOS 13 and Later, Audio AUX Converter Cable iOS to 3.5mm Headphone/E...",Warehouse A,40,34,2025-02-01 08:01:00,6
31059,ORD_31060,4304,Omnix 100 Dry Syrup Strawberry,Warehouse B,26,13,2025-02-01 06:47:00,13
31060,ORD_31061,25461,Docef 50mg Dry Syrup,Warehouse A,79,72,2025-02-01 06:33:00,7
31061,ORD_31062,30329,Fexocon-M 10mg/120mg Tablet,Warehouse A,43,30,2025-02-01 06:13:00,13
31062,ORD_31063,3842,"Pidilite Rangeela Holi Ke Rang - 4 Fluorescent Shades of Holi Colours (Floro Pink, Floro Yellow, Floro Orange, Floro Gree...",Warehouse B,86,78,2025-02-01 05:45:00,8
31063,ORD_31064,34508,Walagra 50mg Tablet,Warehouse A,92,74,2025-02-01 16:48:00,18
31064,ORD_31065,34654,"Fashion Colour Satin Smooth Lip Definer, 2 Sweet Cherry 1.41 gm",Warehouse A,25,10,2025-02-01 21:46:00,15
31065,ORD_31066,3929,Hair Conditioner - Long & Healthy Growth,Warehouse C,61,43,2025-02-01 15:57:00,18
31066,ORD_31067,3928,"Zebronics ZEB-VITA Wireless Bluetooth 10W Portable Bar Speaker With Supporting USB, SD Card, AUX, FM, TWS & Call Function",Warehouse B,27,17,2025-02-01 18:45:00,10
31067,ORD_31068,10664,Rosumac CV 20mg/75mg Tablet,Warehouse A,37,32,2025-02-01 03:48:00,5
31068,ORD_31069,12413,Fashion Colour Charcoal Face Scrub 130 gm,Warehouse B,89,80,2025-02-01 22:13:00,9
31069,ORD_31070,30257,Rhinoban XP Syrup,Warehouse B,86,77,2025-02-01 19:07:00,9
31070,ORD_31071,30254,"Fast Quick Type C Charger for Samsung Galaxy M32, M 32 Charger Original Mobile Charger Wall Charger, Android Smartphone Ch...",Warehouse C,105,92,2025-02-01 08:45:00,13
31071,ORD_31072,34575,Levepsy 250 Tablet,Warehouse A,46,37,2025-02-01 12:35:00,9
31072,ORD_31073,15100,Mefenil 80mg/250mg Tablet DT,Warehouse A,103,87,2025-02-01 00:52:00,16
31073,ORD_31074,22240,"Genie Flamenco Laptop Backpack for Women, 16 inches Office Bag, Sky Blue Stylish and Trendy Bag for Office and College",Warehouse B,80,73,2025-02-01 16:31:00,7
31074,ORD_31075,1452,Allure Large Blender Brush (ASB228) 1's,Warehouse B,105,92,2025-02-01 02:51:00,13
31075,ORD_31076,7261,"iClever DK03 Bluetooth Keyboard and Mouse Set, Rechargeable Dual-Mode (Bluetooth + 2.4G) Wireless Keyboard and Mouse Set, ...",Warehouse A,96,84,2025-02-01 07:14:00,12
31076,ORD_31077,30240,Mazithro 250mg Tablet,Warehouse B,98,85,2025-02-01 19:00:00,13
31077,ORD_31078,3879,Mother Sparsh Baby Dusting Powder (0-5 yrs) 100 gm,Warehouse C,14,4,2025-02-01 09:30:00,10
31078,ORD_31079,18078,Sconac SP 50mg/325mg/15mg Tablet,Warehouse A,56,37,2025-02-01 14:46:00,19
31079,ORD_31080,1459,"F&D A180X 84 W 2.1 Channel Bluetooth Multimedia Speaker with Subwoofer Satellite Speaker, Digital LED Display, Remote, Dig...",Warehouse B,44,37,2025-02-01 04:47:00,7
31080,ORD_31081,10641,"Loofah/Sponge Scrubber/Body Bath  - Hangable, Black, BH-026 BLK",Warehouse C,18,12,2025-02-01 23:48:00,6
31081,ORD_31082,18111,"GoRogue Stud Foldable Wooden Mini Lapdesk for Couch, Sofa Bed, Study Tray Table Stand for Writing (Walnut)",Warehouse A,26,20,2025-02-01 17:41:00,6
31082,ORD_31083,10644,Zimspore 100mg Tablet,Warehouse B,97,80,2025-02-01 07:46:00,17
31083,ORD_31084,12414,"POCO C31 (Royal Blue, 64 GB) (4 GB RAM)",Warehouse B,31,19,2025-02-01 16:50:00,12
31084,ORD_31085,3893,"Sounce USB Charger Charging Magnetic Dock 1 Meter Cable for Honor Band 5, 4, 3, Band 2 Pro, Huawei Band 3 Pro",Warehouse C,108,90,2025-02-01 05:18:00,18
31085,ORD_31086,30301,boAt Bassheads 242 in Ear Wired Earphones with Mic(Spirit Lime),Warehouse B,37,25,2025-02-01 15:28:00,12
31086,ORD_31087,3849,Miss Claire Charcoal O2 Bubble Purifying Mask 20 Gm,Warehouse B,58,47,2025-02-01 23:15:00,11
31087,ORD_31088,24062,"Samsung Galaxy Buds 2 | Active Noise Cancellation, Auto Switch Feature, Up to 20hrs Battery Life, (Graphite)",Warehouse A,50,45,2025-02-01 18:39:00,5
31088,ORD_31089,18051,Althor 500mg Tablet,Warehouse C,60,43,2025-02-01 18:48:00,17
31089,ORD_31090,25759,Medimade Cocoa Butter And Shea Butter Moisturizing Body Lotion (Pack of 2) 1's,Warehouse C,35,20,2025-02-01 01:14:00,15
31090,ORD_31091,25758,"Nokia 5310 Dual SIM Keypad Phone with MP3 Player, Wireless FM Radio and Rear Camera with Flash | Black/Red",Warehouse A,62,50,2025-02-01 06:42:00,12
31091,ORD_31092,25716,Bricarex A Expectorant Apple Sugar Free,Warehouse A,110,93,2025-02-01 07:07:00,17
31092,ORD_31093,30342,"SanDisk 2TB Extreme Pro Portable SSD 2000MB/s R/W, Upto 2 Meter Drop Protection with IP55 Water and dust Resistance, Metal...",Warehouse A,65,52,2025-02-01 11:21:00,13
31093,ORD_31094,10701,Kapither 75mg Injection,Warehouse B,33,14,2025-02-01 07:59:00,19
31094,ORD_31095,12450,Dealfreez Case Compatible with Fire TV Stick 3rd Gen 2021 Full Wrap Silicone Remote Cover Anti-Lost with Loop (D-Black),Warehouse C,101,82,2025-02-01 09:43:00,19
31095,ORD_31096,3814,Dly BB Cream Foundation of Rose Moisture (1),Warehouse C,39,20,2025-02-01 05:30:00,19
31096,ORD_31097,8305,Genoptic B Eye Drop,Warehouse C,82,65,2025-02-01 11:47:00,17
31097,ORD_31098,21088,Pre Shave Foam - Classic Lemon Lime,Warehouse A,52,33,2025-02-01 13:58:00,19
31098,ORD_31099,12361,Vildanex-M SR Tablet,Warehouse A,62,43,2025-02-01 13:45:00,19
31099,ORD_31100,34673,Stuffcool PB9063W 5000mAh Magnetic Powerbank Compatible with Apple Watch Charging and Leather Kick Stand,Warehouse B,45,26,2025-02-01 01:52:00,19
31100,ORD_31101,30561,"Fashion Colour Colour Correction Makeup Base Single Packing, FS28 3.5 gm",Warehouse B,26,7,2025-02-01 02:00:00,19
31101,ORD_31102,12365,Natural Green Tea Body Scrub,Warehouse A,27,13,2025-02-01 23:07:00,14
31102,ORD_31103,12371,Body Wash Aroma Sensual Shower Gel,Warehouse B,85,71,2025-02-01 22:48:00,14
31103,ORD_31104,15076,Cepodem 100 Dry Suspension,Warehouse A,20,4,2025-02-01 03:25:00,16
31104,ORD_31105,7250,Ambroxit 150mg/30mg Tablet,Warehouse B,16,10,2025-02-01 01:53:00,6
31105,ORD_31106,30104,Face Wash - Oily Skin,Warehouse A,14,1,2025-02-01 00:19:00,13
31106,ORD_31107,18165,"Coloressence Oil-Free Roll On Makeup Opaque Foundation Concealer Panstick, 10 gm (Dark Beige) Opaque Finish",Warehouse A,21,4,2025-02-01 01:57:00,17
31107,ORD_31108,25712,Ajmal Majmua Concentrated Perfume Oil Oriental And Avid Homme Deodorant Aquatic Woody Fragrance 210 ml,Warehouse B,26,12,2025-02-01 12:38:00,14
31108,ORD_31109,30040,Moxirol-CV 625 Tablet,Warehouse A,103,88,2025-02-01 13:44:00,15
31109,ORD_31110,3960,Reequil Skin Radiance Cream For Hyperpigmentation & Dark Spots 30 gm,Warehouse A,50,31,2025-02-01 08:09:00,19
31110,ORD_31111,15171,"Lapster USB all types smartwatch charger cable for Boat Xtend,boat storm, W26 W26+ W26m W55+, Noise ColorFit Pulse, Colorf...",Warehouse A,101,92,2025-02-01 18:28:00,9
31111,ORD_31112,6332,"Pidilite Fevicryl Acrylic Painting Color (Prussian Blue, 500ml)",Warehouse C,41,27,2025-02-01 14:08:00,14
31112,ORD_31113,34463,Spigen Thin Fit Cover Case for Apple Watch 8/7 (41mm) - Starlight (Watch not Included),Warehouse A,94,77,2025-02-01 22:58:00,17
31113,ORD_31114,15191,"SpinBot BattleBudz W20 Wired in Ear Gaming Earphones with mic for Mobile, PC/Laptop, Xbox One, PS4, PS5 (Green)",Warehouse B,13,3,2025-02-01 13:41:00,10
31114,ORD_31115,8934,Moxigen Eye Drop,Warehouse A,50,37,2025-02-01 02:28:00,13
31115,ORD_31116,34727,Oxyglow Lacto Bleach with Milk Powder - Anti-Tan Pack 50 gm,Warehouse B,61,44,2025-02-01 06:09:00,17
31116,ORD_31117,10593,Aedipod 100 Tablet DT,Warehouse B,97,88,2025-02-01 20:47:00,9
31117,ORD_31118,1532,Zyrcet-LC 5mg Tablet,Warehouse A,33,27,2025-02-01 13:29:00,6
31118,ORD_31119,15046,Bio Carrot Seed Anti-Aging After Bath Body Oil,Warehouse C,38,22,2025-02-01 08:51:00,16
31119,ORD_31120,30027,Adenoz 6mg Injection,Warehouse C,93,79,2025-02-01 11:54:00,14
31120,ORD_31121,8937,Cefolex 200mg/125mg Tablet,Warehouse C,32,13,2025-02-01 14:31:00,19
31121,ORD_31122,33594,"Ambrane 60W / 3A Type C Fast Charging Unbreakable 1.5m L Shaped Braided Cable, PD Technology, 480Mbps Data Transfer for Sm...",Warehouse B,108,98,2025-02-01 15:00:00,10
31122,ORD_31123,35639,Efer-Sil Effervescent Tablet,Warehouse A,35,18,2025-02-01 16:06:00,17
31123,ORD_31124,9171,boAt Bassheads 220 Wired in Ear Earphones(Raging Red Indi),Warehouse B,30,20,2025-02-01 15:19:00,10
31124,ORD_31125,4607,Detoxie Anti-Pollution & De-Tan Refreshing Face Wash 100 ml,Warehouse C,79,67,2025-02-01 11:28:00,12
31125,ORD_31126,29187,TheGiftKart Shockproof Crystal Clear Back Cover Case for OnePlus 10R 5G / 10R Prime 5G | 360 Degree Protection | Protectiv...,Warehouse A,86,69,2025-02-01 01:34:00,17
31126,ORD_31127,29168,"Belkin Apple Certified Lightning to USB Charge and Sync Cable for iPhone, iPad, Air Pods, 39.6 inch (100cm) Black",Warehouse C,70,51,2025-02-01 15:25:00,19
31127,ORD_31128,29158,Cerime OR 100mg/500mg Tablet,Warehouse A,43,27,2025-02-01 18:08:00,16
31128,ORD_31129,12120,"ZEBRONICS ZEB-FIT7220CH Bluetooth Smart Watch,4.4cm(1.75"") Full Touch Curved Screen,Metal Body & Metal Strap,7 Days Data S...",Warehouse C,92,82,2025-02-01 23:35:00,10
31129,ORD_31130,23711,Pantanix-DSR Capsule,Warehouse B,99,91,2025-02-01 05:13:00,8
31130,ORD_31131,33856,Rose & Honey Hydrating Face Wash,Warehouse A,46,40,2025-02-01 19:07:00,6
31131,ORD_31132,14485,"DUDAO USB C to 3.5Mm Aux Audio Cable, Type C to 3.5Mm Aux Cord Pin Adapter for OnePlus 7Pro/7/6t/8/Nord and All Type C Mob...",Warehouse B,77,66,2025-02-01 10:08:00,11
31132,ORD_31133,33863,Multinus-L Injection,Warehouse B,99,91,2025-02-01 02:07:00,8
31133,ORD_31134,24311,Silky Skin Rose & Geranium Facial Foam,Warehouse B,40,25,2025-02-01 04:11:00,15
31134,ORD_31135,10290,Set 5mg Tablet,Warehouse C,29,24,2025-02-01 13:27:00,5
31135,ORD_31136,14507,Mastowell 20mg Tablet,Warehouse A,55,45,2025-02-01 10:32:00,10
31136,ORD_31137,1000,Caprgblin-NT Tablet,Warehouse B,107,90,2025-02-01 17:44:00,17
31137,ORD_31138,17519,"JBL Flip 5 Wireless Portable Bluetooth Speaker, Signature Sound with Powerful Bass Radiator, Vibrant Colors with Rugged De...",Warehouse B,107,93,2025-02-01 11:08:00,14
31138,ORD_31139,18625,Ultra Blends Shampoo,Warehouse B,33,14,2025-02-01 07:23:00,19
31139,ORD_31140,26119,"Dazller Eyeliner Pencil, Matte Finish, Water-Proof, Smudge-Proof, Long Stay, Sharpener Included, Vegan (Black, 1)",Warehouse B,88,79,2025-02-01 17:14:00,9
31140,ORD_31141,22505,"SPIN CART Toslink Digital Optical Audio Fiber Optic Cable for Home Theater, Sound Bar, TV, PS4, Xbox, Playstation and More...",Warehouse B,22,15,2025-02-01 14:32:00,7
31141,ORD_31142,20750,Solimo Mobile Cover (Soft & Flexible Back case) Transparent for Samsung Galaxy S10 Plus (Silicone,Warehouse B,45,29,2025-02-01 13:37:00,16
31142,ORD_31143,33791,Lenphor Nail Tint Cinnamon 46 12 Ml,Warehouse B,33,21,2025-02-01 00:31:00,12
31143,ORD_31144,10239,Parker Frontier Stainless Steel GT Ball Pen,Warehouse C,53,37,2025-02-01 13:32:00,16
31144,ORD_31145,28799,Maydine 4mg Tablet,Warehouse B,99,88,2025-02-01 14:03:00,11
31145,ORD_31146,28805,Deep Clean Brightening Foaming Cleanser,Warehouse A,58,50,2025-02-01 15:48:00,8
31146,ORD_31147,1969,Ceftrin-S 1000mg/500mg Injection,Warehouse B,11,1,2025-02-01 07:31:00,10
31147,ORD_31148,15719,"SP Silicon Power P34A60 256GB NVMe PCIe M.2 SSD, 3D NAND with SLC Cache, Up to 2200MB/s, M.2 2280 Internal Solid State Dri...",Warehouse B,59,48,2025-02-01 05:15:00,11
31148,ORD_31149,6543,100% Organic Bamboo Toothbrush - For Adults,Warehouse C,39,30,2025-02-01 16:43:00,9
31149,ORD_31150,33928,The Man Company Body Perfume Deodorant Spray - Noir 120 ml,Warehouse A,74,68,2025-02-01 02:10:00,6
31150,ORD_31151,12706,"Duracell Rechargeable AAA 750mAh Batteries, 2 Pcs",Warehouse C,59,46,2025-02-01 00:13:00,13
31151,ORD_31152,35367,Eliptin M Forte 1000mg/20mg Tablet SR,Warehouse B,35,28,2025-02-01 07:54:00,7
31152,ORD_31153,8137,Embeta XR 100 Tablet,Warehouse B,17,12,2025-02-01 01:19:00,5
31153,ORD_31154,31130,Sinflo 100mg Tablet,Warehouse C,49,35,2025-02-01 10:03:00,14
31154,ORD_31155,934,Quess Care Extended Warranty Plan for 2 Year for Washing Machine Between 15001 to 20000(Email Delivery),Warehouse C,91,74,2025-02-01 13:55:00,17
31155,ORD_31156,8829,Activated Charcoal Peel Off Mask,Warehouse B,24,6,2025-02-01 02:18:00,18
31156,ORD_31157,11025,Ion Man Eau De Toilette Deodorant,Warehouse B,41,32,2025-02-01 10:29:00,9
31157,ORD_31158,10250,Deep Radiance Facewash With Vitamin C,Warehouse C,72,66,2025-02-01 11:38:00,6
31158,ORD_31159,14435,Fashion Colour Vitamin C Facial Kit 200 gm,Warehouse A,90,72,2025-02-01 08:02:00,18
31159,ORD_31160,23666,Azogod 250mg Tablet,Warehouse A,54,45,2025-02-01 17:38:00,9
31160,ORD_31161,8831,Remove Soft Wax - Rose & Powder 400 ml,Warehouse A,79,63,2025-02-01 14:35:00,16
31161,ORD_31162,10255,Recef 100mg Tablet,Warehouse A,44,28,2025-02-01 07:09:00,16
31162,ORD_31163,14448,Kiwicet LM 5mg/10mg Tablet,Warehouse C,99,94,2025-02-01 13:39:00,5
31163,ORD_31164,25365,Elegance Deodorizing Talc - For Men 250 g + Gentleman Talc - For Men 250 g,Warehouse A,18,1,2025-02-01 11:39:00,17
31164,ORD_31165,12752,Nebracin F Eye Drop,Warehouse B,17,10,2025-02-01 02:33:00,7
31165,ORD_31166,4454,TheGiftKart Back Cover For Xiaomi Mi 11X / Mi 11X Pro ( Poly Carbonate; TPU|Black ),Warehouse B,79,67,2025-02-01 16:15:00,12
31166,ORD_31167,35375,BG Color Board Eyeshadow Palette 60 Color Makeup Palette Highlighters Eye Make Up High Pigmented Professional Mattes and S...,Warehouse B,72,60,2025-02-01 06:12:00,12
31167,ORD_31168,14471,Hiodic Tablet SR,Warehouse C,32,18,2025-02-01 09:14:00,14
31168,ORD_31169,31004,Etonow 90 Tablet,Warehouse C,56,39,2025-02-01 15:20:00,17
31169,ORD_31170,25391,"OneAssist 1 Year Extended Warranty for Smartwatch up to 3000 - Email Delivery Within 2 Hours, No Physical Kit",Warehouse C,77,62,2025-02-01 23:54:00,15
31170,ORD_31171,4408,"Nokia C01 Plus 4G, 5.45” HD+ Screen, Selfie Camera with Front Flash | 32GB Storage (Grey)",Warehouse B,54,49,2025-02-01 16:50:00,5
31171,ORD_31172,33901,NOTE EYESHADOW PENCIL 03 1.6 gm,Warehouse B,80,69,2025-02-01 21:09:00,11
31172,ORD_31173,35399,"Portronics Power Plate 5 1500W Power Converter with USB Charger & Mobile Holder 3AC Socket + 3USB Ports, 1.5 m Cord Length...",Warehouse B,30,13,2025-02-01 16:14:00,17
31173,ORD_31174,35397,Xyloking Eye Drop,Warehouse B,86,67,2025-02-01 09:38:00,19
31174,ORD_31175,9113,"Shot Body Perfume - Bullet, Bang",Warehouse A,99,86,2025-02-01 00:57:00,13
31175,ORD_31176,4400,Aquaray Eye Drop,Warehouse C,68,56,2025-02-01 19:02:00,12
31176,ORD_31177,35384,Gliss Hair Repair Shampoo Million Gloss,Warehouse C,87,73,2025-02-01 06:54:00,14
31177,ORD_31178,22489,Biosoft Pink Cream Wax Refill Roll On Wax 100 ml,Warehouse B,71,63,2025-02-01 16:07:00,8
31178,ORD_31179,3327,Rowezy 500mg Tablet,Warehouse C,24,9,2025-02-01 18:33:00,15
31179,ORD_31180,17402,Hydrafresh Anti-Ox Spa Water,Warehouse B,58,44,2025-02-01 10:00:00,14
31180,ORD_31181,3392,"ProElite Smart Deer Flip case Cover for Samsung Galaxy Tab A8 10.5 inch {SM-X200/ SM-X205/ SM-X207}, Wine Red",Warehouse A,91,83,2025-02-01 23:52:00,8
31181,ORD_31182,26196,Koserab-LS Capsule SR,Warehouse A,60,53,2025-02-01 03:00:00,7
31182,ORD_31183,10227,Beetel M71 Corded Landline Phone White,Warehouse A,53,44,2025-02-01 18:00:00,9
31183,ORD_31184,22568,NOTE MINERAL EYESHADOW 304 2 gm,Warehouse A,99,83,2025-02-01 04:19:00,16
31184,ORD_31185,28966,Medicated Til Oil,Warehouse B,62,56,2025-02-01 06:18:00,6
31185,ORD_31186,22018,"Fashion Colour Cover Up Concealer Stick, Shade 05 8.5 gm",Warehouse A,114,96,2025-02-01 23:27:00,18
31186,ORD_31187,7498,Physicians Formula Eye Booster Lash Contortionist Mascara - Ultra Black 9 gm,Warehouse B,29,23,2025-02-01 08:04:00,6
31187,ORD_31188,8826,Basicare Facial Oil Blotting Sheets For Face Natural Green Tea & Jasmine Fruit. For Oily Skin Oil Absorbing Tissues Beauty...,Warehouse A,51,38,2025-02-01 18:01:00,13
31188,ORD_31189,18741,Prazloc 40 Tablet,Warehouse A,21,2,2025-02-01 17:27:00,19
31189,ORD_31190,35590,Alernem Syrup,Warehouse B,69,58,2025-02-01 05:29:00,11
31190,ORD_31191,33789,Beetel B25 Basic Corded Phone (Warm Grey),Warehouse B,70,60,2025-02-01 22:22:00,10
31191,ORD_31192,21291,Contiflo OD F Tablet SR,Warehouse B,102,93,2025-02-01 15:59:00,9
31192,ORD_31193,28944,Etoriv MR 60mg/4mg Tablet,Warehouse B,81,63,2025-02-01 16:56:00,18
31193,ORD_31194,18769,Glimmer Premium Nail Enamel Red Rose 10 ml,Warehouse C,112,97,2025-02-01 16:03:00,15
31194,ORD_31195,31194,"YAMAHA YRS-24B Recorder, White",Warehouse A,35,19,2025-02-01 16:16:00,16
31195,ORD_31196,24352,Dysmen Tablet,Warehouse B,102,88,2025-02-01 10:01:00,14
31196,ORD_31197,28874,Winble Back Cover for Realme XT/X2 (Silicone | Black),Warehouse C,59,40,2025-02-01 06:47:00,19
31197,ORD_31198,3348,KABEER ART Heavy Duty 18 mm Cutter Knife Set With 10 Replacement Blades,Warehouse B,80,61,2025-02-01 02:19:00,19
31198,ORD_31199,23623,Pikkme Oneplus 5T Smoke Cover Protective Shockproof Matte Hard Back Case Cover for Oneplus 5T (Black),Warehouse B,56,49,2025-02-01 18:14:00,7
31199,ORD_31200,14359,Regencart Tablet,Warehouse B,96,86,2025-02-01 23:56:00,10
31200,ORD_31201,1939,Reform A Syrup,Warehouse A,114,97,2025-02-01 08:05:00,17
31201,ORD_31202,25333,Deltoid Turbo Face Masks In Navy Mesh With Navy Binding - 1S1001-XL,Warehouse B,31,25,2025-02-01 02:33:00,6
31202,ORD_31203,880,Xefotil L 200mg/250mg Tablet,Warehouse C,39,29,2025-02-01 09:41:00,10
31203,ORD_31204,12078,Hydro Replenish Hydrating Face Mask,Warehouse B,65,48,2025-02-01 07:41:00,17
31204,ORD_31205,14375,Retain Tablet,Warehouse B,44,35,2025-02-01 00:32:00,9
31205,ORD_31206,31163,"ZEBRONICS Zeb-Bro in Ear Wired Earphones with Mic, 3.5mm Audio Jack, 10mm Drivers, Phone/Tablet Compatible(Black)",Warehouse B,99,85,2025-02-01 18:18:00,14
31206,ORD_31207,14382,Rapidotzz Band Straps Compatible for Mi Band 4 and Mi Band 3 (Black and Blue),Warehouse A,9,1,2025-02-01 23:57:00,8
31207,ORD_31208,18770,Decatrac 25 Injection,Warehouse A,73,60,2025-02-01 12:55:00,13
31208,ORD_31209,10935,L.A. Colors 24 color Luxe Eyeshadow Palette - Luxury 1's,Warehouse C,31,12,2025-02-01 20:03:00,19
31209,ORD_31210,28947,Hair Oil For Hair fall Control,Warehouse A,54,39,2025-02-01 05:48:00,15
31210,ORD_31211,33754,Ajmal 4 Wisal Deo & Neea EDP Pack of 5 20 ml,Warehouse B,60,46,2025-02-01 13:59:00,14
31211,ORD_31212,28946,Allure Classic Small Eye Brush and Large Eye Brush (Set of 2 C-19 & C23) 1's,Warehouse A,63,51,2025-02-01 16:08:00,12
31212,ORD_31213,6552,EGOTUDE Silicone Soft Case Camera Protection Microfiber Lining Back Cover for iPhone 14 (Sierra Blue),Warehouse A,100,91,2025-02-01 20:43:00,9
31213,ORD_31214,12058,TheGiftKart Transparent Crystal Clear Back Cover Case for OnePlus 8T | Shockproof Soft TPU Case | Cushioned Edges for Ulti...,Warehouse A,35,27,2025-02-01 20:35:00,8
31214,ORD_31215,33681,Faces Canada Fresh Clean Glow Makeup Remover Wipes 30 30'S,Warehouse A,55,41,2025-02-01 21:10:00,14
31215,ORD_31216,33684,Mycolink 200mg Capsule,Warehouse B,41,34,2025-02-01 23:41:00,7
31216,ORD_31217,4593,Savepan-D Capsule PR,Warehouse C,91,74,2025-02-01 15:12:00,17
31217,ORD_31218,21979,Pregacin Forte  Capsule,Warehouse C,70,60,2025-02-01 21:30:00,10
31218,ORD_31219,22578,"Amazon Basics USB Type-C to USB-A 2.0 Male Fast Charging Cable for Laptop - 6 Feet (1.8 Meters), White",Warehouse B,39,29,2025-02-01 02:38:00,10
31219,ORD_31220,33649,Aricdom D 30mg/40mg Capsule SR,Warehouse C,33,21,2025-02-01 03:45:00,12
31220,ORD_31221,31199,Bathing Soap - Aloevera & Tulsi,Warehouse A,54,46,2025-02-01 20:28:00,8
31221,ORD_31222,33648,Ilu 2mg Syrup,Warehouse C,103,95,2025-02-01 18:01:00,8
31222,ORD_31223,31270,"Blueberry Skin Radiance Kit- Cleanser, Toner & Moistriser",Warehouse C,83,76,2025-02-01 17:09:00,7
31223,ORD_31224,28734,Radiance - Handmade Orange & Neroli Bathing Bar With Natural Chunks,Warehouse A,40,21,2025-02-01 06:26:00,19
31224,ORD_31225,15746,Fashion Colour Anti Ageing Face Serum 50 ml,Warehouse B,46,30,2025-02-01 07:44:00,16
31225,ORD_31226,6036,"Vivo Y100 5G (Metal Black, 8GB RAM, 128GB Storage) with No Cost EMI/Additional Exchange Offers",Warehouse C,67,53,2025-02-01 16:32:00,14
31226,ORD_31227,28747,Roxispan 50mg Tablet DT,Warehouse C,21,9,2025-02-01 23:38:00,12
31227,ORD_31228,14390,"Baby Happy Cotton Pads With D Panthenol, Chamomile & Plantago Extract",Warehouse A,71,60,2025-02-01 11:24:00,11
31228,ORD_31229,11092,Vega Boutique Wooden Comb (HMWC - 06) 39 gm,Warehouse C,107,89,2025-02-01 19:35:00,18
31229,ORD_31230,4640,"MELODINE Professional Makeup Sponge Beauty Blender for Blending Face Makeup, Pink Face Sponge Beauty Blender Puff - (Pack ...",Warehouse C,44,28,2025-02-01 05:36:00,16
31230,ORD_31231,28766,Navratna Talc Mint Fresh 400G + Fair & Handsome Face Wash 100% Oil Clear 100G,Warehouse B,93,82,2025-02-01 00:45:00,11
31231,ORD_31232,15734,"HP 245 G8 Laptop PC with AMD Ryzen 3 3250U/8 GB DDR4 RAM/512 GB PCIe® NVMe™ SSD /AMD Radeon™ Graphics/35.6 cm (14"" inch)/W...",Warehouse C,66,55,2025-02-01 03:21:00,11
31232,ORD_31233,8438,Flormar Loose Powder 003 Medium Sand 18 gm,Warehouse A,110,92,2025-02-01 15:41:00,18
31233,ORD_31234,1981,"Maybelline New York Kajal, Super Black, Intense Colour, Sharp Definition, Long-lasting, Colossal Kajal, 0.35g",Warehouse C,80,66,2025-02-01 14:33:00,14
31234,ORD_31235,31245,Zydalis MD 10 Tablet,Warehouse B,14,1,2025-02-01 22:47:00,13
31235,ORD_31236,33645,Sonaflam T 100mg/4mg Tablet,Warehouse C,45,26,2025-02-01 21:15:00,19
31236,ORD_31237,35664,Deborah Milano Eye Liner - 02 Grey 1.3 gm,Warehouse B,99,81,2025-02-01 16:45:00,18
31237,ORD_31238,25341,Organic Harvest Grapefruit Lip Balm with Mango Butter for Dry and Chapped Lips 3 gm,Warehouse B,29,11,2025-02-01 16:07:00,18
31238,ORD_31239,35581,Vedshakti Oil Pulling - Ayurvedic Mouthwash,Warehouse C,54,37,2025-02-01 21:41:00,17
31239,ORD_31240,31092,Toraflam-T 4mg/4mg Tablet,Warehouse B,75,58,2025-02-01 01:40:00,17
31240,ORD_31241,18886,"MOLTON BROWN Purifying Conditioner with Indian Cress, 300ml",Warehouse A,73,54,2025-02-01 09:58:00,19
31241,ORD_31242,4870,Terizine Plus Tablet,Warehouse C,24,12,2025-02-01 15:40:00,12
31242,ORD_31243,8046,Bestodek 25mg Injection,Warehouse C,54,39,2025-02-01 22:58:00,15
31243,ORD_31244,644,"Police Forbidden For Men Eau de Toilette, 100 ml",Warehouse B,47,39,2025-02-01 01:28:00,8
31244,ORD_31245,36035,"Ambrane 38W Fast Car Charger with Dual Output, Quick Charge 3.0 and Power Delivery, Type-C & USB Port, Wide Compatibility ...",Warehouse C,82,69,2025-02-01 05:25:00,13
31245,ORD_31246,22677,"Amazon Basics RJ45 Cat-5e Network Ethernet Patch/LAN Cable for Router - 50 Feet (15.2 Meters, White)",Warehouse A,53,44,2025-02-01 16:10:00,9
31246,ORD_31247,26398,Czen Tablet,Warehouse B,81,67,2025-02-01 06:52:00,14
31247,ORD_31248,36030,ClubBeauty Waterproof Professional Multicolored Matte Super Matte Lip Liner Pencil - (Set of 12),Warehouse C,22,8,2025-02-01 09:07:00,14
31248,ORD_31249,36026,MAONO Au-Wdm01 Professional Handheld Dynamic Unidirectional/Cardioid Vocal Wired Microphone with XLR Cable (Black),Warehouse B,98,93,2025-02-01 18:13:00,5
31249,ORD_31250,2125,Sandal Skin Lightening Cream,Warehouse C,112,97,2025-02-01 07:13:00,15
31250,ORD_31251,10006,Anset G 1mg Syrup,Warehouse B,116,99,2025-02-01 20:46:00,17
31251,ORD_31252,14120,Omzid-D Capsule,Warehouse A,13,5,2025-02-01 23:34:00,8
31252,ORD_31253,656,Profar 25mg Tablet,Warehouse C,38,26,2025-02-01 14:16:00,12
31253,ORD_31254,15921,Diflox S 50mg/15mg Tablet,Warehouse A,63,46,2025-02-01 19:37:00,17
31254,ORD_31255,4843,Scrub - Mineral Glow,Warehouse A,77,60,2025-02-01 22:20:00,17
31255,ORD_31256,11938,Ant Esports MK1500 Mini 60% Pro Wireless Gaming Keyboard with Membrane Switches- White,Warehouse B,94,80,2025-02-01 11:57:00,14
31256,ORD_31257,5954,Cinim 100mg Tablet,Warehouse A,108,97,2025-02-01 11:33:00,11
31257,ORD_31258,31544,Natural Clay Pack - Orange Peel & Geranium,Warehouse B,106,99,2025-02-01 09:56:00,7
31258,ORD_31259,23429,"ARISTO Multipurpose Plastic Storage Container Box with Wheels 25 LTR (Clear, Transparent), (45.8 x 34 x 26) cm",Warehouse A,68,50,2025-02-01 06:50:00,18
31259,ORD_31260,17232,Charmacy Milano Soft Satin Matte Lipstick (Bitter Sweet) 3.8 gm,Warehouse C,43,34,2025-02-01 14:06:00,9
31260,ORD_31261,17222,Octrix Samsung Charger Original 25W C-Type Super Fast Charger Adapter with Cable Set Charger for Galaxy S22/S21+/S21 Ultr...,Warehouse C,64,50,2025-02-01 12:50:00,14
31261,ORD_31262,19192,Rabidaz-LSR Capsule,Warehouse C,35,24,2025-02-01 16:13:00,11
31262,ORD_31263,616,"FOLX FNO02 G-Hook Nylon Alpine Bands Compatible With Apple Watch Band For Men Women, Replacement Straps For iWatch Series ...",Warehouse A,93,74,2025-02-01 08:06:00,19
31263,ORD_31264,11914,Aristocrat Cadet Polyester 52 cms Red Travel Duffle (Cadet),Warehouse A,68,51,2025-02-01 11:41:00,17
31264,ORD_31265,11915,Nimtop 100mg Tablet MD,Warehouse B,58,46,2025-02-01 21:56:00,12
31265,ORD_31266,19191,Levroxa 750mg Tablet,Warehouse B,99,91,2025-02-01 16:35:00,8
31266,ORD_31267,15957,Insight Cosmetics Nail Polish Remover - Lemon 100 ml,Warehouse A,53,40,2025-02-01 00:14:00,13
31267,ORD_31268,23419,Activated Charcoal Hair Shampoo,Warehouse A,45,29,2025-02-01 07:32:00,16
31268,ORD_31269,24490,Keptron Syrup,Warehouse A,51,36,2025-02-01 19:32:00,15
31269,ORD_31270,4875,Dia Free Capsules,Warehouse C,63,52,2025-02-01 04:59:00,11
31270,ORD_31271,4864,"High Definition Curl, Curl Defining Leave-In Cream With Hydrolyzed Wheat Protein",Warehouse A,72,65,2025-02-01 23:09:00,7
31271,ORD_31272,12915,"FatCherry 4+1, 6A Extension Board 2 Meters Wire, 240 V, 1440 Watt, 4 International Socket,1 LED Indicator Master Switch, M...",Warehouse B,15,2,2025-02-01 15:50:00,13
31272,ORD_31273,28547,Zenodex 500mg/50mg/500mg Tablet,Warehouse B,47,32,2025-02-01 11:33:00,15
31273,ORD_31274,35775,Dul 20mg Tablet,Warehouse B,29,21,2025-02-01 02:34:00,8
31274,ORD_31275,12023,Monoi Thyme & Mint Shaving Foam For Men,Warehouse A,32,15,2025-02-01 21:10:00,17
31275,ORD_31276,7549,"Mi Step Out 12 L Mini Backpack (Small Size, Black, Water Repellant)",Warehouse A,94,81,2025-02-01 04:40:00,13
31276,ORD_31277,12854,"Casio FX-991MS 2nd Gen Non-Programmable Scientific Calculator, 401 Functions and 2-line Display, Black",Warehouse C,60,51,2025-02-01 05:35:00,9
31277,ORD_31278,33615,Strontium Nitro A1 128GB Micro SDXC Memory Card 100MB/s A1 UHS-I U3 Class 10 with High Speed Adapter for Smartphones Table...,Warehouse A,31,20,2025-02-01 14:42:00,11
31278,ORD_31279,9170,Lefox 500mg Tablet,Warehouse C,76,57,2025-02-01 19:02:00,19
31279,ORD_31280,812,Merid 1mg/500mg Tablet,Warehouse A,55,41,2025-02-01 13:34:00,14
31280,ORD_31281,8080,Pikkme Realme 9 4G / Realme 9 Pro Plus 5G Back Cover Soft Matte Liquid Silicone TPU | Camera Protection | Shockproof Slim ...,Warehouse A,45,34,2025-02-01 20:03:00,11
31281,ORD_31282,1996,"O3+ Radiant Day Cream SPF 30 | For Glowing, Even Skin Tone | Moisturises & Protects All Skin Types 50g",Warehouse A,49,38,2025-02-01 18:03:00,11
31282,ORD_31283,35789,OpenTech® Tempered Glass Screen Protector Compatible for Samsung Galaxy M32 5G / A32 5G / M12 / A12 / M02 / M02s / A02 / A...,Warehouse A,111,95,2025-02-01 17:56:00,16
31283,ORD_31284,18900,"Wayona Nylon Braided Lightning 2 Meter Long Usb Data Sync And Charging Cable For Iphones, Ipad Air, Ipad Mini, Ipod Nano A...",Warehouse B,108,97,2025-02-01 01:22:00,11
31284,ORD_31285,15796,Hardiv P 25mg/75mg Injection,Warehouse A,32,13,2025-02-01 13:17:00,19
31285,ORD_31286,9174,Diamicron XR Mex 60/1000 Tablet ER,Warehouse B,65,58,2025-02-01 02:04:00,7
31286,ORD_31287,14246,Faber-Castell Modelling Dough - Pack of 6 (Assorted),Warehouse C,90,73,2025-02-01 10:13:00,17
31287,ORD_31288,10079,Bitof OZ Oral Suspension,Warehouse B,36,24,2025-02-01 19:59:00,12
31288,ORD_31289,9187,Gromark Drop,Warehouse C,34,20,2025-02-01 14:26:00,14
31289,ORD_31290,28641,"LOXXO® Microfiber Candy Case Compatible for iPhone 11 6.1 inch, Shockproof Slim Back Cover Liquid Silicone Case (Black)",Warehouse C,18,10,2025-02-01 17:08:00,8
31290,ORD_31291,21963,Gemblue Biocare Cucumber Gel Scrub 500 ml,Warehouse C,76,66,2025-02-01 10:27:00,10
31291,ORD_31292,33575,"Extra Care Toothbrush - Pink, Soft",Warehouse C,39,26,2025-02-01 01:25:00,13
31292,ORD_31293,7555,Spigen Liquid Air Back Cover Case for Samsung Galaxy S23 Ultra (TPU | Abyss Green),Warehouse B,58,51,2025-02-01 19:50:00,7
31293,ORD_31294,9185,boAt Aavante Bar 1160 60 Watt 2.0 Channel Wireless Bluetooth Soundbar (Premium Black),Warehouse B,54,38,2025-02-01 07:02:00,16
31294,ORD_31295,15780,"Khadi Omorose Bhringraj Hair Oil For Deep Continioning - Controls Hair Fall,Makes Hair Strong, 210ml",Warehouse A,14,6,2025-02-01 14:00:00,8
31295,ORD_31296,3262,T.O.G. Micro Applicators Brushes Disposable for Eyebrow Eyelash Extensions Blue,Warehouse A,112,99,2025-02-01 09:02:00,13
31296,ORD_31297,35807,DURACELL Alkaline AA Battery with Storage Box (Pack of 12),Warehouse C,110,91,2025-02-01 12:21:00,19
31297,ORD_31298,25280,Shryoan Liquid Highlighter,Warehouse C,45,39,2025-02-01 03:52:00,6
31298,ORD_31299,14253,Ofen MR Tablet,Warehouse C,66,50,2025-02-01 13:36:00,16
31299,ORD_31300,24400,Rabimark 20mg Tablet,Warehouse A,41,32,2025-02-01 23:30:00,9
31300,ORD_31301,11928,Hb-Best Tablet,Warehouse C,58,39,2025-02-01 10:03:00,19
31301,ORD_31302,26412,"ZEBRONICS Zeb-Thunder Bluetooth Wireless On Ear Headphone FM, mSD, 9 hrs Playback with Mic (Neon Yellow)",Warehouse A,24,9,2025-02-01 11:55:00,15
31302,ORD_31303,35548,Eukarit 100 Capsule,Warehouse A,76,64,2025-02-01 01:33:00,12
31303,ORD_31304,14108,POPIO Tempered Glass Screen Protector Compatible for Samsung Galaxy S21 FE 5G (Black) with Edge to Edge Coverage and Easy ...,Warehouse C,19,2,2025-02-01 22:00:00,17
31304,ORD_31305,2103,Propynate NF Cream,Warehouse C,59,40,2025-02-01 05:33:00,19
31305,ORD_31306,11950,Roxup 150mg Tablet,Warehouse A,38,32,2025-02-01 02:10:00,6
31306,ORD_31307,31501,"Makeup Sponges Blender Set - Professional Beauty Sponge Foundation Blending Blender with Egg Case, Flawless for Cream, Pow...",Warehouse B,67,54,2025-02-01 09:55:00,13
31307,ORD_31308,21916,Levosiz-M Kid Tablet,Warehouse A,76,69,2025-02-01 19:41:00,7
31308,ORD_31309,15889,Halobull Cream,Warehouse C,113,95,2025-02-01 02:24:00,18
31309,ORD_31310,31488,70mai Hardwire Cable Kit for 24 Hour Parking Monitoring with 6 Pcs Fuse Tap Adapters for Safe Installation (2 Pcs Each of ...,Warehouse C,51,32,2025-02-01 19:55:00,19
31310,ORD_31311,26235,Soft & Fresh Bathing Bar with 98% Pure Glycerine & Mint Extracts,Warehouse A,89,82,2025-02-01 07:44:00,7
31311,ORD_31312,17371,Miss Claire Glimmersticks For Eyes E-02 Silky Grey 1.8 Gm,Warehouse B,88,80,2025-02-01 12:30:00,8
31312,ORD_31313,25404,"Amozo USB Type C to 3.5 mm Audio Jack Connector, Noise Cancelling Headphones Jack Converter Audio Adapter for OnePlus 9 / ...",Warehouse B,85,67,2025-02-01 12:57:00,18
31313,ORD_31314,4469,Medkuff LS Syrup,Warehouse B,84,66,2025-02-01 16:43:00,18
31314,ORD_31315,17491,RAEGR Arc 400 Pro 15W Type-C PD |Made in India| Qi-Certified Wireless Charger with Fireproof ABS for iPhone 14/13/12/11 Se...,Warehouse B,36,23,2025-02-01 06:48:00,13
31315,ORD_31316,21286,Bifenac-SP Tablet,Warehouse A,60,51,2025-02-01 01:24:00,9
31316,ORD_31317,24321,"HDMI Display Dongle 1080P Wireless Mini Receiver Chrome Casters Adapter Support Airplay Miracast, Sharing, Screen mirrorin...",Warehouse B,41,27,2025-02-01 00:04:00,14
31317,ORD_31318,14452,Ajmal Blu & Sacrifice II & Wisal Dahab Deo & Yearn EDP Pack of 4 20 ml,Warehouse A,35,30,2025-02-01 12:49:00,5
31318,ORD_31319,12746,Portronics Power Plate 4 with 4 Power Sockets + 1 USB Port Power Converter with Extension I Cord 1.5 Meter I 1500 Watts Ma...,Warehouse A,98,92,2025-02-01 08:49:00,6
31319,ORD_31320,1872,Acarsafe 25mg Tablet,Warehouse B,74,64,2025-02-01 19:03:00,10
31320,ORD_31321,18680,"Natural Clay Pack - Neem, Aloe Vera & Tea Tree",Warehouse C,104,97,2025-02-01 23:49:00,7
31321,ORD_31322,18866,L.A Girl HD PRO Conceal Chestnut 8 gm,Warehouse C,41,31,2025-02-01 03:19:00,10
31322,ORD_31323,10274,Dekan SP 50mg/325mg/15mg Tablet,Warehouse B,106,90,2025-02-01 17:37:00,16
31323,ORD_31324,14463,Sounce Charger Compatible with Oneplus Smart Band - USB Magnetic Charging Cable 3.3ft/100cm - Fitness Tracker Accessories,Warehouse C,84,72,2025-02-01 09:45:00,12
31324,ORD_31325,6499,"Hair Fall Control Kit - Oil, Shampoo & Serum",Warehouse A,18,12,2025-02-01 09:03:00,6
31325,ORD_31326,29094,"DHC Lip Cream (1.5g) for Dry Chapped Lips, Lip Moisturizer enriched with Olive, Gensing & Aloe, Made in Japan",Warehouse C,8,1,2025-02-01 01:18:00,7
31326,ORD_31327,29097,L'Amante Sunkissed Eau De Parfum - Perfume For Women,Warehouse B,77,72,2025-02-01 06:12:00,5
31327,ORD_31328,31058,Jaquline USA Lipstick Angel Kiss 05 (Matte),Warehouse C,93,84,2025-02-01 12:30:00,9
31328,ORD_31329,25377,Juflox 200mg Tablet,Warehouse C,69,63,2025-02-01 15:37:00,6
31329,ORD_31330,12109,Altime CF Syrup,Warehouse A,41,29,2025-02-01 05:29:00,12
31330,ORD_31331,10262,Deeworm I 6mg/400mg Tablet,Warehouse C,20,1,2025-02-01 18:53:00,19
31331,ORD_31332,4814,"Redgear Shadow Blade Mechanical Keyboard with Drive Customization, Spectrum LED Lights, Media Control Knob and Wrist Suppo...",Warehouse C,16,3,2025-02-01 23:01:00,13
31332,ORD_31333,33414,Fixzem Dry Syrup,Warehouse B,21,15,2025-02-01 04:25:00,6
31333,ORD_31334,19124,"Samsung 980 1TB Up to 3,500 MB/s PCIe 3.0 NVMe M.2 (2280) Internal Solid State Drive (SSD) (MZ-V8V1T0)",Warehouse B,64,58,2025-02-01 00:35:00,6
31334,ORD_31335,23483,Shaltop Lotion,Warehouse C,16,8,2025-02-01 07:07:00,8
31335,ORD_31336,19184,Gliprip-M2 Tablet PR,Warehouse A,19,8,2025-02-01 06:32:00,11
31336,ORD_31337,28422,Foxydol 10mg/10mg/2.5mg Tablet,Warehouse B,99,92,2025-02-01 19:57:00,7
31337,ORD_31338,17236,Nexovas 10 Tablet,Warehouse B,13,6,2025-02-01 20:55:00,7
31338,ORD_31339,10076,boAt Bassheads 220 in Ear Wired Earphones(Fiery Orange Indi),Warehouse C,43,28,2025-02-01 14:45:00,15
31339,ORD_31340,23474,"Lip Balm - Disney Limited Edition, Watermelon Shine",Warehouse C,67,60,2025-02-01 08:45:00,7
31340,ORD_31341,23479,N95 + PM2.5 Anti Pollution Face Mask With Activated Carbon - Medium,Warehouse C,22,16,2025-02-01 11:51:00,6
31341,ORD_31342,19072,Mongoora Universal Air Vent Car Phone Mount Holder - Updated Version for Any Smartphone - Car Cell Phone Holder - Vent Pho...,Warehouse A,36,28,2025-02-01 04:05:00,8
31342,ORD_31343,31482,Itrag 100mg Capsule,Warehouse A,69,50,2025-02-01 13:23:00,19
31343,ORD_31344,15879,"Ultra Healing - Extra Dry Skin Moisturiser With Vitamin C, E & B5",Warehouse C,42,33,2025-02-01 10:30:00,9
31344,ORD_31345,20604,Nucort-M4 Tablet DT,Warehouse A,100,84,2025-02-01 13:03:00,16
31345,ORD_31346,12922,Z8 10mg Tablet,Warehouse C,40,22,2025-02-01 20:04:00,18
31346,ORD_31347,11161,SKYVIK TRUHOLD StickOn Magnetic Mount Mobile or Remote Holder for Car-Bike-Scooter-Home-Kitchen-Office-Desk-(Silver),Warehouse C,69,58,2025-02-01 20:08:00,11
31347,ORD_31348,28497,Amazon Basics - High-Speed Male to Female HDMI Extension Cable - 6 Feet (Black),Warehouse A,82,68,2025-02-01 20:19:00,14
31348,ORD_31349,6601,"Bath brush Silicone Body Back Scrubber, Double Side Bathing Brush for Skin Deep Cleaning Massage, Dead Skin Removal Exfoli...",Warehouse B,42,34,2025-02-01 15:27:00,8
31349,ORD_31350,15869,Insight Cosmetics Non - Transfer Lip Color - 03 Divine Wine 4 ml,Warehouse C,17,2,2025-02-01 18:38:00,15
31350,ORD_31351,35959,Hyaluronic Acid Moisture Cream,Warehouse C,57,39,2025-02-01 01:55:00,18
31351,ORD_31352,9208,Mamaearth Ubtan Nourishing Hair Removal Kit 150 gm,Warehouse C,81,62,2025-02-01 05:07:00,19
31352,ORD_31353,28541,"Gilary Multi Charging Cable, 3 in 1 Nylon Braided Fast Charging Cable for iPhone Micro USB Type C Mobile Phone | Colour ma...",Warehouse B,76,62,2025-02-01 05:58:00,14
31353,ORD_31354,33424,Ramhop 1.25mg Tablet,Warehouse B,97,86,2025-02-01 11:41:00,11
31354,ORD_31355,23473,Zinq Cool Slate Dual Fan Cooling Pad for Notebook/Laptop with Dual USB Port(Black),Warehouse C,64,47,2025-02-01 18:06:00,17
31355,ORD_31356,14130,Zofcin TZ 200mg/500mg Tablet,Warehouse A,69,61,2025-02-01 09:15:00,8
31356,ORD_31357,7001,OFIXO 400 Sheets (5 Mix Colors * 80 Sheets Each Color) Fluorescent Paper Self Adhesive Memo Pad Sticky Notes Bookmark Poin...,Warehouse C,75,63,2025-02-01 17:17:00,12
31357,ORD_31358,33391,"Eridanus Ultra-Mini Bluetooth Adapter for PC, CSR 4.0 Bluetooth USB Dongle Receiver, Support Windows 10/8.1/8/7/XP for Des...",Warehouse A,71,57,2025-02-01 06:06:00,14
31358,ORD_31359,2114,Xylid M Oral Suspension,Warehouse B,69,50,2025-02-01 13:16:00,19
31359,ORD_31360,17251,Benacof 25mg Soft Gelatin Capsule,Warehouse C,97,79,2025-02-01 02:16:00,18
31360,ORD_31361,11948,Piotop 30mg Tablet,Warehouse C,62,45,2025-02-01 07:57:00,17
31361,ORD_31362,22115,"Blue Heaven Hypergel Nailpaint - Stormy Grey, 103 11 ml",Warehouse C,24,19,2025-02-01 03:18:00,5
31362,ORD_31363,28925,V88R®Mini GPS Tracker GF-07 New Small Size GF07 GPS Tracker Long Battery GPS Tracking Device Personal Kids Pet Smart,Warehouse A,62,50,2025-02-01 16:47:00,12
31363,ORD_31364,7923,"Powerpak 5-in-1 Collapsible Photo Light Reflector 42"" (110 cm), Multi Color",Warehouse A,35,18,2025-02-01 18:56:00,17
31364,ORD_31365,32622,Zitel Hard PC Case Compatible with Samsung Galaxy Watch 4 44mm Bumper Cover with Built-in 9H Tempered Glass Screen Protect...,Warehouse A,70,61,2025-02-01 06:55:00,9
31365,ORD_31366,2536,Synid 200mg Tablet SR,Warehouse B,31,21,2025-02-01 00:16:00,10
31366,ORD_31367,36925,"SWISS BEAUTY Studio Full Coverage Face Cream Makeup Foundation (Medium Pale, 30ml) Matte Finish",Warehouse B,22,9,2025-02-01 17:10:00,13
31367,ORD_31368,19976,Nandrol 50mg Injection,Warehouse B,24,5,2025-02-01 20:22:00,19
31368,ORD_31369,24939,Diprosone Cream,Warehouse C,60,47,2025-02-01 06:52:00,13
31369,ORD_31370,9538,OneAssist 2 Years Furniture Extended Warranty Plan 3000 to 5000 - Digital Delivery in 2 Hours,Warehouse C,104,91,2025-02-01 06:11:00,13
31370,ORD_31371,5499,Utistat DN2 Capsule,Warehouse B,57,50,2025-02-01 22:20:00,7
31371,ORD_31372,11514,The Skin Story Keratin Body Lotion 100 ml,Warehouse C,69,60,2025-02-01 21:24:00,9
31372,ORD_31373,32632,IBUGESIC 300MG CAPSULE SR,Warehouse A,71,60,2025-02-01 07:38:00,11
31373,ORD_31374,9545,"pTron Bassbuds B21 Bluetooth 5.2 Truly Wireless in Ear Earbuds with mic, Immersive Sound, Stereo Calls, 24Hrs Playtime, Li...",Warehouse B,88,77,2025-02-01 03:05:00,11
31374,ORD_31375,19964,"Miss Rose, 09 colorful shimmer eyeshadow palette waterproof red pigment powder glitter eyeshadow, Brown, 12 g",Warehouse B,50,45,2025-02-01 21:29:00,5
31375,ORD_31376,11476,M.G.R.J® Tempered Glass Screen Protector for Samsung Galaxy Tab S8 / S7 (SM-X700 / SM-X706 / SM-T870 / SM-T875 / SM-T876B)...,Warehouse B,66,55,2025-02-01 14:03:00,11
31376,ORD_31377,32247,Green Tea Collagen Essence Mask,Warehouse A,88,74,2025-02-01 12:57:00,14
31377,ORD_31378,9622,Ajmal Nightingale & Distraction & Persuade Deo & Yearn EDP Pack of 3 20 ml,Warehouse C,98,92,2025-02-01 21:47:00,6
31378,ORD_31379,36783,"Wella Professionals SP Sp Luxeoil Shampoo 200ml and Reconstructive Elixir 30ml For Keratin Protection, 2 Pieces",Warehouse A,45,26,2025-02-01 00:00:00,19
31379,ORD_31380,32772,Colorbar Just Smoky Pencil Kajal Jsp001 1.2 Gm,Warehouse A,97,87,2025-02-01 13:19:00,10
31380,ORD_31381,36780,Verigo-D Tablet,Warehouse C,104,91,2025-02-01 13:31:00,13
31381,ORD_31382,32204,LKMO New Trending Universal 360 ° Rotation Car Dashboard Mobile Phone Holder Mount for All Mobile Phone 3.5-7 inch,Warehouse A,66,52,2025-02-01 11:16:00,14
31382,ORD_31383,24802,Pikkme Oppo F9 / F9 Pro / A5 / A5s /A7 / A11k /A12/ Realme 2 / 2 Pro / Realme U1 Flip Cover Magnetic Leather Wallet Case S...,Warehouse B,51,38,2025-02-01 14:07:00,13
31383,ORD_31384,27433,Neem Mud Pack,Warehouse A,101,89,2025-02-01 22:22:00,12
31384,ORD_31385,36759,NOTE LUMINOUS SILK MONO EYESHADOW 18 4.5 gm,Warehouse B,89,75,2025-02-01 08:40:00,14
31385,ORD_31386,27421,"GM 3262 Cuba 3+1 Power Strip with Master Switch, Indicator, Safety Shutter, 2 International Sockets & 3 USB Ports 2.4A",Warehouse A,41,34,2025-02-01 15:32:00,7
31386,ORD_31387,16802,Aloe Cucumber Body Lotion,Warehouse C,93,88,2025-02-01 07:31:00,5
31387,ORD_31388,9368,Deodorant Body Spray - Gold Chastity For Women,Warehouse C,18,9,2025-02-01 09:53:00,9
31388,ORD_31389,27448,Sultana Eau De Parfum,Warehouse A,6,1,2025-02-01 17:24:00,5
31389,ORD_31390,5381,NOTE LUMINOUS SILK MONO EYESHADOW 05 4.5 gm,Warehouse B,70,65,2025-02-01 15:25:00,5
31390,ORD_31391,5669,MOCA Vintage 7.9-inch Folio Flip Cover case for Apple iPad Mini 1/2/3/A1432/A1454/ A1455/ A1489/ A1601/ A1490/A1491/ A159...,Warehouse C,93,80,2025-02-01 08:26:00,13
31391,ORD_31392,32621,"SanDisk Extreme Pro microSD UHS I Card 512GB for 4K Video on Smartphones,Action Cams,Drones 200MB/s Read, 140MB/s Write",Warehouse C,43,26,2025-02-01 00:27:00,17
31392,ORD_31393,32617,In The Clear Acne-Action Face Mask 60 Gm,Warehouse B,49,34,2025-02-01 17:43:00,15
31393,ORD_31394,21606,Itradex 100mg Capsule,Warehouse B,115,96,2025-02-01 14:25:00,19
31394,ORD_31395,17172,Lafz Iffet No Alcohol No Gas Premium Body Spray - For Women 120 ml,Warehouse C,99,92,2025-02-01 01:32:00,7
31395,ORD_31396,31768,VEGA Go Style 1200w Hot & Cool Foldable Hair Dryer (VHDH-18) White 1 gm,Warehouse C,59,44,2025-02-01 22:17:00,15
31396,ORD_31397,4937,Sensitive Toothbrush With Soft Rounded Bristles,Warehouse C,40,23,2025-02-01 11:25:00,17
31397,ORD_31398,11812,House of Aroma Vetivert Essential Oil 10 ml,Warehouse C,36,19,2025-02-01 08:38:00,17
31398,ORD_31399,23391,Hair Styl Wax - Matte,Warehouse C,33,22,2025-02-01 02:37:00,11
31399,ORD_31400,31848,TULIPS Cotton Ear Buds/Swabs {pack of 3} with White PAPER Sticks {100/200 Tips} in a Jar,Warehouse A,24,11,2025-02-01 08:47:00,13
31400,ORD_31401,19416,Faces Canada Ultime Pro Brow Defining Pencil Dark Brown 02 M 1.2 Gm,Warehouse A,102,94,2025-02-01 09:30:00,8
31401,ORD_31402,25733,Ashwagandha Churna,Warehouse B,117,98,2025-02-01 22:28:00,19
31402,ORD_31403,31889,Electvision Remote Control for LED or LCD TV Compatible with Realme Led TV (Without Voice mic Function),Warehouse C,51,34,2025-02-01 17:30:00,17
31403,ORD_31404,26876,Nuprega G 300mg/500mcg Tablet,Warehouse B,99,89,2025-02-01 00:53:00,10
31404,ORD_31405,16477,"HP 15s-Ryzen 3 3250U 8GB SDRAM/256GB SSD 15.6""(39.6cm)HD Laptop/AMD Radeon Graphics/Win11 Home/MSO 2021/Fast Charge/Jet Bl...",Warehouse B,18,1,2025-02-01 04:55:00,17
31405,ORD_31406,36888,"(Renewed) Fire-Boltt Ninja Call Pro Dual Chip Bluetooth Calling Smartwatch, AI Voice Assistance 1.69 HD Display, 100 Sport...",Warehouse A,63,46,2025-02-01 12:56:00,17
31406,ORD_31407,16709,"Amkette Ergo Desk Phone Holder, Foldable Mobile Stand with Height Adjustable Design and Anti-Slip Silicone Grips for Offic...",Warehouse B,92,79,2025-02-01 19:29:00,13
31407,ORD_31408,26889,"ETIPL ETI Book Binding/Duct Tape (Black, 72 mm)",Warehouse A,70,63,2025-02-01 13:23:00,7
31408,ORD_31409,32292,Zymox Premix 125mg Oral Suspension,Warehouse B,61,51,2025-02-01 07:17:00,10
31409,ORD_31410,8599,Uboxin OZ 200mg/500mg Tablet,Warehouse A,39,27,2025-02-01 08:30:00,12
31410,ORD_31411,19945,Eeaze 500mg Tablet,Warehouse B,72,54,2025-02-01 09:52:00,18
31411,ORD_31412,27246,"SanDisk Ultra® microSDXC™ UHS-I Card, 256GB, 150MB/s R, 10 Y Warranty, for Smartphones",Warehouse C,37,24,2025-02-01 21:46:00,13
31412,ORD_31413,16719,Esofed D 30mg/40mg Capsule SR,Warehouse B,116,99,2025-02-01 16:06:00,17
31413,ORD_31414,32691,"Non Transfer Lip Color, Matte Finish4ml -11 Coffee Command",Warehouse A,10,1,2025-02-01 09:27:00,9
31414,ORD_31415,21715,Clodus 5mg Tablet,Warehouse A,60,47,2025-02-01 18:01:00,13
31415,ORD_31416,2499,Deodorant - Identity,Warehouse C,102,85,2025-02-01 09:35:00,17
31416,ORD_31417,26856,Liquorice Cold Cream 50 Gm,Warehouse C,61,51,2025-02-01 09:54:00,10
31417,ORD_31418,21593,"Ambrane 45W BoostedSpeed Type-C Port Fast Charger with Power Delivery, Type-C Lightning Laptop Charging, Made in India, iP...",Warehouse B,107,95,2025-02-01 14:10:00,12
31418,ORD_31419,11625,Plantas Skin Brightening Organic Cleansing Milk 100 ml,Warehouse A,23,16,2025-02-01 21:26:00,7
31419,ORD_31420,27241,Techmount Silicone Shock Proof New Cartoon 3D Designer Protection Cover Case Compatible for Apple Airpods1 & 2 Only (NOT f...,Warehouse B,97,86,2025-02-01 07:13:00,11
31420,ORD_31421,2750,Semitor 10mg Tablet,Warehouse C,58,51,2025-02-01 06:31:00,7
31421,ORD_31422,36785,Antipen 100mg Tablet,Warehouse B,69,53,2025-02-01 02:35:00,16
31422,ORD_31423,26844,SupCares Edge to Edge Tempered Glass for Motorola Moto G40 Fusion and Motorola Moto G60 (6.8 Inch) with Easy Self Installa...,Warehouse A,80,70,2025-02-01 01:48:00,10
31423,ORD_31424,11463,Facial Masque Anti-Acne,Warehouse C,40,30,2025-02-01 11:35:00,10
31424,ORD_31425,26952,Lavidoxime 200mg Tablet,Warehouse A,26,15,2025-02-01 03:11:00,11
31425,ORD_31426,32525,Nutrition - Nutri Silky Mask,Warehouse B,46,33,2025-02-01 06:19:00,13
31426,ORD_31427,36953,Revlon Colorstay Gel Envy Long Wear Nail Enamel - Roll The Dice 11.6 Ml,Warehouse B,106,87,2025-02-01 20:03:00,19
31427,ORD_31428,2629,Stelkof D Syrup,Warehouse C,18,2,2025-02-01 11:46:00,16
31428,ORD_31429,26999,Vogliking 0.2 M 1000 Tablet SR,Warehouse B,107,90,2025-02-01 16:32:00,17
31429,ORD_31430,20173,Blygin 100mg/325mg Tablet,Warehouse A,66,52,2025-02-01 10:38:00,14
31430,ORD_31431,9443,Atorapid 40mg Tablet,Warehouse B,87,76,2025-02-01 10:48:00,11
31431,ORD_31432,32493,Masterchefs Germ Protection Liquid Hand Wash,Warehouse C,44,31,2025-02-01 12:30:00,13
31432,ORD_31433,20165,Nudoth 75mg Tablet,Warehouse A,13,1,2025-02-01 12:02:00,12
31433,ORD_31434,13380,Sacred Love EDP Floral Perfume For Women,Warehouse B,66,47,2025-02-01 18:50:00,19
31434,ORD_31435,24875,MICROWARE VGA to HDMI Adapter VGA to HDMI Converter VGA Male to HDMI Female with 3.5MM Audio Jack Full HD 1080P for Connec...,Warehouse B,89,72,2025-02-01 05:56:00,17
31435,ORD_31436,13384,Ajmal Captivate & Afterglow & Magnetize & Persuade Deodorant Combo pack of 4 Deodorant 200ml each (Total 800ML) for Men & ...,Warehouse A,62,50,2025-02-01 01:38:00,12
31436,ORD_31437,20187,Amoxytis CL 457 Dry Syrup Pineapple,Warehouse A,107,96,2025-02-01 23:40:00,11
31437,ORD_31438,11558,Vovifen 50mg Tablet,Warehouse A,81,72,2025-02-01 09:57:00,9
31438,ORD_31439,16605,Olmeglare 40mg Tablet,Warehouse C,93,84,2025-02-01 00:30:00,9
31439,ORD_31440,20156,"RJ11 Telephone Line Wire Patch Cable Compatible for Landline, Telephone (Black) (5 Meters)",Warehouse C,104,95,2025-02-01 11:36:00,9
31440,ORD_31441,2632,Mecophar PG 750mcg/75mg Capsule,Warehouse A,71,55,2025-02-01 01:58:00,16
31441,ORD_31442,11588,Advanced Hand Sanitizer,Warehouse B,89,73,2025-02-01 00:44:00,16
31442,ORD_31443,5564,"GUBB Cotton Pads For Face Cleansing, Makeup Remover Cotton Pads Embossed Pack of 4, 100 Pieces Each",Warehouse C,70,64,2025-02-01 07:18:00,6
31443,ORD_31444,22931,"Imou IP 67 Outdoor Security Bullet Camera, Color Night Vision, 1080P Full HD,Up to 256GB SD Card, WiFi & Ethernet Connecti...",Warehouse B,80,71,2025-02-01 22:56:00,9
31444,ORD_31445,16509,Lamicof TA Syrup,Warehouse A,28,18,2025-02-01 17:24:00,10
31445,ORD_31446,11537,"Amazon Basics 12V 2A UPS for Router, Intercom, CCTV, Set-top Box with Upto 4 Hours Power Backup",Warehouse A,63,48,2025-02-01 18:01:00,15
31446,ORD_31447,6819,"Loofah/Sponge Scrubber/Body Bath - Cream, BH-063 CRM",Warehouse B,59,49,2025-02-01 09:18:00,10
31447,ORD_31448,13315,"Lenovo Ideapad Gaming 3 AMD Ryzen 5 5600H 15.6"" (39.62cm) FHD IPS Gaming Laptop (8GB/512GB SSD/4GB NVIDIA GTX 1650/120Hz/W...",Warehouse C,76,57,2025-02-01 05:01:00,19
31448,ORD_31449,9419,Tegut 100% Natural Activated Charcoal Powder Ideal for Skin - Pack Of 1,Warehouse A,94,80,2025-02-01 00:20:00,14
31449,ORD_31450,32400,"RiaTech Large Size (600x300x2mm) Extended Gaming Mouse Pad Speed Type Non-Slip Rubber Base Mousepad, Keyboard Desk Mat wit...",Warehouse A,25,15,2025-02-01 22:59:00,10
31450,ORD_31451,16517,Hit Mox 625 Tablet,Warehouse C,42,24,2025-02-01 08:21:00,18
31451,ORD_31452,7896,Ozeflox 200 Tablet,Warehouse B,22,5,2025-02-01 10:09:00,17
31452,ORD_31453,13423,"Lenovo 300 Wired Plug & Play USB Mouse, High Resolution 1600 DPI Optical Sensor, 3-Button Design with clickable Scroll Whe...",Warehouse A,15,6,2025-02-01 00:42:00,9
31453,ORD_31454,9487,Panty Liners - Intima Normal,Warehouse B,38,30,2025-02-01 11:22:00,8
31454,ORD_31455,16559,Peltasol 100mg Injection,Warehouse A,62,52,2025-02-01 01:47:00,10
31455,ORD_31456,26818,Orange & Bee Wax Brightening Scrub,Warehouse A,83,68,2025-02-01 02:41:00,15
31456,ORD_31457,23098,CEDO Redmi 8 Back Cover | Matte Soft Silicon Flexible | Camera Bump Protection | All Side Shock Proof Rubberised Back Case...,Warehouse B,99,81,2025-02-01 20:58:00,18
31457,ORD_31458,32730,"Gel Toothpaste For Kids - Mango Flavor, Doraemon",Warehouse A,17,4,2025-02-01 05:56:00,13
31458,ORD_31459,9590,Bae Beaute Siliconie Eye Make up Practice Board Face Practicing Reusuable for students and artists,Warehouse B,56,38,2025-02-01 21:53:00,18
31459,ORD_31460,27373,Stivdox CV 200mg/125mg Tablet,Warehouse A,21,8,2025-02-01 22:58:00,13
31460,ORD_31461,24974,Atulya Onion Bhringraj Hair Conditioner 300 ml,Warehouse C,74,69,2025-02-01 07:59:00,5
31461,ORD_31462,9599,mCaffeine Mocha Coffee Face Mask for Skin Repair & Oil Control with Cocoa & Bentonite Clay 100 gm,Warehouse B,64,51,2025-02-01 12:48:00,13
31462,ORD_31463,19852,"Sudanta Gel Toothpaste - Non-Fluoride, 100% Vegetarian",Warehouse A,22,8,2025-02-01 00:17:00,14
31463,ORD_31464,23110,Vega Curve Emery Foot File (PD - 21) 68 gm,Warehouse A,70,56,2025-02-01 19:44:00,14
31464,ORD_31465,16781,HP 47 Tri-Color Original Ink Cartridge,Warehouse B,24,10,2025-02-01 03:47:00,14
31465,ORD_31466,16387,Saffron Care Kesar Massage Cream,Warehouse B,78,68,2025-02-01 17:16:00,10
31466,ORD_31467,26822,Nutadol 100mg Tablet,Warehouse A,49,38,2025-02-01 05:23:00,11
31467,ORD_31468,32766,Telmidoz CC 40mg/10mg/12.5mg Tablet,Warehouse A,15,10,2025-02-01 14:27:00,5
31468,ORD_31469,24850,SERY Satin Flawless Longwear Foundation Ivory 30 ml,Warehouse C,40,29,2025-02-01 02:00:00,11
31469,ORD_31470,22943,"FATMUG Laptop Bag For Men - Convertible Backpack For Office And Travel (Dark Grey,Oxford Fabric)",Warehouse C,75,70,2025-02-01 08:11:00,5
31470,ORD_31471,32615,"Nokia T21 with 10.36"" 2K Screen, with Flip Cover, Android 12 with 2 Years of OS Upgrades & 3 Years of Security Updates, 4G...",Warehouse B,48,36,2025-02-01 02:12:00,12
31471,ORD_31472,36952,Emjoy 5mg Tablet,Warehouse B,44,25,2025-02-01 15:19:00,19
31472,ORD_31473,11576,Tea Tree Oil,Warehouse A,97,89,2025-02-01 09:12:00,8
31473,ORD_31474,16622,LAKMÉ Lipstick Mocha Shot (Matte),Warehouse C,29,21,2025-02-01 15:56:00,8
31474,ORD_31475,2599,"Aster 250 Volts Three pin Multi Plug Point Cordless Wall Socket Multi Outlet Extension Board with Fuse Protection, Univers...",Warehouse B,36,25,2025-02-01 08:52:00,11
31475,ORD_31476,32535,Clearbet Soft Gelatin Capsule,Warehouse B,102,97,2025-02-01 14:09:00,5
31476,ORD_31477,16580,CEDO Back Cover Redmi 9 Prime | Matte Soft Silicon Flexible | Camera Bump Protection | All Side Shock Proof Rubberised Bac...,Warehouse A,53,43,2025-02-01 22:53:00,10
31477,ORD_31478,27041,St.Botanica Body Wash - Thai Kaffir Lime 250 ml,Warehouse B,118,99,2025-02-01 02:29:00,19
31478,ORD_31479,13347,Ceflens 200 Lb Tablet,Warehouse A,32,18,2025-02-01 20:32:00,14
31479,ORD_31480,2636,"Perfume Body Spray - Super Saver Pack, 2 Voyage & 1 Neo",Warehouse A,14,5,2025-02-01 10:01:00,9
31480,ORD_31481,21672,Beetel B15 Basic Corded Landline Phone (Warm Gray),Warehouse B,48,33,2025-02-01 11:44:00,15
31481,ORD_31482,24900,Levalty 250mg Tablet,Warehouse C,10,4,2025-02-01 11:04:00,6
31482,ORD_31483,28085,Nisifenac 200mg Tablet SR,Warehouse B,31,20,2025-02-01 01:29:00,11
31483,ORD_31484,26579,Leoprime Kid 7.5mg Tablet,Warehouse C,88,78,2025-02-01 04:33:00,10
31484,ORD_31485,17603,Thyrozip 75mcg Tablet,Warehouse B,29,24,2025-02-01 21:37:00,5
31485,ORD_31486,9281,Senate 60mg Injection,Warehouse A,46,41,2025-02-01 01:32:00,5
31486,ORD_31487,28274,"Jeanne Arthes JS Magnetic Power Navy Blue EDT for him, 100 ml",Warehouse C,16,3,2025-02-01 08:22:00,13
31487,ORD_31488,532,Hair Cream For Men - Daily Use,Warehouse C,82,67,2025-02-01 17:45:00,15
31488,ORD_31489,33210,"Redmi 10A Sport (Slate Grey, 6GB RAM, 128GB Storage) | 2 Ghz Octa Cor Helio G25 | 5000 mAh Battery | Finger Print Sensor |...",Warehouse C,76,68,2025-02-01 09:22:00,8
31489,ORD_31490,22695,Easylax Plus Oral Emulsion Peppermint Sugar Free,Warehouse A,55,43,2025-02-01 03:17:00,12
31490,ORD_31491,36352,"boAt Rockerz 450 Wonder Woman Edition Bluetooth On Ear Headphones with Mic, Upto 15 Hours Playback, 40MM Drivers, Padded E...",Warehouse B,90,82,2025-02-01 05:42:00,8
31491,ORD_31492,16136,"Fashion Colour Face Highlighter Bronzer And Illumintor, Shade 02 7.5 gm",Warehouse A,60,51,2025-02-01 09:52:00,9
31492,ORD_31493,4909,Atostat 20mg Tablet,Warehouse A,37,21,2025-02-01 02:19:00,16
31493,ORD_31494,2218,SAVIAURA 1 Sheet 2 in 1 Photography Backdrop 3D Flat Lay Tabletop Double-Sided 22x16 Photo Background PVC Wrinkle-Free for...,Warehouse A,9,3,2025-02-01 02:54:00,6
31494,ORD_31495,26517,Rydon 3mg Tablet MD,Warehouse A,103,86,2025-02-01 04:29:00,17
31495,ORD_31496,13964,"rts (2 Pack) USB 3.1 Type C USB C Female to USB Male Adapter USB-C Female to USB Male, USB Type C Female to USB OTG Adapte...",Warehouse C,80,63,2025-02-01 16:53:00,17
31496,ORD_31497,17124,SKY HUB V380 Pro HD 1080P Night Vision Wireless WiFi IP Camera with 2 Way Audio and Upto 64 GB SD Card Support 50% Off CCT...,Warehouse A,57,45,2025-02-01 21:21:00,12
31497,ORD_31498,36225,Daily Use Sunscreen SPF 30,Warehouse A,39,26,2025-02-01 14:30:00,13
31498,ORD_31499,9829,Nax-D Tablet,Warehouse C,66,59,2025-02-01 14:17:00,7
31499,ORD_31500,604,Coloressence Britone Natural Brightener Face Powder,Warehouse C,39,32,2025-02-01 17:16:00,7
31500,ORD_31501,31625,Faces Canada Hi Shine Nail Enamel Lavender 233 9 Ml,Warehouse B,89,83,2025-02-01 21:11:00,6
31501,ORD_31502,14056,MI Micro USB 100cm Braided Cable Black Micro USB/Type B|Tangle Free |Sturdy Built with Kevlar Protection|480Mbps Speed|Sup...,Warehouse B,62,48,2025-02-01 00:10:00,14
31502,ORD_31503,2221,Bio Renew White Strawberry & Sweet Mint Conditioner,Warehouse C,84,76,2025-02-01 00:29:00,8
31503,ORD_31504,26591,Papaya Fruit Facial Kit,Warehouse B,22,14,2025-02-01 12:55:00,8
31504,ORD_31505,36212,Divanet OD 1000mg Tablet,Warehouse A,66,47,2025-02-01 06:04:00,19
31505,ORD_31506,31883,Generic LTT-0017 Wood Multipurpose Laptop Table with Dock Stand & Non-Slip Legs Foldable and Portable Lapdesk for Study & ...,Warehouse B,27,9,2025-02-01 08:42:00,18
31506,ORD_31507,25181,Flutris 20mg Capsule,Warehouse C,37,27,2025-02-01 06:12:00,10
31507,ORD_31508,21444,"Casio CTK-2550 61-Key Portable Keyboard with Piano tones, Black",Warehouse A,89,78,2025-02-01 03:14:00,11
31508,ORD_31509,14053,My Story For Him - EDP 10 ml,Warehouse B,44,35,2025-02-01 22:07:00,9
31509,ORD_31510,13047,"False Eyelash, Eye Makeup Lash 3D Faux Mink Fake Eyelash Long Natural Eyelashes no. 63 (1 pair)",Warehouse B,38,22,2025-02-01 03:28:00,16
31510,ORD_31511,17166,Camlin Sketch Pens with Free Stencil - 24 Shades (Multicolor),Warehouse C,50,39,2025-02-01 18:00:00,11
31511,ORD_31512,5051,"Revlon PhotoReady BB Skin Cream Perfector, Light/Medium",Warehouse B,18,1,2025-02-01 06:44:00,17
31512,ORD_31513,28283,Medimade Hydrating Shampoo With Coconut Milk 300 ml,Warehouse B,21,11,2025-02-01 05:20:00,10
31513,ORD_31514,9826,Amazon Brand-Solimo Silicone Basic Case for Samsung Galaxy M33 5G - Clear,Warehouse B,51,38,2025-02-01 19:06:00,13
31514,ORD_31515,28279,Allure Classic Mascara Brush & Pan Cake Brush Combo 1's,Warehouse C,68,59,2025-02-01 17:54:00,9
31515,ORD_31516,526,Duracell Ultra Alkaline Battery AAA - 20 Pieces,Warehouse A,40,24,2025-02-01 12:21:00,16
31516,ORD_31517,5928,"AirCase C41- Earphone Case Pouch & Travel Organizer for Earphone, Pen Drives, Memory Card, Data Cable (Grey Zip)",Warehouse A,82,67,2025-02-01 04:05:00,15
31517,ORD_31518,6636,Complete Active Toothbrush Hard Bristles - Colour May Vary,Warehouse C,78,63,2025-02-01 16:54:00,15
31518,ORD_31519,513,Criticef 750mg Injection,Warehouse B,51,46,2025-02-01 16:44:00,5
31519,ORD_31520,36359,Eyetex Pallavi G1 Maroon bindis(pack of 10 flaps),Warehouse B,82,74,2025-02-01 19:23:00,8
31520,ORD_31521,28289,UNIGEN UNIDOCK 3-in-1 Wireless Charging Station Type-C PD for iWatch Series SE/8/7/6/5/4/3/2/1; AirPods 1/2/Pro/3; iPhone ...,Warehouse C,37,24,2025-02-01 21:34:00,13
31521,ORD_31522,11317,Prasudoc 5mg Tablet,Warehouse A,111,98,2025-02-01 21:54:00,13
31522,ORD_31523,8720,Bimat LS Eye Drop,Warehouse C,38,23,2025-02-01 03:59:00,15
31523,ORD_31524,28267,C Tax 125mg Injection,Warehouse A,51,34,2025-02-01 03:07:00,17
31524,ORD_31525,11220,Etolis P 60mg/325mg Tablet,Warehouse B,52,37,2025-02-01 00:18:00,15
31525,ORD_31526,31601,Pikkme Flip Cover for Samsung Galaxy M21 2021 / M30s / M21 (Faux Leather | Brown),Warehouse A,21,6,2025-02-01 03:27:00,15
31526,ORD_31527,36092,Portronics My Buddy Hexa 22 Adjustable Tabletop Laptop Stand with Mobile Holder Ventilated Portable Foldable Compatible fo...,Warehouse A,78,68,2025-02-01 18:14:00,10
31527,ORD_31528,3043,"Natural Blueberry Body Lotion With Cocoa Butter, Vitamin E & Olive Oil",Warehouse B,100,88,2025-02-01 04:55:00,12
31528,ORD_31529,16113,Andp 20mg Capsule,Warehouse C,104,89,2025-02-01 02:28:00,15
31529,ORD_31530,13992,Anti- Acne Glycolic & Salicylic Acid Face Wash,Warehouse C,68,63,2025-02-01 08:28:00,5
31530,ORD_31531,19314,Ketocool 2% Shampoo,Warehouse C,23,18,2025-02-01 06:51:00,5
31531,ORD_31532,16992,HIRATEK Magnetic Mount Metal Plates for Magnetic Car Dashboard Mount Mobile Phone Holders and Other Magnetic Mount Holders...,Warehouse B,39,23,2025-02-01 18:53:00,16
31532,ORD_31533,511,Makzone Injection,Warehouse A,101,95,2025-02-01 08:10:00,6
31533,ORD_31534,23395,"YOGAFY- Foot Soak for PAIN RELIEF with Epsom Salt - (300 gm) || DETOX SPA || Remove Impurities, Relieve Stress and Improve...",Warehouse B,100,87,2025-02-01 09:43:00,13
31534,ORD_31535,33219,Vexifix CV 200mg/125mg Tablet,Warehouse B,79,70,2025-02-01 19:15:00,9
31535,ORD_31536,36202,Hydro Replenish Gentle Face Wash,Warehouse C,104,87,2025-02-01 14:00:00,17
31536,ORD_31537,13879,"WeCool Moonwalk M1 ENC True Wireless in Ear Earbuds with Mic, Titanium Drivers for Rich Bass Experience, 40+ Hours Play Ti...",Warehouse C,29,17,2025-02-01 05:01:00,12
31537,ORD_31538,13867,Oil - Hair Repair,Warehouse C,69,53,2025-02-01 05:04:00,16
31538,ORD_31539,6675,Cetmax  Tablet,Warehouse B,48,42,2025-02-01 21:32:00,6
31539,ORD_31540,6948,Limacid Suspension,Warehouse B,38,31,2025-02-01 23:21:00,7
31540,ORD_31541,31631,Nozy Nasal Drops,Warehouse B,7,2,2025-02-01 09:15:00,5
31541,ORD_31542,36114,Soulflower Lavender Himalayan Pink Rock Aroma Bath Salt 500 gm,Warehouse C,79,72,2025-02-01 00:12:00,7
31542,ORD_31543,26452,Mcaffeine De - Stress Scalp Massager 1's,Warehouse B,58,52,2025-02-01 04:31:00,6
31543,ORD_31544,9873,"HP Smart Tank 529 All-in-one Colour Printer (Upto 6000 Black and 6000 Colour Pages Included in The Box). - Print, Scan & C...",Warehouse B,57,38,2025-02-01 21:32:00,19
31544,ORD_31545,9872,Trypcare-Plus Tablet,Warehouse B,60,50,2025-02-01 18:02:00,10
31545,ORD_31546,33112,"Storin 14 inch Laptop Sleeve 14 inch Bag, Case, Pouch Reversible Black & Red Model for Dell,hp,acer,lenova,Apple,etc Laptops",Warehouse A,44,27,2025-02-01 23:19:00,17
31546,ORD_31547,9248,The Derma Co Squalane + Zinc Oil Free Face Moisturizer - 50 gm(dermaco),Warehouse B,107,90,2025-02-01 00:33:00,17
31547,ORD_31548,9863,Newlans 15mg Tablet DT,Warehouse A,70,60,2025-02-01 20:04:00,10
31548,ORD_31549,36201,Essential Oil - Cypress,Warehouse C,59,47,2025-02-01 07:52:00,12
31549,ORD_31550,2262,Tyto-Spas 10mg/250mg Tablet,Warehouse A,105,93,2025-02-01 10:09:00,12
31550,ORD_31551,36332,Keyone 500mg/500mg Injection,Warehouse B,49,37,2025-02-01 05:24:00,12
31551,ORD_31552,28097,Thiovator 25mg Tablet,Warehouse B,77,67,2025-02-01 16:44:00,10
31552,ORD_31553,8531,Meox CV Kid 200mg/28.5mg Tablet,Warehouse A,47,38,2025-02-01 20:42:00,9
31553,ORD_31554,26547,"Portronics Konnect Core Type C Cable Tangle-Free with 3A Rapid Charging & 480mbps Data Transmission, 1 Meter Length(Black)",Warehouse B,77,71,2025-02-01 14:28:00,6
31554,ORD_31555,17078,Eslocarm Tablet,Warehouse C,117,98,2025-02-01 19:56:00,19
31555,ORD_31556,23312,Tridom 1mg/ml Suspension,Warehouse C,38,29,2025-02-01 04:46:00,9
31556,ORD_31557,435,"IFB 30 L Convection Microwave Oven (30BRC2, Black, With Starter Kit)",Warehouse A,102,85,2025-02-01 18:15:00,17
31557,ORD_31558,27942,Onamed 4mg Tablet,Warehouse B,50,34,2025-02-01 20:38:00,16
31558,ORD_31559,27939,"Fashion Colour Lip Crayon, Waterproof, Long Lasting, 11 Passionate Pink 2.8 gm",Warehouse A,68,63,2025-02-01 03:38:00,5
31559,ORD_31560,26522,USM ID116 Smart Watch Smart Bracelet Fitness Tracker Color Screen Smartwatch Heart Rate Blood Pressure Pedometer Sleep Mon...,Warehouse B,74,64,2025-02-01 20:09:00,10
31560,ORD_31561,19225,SAARA Thalisapathiri Powder 200 Grams,Warehouse B,81,71,2025-02-01 08:14:00,10
31561,ORD_31562,23393,Homoflox-OP Eye Drop,Warehouse A,104,91,2025-02-01 23:10:00,13
31562,ORD_31563,11847,Speronden 2mg/5ml Syrup,Warehouse C,84,65,2025-02-01 19:50:00,19
31563,ORD_31564,28265,Spigen TPU Rugged Armor Pro Case and Strap for Galaxy Watch 4 Classic (46mm) - Charcoal Gray (Watch not Included),Warehouse B,79,65,2025-02-01 21:33:00,14
31564,ORD_31565,36327,Mintoral Fresh Mouth Wash,Warehouse B,41,29,2025-02-01 14:46:00,12
31565,ORD_31566,26465,I AM EYECONIC FINE GLITTER MONEY MOVES 4 gm,Warehouse B,68,61,2025-02-01 05:49:00,7
31566,ORD_31567,20523,GENERIC VIDEOCON AC Remote(White),Warehouse C,67,62,2025-02-01 20:33:00,5
31567,ORD_31568,36249,Spasidex Tablet,Warehouse B,68,63,2025-02-01 13:00:00,5
31568,ORD_31569,21464,Ibuprol Plus Oral Suspension,Warehouse A,57,49,2025-02-01 08:00:00,8
31569,ORD_31570,5075,Urinif 100mg Tablet,Warehouse A,84,71,2025-02-01 18:51:00,13
31570,ORD_31571,9941,Soulflower Hexagon Bath Set With Rose 1300 gm,Warehouse A,38,31,2025-02-01 21:42:00,7
31571,ORD_31572,19258,"Sounce Earbud Case for Nothing Ear Case - Clear Silicone Earbud Case Cover for Nothing Ear 1, Protective Case Compatible w...",Warehouse A,78,67,2025-02-01 15:40:00,11
31572,ORD_31573,2988,Arq of Rose,Warehouse B,106,90,2025-02-01 18:59:00,16
31573,ORD_31574,16090,Airtel DigitalTV HD Setup Box Remote,Warehouse A,89,74,2025-02-01 11:39:00,15
31574,ORD_31575,36261,Minoclav 1gm/0.2gm Injection,Warehouse B,103,87,2025-02-01 07:02:00,16
31575,ORD_31576,11287,Telitoss C 10mg/40mg Tablet,Warehouse B,81,66,2025-02-01 07:19:00,15
31576,ORD_31577,2198,Spigen EZ Fit Tempered Glass Screen Guard Protector for iPad Pro 11 inch M2 (2022) / iPad Pro 11 inch (2021/2020/2018) iPa...,Warehouse B,54,36,2025-02-01 12:38:00,18
31577,ORD_31578,3024,Snapace-TH4 Tablet,Warehouse A,21,9,2025-02-01 02:27:00,12
31578,ORD_31579,15991,Rabimor DSR 30 mg/20 mg Capsule,Warehouse B,92,79,2025-02-01 09:37:00,13
31579,ORD_31580,33266,PagKis Straight and Curved Stainless Steel Tweezers (Black) - Set of 2,Warehouse B,75,60,2025-02-01 17:24:00,15
31580,ORD_31581,15987,Parker Classic Anti Microbial Stainless Steel Ball Pen - CION Coated (Ink - Blue),Warehouse A,75,64,2025-02-01 23:02:00,11
31581,ORD_31582,495,Lafz Cocoa Butter Lip Balm 4.5 gm,Warehouse B,100,92,2025-02-01 09:13:00,8
31582,ORD_31583,8010,Lapster 5-in-1 Multi-Function Laptop Cleaning Brush/Keyboard Cleaning kit/Gadget Cleaning kit Gap Duster Key-Cap Puller fo...,Warehouse C,83,67,2025-02-01 12:37:00,16
31583,ORD_31584,15981,Mirabelle Korea Avocado Fairness Facial Sheet Mask 25 Ml,Warehouse A,49,32,2025-02-01 17:49:00,17
31584,ORD_31585,21868,BLUSHIA Mannequin Head for Makeup Practice Mannequin Head for Eyelashes Mannequin Training Head Closed Practice Model Mass...,Warehouse B,46,28,2025-02-01 16:48:00,18
31585,ORD_31586,13003,Nourishing Cleansing Milk Almond & Honey 400 ml,Warehouse B,44,33,2025-02-01 06:37:00,11
31586,ORD_31587,21416,Rabidoc 20 Tablet,Warehouse A,71,62,2025-02-01 21:06:00,9
31587,ORD_31588,5062,House Of Makeup Nail Lacquer - Blooming Peony 12 ml,Warehouse A,40,21,2025-02-01 21:10:00,19
31588,ORD_31589,472,"Duracell Ultra Alkaline C Battery, 2 pcs",Warehouse A,97,85,2025-02-01 18:49:00,12
31589,ORD_31590,5050,"Boat Micro USB 550 Stress Resistant, Tangle-Free, Sturdy Cable with 3A Fast Charging & 480Mbps Data Transmission, 10000+ B...",Warehouse A,65,53,2025-02-01 14:46:00,12
31590,ORD_31591,16007,Plum Bodylovin' Drivin' Me Cherry Body Butter 200 Gm,Warehouse B,22,3,2025-02-01 12:52:00,19
31591,ORD_31592,2252,Onrif 2mg Oral Drops,Warehouse B,101,86,2025-02-01 20:03:00,15
31592,ORD_31593,28167,Flormar Nail Enamel 127 Berry Nuances 11 ml,Warehouse A,94,83,2025-02-01 13:59:00,11
31593,ORD_31594,28168,Lupituss Oral Suspension,Warehouse B,104,85,2025-02-01 22:22:00,19
31594,ORD_31595,11833,Rably-LS Capsule SR,Warehouse C,104,94,2025-02-01 01:18:00,10
31595,ORD_31596,9881,KABEER ART 2.0mm Mechanical Pencil With Leads,Warehouse A,31,14,2025-02-01 01:11:00,17
31596,ORD_31597,5044,Biosoft Aloevera Pre Wax Gel 500 ml,Warehouse B,109,96,2025-02-01 21:02:00,13
31597,ORD_31598,479,Zentran 100mg Capsule,Warehouse A,86,74,2025-02-01 02:43:00,12
31598,ORD_31599,17148,Aldezole 400mg Tablet,Warehouse A,30,22,2025-02-01 14:49:00,8
31599,ORD_31600,2251,"Lapster CAsing-Black External 6.35 cm (2.5"") sata to USB Hard Disk Drive , HDD casing for Laptop - Multi Colour",Warehouse A,66,60,2025-02-01 10:48:00,6
31600,ORD_31601,28192,Vega Graduated Dressing Comb (HMSC - 09D) 25 gm,Warehouse C,83,77,2025-02-01 01:01:00,6
31601,ORD_31602,16643,And Mystique Elegance Eau De Parfum 100ML Long Lasting Scent Spray Gift For Women Crafted By Ajmal,Warehouse C,85,68,2025-02-01 23:46:00,17
31602,ORD_31603,36990,"MOVCTON Original ID116 Plus Smart Watch 1.3"" HD Display, Multiple Watch Faces, SpO2 Monitoring, Sleep Monitor for Boys, Gi...",Warehouse B,97,87,2025-02-01 05:07:00,10
31603,ORD_31604,5523,Iverhope 6mg Tablet,Warehouse B,79,64,2025-02-01 18:41:00,15
31604,ORD_31605,29476,Protein Meal Replacement Shake - Nutritious & Delicious,Warehouse B,57,38,2025-02-01 23:29:00,19
31605,ORD_31606,36613,Yonireb 20mg Tablet,Warehouse C,37,30,2025-02-01 13:18:00,7
31606,ORD_31607,3133,MyGlamm LIT Creamy Matte Lipstick-LIIT 3.7 gm,Warehouse C,65,55,2025-02-01 23:12:00,10
31607,ORD_31608,9202,Hair Oil - Brahmi Amla Ayurvedic,Warehouse B,61,55,2025-02-01 22:52:00,6
31608,ORD_31609,36089,Norpace New Capsule,Warehouse C,63,47,2025-02-01 15:46:00,16
31609,ORD_31610,30738,Vega Hot Curl Brush Medium (E16 - PRB) 135 gm,Warehouse C,13,5,2025-02-01 12:04:00,8
31610,ORD_31611,35078,"Soap Bar - Water Lily & Cooling Mint, Fresh Splash, Save Rs. 6/-",Warehouse C,17,12,2025-02-01 05:33:00,5
31611,ORD_31612,17722,Rifarcin Plus 450 mg/300 mg Tablet,Warehouse A,96,88,2025-02-01 08:23:00,8
31612,ORD_31613,12219,Defaus 6mg Tablet,Warehouse A,74,69,2025-02-01 07:13:00,5
31613,ORD_31614,25942,Wayona Type C Cable Nylon Braided USB C QC 3.0 Fast Charging Short Power Bank Cable for Samsung Galaxy S10e/S10+/S10/S9/S...,Warehouse A,86,81,2025-02-01 06:35:00,5
31614,ORD_31615,34191,"Aroma® Studio 1 Handy 10W Bluetooth Speaker Hi-fi Stereo Sound Surround Upto 10 Hours Playback, Best for Mobile, Laptop/P...",Warehouse B,51,45,2025-02-01 13:09:00,6
31615,ORD_31616,29559,"Acer EB192Q 18.5 inch (46.99 Cm) 1366 x 768 Pixels HD LCD Monitor with LED Back Light Technology with HDMI, VGA Ports Inbo...",Warehouse C,41,33,2025-02-01 19:17:00,8
31616,ORD_31617,30722,Axmon® Extension Cord with USB Port [FIRE Resistant] [2 Socket with 2 USB Charging Ports] 6V-2.4 Amp Heavy Duty Extension ...,Warehouse B,78,70,2025-02-01 12:09:00,8
31617,ORD_31618,10856,Medon 4mg Tablet,Warehouse B,91,82,2025-02-01 15:24:00,9
31618,ORD_31619,8894,"Imou 360° 1080P Full HD Security Camera White,Human Detection,Motion Tracking,2-Way Audio,Night Vision,Dome Camera with Ex...",Warehouse B,107,93,2025-02-01 02:38:00,14
31619,ORD_31620,10840,Licox Dry Syrup,Warehouse B,41,30,2025-02-01 03:49:00,11
31620,ORD_31621,24172,"Xiaomi 13 Pro (Ceramic Black, 12GB RAM 256GB Storage) | Leica Professional 50MP Triple Camera | Biggest Camera Sensor 1"" I...",Warehouse C,55,50,2025-02-01 17:05:00,5
31621,ORD_31622,24170,Cutibeam Cream,Warehouse A,61,42,2025-02-01 11:29:00,19
31622,ORD_31623,24168,"LOVELASH 3 Pairs Magnetic False Eyelash with 1 Waterproof Magnetic Eyeliner Kit, India's First 8D Faux Mink Eye lashes, Na...",Warehouse C,101,84,2025-02-01 13:32:00,17
31623,ORD_31624,1712,Gem Q 600mg Tablet,Warehouse B,16,11,2025-02-01 06:00:00,5
31624,ORD_31625,1715,KYOSEI[2 Pack Ultra Clear Anti-Explosion 9H Hardness Camera Lens Glass Camera Lens Protector Compatible with iPhone 14/14 ...,Warehouse C,108,92,2025-02-01 14:50:00,16
31625,ORD_31626,18438,"Maybelline SuperStay Eraser Lip Color Remover, Metallic Finish, 0.1 oz. - Clear",Warehouse B,97,89,2025-02-01 09:30:00,8
31626,ORD_31627,29523,Ajmal Blu & Sacrifice II & Wisal Dahab Deo & Aretha EDP Pack of 4 20 ml,Warehouse B,64,45,2025-02-01 15:56:00,19
31627,ORD_31628,9085,Loratop 1mg Tablet,Warehouse A,40,31,2025-02-01 00:42:00,9
31628,ORD_31629,4272,Skin Lightening Face Wash - Sulphate Free,Warehouse C,95,81,2025-02-01 19:10:00,14
31629,ORD_31630,29461,Qraa Men Haldi Chandan Face Pack for Skin Brightening/Lightening with Turmeric Oil & Sandalwood,Warehouse A,114,97,2025-02-01 06:27:00,17
31630,ORD_31631,19738,iwon Shock Proof Protection Cartoon Case / Tough Cover Case Compatible with AirPods (2 & 1) /Leather Cover for AirPods Wir...,Warehouse B,112,96,2025-02-01 18:45:00,16
31631,ORD_31632,2395,ORBITAR OSG1101 Shocked Proof Flexible Silicone TPU Watch Case Cover with Screen Protector Temper Compatible for Apple Wat...,Warehouse B,33,23,2025-02-01 02:56:00,10
31632,ORD_31633,11736,ProElite Smart Case for iPad 10th Generation 10.9 inch 2022 [Auto Sleep/Wake Cover] [Pencil Holder] [Soft Flexible Case] R...,Warehouse C,94,87,2025-02-01 04:27:00,7
31633,ORD_31634,2871,House of Aroma Patchouli Fragrance Oil 10 ml,Warehouse B,68,56,2025-02-01 16:11:00,12
31634,ORD_31635,11406,I AM EYECONIC FINE GLITTER MAUVE OVER 4 gm,Warehouse B,114,95,2025-02-01 05:42:00,19
31635,ORD_31636,27584,"Episkey Cleaner Pen Kit for Airpods, 3 in 1 Multifunction Bluetooth Earbuds Cleaning Pen with Soft Brush, Portable Cleanin...",Warehouse C,81,64,2025-02-01 15:12:00,17
31636,ORD_31637,19702,NEMIZI Tablet Matte Screen Guard for Xiaomi MI Pad 5 11 Inch -Black Edges [Matte Feel Temper(It's Not Glass)],Warehouse B,46,28,2025-02-01 16:58:00,18
31637,ORD_31638,292,"Pilot V5 Liquid Ink Roller Ball Pen -Blue(Pack of 3), (9000014710)",Warehouse A,99,82,2025-02-01 22:04:00,17
31638,ORD_31639,7737,Amcro 250mg Injection,Warehouse A,65,58,2025-02-01 02:20:00,7
31639,ORD_31640,16248,"Reusable Anti Pollution Face Mask - With Activated Carbon, N99 + PM2.5, Large",Warehouse C,98,87,2025-02-01 15:45:00,11
31640,ORD_31641,26713,Sumalgia 85mg/500mg Tablet,Warehouse C,32,16,2025-02-01 02:48:00,16
31641,ORD_31642,23194,Zedobact-CL 500mg/125mg Tablet,Warehouse B,71,62,2025-02-01 12:01:00,9
31642,ORD_31643,36564,Serie Expert A-OX Vitamino Color Protecting Shampoo,Warehouse A,79,72,2025-02-01 17:58:00,7
31643,ORD_31644,19699,Pantika D 10mg/40mg Tablet,Warehouse C,70,56,2025-02-01 19:03:00,14
31644,ORD_31645,25199,"Wayona Nylon Braided USB to Lightning Fast Charging and Data Sync Cable Compatible for iPhone 13, 12,11, X, 8, 7, 6, 5, iP...",Warehouse C,31,13,2025-02-01 04:17:00,18
31645,ORD_31646,19725,"Panasonic Corded Telephone, White",Warehouse B,82,66,2025-02-01 16:32:00,16
31646,ORD_31647,32926,Skin Lightening Face Wash,Warehouse A,54,43,2025-02-01 19:49:00,11
31647,ORD_31648,2377,Glimmer Nail Polish Big Apple Red 5 ml,Warehouse C,111,99,2025-02-01 18:24:00,12
31648,ORD_31649,2388,Wet N Wild Makeup Brush - Crease Brush 1's,Warehouse B,97,79,2025-02-01 01:23:00,18
31649,ORD_31650,9677,Migace MR 100mg/325mg/250mg Tablet,Warehouse A,84,79,2025-02-01 02:45:00,5
31650,ORD_31651,2854,American Tourister Spin 49 cms Navy Laptop Backpack,Warehouse B,32,17,2025-02-01 04:18:00,15
31651,ORD_31652,32047,"Apple MagSafe Charger (for iPhone, AirPods Pro, AirPods with Wireless Charging Case)",Warehouse A,17,12,2025-02-01 00:18:00,5
31652,ORD_31653,32063,Thiocent Plus 4mg/100mg/325mg Tablet,Warehouse A,84,74,2025-02-01 06:15:00,10
31653,ORD_31654,20359,"techlife solutions Car Windshield Suction Cup Mount with 1/4"" Tripod Mount Adapter Screw for GoPro Hero, SJCAM, Yi & Other...",Warehouse B,33,23,2025-02-01 12:24:00,10
31654,ORD_31655,27601,Etoxin B Tablet,Warehouse C,7,2,2025-02-01 13:02:00,5
31655,ORD_31656,36587,mayoo Tiny Small Bindi 2mm Multi Colour Red Maroon Black Tikka for Girls Women Matching Bindis,Warehouse A,70,51,2025-02-01 10:46:00,19
31656,ORD_31657,23202,"Nokia 2660 Flip 4G Volte keypad Phone with Dual SIM, Dual Screen, inbuilt MP3 Player & Wireless FM Radio | Blue",Warehouse C,96,81,2025-02-01 03:51:00,15
31657,ORD_31658,29472,Bold Hold - Firm Hold Styling Spray Gel 250 ml,Warehouse C,103,95,2025-02-01 16:25:00,8
31658,ORD_31659,1729,Tsitide Tablet MR,Warehouse A,41,24,2025-02-01 10:34:00,17
31659,ORD_31660,27181,"Echo (4th Gen, 2020 release) | Premium sound powered by Dolby and Alexa (Black)",Warehouse A,19,13,2025-02-01 18:57:00,6
31660,ORD_31661,34132,"XP-PEN Star03 V2 8192 Levels of Pressure Sensitivity, Battery-Free Stylus, 8 Shortcut Keys and 8 nibs Graphics Drawing Tab...",Warehouse A,81,72,2025-02-01 08:41:00,9
31661,ORD_31662,18399,Remthol CV Dry Syrup,Warehouse C,41,35,2025-02-01 23:59:00,6
31662,ORD_31663,9052,"Pebble Newly Launched Cosmos Prime Bluetooth Calling Smart Watch, Largest 1.91"" Bezel-Less Edge-to-Edge Display, 600 Nits ...",Warehouse C,52,34,2025-02-01 00:59:00,18
31663,ORD_31664,30667,Zosuc 500mg/125mg Tablet,Warehouse B,73,59,2025-02-01 20:25:00,14
31664,ORD_31665,10480,Faces Canada Instaremove Dip & Twist Remover 80 Ml,Warehouse C,66,52,2025-02-01 08:11:00,14
31665,ORD_31666,12590,"HP 15s, 11th Gen Intel Core i5-1155G7, 15.6 inch(39.6cm) FHD Anti-Glare Laptop(8GB RAM/512 GB SSD/Intel Iris Xe Graphics/W...",Warehouse C,60,45,2025-02-01 03:44:00,15
31666,ORD_31667,25915,Unicif 50mg Dry Syrup,Warehouse C,62,46,2025-02-01 16:51:00,16
31667,ORD_31668,21164,Remcox ZH Tablet,Warehouse C,88,71,2025-02-01 00:16:00,17
31668,ORD_31669,1217,Allure Avatar Deodorant & Body Spray Perfume For Men,Warehouse C,69,64,2025-02-01 08:03:00,5
31669,ORD_31670,18393,Zimnic DX Tablet,Warehouse B,73,65,2025-02-01 02:36:00,8
31670,ORD_31671,18391,Lorawel 1mg Tablet,Warehouse A,84,70,2025-02-01 03:45:00,14
31671,ORD_31672,15391,Anzifen SP Tablet,Warehouse A,20,14,2025-02-01 05:49:00,6
31672,ORD_31673,1225,"D-Link AC1200 DIR-811 Dual Band Wi-Fi Speed Up to 867 Mbps/5 GHz + 300 Mbps/2.4 GHz, 2 Fast Ethernet Ports, 2 External Ant...",Warehouse C,83,78,2025-02-01 17:17:00,5
31673,ORD_31674,10892,"OBAGE HT-244 130 Watts 4.1 Home Theatre System with Optical in, Bluetooth 5.0, USB, FM, AUX",Warehouse B,62,57,2025-02-01 02:34:00,5
31674,ORD_31675,25472,Oil - Castor,Warehouse A,44,33,2025-02-01 15:02:00,11
31675,ORD_31676,24493,"70mai Pro Plus+ A500S Dual Channel Car Dash Cam, 3K, ADAS, Built-in GPS Logger, Route Recorder, App Playback & Share, Opti...",Warehouse C,65,50,2025-02-01 11:10:00,15
31676,ORD_31677,1075,"ELINOR Collagen Face Serum with Peptides Enhance Skin Elasticity, Anti Wrinkles, Anti Aging, Improves Skin Texture, Deep M...",Warehouse A,109,99,2025-02-01 05:08:00,10
31677,ORD_31678,20768,Pain Relief Spray,Warehouse C,66,55,2025-02-01 12:18:00,11
31678,ORD_31679,35290,TheGiftKart Tough Armor Bumper Back Case Cover for OnePlus 11 5G | Ring Holder & Kickstand in-Built | 360 Degree Protectio...,Warehouse A,10,3,2025-02-01 23:34:00,7
31679,ORD_31680,35287,Levosiz 2.5mg Syrup,Warehouse B,59,49,2025-02-01 08:17:00,10
31680,ORD_31681,6466,Ajmal Tempest Concentrated Perfume Oil Floral And Maryaj Deuce Homme EDP Spicy Woody Perfume 112 ml,Warehouse C,32,27,2025-02-01 08:47:00,5
31681,ORD_31682,23795,"Fashion Colour Duo Contour Stick, Shade 03 3.8 gm",Warehouse A,23,9,2025-02-01 04:08:00,14
31682,ORD_31683,6464,Zylocef O 200 mg/200 mg Tablet,Warehouse A,49,32,2025-02-01 04:50:00,17
31683,ORD_31684,35280,Dolopar 650 Tablet,Warehouse A,27,18,2025-02-01 04:25:00,9
31684,ORD_31685,14667,SanDisk SDCZ430-128G-I35 Ultra Fit 3.1 128GB USB Flash Drive (Black),Warehouse C,82,69,2025-02-01 04:47:00,13
31685,ORD_31686,34007,Vigini VPlus Fiery Hot 2 in 1 Men's Oil 25 ml,Warehouse A,75,69,2025-02-01 02:22:00,6
31686,ORD_31687,15527,Jypan 40mg Injection,Warehouse A,27,21,2025-02-01 11:05:00,6
31687,ORD_31688,29637,Relisulide 100mg Tablet,Warehouse C,109,90,2025-02-01 17:28:00,19
31688,ORD_31689,3638,Wizid 250mg Injection,Warehouse C,54,38,2025-02-01 14:07:00,16
31689,ORD_31690,18401,Omwin 20mg Capsule,Warehouse B,13,3,2025-02-01 10:35:00,10
31690,ORD_31691,14799,Spigen Ultra Hybrid Back Cover Case for iPhone 13 Pro Max (TPU + Poly Carbonate | Matte Black),Warehouse A,101,90,2025-02-01 22:53:00,11
31691,ORD_31692,18449,Precision Eye Liner Eye Liner Liquid Eln001 2.5 Ml,Warehouse C,34,26,2025-02-01 06:59:00,8
31692,ORD_31693,23837,Vogliset M 0.3 Tablet,Warehouse A,99,87,2025-02-01 07:09:00,12
31693,ORD_31694,30774,Bonjour Paris Photo Match Liquid Concealer - Rose Fair 4 ml,Warehouse C,28,15,2025-02-01 22:28:00,13
31694,ORD_31695,3573,Redragon M612 Predator RGB Wired Optical Gaming Mouse,Warehouse B,71,63,2025-02-01 02:59:00,8
31695,ORD_31696,22375,Canon CL57s Ink Cartridge,Warehouse C,49,33,2025-02-01 10:33:00,16
31696,ORD_31697,15458,Doxion 200mg Tablet,Warehouse A,92,73,2025-02-01 06:11:00,19
31697,ORD_31698,34147,"Urban Gabru Hair Cream - Coconut Oil, Aloe Vera & Lupine Protein 100 gm",Warehouse A,78,73,2025-02-01 10:09:00,5
31698,ORD_31699,30768,"Kite Media - YoYo Ovel, Retractable Reel ID Card Holder - Set of 3 Nos (Black)",Warehouse B,35,18,2025-02-01 23:38:00,17
31699,ORD_31700,18417,Tea Tree Facial Therapy,Warehouse A,92,84,2025-02-01 11:46:00,8
31700,ORD_31701,34257,Ajmal Aurum Aurum Wisal Deodorant Spray (Pack of 3) 200 ml,Warehouse A,43,24,2025-02-01 20:17:00,19
31701,ORD_31702,30669,Glimmer Premium Nail Enamel Olive Green 10 ml,Warehouse C,100,90,2025-02-01 01:24:00,10
31702,ORD_31703,30661,Urofin Eye Drop,Warehouse B,36,29,2025-02-01 00:15:00,7
31703,ORD_31704,8900,"Blue Heaven Deluxe Kajal (2 G, Black) (Set Of 12 Pc)",Warehouse A,87,82,2025-02-01 11:47:00,5
31704,ORD_31705,23896,SWHF Wine & Gift Bottle Paper Carry Bags with Printed Design (Multicolored Pack of 4) (Small (5 * 5 * 14 Inches)),Warehouse C,23,13,2025-02-01 14:34:00,10
31705,ORD_31706,22356,TP-Link 5 Port 10/100 Mbps Fast Ethernet Switch | Desktop Ethernet Splitter | Ethernet Hub | Plug & Play | Fanless Quiet |...,Warehouse C,64,52,2025-02-01 22:02:00,12
31706,ORD_31707,10828,"Camel Paint Brush Series 66 - Round Synthetic Gold, Set of 7",Warehouse B,57,44,2025-02-01 05:28:00,13
31707,ORD_31708,29691,Mikanext 500mg Injection,Warehouse A,55,49,2025-02-01 23:38:00,6
31708,ORD_31709,8339,Afdiflam Tablet,Warehouse C,103,96,2025-02-01 21:41:00,7
31709,ORD_31710,3662,"Hawaiian Tropic Silk Hydration After Sun Lotion, 6 Ounce",Warehouse B,86,80,2025-02-01 11:11:00,6
31710,ORD_31711,14823,Cvy-Mox 625 Tablet,Warehouse C,70,60,2025-02-01 11:04:00,10
31711,ORD_31712,14835,Mustang Orchestral Music Stand with FREE Carry Cover And Folding Plate,Warehouse A,91,85,2025-02-01 04:41:00,6
31712,ORD_31713,1250,AmazonBasics PBH-20216 2-Male to 2-Male RCA Audio Cable - 4 Feet (Black),Warehouse C,74,64,2025-02-01 14:46:00,10
31713,ORD_31714,18358,ENVIE® Infinite 9V 800 maH Li-ion Rechargeable Battery ERB 9V MU,Warehouse A,99,81,2025-02-01 09:57:00,18
31714,ORD_31715,7203,Plantas Tan Defence Organic Face Wash 50 ml,Warehouse B,18,7,2025-02-01 08:47:00,11
31715,ORD_31716,4119,Telpride H 40mg/12.5mg Tablet,Warehouse B,90,72,2025-02-01 16:34:00,18
31716,ORD_31717,12544,Casio MJ-12VCb-BU 300 Steps Check & Correct Colourful Desktop Calculator (Blue),Warehouse C,66,60,2025-02-01 06:34:00,6
31717,ORD_31718,3682,Saregama Carvaan Mini Hindi 2.0- Music Player with Bluetooth/FM/AM/AUX (Sunset Red),Warehouse A,114,97,2025-02-01 02:17:00,17
31718,ORD_31719,3644,Nisurex P 100mg/500mg Tablet,Warehouse C,34,25,2025-02-01 00:10:00,9
31719,ORD_31720,16860,"GadgetBite Portable Pouch for Electronic Accessories USB Cables, Power Bank, Battery, Portable Hard Drive, SD Memory Card,...",Warehouse B,82,65,2025-02-01 05:42:00,17
31720,ORD_31721,32820,Sony Bravia 108 cm (43 inches) 4K Ultra HD Smart LED Google TV KD-43X74K (Black),Warehouse A,68,54,2025-02-01 07:26:00,14
31721,ORD_31722,23162,Flormar Pearly Nail Enamel PL068 Velvet Bordeaux 11 ml,Warehouse B,116,98,2025-02-01 16:57:00,18
31722,ORD_31723,2919,Aboxtil 250 Tablet,Warehouse B,21,2,2025-02-01 11:31:00,19
31723,ORD_31724,23254,Deflacost Tablet,Warehouse B,51,32,2025-02-01 14:46:00,19
31724,ORD_31725,27733,Syzopride MV 1mg/500mg/0.2mg Tablet,Warehouse A,98,80,2025-02-01 23:03:00,18
31725,ORD_31726,27735,Neemli Naturals Hyaluronic & Ceramide face wash 100 ml,Warehouse B,97,79,2025-02-01 16:33:00,18
31726,ORD_31727,23258,"POND'S Dream Flower Talc Powder, Pack of 200gm",Warehouse A,54,47,2025-02-01 05:37:00,7
31727,ORD_31728,33018,INSHINE Absolute Matte No Transfer Lipstick for Women And Girls,Warehouse A,42,33,2025-02-01 11:10:00,9
31728,ORD_31729,6704,"BEILI Professional Makeup Brush Set ,Natural Goat Hair Premium Synthetic Kabuki Foundation Face Powder Highlighter Blush C...",Warehouse C,56,51,2025-02-01 04:11:00,5
31729,ORD_31730,11374,"Zebra Highlighter Mildliner, 5 Color Set (WKT7-5C)",Warehouse A,25,11,2025-02-01 13:21:00,14
31730,ORD_31731,5215,Compact Paddle Hair Brush,Warehouse B,70,65,2025-02-01 13:53:00,5
31731,ORD_31732,25024,Sylip 500mg Tablet,Warehouse B,31,25,2025-02-01 01:10:00,6
31732,ORD_31733,23224,Ctasorin M Forte 100mg/1000mg Tablet,Warehouse C,32,22,2025-02-01 10:33:00,10
31733,ORD_31734,27627,Hand Wash - White Lily,Warehouse C,44,25,2025-02-01 10:19:00,19
31734,ORD_31735,11754,HP Smart Tank 580 All-in-one WiFi Colour Printer with 1 Extra Black Ink Bottle(Upto 12000 Black and 6000 Colour Prints) an...,Warehouse C,82,64,2025-02-01 12:07:00,18
31735,ORD_31736,25018,"Infinity (JBL Glide 500, 20 Hrs Playtime with Quick Charge, Wireless On Ear Headphone with Mic, Deep Bass, Dual Equalizer,...",Warehouse C,78,66,2025-02-01 13:15:00,12
31736,ORD_31737,5274,Berina A19 Golden Orange Hair Color Cream 60 gm,Warehouse B,108,91,2025-02-01 18:19:00,17
31737,ORD_31738,27649,Fexomik 180mg Tablet,Warehouse A,21,8,2025-02-01 18:51:00,13
31738,ORD_31739,19647,Fashion Colour Vitamin C Face Serum 30 ml,Warehouse A,65,47,2025-02-01 07:21:00,18
31739,ORD_31740,19665,Cosmic Byte Equinox Mousepad Speed Edition (XL) (80x25x0.3cms),Warehouse C,74,65,2025-02-01 11:13:00,9
31740,ORD_31741,32951,Iritros D Syrup,Warehouse C,48,42,2025-02-01 03:06:00,6
31741,ORD_31742,19661,Megapod-SB Injection,Warehouse C,54,46,2025-02-01 17:36:00,8
31742,ORD_31743,32956,Superdry - Heritage Hawaii Mens Body + Hair Wash 250 ml,Warehouse B,67,51,2025-02-01 19:44:00,16
31743,ORD_31744,27666,Flormar Silk Matte Liquid Lipstick 002 Fall Rose 4.5 gm,Warehouse B,62,57,2025-02-01 03:42:00,5
31744,ORD_31745,23244,"ZORBES® Wall Adapter Holder for Alexa Echo Dot 4th Generation,A Space-Saving Solution with Cord Management for Your Smart ...",Warehouse B,97,82,2025-02-01 00:30:00,15
31745,ORD_31746,36456,Revlon ColorSilk Hair Color with Keratin - 3RB Dark Mahogany Brown 91.85 ML,Warehouse A,55,44,2025-02-01 04:53:00,11
31746,ORD_31747,13778,Aurox 15mg Tablet,Warehouse B,25,20,2025-02-01 07:52:00,5
31747,ORD_31748,5372,Galpara Drops,Warehouse C,87,77,2025-02-01 11:54:00,10
31748,ORD_31749,13836,Enapra Suspension,Warehouse A,64,46,2025-02-01 06:20:00,18
31749,ORD_31750,2357,Conditioning Shampoo,Warehouse A,75,62,2025-02-01 20:16:00,13
31750,ORD_31751,25053,Amn 200mg Tablet SR,Warehouse C,70,57,2025-02-01 21:58:00,13
31751,ORD_31752,19611,"SupCares Edge to Edge Tempered Glass for iQOO Neo 7 5G, iQOO 11 5G and iQOO 9T 5G (6.78 Inch) with Easy Self Installation ...",Warehouse A,67,55,2025-02-01 17:38:00,12
31752,ORD_31753,24858,Miss Rose Professsional Makeup Glow Powder Metalises 7001 - 010M 08 2.5 gm,Warehouse B,31,26,2025-02-01 07:06:00,5
31753,ORD_31754,2550,Nomigan 5mg Tablet,Warehouse B,88,83,2025-02-01 23:52:00,5
31754,ORD_31755,13483,Herbal Rose & Aloevera Facial Massage Gel,Warehouse A,86,71,2025-02-01 16:40:00,15
31755,ORD_31756,20237,Daily Liners - Clean & Fresh,Warehouse C,91,79,2025-02-01 10:04:00,12
31756,ORD_31757,13320,Wahrab-LS Capsule SR,Warehouse C,46,33,2025-02-01 18:31:00,13
31757,ORD_31758,27147,"Acko 1 Year Extended Warranty for Appliances from Rs 20,000 to Rs 30,000 (Email Delivery)",Warehouse C,74,60,2025-02-01 10:13:00,14
31758,ORD_31759,21690,Sertane A 0.25mg/50mg Tablet,Warehouse A,99,93,2025-02-01 19:44:00,6
31759,ORD_31760,13446,Quess Care Total Protection Plan for 1 Year Protection for Mobile - Price Between 10001 to 15000 (Email Delivery),Warehouse A,67,60,2025-02-01 05:19:00,7
31760,ORD_31761,20031,Alifiya Polyester Tablet Sleeve/Laptop Sleeve Bag/Case Cover Upto 11.6 inch for iPad/Samsung Galaxy/Lenovo (Black_L20),Warehouse C,61,46,2025-02-01 06:04:00,15
31761,ORD_31762,6817,Hipodoxime 200mg Tablet,Warehouse A,35,18,2025-02-01 21:20:00,17
31762,ORD_31763,8611,Fujifilm Instax Mini 9 Instant Camera (Cobalt Blue) Gift Box with 10 Shots,Warehouse A,97,89,2025-02-01 23:34:00,8
31763,ORD_31764,6779,Amoxent 375 Tablet,Warehouse B,98,86,2025-02-01 00:59:00,12
31764,ORD_31765,9421,Bowiemall 2Pcs Side Bang Clip in Bangs Real Human Hair Side Covers Wave Fringe Hair Extensions for Women Girls (Natural Bl...,Warehouse C,90,77,2025-02-01 01:27:00,13
31765,ORD_31766,5547,"Camlin PB White Board Bold Marker - Pack of 4 Assorted Colors (Black, Blue, Red, Green)",Warehouse A,80,68,2025-02-01 10:41:00,12
31766,ORD_31767,32987,Eyetex pallavi bindi P4 BLACK Pack of 10 flaps+Fancy designer bindis 1 card,Warehouse C,63,47,2025-02-01 09:04:00,16
31767,ORD_31768,2660,Pullup Pant Style Adult Diapers - M-L,Warehouse C,53,44,2025-02-01 04:32:00,9
31768,ORD_31769,27114,"STARSTRUCK BY SUNNY LEONE Liquid Lip Glossy Highly Pigmented, Clear Shine & Non-Sticky Formula, Berry Glimmer",Warehouse C,65,56,2025-02-01 19:06:00,9
31769,ORD_31770,5656,"Gizga Essentials Magic Slate Digital LCD Writing Tablet with Stylus Pen & 12-Inch Screen, Slate Board for E-Notes, Digital...",Warehouse B,68,51,2025-02-01 18:15:00,17
31770,ORD_31771,24907,BEAUTY BERRY BASE FOUNDATION WITH PRIMER OIL FREE & WATER PROOF (IVORY),Warehouse B,97,79,2025-02-01 17:29:00,18
31771,ORD_31772,23002,Axime OZ 200mg/500mg Tablet,Warehouse B,29,22,2025-02-01 17:42:00,7
31772,ORD_31773,2796,St.Botanica Body Wash - Red Desire 250 ml,Warehouse C,104,85,2025-02-01 15:51:00,19
31773,ORD_31774,7776,TheGiftKart Shockproof Crystal Clear Back Cover Case for Vivo V27 / V27 PRO 5G | 360 Degree Protection | Protective Design...,Warehouse C,49,43,2025-02-01 19:21:00,6
31774,ORD_31775,20435,Totta Beauty Creamy Matte Long Lasting Lipsticks | Nude Affair | Vitamin E | Long Stay for 12 Hours | Waterproof | Keeps L...,Warehouse A,8,2,2025-02-01 13:39:00,6
31775,ORD_31776,2914,Azipan 500mg Tablet,Warehouse C,67,62,2025-02-01 19:09:00,5
31776,ORD_31777,24719,Flutivio Nasal Spray,Warehouse A,36,19,2025-02-01 23:18:00,17
31777,ORD_31778,16205,"Amkette 30 Pin to USB Charging & Data Sync Cable for iPhone 3G/3GS/4/4s/iPad 1/2/3, iPod Nano 5th/6th Gen and iPod Touch 3...",Warehouse C,95,77,2025-02-01 00:51:00,18
31778,ORD_31779,9719,Xmet-Trio 2mg/500mg/0.3mg Tablet,Warehouse C,92,87,2025-02-01 12:07:00,5
31779,ORD_31780,337,M.G.R.J® Tempered Glass Screen Protector for Samsung Galaxy Tab A 8.0 (SM-T295 / T290) (2019),Warehouse B,106,93,2025-02-01 18:21:00,13
31780,ORD_31781,27792,"Loofah/Sponge Scrubber/Body Bath  - Hangable, Off White, BH-021 WTE",Warehouse C,100,95,2025-02-01 03:13:00,5
31781,ORD_31782,9786,Makeup Revolution Super Serum Foundation F6 25 ml,Warehouse A,15,10,2025-02-01 23:32:00,5
31782,ORD_31783,36411,Zebicom Injection,Warehouse B,47,41,2025-02-01 23:53:00,6
31783,ORD_31784,16846,Vertishine 8mg Tablet,Warehouse B,109,90,2025-02-01 19:19:00,19
31784,ORD_31785,19804,Skin Cottage Bath + Scrub (Strawberry) 1000 ml,Warehouse C,17,10,2025-02-01 21:00:00,7
31785,ORD_31786,24760,"SanDisk Ultra Dual Drive Go USB Type C Pendrive for Mobile (Black, 128 GB, 5Y - SDDDC3-128G-I35)",Warehouse A,85,79,2025-02-01 07:20:00,6
31786,ORD_31787,5338,CEDO Samsung M31 / F41 / M31 Prime Flip Cover | Leather Finish | Inside Pockets & Inbuilt Stand | Shockproof Wallet Style ...,Warehouse C,60,51,2025-02-01 21:10:00,9
31787,ORD_31788,6722,Sitaglyn M IR 50/1000 Tablet,Warehouse A,22,15,2025-02-01 13:13:00,7
31788,ORD_31789,11725,Clavbel 400mg/57mg Oral Suspension,Warehouse C,41,35,2025-02-01 16:04:00,6
31789,ORD_31790,26997,Tycil 50mg Dry Syrup,Warehouse C,102,89,2025-02-01 18:59:00,13
31790,ORD_31791,16853,INDRICO® Extension Boards with Individual Switch of 4 Sockets with 5 Meter Long Cable PVC White,Warehouse B,52,41,2025-02-01 01:17:00,11
31791,ORD_31792,13192,Berina Hair Treatment Spa 100 gm,Warehouse A,45,30,2025-02-01 00:35:00,15
31792,ORD_31793,25005,I AM EYECONIC FINE GLITTER MERMAID KISS 4 gm,Warehouse A,100,91,2025-02-01 06:12:00,9
31793,ORD_31794,16854,Alten F 10/80 Tablet,Warehouse A,42,31,2025-02-01 16:00:00,11
31794,ORD_31795,25006,Itanil SP 100mg/325mg/15mg Tablet,Warehouse C,83,78,2025-02-01 12:25:00,5
31795,ORD_31796,5760,5IN1 GREEN TEA COMPACT AND SHINE FINISH CONCEALER WITH BRUSH COMPACT,Warehouse A,79,70,2025-02-01 10:01:00,9
31796,ORD_31797,6853,Cloza 100mg Tablet,Warehouse A,75,59,2025-02-01 02:05:00,16
31797,ORD_31798,16279,Halopidol 20mg Tablet,Warehouse A,89,82,2025-02-01 10:31:00,7
31798,ORD_31799,11385,THE LOVE CO. Vitamin C Toner With Rose Water 200Ml - Toner For Open Pores Tightening - Face Toner For Glowing Skin - Toner...,Warehouse A,99,83,2025-02-01 10:02:00,16
31799,ORD_31800,5364,Ciclogen-P Oral Suspension,Warehouse B,40,25,2025-02-01 14:42:00,15
31800,ORD_31801,13662,Carry 100mg Tablet,Warehouse C,85,68,2025-02-01 04:30:00,17
31801,ORD_31802,16364,Cewap Dry Syrup,Warehouse A,77,64,2025-02-01 00:21:00,13
31802,ORD_31803,23142,Coscuf-ALG Syrup,Warehouse A,69,52,2025-02-01 15:08:00,17
31803,ORD_31804,11435,Emcillin CV Dry Syrup,Warehouse A,34,15,2025-02-01 07:39:00,19
31804,ORD_31805,21747,Ajmal Amber Magic EDP Spicy Aromatic Perfume And Wisal Dhahab Deodorant Fruity Floral Fragrance 300 ml,Warehouse C,71,56,2025-02-01 05:54:00,15
31805,ORD_31806,36712,Telnem AM 40mg/5mg Tablet,Warehouse C,27,12,2025-02-01 15:07:00,15
31806,ORD_31807,22838,So Soft Wet Wipes - Aloe Vera Flavour,Warehouse C,84,71,2025-02-01 18:56:00,13
31807,ORD_31808,7763,Medimade Ginger & Tea Tree Premium Soap 100 gm,Warehouse C,100,85,2025-02-01 07:56:00,15
31808,ORD_31809,13678,Ajmal Blu & Silver Shade & Evoke silver Edition Homme & Shadow Homme Deo & Prose EDP Pack of 5 20 ml,Warehouse C,43,26,2025-02-01 13:14:00,17
31809,ORD_31810,27485,INEFABLE® Mi Band 3 & 4 Strap Original Compatible with Mi M3 & M4 with One Year Warranty - Device Not Included - Black - P...,Warehouse B,94,88,2025-02-01 10:43:00,6
31810,ORD_31811,27496,Evocet M Kid Tablet,Warehouse A,55,41,2025-02-01 10:57:00,14
31811,ORD_31812,27516,Fromelon  Eye Drops,Warehouse B,109,94,2025-02-01 02:25:00,15
31812,ORD_31813,16903,Meaxon Plus Injection,Warehouse A,61,51,2025-02-01 05:08:00,10
31813,ORD_31814,21486,Saniola Hand Sani Aloe & Basil 38 ml,Warehouse B,102,87,2025-02-01 14:47:00,15
31814,ORD_31815,2330,Quicktuss Mint Syrup,Warehouse A,105,94,2025-02-01 00:31:00,11
31815,ORD_31816,26632,Flexodin 50mg/750mg/250mg Tablet,Warehouse B,62,57,2025-02-01 13:03:00,5
31816,ORD_31817,5174,Acmerose 5 Tablet,Warehouse B,79,69,2025-02-01 04:14:00,10
31817,ORD_31818,16144,Axogrip NT Tablet SR,Warehouse C,101,92,2025-02-01 18:56:00,9
31818,ORD_31819,25073,Eyedol Eye Drop,Warehouse B,27,9,2025-02-01 12:14:00,18
31819,ORD_31820,33067,Amitril 10mg Tablet,Warehouse C,94,81,2025-02-01 14:58:00,13
31820,ORD_31821,13840,Hair Fall Control Shampoo B1G1 350 Ml,Warehouse B,60,42,2025-02-01 13:41:00,18
31821,ORD_31822,398,Naturals Sea Minerals Liquid Hand Wash,Warehouse B,23,15,2025-02-01 16:06:00,8
31822,ORD_31823,5158,TRIOHOMES Premium Collection Multicolor Medium Size Round Bindis for Women Combo Pack of 6,Warehouse A,111,95,2025-02-01 01:48:00,16
31823,ORD_31824,36421,Amizest 200mg Tablet,Warehouse C,48,32,2025-02-01 06:46:00,16
31824,ORD_31825,16980,Cgmide 1.5mg Tablet SR,Warehouse A,15,2,2025-02-01 02:49:00,13
31825,ORD_31826,360,Gesicare DP 50mg/325mg/15mg Tablet,Warehouse A,64,54,2025-02-01 15:02:00,10
31826,ORD_31827,26665,Beauty People Sheer Color Lipstick - 512 3.8 gm,Warehouse A,20,12,2025-02-01 03:06:00,8
31827,ORD_31828,6686,"Cosmic Byte CosmoBuds X100 True Wireless (TWS) in-Earbuds, BT 5.3, 40 Hrs Playtime, 38ms Latency, Music & GOD Mode, ENC, P...",Warehouse B,48,38,2025-02-01 00:45:00,10
31828,ORD_31829,23220,Rheza-Asp Capsule,Warehouse A,22,10,2025-02-01 16:03:00,12
31829,ORD_31830,2328,Wipeout Germ Killing Foot Cream,Warehouse A,75,67,2025-02-01 11:22:00,8
31830,ORD_31831,5211,"Lakmé 9 To 5 Primer+Matte Liquid Concealer, 5.4ml",Warehouse C,87,77,2025-02-01 18:41:00,10
31831,ORD_31832,7987,GALAKOL Tablets - The Natural Galactogogue,Warehouse C,101,87,2025-02-01 06:08:00,14
31832,ORD_31833,19551,Furabit Capsule,Warehouse B,93,76,2025-02-01 19:18:00,17
31833,ORD_31834,36445,Base Camp Cologne Spray & Ammunition Cologne Spray,Warehouse C,95,89,2025-02-01 00:21:00,6
31834,ORD_31835,2322,Bactopace 500mg Injection,Warehouse C,83,78,2025-02-01 14:01:00,5
31835,ORD_31836,9761,Liner Magique Eyeliner,Warehouse A,102,95,2025-02-01 01:17:00,7
31836,ORD_31837,9764,Sha Clove Pimple Cream,Warehouse B,87,75,2025-02-01 07:57:00,12
31837,ORD_31838,9768,"Nokia 5310 Dual SIM Keypad Phone with MP3 Player, Wireless FM Radio and Rear Camera with Flash | White/Red",Warehouse C,34,18,2025-02-01 22:01:00,16
31838,ORD_31839,24673,HUDA BB Professional Beauty Makeup Combo Kits For Girls & Women With All Products In 1-Kit Set Of 16,Warehouse A,19,7,2025-02-01 09:51:00,12
31839,ORD_31840,26657,"Samsung Galaxy Watch4 Bluetooth(44mm, Black, Compatible with Android only)",Warehouse B,95,77,2025-02-01 10:12:00,18
31840,ORD_31841,16239,Soulflower Coldpressed Argan Carrier Oil 30 ml,Warehouse C,41,34,2025-02-01 19:15:00,7
31841,ORD_31842,32138,Lambre PURE THERAPY FACE WASH GEL Oily and Mixed Skin 120ml,Warehouse A,22,4,2025-02-01 21:30:00,18
